Player_ID,Player Name,Position,Nationality,Age,Height,Year,TeamA,TeamB,Match_Date,Winner,Serve_Points,Serve_Errors,Serve_Attempts,Total_Serves,Set_Successes,Set_Errors,Set_Attempts,Total_Sets,Attack_Success,Attack Errors,Attack_Attempts,Total_Attacks,Block_Successful,Block_Errors,Block_Rebounds,Total_Blocks,Reception_Successful,Reception_Errors,Reception_Attemps,Total_Receptions,Dig_Success,Dig_Errors,Dig_Attempts,Total_Digs
142412.0,Sanchez Matias,S,Argentina,25.0,175.0,2021,Netherlands,Argentina,2021-06-05,True,0,0,0,0,0,0,0,0,0,0,0,0,0,0,0,0,0,0,0,0,0,0,0,0
142412.0,Sanchez Matias,S,Argentina,25.0,175.0,2021,Argentina,Australia,2021-06-10,True,1,1,12,14,34,0,39,73,2,0,0,2,0,1,0,1,0,0,0,0,3,4,0,7
142412.0,Sanchez Matias,S,Argentina,25.0,175.0,2021,Japan,Argentina,2021-06-11,True,0,0,1,1,7,0,6,13,0,0,0,0,0,0,0,0,0,0,0,0,0,0,0,0
142412.0,Sanchez Matias,S,Argentina,25.0,175.0,2021,Argentina,Bulgaria,2021-06-15,True,0,0,0,0,2,0,6,8,0,0,0,0,0,0,0,0,0,0,0,0,1,0,0,1
142412.0,Sanchez Matias,S,Argentina,25.0,175.0,2021,Argentina,Serbia,2021-06-17,True,1,1,11,13,25,0,22,47,0,0,0,0,0,0,0,0,0,0,0,0,5,0,1,6
142412.0,Sanchez Matias,S,Argentina,25.0,175.0,2021,France,Argentina,2021-06-22,False,0,0,1,1,2,0,5,7,0,0,0,0,0,0,0,0,0,0,0,0,0,0,0,0
142412.0,Sanchez Matias,S,Argentina,25.0,175.0,2021,Iran,Argentina,2021-06-23,True,0,0,0,0,2,0,2,4,0,0,0,0,0,0,0,0,0,0,0,0,1,0,0,1
117445.0,Pereyra Federico,O,Argentina,33.0,200.0,2021,Brazil,Argentina,2021-05-28,False,1,4,5,10,0,1,0,1,14,4,7,25,1,2,1,4,0,0,0,0,3,1,0,4
117445.0,Pereyra Federico,O,Argentina,33.0,200.0,2021,Argentina,Canada,2021-05-29,False,1,1,5,7,0,0,0,0,4,7,2,13,0,3,0,3,0,0,0,0,1,1,0,2
117445.0,Pereyra Federico,O,Argentina,33.0,200.0,2021,USA,Argentina,2021-05-30,False,0,3,8,11,0,0,4,4,7,8,7,22,1,0,0,1,0,0,0,0,1,0,0,1
117445.0,Pereyra Federico,O,Argentina,33.0,200.0,2021,Germany,Argentina,2021-06-03,True,1,5,12,18,0,0,0,0,20,4,9,33,1,2,1,4,0,0,0,0,6,1,0,7
117445.0,Pereyra Federico,O,Argentina,33.0,200.0,2021,Argentina,Slovenia,2021-06-04,False,0,3,3,6,0,0,2,2,4,7,9,20,0,1,1,2,0,0,0,0,1,0,2,3
117445.0,Pereyra Federico,O,Argentina,33.0,200.0,2021,Netherlands,Argentina,2021-06-05,True,1,3,7,11,0,0,2,2,8,6,9,23,6,2,2,10,0,0,0,0,2,5,0,7
117445.0,Pereyra Federico,O,Argentina,33.0,200.0,2021,Argentina,Italy,2021-06-09,False,0,0,0,0,0,0,0,0,1,0,2,3,0,1,0,1,0,0,0,0,0,0,0,0
117445.0,Pereyra Federico,O,Argentina,33.0,200.0,2021,Argentina,Australia,2021-06-10,True,3,4,7,14,0,0,1,1,12,4,5,21,0,3,0,3,0,0,0,0,2,1,0,3
117445.0,Pereyra Federico,O,Argentina,33.0,200.0,2021,Japan,Argentina,2021-06-11,True,2,4,10,16,0,0,2,2,18,6,12,36,2,3,6,11,0,0,0,0,5,0,0,5
117445.0,Pereyra Federico,O,Argentina,33.0,200.0,2021,Argentina,Bulgaria,2021-06-15,True,0,0,1,1,0,0,0,0,2,0,0,2,0,0,0,0,0,0,0,0,2,1,0,3
117445.0,Pereyra Federico,O,Argentina,33.0,200.0,2021,Argentina,Russia,2021-06-16,False,1,2,3,6,0,0,1,1,15,6,5,26,0,3,1,4,0,0,1,1,0,2,0,2
117445.0,Pereyra Federico,O,Argentina,33.0,200.0,2021,Argentina,Serbia,2021-06-17,True,0,1,1,2,0,0,0,0,6,1,2,9,0,0,1,1,0,0,0,0,0,0,0,0
117445.0,Pereyra Federico,O,Argentina,33.0,200.0,2021,Poland,Argentina,2021-06-21,False,0,2,6,8,0,0,1,1,10,3,3,16,0,1,0,1,0,0,0,0,2,1,2,5
117445.0,Pereyra Federico,O,Argentina,33.0,200.0,2021,France,Argentina,2021-06-22,False,0,0,2,2,0,0,0,0,2,0,1,3,0,0,0,0,0,0,0,0,0,1,0,1
117445.0,Pereyra Federico,O,Argentina,33.0,200.0,2021,Iran,Argentina,2021-06-23,True,0,0,0,0,0,0,0,0,2,0,0,2,1,0,0,1,0,0,0,0,0,0,0,0
142410.0,Martinez Franchi Jan,U,Argentina,24.0,190.0,2021,Brazil,Argentina,2021-05-28,False,0,2,8,10,0,0,0,0,4,1,8,13,0,0,0,0,4,0,8,12,4,1,0,5
142410.0,Martinez Franchi Jan,U,Argentina,24.0,190.0,2021,Argentina,Canada,2021-05-29,False,0,0,0,0,0,0,1,1,0,0,0,0,0,0,0,0,6,1,8,15,4,3,0,7
142410.0,Martinez Franchi Jan,U,Argentina,24.0,190.0,2021,USA,Argentina,2021-05-30,False,0,1,12,13,0,0,5,5,9,4,13,26,0,3,0,3,4,0,14,18,4,1,0,5
142410.0,Martinez Franchi Jan,U,Argentina,24.0,190.0,2021,Germany,Argentina,2021-06-03,True,0,3,14,17,0,0,0,0,18,2,12,32,1,4,0,5,6,1,16,23,10,0,0,10
142410.0,Martinez Franchi Jan,U,Argentina,24.0,190.0,2021,Argentina,Slovenia,2021-06-04,False,0,3,7,10,0,0,4,4,7,1,9,17,0,1,0,1,5,0,14,19,9,1,0,10
142410.0,Martinez Franchi Jan,U,Argentina,24.0,190.0,2021,Netherlands,Argentina,2021-06-05,True,0,0,0,0,0,0,0,0,0,0,0,0,0,0,0,0,0,0,0,0,0,0,0,0
142410.0,Martinez Franchi Jan,U,Argentina,24.0,190.0,2021,Argentina,Italy,2021-06-09,False,0,0,5,5,0,0,0,0,5,3,8,16,0,0,0,0,5,2,6,13,2,0,0,2
142410.0,Martinez Franchi Jan,U,Argentina,24.0,190.0,2021,Argentina,Australia,2021-06-10,True,0,2,13,15,0,0,1,1,8,2,7,17,1,3,2,6,9,0,9,18,5,0,0,5
142410.0,Martinez Franchi Jan,U,Argentina,24.0,190.0,2021,Japan,Argentina,2021-06-11,True,0,0,0,0,0,0,0,0,0,0,0,0,0,0,0,0,0,0,0,0,0,0,0,0
142410.0,Martinez Franchi Jan,U,Argentina,24.0,190.0,2021,Poland,Argentina,2021-06-21,False,0,0,0,0,0,0,0,0,0,0,0,0,0,0,0,0,0,0,0,0,0,0,0,0
142410.0,Martinez Franchi Jan,U,Argentina,24.0,190.0,2021,France,Argentina,2021-06-22,False,0,0,0,0,0,0,0,0,0,0,0,0,0,0,0,0,0,0,0,0,0,0,0,0
142410.0,Martinez Franchi Jan,U,Argentina,24.0,190.0,2021,Iran,Argentina,2021-06-23,True,0,0,0,0,0,0,0,0,0,0,0,0,0,0,0,0,0,0,0,0,0,0,0,0
119846.0,Uriarte Nicolas,S,Argentina,32.0,192.0,2021,Brazil,Argentina,2021-05-28,False,0,0,1,1,0,0,0,0,0,0,0,0,0,0,0,0,0,0,0,0,0,0,0,0
119846.0,Uriarte Nicolas,S,Argentina,32.0,192.0,2021,Argentina,Canada,2021-05-29,False,0,1,4,5,9,0,22,31,1,0,1,2,1,3,1,5,0,0,0,0,0,0,0,0
119846.0,Uriarte Nicolas,S,Argentina,32.0,192.0,2021,USA,Argentina,2021-05-30,False,0,0,2,2,6,0,8,14,0,0,0,0,1,0,1,2,0,0,0,0,1,1,0,2
119846.0,Uriarte Nicolas,S,Argentina,32.0,192.0,2021,Germany,Argentina,2021-06-03,True,0,0,3,3,2,1,4,7,0,0,0,0,0,0,0,0,0,0,0,0,1,1,0,2
119846.0,Uriarte Nicolas,S,Argentina,32.0,192.0,2021,Argentina,Slovenia,2021-06-04,False,0,0,4,4,15,0,24,39,0,0,1,1,2,0,3,5,0,0,0,0,2,0,1,3
119846.0,Uriarte Nicolas,S,Argentina,32.0,192.0,2021,Argentina,Italy,2021-06-09,False,0,2,3,5,16,0,38,54,0,0,3,3,0,0,1,1,0,0,1,1,0,1,0,1
119846.0,Uriarte Nicolas,S,Argentina,32.0,192.0,2021,Argentina,Australia,2021-06-10,True,0,0,0,0,0,0,0,0,0,0,0,0,0,0,0,0,0,0,0,0,0,0,0,0
119846.0,Uriarte Nicolas,S,Argentina,32.0,192.0,2021,Japan,Argentina,2021-06-11,True,0,1,0,1,0,0,0,0,0,0,0,0,0,0,0,0,0,0,0,0,0,0,0,0
119846.0,Uriarte Nicolas,S,Argentina,32.0,192.0,2021,Argentina,Russia,2021-06-16,False,0,0,7,7,14,0,35,49,2,0,1,3,0,0,1,1,0,0,0,0,6,1,1,8
119846.0,Uriarte Nicolas,S,Argentina,32.0,192.0,2021,Poland,Argentina,2021-06-21,False,0,1,4,5,16,0,26,42,0,0,0,0,1,0,1,2,0,0,0,0,1,1,0,2
119853.0,Poglajen Cristian,OH,Argentina,32.0,195.0,2021,Germany,Argentina,2021-06-03,True,0,0,0,0,0,0,0,0,0,0,0,0,0,0,0,0,0,0,0,0,0,0,0,0
119853.0,Poglajen Cristian,OH,Argentina,32.0,195.0,2021,Argentina,Slovenia,2021-06-04,False,0,0,5,5,0,0,0,0,4,2,6,12,0,2,3,5,1,1,9,11,5,2,0,7
119853.0,Poglajen Cristian,OH,Argentina,32.0,195.0,2021,Netherlands,Argentina,2021-06-05,True,0,2,12,14,0,0,1,1,6,1,2,9,0,3,0,3,5,2,7,14,3,1,0,4
119853.0,Poglajen Cristian,OH,Argentina,32.0,195.0,2021,Argentina,Australia,2021-06-10,True,0,0,0,0,0,0,0,0,0,0,0,0,0,0,0,0,0,0,0,0,0,0,0,0
119853.0,Poglajen Cristian,OH,Argentina,32.0,195.0,2021,Japan,Argentina,2021-06-11,True,1,0,12,13,0,0,8,8,12,2,11,25,1,2,5,8,11,1,11,23,10,1,1,12
119853.0,Poglajen Cristian,OH,Argentina,32.0,195.0,2021,Argentina,Bulgaria,2021-06-15,True,0,0,0,0,0,0,0,0,0,0,0,0,0,0,0,0,0,0,0,0,0,0,0,0
119853.0,Poglajen Cristian,OH,Argentina,32.0,195.0,2021,Argentina,Russia,2021-06-16,False,0,3,8,11,0,0,3,3,5,4,6,15,0,3,2,5,3,3,16,22,6,0,0,6
119853.0,Poglajen Cristian,OH,Argentina,32.0,195.0,2021,Argentina,Serbia,2021-06-17,True,0,0,0,0,0,0,0,0,0,0,0,0,0,0,0,0,0,0,0,0,0,0,0,0
119853.0,Poglajen Cristian,OH,Argentina,32.0,195.0,2021,Poland,Argentina,2021-06-21,False,0,3,7,10,0,0,1,1,7,0,8,15,0,0,3,3,3,3,7,13,3,3,1,7
119853.0,Poglajen Cristian,OH,Argentina,32.0,195.0,2021,France,Argentina,2021-06-22,False,0,2,3,5,0,0,2,2,1,1,4,6,0,0,0,0,2,2,12,16,4,1,0,5
119853.0,Poglajen Cristian,OH,Argentina,32.0,195.0,2021,Iran,Argentina,2021-06-23,True,0,4,17,21,0,0,1,1,10,5,14,29,2,3,3,8,3,1,16,20,8,0,1,9
118886.0,Conte Facundo,OH,Argentina,32.0,197.0,2021,Brazil,Argentina,2021-05-28,False,1,3,9,13,0,0,0,0,9,7,4,20,3,2,0,5,7,6,15,28,4,1,0,5
118886.0,Conte Facundo,OH,Argentina,32.0,197.0,2021,Argentina,Canada,2021-05-29,False,0,4,7,11,0,1,0,1,7,3,8,18,1,2,0,3,3,2,12,17,6,1,0,7
118886.0,Conte Facundo,OH,Argentina,32.0,197.0,2021,USA,Argentina,2021-05-30,False,1,4,9,14,0,0,6,6,7,4,11,22,1,2,1,4,7,2,13,22,6,3,0,9
118886.0,Conte Facundo,OH,Argentina,32.0,197.0,2021,Germany,Argentina,2021-06-03,True,0,0,0,0,0,0,0,0,0,0,0,0,0,0,0,0,0,0,0,0,0,0,0,0
118886.0,Conte Facundo,OH,Argentina,32.0,197.0,2021,Argentina,Slovenia,2021-06-04,False,0,0,0,0,0,0,0,0,0,0,0,0,0,0,0,0,0,0,0,0,0,0,0,0
118886.0,Conte Facundo,OH,Argentina,32.0,197.0,2021,Netherlands,Argentina,2021-06-05,True,0,2,8,10,0,0,1,1,12,1,12,25,2,2,1,5,9,1,13,23,5,1,0,6
118886.0,Conte Facundo,OH,Argentina,32.0,197.0,2021,Argentina,Italy,2021-06-09,False,0,0,4,4,0,0,1,1,0,4,6,10,1,0,0,1,3,2,7,12,2,1,0,3
118886.0,Conte Facundo,OH,Argentina,32.0,197.0,2021,Argentina,Australia,2021-06-10,True,0,0,0,0,0,0,0,0,0,0,0,0,0,0,0,0,0,0,0,0,0,0,0,0
118886.0,Conte Facundo,OH,Argentina,32.0,197.0,2021,Japan,Argentina,2021-06-11,True,0,2,15,17,0,0,4,4,9,6,17,32,3,4,0,7,7,0,17,24,8,7,1,16
118886.0,Conte Facundo,OH,Argentina,32.0,197.0,2021,Argentina,Bulgaria,2021-06-15,True,0,5,10,15,0,0,3,3,12,1,8,21,0,3,3,6,3,2,10,15,9,3,0,12
118886.0,Conte Facundo,OH,Argentina,32.0,197.0,2021,Argentina,Russia,2021-06-16,False,0,4,10,14,0,0,10,10,7,6,10,23,0,2,1,3,4,0,22,26,7,1,2,10
118886.0,Conte Facundo,OH,Argentina,32.0,197.0,2021,Argentina,Serbia,2021-06-17,True,0,2,8,10,0,0,3,3,12,2,6,20,2,3,2,7,5,1,13,19,3,2,1,6
118886.0,Conte Facundo,OH,Argentina,32.0,197.0,2021,Poland,Argentina,2021-06-21,False,0,3,8,11,0,0,0,0,4,2,10,16,0,3,1,4,7,2,16,25,8,2,0,10
118886.0,Conte Facundo,OH,Argentina,32.0,197.0,2021,France,Argentina,2021-06-22,False,0,2,6,8,0,0,1,1,4,2,4,10,3,2,0,5,4,0,12,16,2,1,2,5
118886.0,Conte Facundo,OH,Argentina,32.0,197.0,2021,Iran,Argentina,2021-06-23,True,0,4,10,14,0,0,2,2,9,5,4,18,2,2,2,6,8,2,24,34,8,2,0,10
152692.0,Loser Agustin,MB,Argentina,24.0,198.0,2021,Germany,Argentina,2021-06-03,True,0,5,11,16,0,0,1,1,9,2,3,14,1,8,3,12,1,0,0,1,4,0,0,4
152692.0,Loser Agustin,MB,Argentina,24.0,198.0,2021,Argentina,Slovenia,2021-06-04,False,0,0,0,0,0,0,0,0,0,0,0,0,0,0,0,0,0,0,0,0,0,0,0,0
152692.0,Loser Agustin,MB,Argentina,24.0,198.0,2021,Netherlands,Argentina,2021-06-05,True,1,2,9,12,0,0,0,0,8,1,1,10,1,3,2,6,1,0,0,1,0,1,0,1
152692.0,Loser Agustin,MB,Argentina,24.0,198.0,2021,Argentina,Italy,2021-06-09,False,1,3,5,9,0,0,0,0,3,0,1,4,4,0,2,6,0,1,2,3,0,1,0,1
152692.0,Loser Agustin,MB,Argentina,24.0,198.0,2021,Argentina,Australia,2021-06-10,True,0,3,8,11,0,0,2,2,13,1,5,19,1,3,1,5,0,0,0,0,5,0,0,5
152692.0,Loser Agustin,MB,Argentina,24.0,198.0,2021,Japan,Argentina,2021-06-11,True,2,2,14,18,0,0,2,2,9,0,3,12,1,5,2,8,0,0,3,3,2,0,1,3
152692.0,Loser Agustin,MB,Argentina,24.0,198.0,2021,Argentina,Bulgaria,2021-06-15,True,2,5,10,17,0,0,0,0,7,0,0,7,1,5,5,11,0,0,2,2,2,1,0,3
152692.0,Loser Agustin,MB,Argentina,24.0,198.0,2021,Argentina,Russia,2021-06-16,False,1,2,12,15,0,0,0,0,7,1,5,13,2,3,3,8,0,0,0,0,4,1,1,6
152692.0,Loser Agustin,MB,Argentina,24.0,198.0,2021,Argentina,Serbia,2021-06-17,True,1,2,14,17,0,0,0,0,8,1,5,14,3,3,2,8,0,0,1,1,3,2,0,5
152692.0,Loser Agustin,MB,Argentina,24.0,198.0,2021,Poland,Argentina,2021-06-21,False,1,5,5,11,0,0,2,2,4,0,4,8,0,7,7,14,0,0,0,0,0,0,1,1
152692.0,Loser Agustin,MB,Argentina,24.0,198.0,2021,France,Argentina,2021-06-22,False,0,2,6,8,0,0,1,1,8,1,3,12,0,6,3,9,0,0,0,0,3,0,0,3
152692.0,Loser Agustin,MB,Argentina,24.0,198.0,2021,Iran,Argentina,2021-06-23,True,0,4,15,19,0,0,0,0,10,1,2,13,2,3,3,8,0,1,2,3,1,2,1,4
153053.0,Danani Santiago,L,Argentina,26.0,176.0,2021,Argentina,Italy,2021-06-09,False,0,0,0,0,0,0,4,4,0,0,0,0,0,0,0,0,4,0,7,11,7,6,1,14
153053.0,Danani Santiago,L,Argentina,26.0,176.0,2021,Argentina,Bulgaria,2021-06-15,True,0,0,0,0,0,0,5,5,0,0,0,0,0,0,0,0,8,0,14,22,9,1,1,11
153053.0,Danani Santiago,L,Argentina,26.0,176.0,2021,Argentina,Russia,2021-06-16,False,0,0,0,0,0,0,3,3,0,0,0,0,0,0,0,0,5,0,12,17,13,2,1,16
153053.0,Danani Santiago,L,Argentina,26.0,176.0,2021,Argentina,Serbia,2021-06-17,True,0,0,0,0,0,0,4,4,0,0,0,0,0,0,0,0,6,1,8,15,7,1,1,9
153053.0,Danani Santiago,L,Argentina,26.0,176.0,2021,Poland,Argentina,2021-06-21,False,0,0,0,0,0,0,1,1,0,0,0,0,0,0,0,0,2,2,13,17,4,4,1,9
153053.0,Danani Santiago,L,Argentina,26.0,176.0,2021,France,Argentina,2021-06-22,False,0,0,0,0,0,0,6,6,0,0,0,0,0,0,0,0,1,1,6,8,7,4,2,13
153053.0,Danani Santiago,L,Argentina,26.0,176.0,2021,Iran,Argentina,2021-06-23,True,0,0,0,0,0,0,6,6,0,0,0,0,0,0,0,0,10,1,15,26,6,5,2,13
136737.0,Lazo Nicolás,OH,Argentina,26.0,192.0,2021,Argentina,Italy,2021-06-09,False,0,0,6,6,0,0,0,0,4,4,9,17,2,0,0,2,2,0,5,7,1,1,0,2
136737.0,Lazo Nicolás,OH,Argentina,26.0,192.0,2021,Argentina,Bulgaria,2021-06-15,True,0,1,4,5,0,0,0,0,5,4,2,11,1,2,0,3,1,1,6,8,3,1,0,4
136737.0,Lazo Nicolás,OH,Argentina,26.0,192.0,2021,Argentina,Russia,2021-06-16,False,0,0,0,0,0,0,0,0,0,0,0,0,0,0,0,0,0,0,0,0,0,0,0,0
136737.0,Lazo Nicolás,OH,Argentina,26.0,192.0,2021,Argentina,Serbia,2021-06-17,True,0,0,0,0,0,0,0,0,0,0,0,0,0,0,0,0,0,0,0,0,0,0,0,0
136737.0,Lazo Nicolás,OH,Argentina,26.0,192.0,2021,Poland,Argentina,2021-06-21,False,0,0,0,0,0,0,0,0,0,0,0,0,0,0,0,0,0,0,0,0,0,0,0,0
133730.0,Solé Sebastian,MB,Italy,30.0,200.0,2021,Brazil,Argentina,2021-05-28,False,0,2,8,10,0,0,0,0,5,0,5,10,2,9,2,13,0,0,2,2,2,0,0,2
133730.0,Solé Sebastian,MB,Italy,30.0,200.0,2021,Argentina,Canada,2021-05-29,False,0,1,8,9,0,0,0,0,4,2,4,10,1,1,2,4,1,0,1,2,2,0,0,2
133730.0,Solé Sebastian,MB,Italy,30.0,200.0,2021,USA,Argentina,2021-05-30,False,0,1,9,10,0,0,0,0,3,0,2,5,2,2,2,6,1,0,1,2,0,0,0,0
133730.0,Solé Sebastian,MB,Italy,30.0,200.0,2021,Germany,Argentina,2021-06-03,False,0,5,12,17,0,0,0,0,11,1,2,14,2,7,4,13,2,0,0,2,5,1,0,6
133730.0,Solé Sebastian,MB,Italy,30.0,200.0,2021,Argentina,Slovenia,2021-06-04,False,0,0,0,0,0,0,0,0,0,0,0,0,0,0,0,0,0,0,0,0,0,0,0,0
133730.0,Solé Sebastian,MB,Italy,30.0,200.0,2021,Netherlands,Argentina,2021-06-05,False,0,0,10,10,1,0,0,1,8,0,2,10,1,2,1,4,0,0,0,0,1,1,0,2
133730.0,Solé Sebastian,MB,Italy,30.0,200.0,2021,Argentina,Italy,2021-06-09,True,0,2,15,17,0,0,1,1,6,1,7,14,2,3,3,8,0,0,1,1,2,0,0,2
133730.0,Solé Sebastian,MB,Italy,30.0,200.0,2021,Argentina,Australia,2021-06-10,False,0,0,0,0,0,0,0,0,0,0,0,0,0,0,0,0,0,0,0,0,0,0,0,0
133730.0,Solé Sebastian,MB,Italy,30.0,200.0,2021,Japan,Argentina,2021-06-11,False,0,2,17,19,0,0,0,0,11,1,5,17,1,4,13,18,2,0,1,3,6,2,0,8
133730.0,Solé Sebastian,MB,Italy,30.0,200.0,2021,Argentina,Bulgaria,2021-06-15,False,0,2,12,14,0,0,1,1,6,1,5,12,1,5,7,13,1,0,0,1,1,0,0,1
133730.0,Solé Sebastian,MB,Italy,30.0,200.0,2021,Argentina,Russia,2021-06-16,False,1,1,17,19,0,0,2,2,5,0,7,12,3,2,8,13,0,0,0,0,5,0,0,5
142415.0,Lima Bruno,O,Argentina,26.0,198.0,2021,Argentina,Italy,2021-06-09,False,0,5,6,11,0,0,0,0,10,8,4,22,0,0,3,3,1,0,0,1,4,2,0,6
142415.0,Lima Bruno,O,Argentina,26.0,198.0,2021,Argentina,Bulgaria,2021-06-15,True,2,3,10,15,0,0,1,1,14,6,4,24,0,5,3,8,0,0,0,0,2,2,1,5
142415.0,Lima Bruno,O,Argentina,26.0,198.0,2021,Argentina,Russia,2021-06-16,False,0,3,3,6,0,0,1,1,6,5,4,15,0,0,1,1,0,0,0,0,2,1,1,4
142415.0,Lima Bruno,O,Argentina,26.0,198.0,2021,Argentina,Serbia,2021-06-17,True,0,1,3,4,0,0,0,0,9,4,4,17,1,3,4,8,0,0,0,0,0,1,0,1
142415.0,Lima Bruno,O,Argentina,26.0,198.0,2021,Poland,Argentina,2021-06-21,False,0,1,4,5,0,0,0,0,4,1,3,8,0,1,0,1,0,0,0,0,1,1,0,2
142415.0,Lima Bruno,O,Argentina,26.0,198.0,2021,France,Argentina,2021-06-22,False,0,3,8,11,0,0,1,1,10,4,5,19,1,2,1,4,0,0,0,0,3,0,0,3
142415.0,Lima Bruno,O,Argentina,26.0,198.0,2021,Iran,Argentina,2021-06-23,True,1,6,9,16,0,0,1,1,23,3,9,35,0,8,2,10,0,0,1,1,6,1,1,8
125048.0,Palacios Ezequiel,OH,Argentina,29.0,198.0,2021,Germany,Argentina,2021-06-03,True,0,0,0,0,0,0,0,0,0,2,1,3,0,0,0,0,0,0,0,0,1,0,0,1
125048.0,Palacios Ezequiel,OH,Argentina,29.0,198.0,2021,Argentina,Slovenia,2021-06-04,False,0,0,0,0,0,0,0,0,0,0,0,0,0,0,0,0,0,0,0,0,0,0,0,0
125048.0,Palacios Ezequiel,OH,Argentina,29.0,198.0,2021,Netherlands,Argentina,2021-06-05,True,0,0,0,0,0,0,0,0,0,0,0,0,0,0,0,0,0,0,1,1,0,1,0,1
125048.0,Palacios Ezequiel,OH,Argentina,29.0,198.0,2021,Argentina,Australia,2021-06-10,True,0,0,0,0,0,0,0,0,0,0,0,0,0,0,0,0,0,0,0,0,0,0,0,0
125048.0,Palacios Ezequiel,OH,Argentina,29.0,198.0,2021,Japan,Argentina,2021-06-11,True,0,0,0,0,0,0,0,0,0,0,0,0,0,0,0,0,0,0,0,0,0,0,0,0
125048.0,Palacios Ezequiel,OH,Argentina,29.0,198.0,2021,Argentina,Bulgaria,2021-06-15,True,2,1,8,11,0,0,0,0,7,1,5,13,0,0,3,3,7,1,9,17,3,2,0,5
125048.0,Palacios Ezequiel,OH,Argentina,29.0,198.0,2021,Argentina,Russia,2021-06-16,False,0,1,1,2,0,0,0,0,1,2,3,6,0,0,0,0,2,0,5,7,2,0,0,2
125048.0,Palacios Ezequiel,OH,Argentina,29.0,198.0,2021,Argentina,Serbia,2021-06-17,True,1,5,6,12,0,1,2,3,4,2,3,9,0,2,0,2,9,0,12,21,5,0,1,6
125048.0,Palacios Ezequiel,OH,Argentina,29.0,198.0,2021,Poland,Argentina,2021-06-21,False,0,0,0,0,0,0,0,0,0,0,0,0,0,0,0,0,0,0,0,0,0,0,0,0
125048.0,Palacios Ezequiel,OH,Argentina,29.0,198.0,2021,France,Argentina,2021-06-22,False,0,3,2,5,0,0,1,1,4,1,4,9,2,0,1,3,3,1,4,8,0,1,0,1
125048.0,Palacios Ezequiel,OH,Argentina,29.0,198.0,2021,Iran,Argentina,2021-06-23,True,0,0,0,0,0,0,0,0,0,0,0,0,0,0,0,0,0,0,0,0,0,0,0,0
119851.0,Crer Pablo,MB,Argentina,32.0,202.0,2021,Germany,Argentina,2021-06-03,True,0,0,0,0,0,0,0,0,0,0,0,0,0,0,0,0,0,0,0,0,0,0,0,0
119851.0,Crer Pablo,MB,Argentina,32.0,202.0,2021,Argentina,Slovenia,2021-06-04,False,0,1,11,12,0,0,1,1,6,1,2,9,2,2,2,6,0,0,1,1,3,1,1,5
119851.0,Crer Pablo,MB,Argentina,32.0,202.0,2021,Netherlands,Argentina,2021-06-05,True,0,0,0,0,0,0,0,0,0,0,0,0,0,0,0,0,0,0,0,0,0,0,0,0
117457.0,De Cecco Luciano,S,Argentina,33.0,191.0,2021,Brazil,Argentina,2021-05-28,False,0,2,13,15,22,1,51,74,0,0,1,1,3,1,0,4,0,0,0,0,0,2,0,2
117457.0,De Cecco Luciano,S,Argentina,33.0,191.0,2021,Argentina,Canada,2021-05-29,False,0,2,2,4,9,0,28,37,0,0,2,2,0,0,0,0,0,0,0,0,0,1,0,1
117457.0,De Cecco Luciano,S,Argentina,33.0,191.0,2021,USA,Argentina,2021-05-30,False,0,3,8,11,22,0,43,65,1,0,3,4,0,1,1,2,0,0,2,2,2,0,1,3
117457.0,De Cecco Luciano,S,Argentina,33.0,191.0,2021,Germany,Argentina,2021-06-03,True,1,4,11,16,35,1,82,118,3,1,2,6,0,2,4,6,0,0,0,0,6,3,0,9
117457.0,De Cecco Luciano,S,Argentina,33.0,191.0,2021,Argentina,Slovenia,2021-06-04,False,0,1,6,7,11,0,23,34,0,0,0,0,0,0,2,2,0,0,1,1,1,1,2,4
117457.0,De Cecco Luciano,S,Argentina,33.0,191.0,2021,Netherlands,Argentina,2021-06-05,True,0,0,17,17,24,0,49,73,1,0,3,4,0,0,1,1,0,1,0,1,1,2,0,3
117457.0,De Cecco Luciano,S,Argentina,33.0,191.0,2021,Argentina,Italy,2021-06-09,False,0,0,5,5,7,0,32,39,0,0,0,0,0,1,0,1,0,0,0,0,1,0,0,1
117457.0,De Cecco Luciano,S,Argentina,33.0,191.0,2021,Argentina,Australia,2021-06-10,True,0,0,0,0,0,0,0,0,0,0,0,0,0,0,0,0,0,0,0,0,0,0,0,0
117457.0,De Cecco Luciano,S,Argentina,33.0,191.0,2021,Japan,Argentina,2021-06-11,True,1,3,13,17,41,0,52,93,1,0,1,2,1,2,1,4,0,0,0,0,10,4,2,16
117457.0,De Cecco Luciano,S,Argentina,33.0,191.0,2021,Argentina,Bulgaria,2021-06-15,True,0,2,10,12,20,0,56,76,1,0,1,2,0,1,3,4,0,0,0,0,4,3,1,8
117457.0,De Cecco Luciano,S,Argentina,33.0,191.0,2021,Argentina,Russia,2021-06-16,False,1,0,6,7,11,1,30,42,0,0,1,1,0,2,1,3,0,1,0,1,5,0,0,5
117457.0,De Cecco Luciano,S,Argentina,33.0,191.0,2021,Argentina,Serbia,2021-06-17,True,0,1,5,6,11,0,13,24,0,0,0,0,0,0,0,0,0,0,0,0,1,0,1,2
117457.0,De Cecco Luciano,S,Argentina,33.0,191.0,2021,Poland,Argentina,2021-06-21,False,0,0,2,2,10,0,16,26,0,0,0,0,0,0,0,0,0,0,0,0,0,0,0,0
117457.0,De Cecco Luciano,S,Argentina,33.0,191.0,2021,France,Argentina,2021-06-22,False,0,0,10,10,23,1,32,56,0,0,0,0,0,2,1,3,0,0,1,1,4,0,0,4
117457.0,De Cecco Luciano,S,Argentina,33.0,191.0,2021,Iran,Argentina,2021-06-23,True,1,2,14,17,40,1,57,98,1,0,0,1,2,2,0,4,0,0,1,1,2,1,0,3
162546.0,Palonsky Luciano,OH,Argentina,22.0,198.0,2021,Brazil,Argentina,2021-05-28,False,0,0,1,1,0,0,0,0,1,0,1,2,0,0,0,0,0,1,2,3,1,2,0,3
162546.0,Palonsky Luciano,OH,Argentina,22.0,198.0,2021,Argentina,Canada,2021-05-29,False,0,2,1,3,0,0,0,0,2,1,4,7,0,0,0,0,0,0,0,0,1,2,0,3
162546.0,Palonsky Luciano,OH,Argentina,22.0,198.0,2021,USA,Argentina,2021-05-30,False,0,1,6,7,0,0,0,0,5,4,4,13,1,0,0,1,0,0,0,0,1,1,0,2
162546.0,Palonsky Luciano,OH,Argentina,22.0,198.0,2021,Germany,Argentina,2021-06-03,True,0,1,1,2,0,0,0,0,1,0,2,3,0,0,0,0,0,0,0,0,0,0,0,0
162546.0,Palonsky Luciano,OH,Argentina,22.0,198.0,2021,Argentina,Slovenia,2021-06-04,False,0,1,4,5,0,0,1,1,4,2,4,10,0,1,0,1,0,0,0,0,4,2,0,6
162546.0,Palonsky Luciano,OH,Argentina,22.0,198.0,2021,Netherlands,Argentina,2021-06-05,True,0,0,0,0,0,0,0,0,0,0,0,0,0,0,0,0,0,0,0,0,0,0,0,0
162546.0,Palonsky Luciano,OH,Argentina,22.0,198.0,2021,Argentina,Italy,2021-06-09,False,0,0,0,0,0,0,0,0,0,0,0,0,0,0,0,0,0,0,0,0,0,0,0,0
162546.0,Palonsky Luciano,OH,Argentina,22.0,198.0,2021,Argentina,Australia,2021-06-10,True,0,0,0,0,0,0,0,0,0,0,0,0,0,0,0,0,0,0,0,0,0,0,0,0
162546.0,Palonsky Luciano,OH,Argentina,22.0,198.0,2021,Japan,Argentina,2021-06-11,True,0,0,2,2,0,0,0,0,1,1,1,3,0,1,0,1,0,0,0,0,0,0,0,0
162546.0,Palonsky Luciano,OH,Argentina,22.0,198.0,2021,Argentina,Serbia,2021-06-17,True,0,0,0,0,0,0,0,0,0,0,0,0,0,0,0,0,0,0,0,0,0,0,0,0
162546.0,Palonsky Luciano,OH,Argentina,22.0,198.0,2021,France,Argentina,2021-06-22,False,0,0,0,0,0,0,0,0,0,0,0,0,0,0,0,0,0,0,0,0,0,0,0,0
162546.0,Palonsky Luciano,OH,Argentina,22.0,198.0,2021,Iran,Argentina,2021-06-23,True,0,0,0,0,0,0,0,0,0,0,0,0,0,0,0,0,0,0,0,0,0,0,0,0
125049.0,Mendez Nicolas,OH,Argentina,29.0,191.0,2021,Brazil,Argentina,2021-05-28,False,0,0,0,0,0,0,1,1,0,0,0,0,0,0,0,0,8,0,19,27,6,2,0,8
125049.0,Mendez Nicolas,OH,Argentina,29.0,191.0,2021,Argentina,Canada,2021-05-29,False,0,3,5,8,0,0,0,0,6,6,3,15,1,0,0,1,4,1,18,23,3,3,1,7
125049.0,Mendez Nicolas,OH,Argentina,29.0,191.0,2021,USA,Argentina,2021-05-30,False,0,0,0,0,0,0,3,3,0,0,0,0,0,0,0,0,4,3,20,27,12,5,1,18
125049.0,Mendez Nicolas,OH,Argentina,29.0,191.0,2021,Germany,Argentina,2021-06-03,True,0,3,13,16,0,0,4,4,8,5,17,30,3,1,2,6,11,2,20,33,6,4,3,13
125049.0,Mendez Nicolas,OH,Argentina,29.0,191.0,2021,Argentina,Slovenia,2021-06-04,False,0,1,2,3,0,0,1,1,2,1,6,9,2,2,1,5,3,1,11,15,2,0,0,2
125049.0,Mendez Nicolas,OH,Argentina,29.0,191.0,2021,Netherlands,Argentina,2021-06-05,True,0,0,0,0,0,0,0,0,0,0,0,0,0,0,0,0,0,0,0,0,0,0,0,0
125049.0,Mendez Nicolas,OH,Argentina,29.0,191.0,2021,Argentina,Italy,2021-06-09,False,0,2,5,7,0,0,2,2,8,1,4,13,0,1,1,2,3,1,10,14,1,3,0,4
125049.0,Mendez Nicolas,OH,Argentina,29.0,191.0,2021,Argentina,Australia,2021-06-10,True,0,0,10,10,0,0,2,2,9,2,2,13,0,2,0,2,9,1,10,20,3,1,0,4
125049.0,Mendez Nicolas,OH,Argentina,29.0,191.0,2021,Japan,Argentina,2021-06-11,True,0,0,0,0,0,0,0,0,0,0,0,0,0,0,0,0,0,0,0,0,0,0,0,0
125049.0,Mendez Nicolas,OH,Argentina,29.0,191.0,2021,Argentina,Bulgaria,2021-06-15,True,0,0,0,0,0,0,0,0,0,0,0,0,0,0,0,0,0,0,1,1,0,0,0,0
125049.0,Mendez Nicolas,OH,Argentina,29.0,191.0,2021,Argentina,Russia,2021-06-16,False,0,0,0,0,0,0,0,0,0,1,2,3,0,0,0,0,0,1,0,1,0,0,0,0
125049.0,Mendez Nicolas,OH,Argentina,29.0,191.0,2021,Argentina,Serbia,2021-06-17,True,0,0,0,0,0,0,0,0,0,0,0,0,0,0,0,0,0,0,0,0,0,0,0,0
125049.0,Mendez Nicolas,OH,Argentina,29.0,191.0,2021,Poland,Argentina,2021-06-21,False,0,0,0,0,0,0,0,0,0,0,0,0,0,0,0,0,0,0,0,0,0,0,0,0
125049.0,Mendez Nicolas,OH,Argentina,29.0,191.0,2021,France,Argentina,2021-06-22,False,0,2,6,8,0,0,2,2,5,1,3,9,1,2,0,3,2,2,7,11,2,0,1,3
125049.0,Mendez Nicolas,OH,Argentina,29.0,191.0,2021,Iran,Argentina,2021-06-23,True,0,0,0,0,0,0,0,0,0,0,0,0,0,0,0,0,0,0,0,0,0,0,0,0
125047.0,Ramos Martin,MB,Argentina,30.0,197.0,2021,Brazil,Argentina,2021-05-28,False,1,2,7,10,0,0,0,0,5,1,1,7,4,2,0,6,0,0,0,0,2,0,0,2
125047.0,Ramos Martin,MB,Argentina,30.0,197.0,2021,Argentina,Canada,2021-05-29,False,1,2,6,9,0,0,0,0,3,0,1,4,1,5,0,6,3,0,0,3,2,1,0,3
125047.0,Ramos Martin,MB,Argentina,30.0,197.0,2021,USA,Argentina,2021-05-30,False,0,2,11,13,0,0,0,0,4,1,2,7,3,5,1,9,0,1,0,1,1,1,0,2
125047.0,Ramos Martin,MB,Argentina,30.0,197.0,2021,Germany,Argentina,2021-06-03,True,0,0,0,0,0,0,0,0,0,0,0,0,0,0,0,0,0,0,0,0,0,0,0,0
125047.0,Ramos Martin,MB,Argentina,30.0,197.0,2021,Argentina,Slovenia,2021-06-04,False,0,1,7,8,0,1,1,2,5,1,3,9,1,4,5,10,1,0,0,1,3,1,3,7
125047.0,Ramos Martin,MB,Argentina,30.0,197.0,2021,Netherlands,Argentina,2021-06-05,True,0,0,0,0,0,0,0,0,0,0,0,0,0,0,0,0,0,0,0,0,0,0,0,0
125047.0,Ramos Martin,MB,Argentina,30.0,197.0,2021,Argentina,Italy,2021-06-09,False,0,0,1,1,0,0,0,0,1,1,1,3,0,2,0,2,0,0,1,1,1,0,0,1
125047.0,Ramos Martin,MB,Argentina,30.0,197.0,2021,Argentina,Australia,2021-06-10,True,1,2,6,9,0,0,0,0,5,0,6,11,4,4,0,8,1,0,0,1,2,0,0,2
125047.0,Ramos Martin,MB,Argentina,30.0,197.0,2021,Japan,Argentina,2021-06-11,True,0,0,0,0,0,0,0,0,0,0,0,0,0,0,0,0,0,0,0,0,0,0,0,0
125047.0,Ramos Martin,MB,Argentina,30.0,197.0,2021,Argentina,Bulgaria,2021-06-15,True,0,0,0,0,0,0,0,0,0,0,0,0,0,0,0,0,0,0,0,0,0,0,0,0
125047.0,Ramos Martin,MB,Argentina,30.0,197.0,2021,Argentina,Russia,2021-06-16,False,0,0,0,0,0,0,0,0,0,0,0,0,0,0,0,0,0,0,0,0,0,0,0,0
125047.0,Ramos Martin,MB,Argentina,30.0,197.0,2021,Argentina,Serbia,2021-06-17,True,0,1,12,13,0,0,1,1,6,3,2,11,2,7,2,11,1,0,0,1,0,0,1,1
125047.0,Ramos Martin,MB,Argentina,30.0,197.0,2021,Poland,Argentina,2021-06-21,False,0,2,9,11,0,0,0,0,8,0,2,10,0,5,5,10,1,0,2,3,3,3,2,8
125047.0,Ramos Martin,MB,Argentina,30.0,197.0,2021,France,Argentina,2021-06-22,False,0,2,9,11,0,0,0,0,3,2,2,7,0,2,3,5,0,0,1,1,1,0,0,1
125047.0,Ramos Martin,MB,Argentina,30.0,197.0,2021,Iran,Argentina,2021-06-23,True,1,3,21,25,0,0,1,1,10,1,3,14,3,6,1,10,0,0,1,1,3,0,1,4
135349.0,Massimino Franco,L,Argentina,33.0,177.0,2021,Germany,Argentina,2021-06-03,True,0,0,0,0,0,0,2,2,0,0,0,0,0,0,0,0,13,1,14,28,12,2,2,16
135349.0,Massimino Franco,L,Argentina,33.0,177.0,2021,Argentina,Slovenia,2021-06-04,False,0,0,0,0,0,0,3,3,0,0,0,0,0,0,0,0,2,2,6,10,4,4,2,10
135349.0,Massimino Franco,L,Argentina,33.0,177.0,2021,Netherlands,Argentina,2021-06-05,True,0,0,0,0,0,0,3,3,0,0,0,0,0,0,0,0,2,2,8,12,9,3,1,13
135349.0,Massimino Franco,L,Argentina,33.0,177.0,2021,Argentina,Italy,2021-06-09,False,0,0,0,0,0,0,0,0,0,0,0,0,0,0,0,0,0,0,0,0,0,0,0,0
135349.0,Massimino Franco,L,Argentina,33.0,177.0,2021,Argentina,Australia,2021-06-10,True,0,0,0,0,0,0,3,3,0,0,0,0,0,0,0,0,5,0,5,10,5,3,1,9
135349.0,Massimino Franco,L,Argentina,33.0,177.0,2021,Japan,Argentina,2021-06-11,True,0,0,0,0,0,0,1,1,0,0,0,0,0,0,0,0,9,0,11,20,13,5,2,20
135349.0,Massimino Franco,L,Argentina,33.0,177.0,2021,Argentina,Bulgaria,2021-06-15,True,0,0,0,0,0,0,0,0,0,0,0,0,0,0,0,0,0,0,0,0,0,0,0,0
135349.0,Massimino Franco,L,Argentina,33.0,177.0,2021,Argentina,Russia,2021-06-16,False,0,0,0,0,0,0,0,0,0,0,0,0,0,0,0,0,0,0,0,0,0,0,0,0
135349.0,Massimino Franco,L,Argentina,33.0,177.0,2021,Argentina,Serbia,2021-06-17,True,0,0,0,0,0,0,0,0,0,0,0,0,0,0,0,0,0,0,0,0,0,0,0,0
135349.0,Massimino Franco,L,Argentina,33.0,177.0,2021,Poland,Argentina,2021-06-21,False,0,0,0,0,0,0,0,0,0,0,0,0,0,0,0,0,0,0,0,0,0,0,0,0
135349.0,Massimino Franco,L,Argentina,33.0,177.0,2021,France,Argentina,2021-06-22,False,0,0,0,0,0,0,0,0,0,0,0,0,0,0,0,0,0,0,0,0,0,0,0,0
135349.0,Massimino Franco,L,Argentina,33.0,177.0,2021,Iran,Argentina,2021-06-23,True,0,0,0,0,0,0,0,0,0,0,0,0,0,0,0,0,0,0,0,0,0,0,0,0
144457.0,Graham Beau,MB,Australia,27.0,203.0,2021,Germany,Australia,2021-05-28,False,0,2,8,10,0,0,0,0,7,1,4,12,0,2,2,4,0,0,0,0,0,1,0,1
144457.0,Graham Beau,MB,Australia,27.0,203.0,2021,Australia,Bulgaria,2021-05-29,False,0,2,4,6,0,0,0,0,6,6,4,16,0,1,0,1,0,2,1,3,1,2,1,4
144457.0,Graham Beau,MB,Australia,27.0,203.0,2021,Australia,France,2021-05-30,False,0,5,12,17,0,1,0,1,13,5,8,26,1,2,2,5,0,0,0,0,4,2,1,7
144457.0,Graham Beau,MB,Australia,27.0,203.0,2021,Australia,Poland,2021-06-03,False,0,1,3,4,0,0,1,1,2,3,3,8,0,0,0,0,0,1,0,1,1,4,0,5
144457.0,Graham Beau,MB,Australia,27.0,203.0,2021,Russia,Australia,2021-06-04,False,0,2,9,11,0,0,0,0,6,8,11,25,0,1,0,1,0,0,0,0,1,1,0,2
144457.0,Graham Beau,MB,Australia,27.0,203.0,2021,USA,Australia,2021-06-05,False,0,4,3,7,0,0,2,2,7,6,9,22,0,2,1,3,0,0,0,0,4,0,0,4
144457.0,Graham Beau,MB,Australia,27.0,203.0,2021,Japan,Australia,2021-06-09,False,0,0,9,9,0,0,2,2,5,2,3,10,0,2,3,5,0,0,0,0,1,5,0,6
144457.0,Graham Beau,MB,Australia,27.0,203.0,2021,Argentina,Australia,2021-06-10,False,0,0,6,6,0,0,0,0,6,0,4,10,0,1,0,1,0,0,1,1,1,1,0,2
144457.0,Graham Beau,MB,Australia,27.0,203.0,2021,Australia,Italy,2021-06-11,False,0,0,6,6,0,0,0,0,5,5,3,13,0,1,2,3,0,0,0,0,2,2,0,4
144457.0,Graham Beau,MB,Australia,27.0,203.0,2021,Iran,Australia,2021-06-15,True,3,2,22,27,0,0,2,2,12,4,9,25,0,2,1,3,1,0,1,2,2,5,0,7
144457.0,Graham Beau,MB,Australia,27.0,203.0,2021,Slovenia,Australia,2021-06-16,False,0,2,9,11,0,0,1,1,7,2,10,19,1,3,1,5,0,0,0,0,1,2,0,3
144457.0,Graham Beau,MB,Australia,27.0,203.0,2021,Australia,Brazil,2021-06-17,False,0,1,7,8,0,0,0,0,10,4,11,25,0,4,1,5,0,0,0,0,2,1,0,3
144457.0,Graham Beau,MB,Australia,27.0,203.0,2021,Australia,Serbia,2021-06-21,False,0,2,11,13,0,0,2,2,7,9,7,23,0,4,2,6,0,0,0,0,1,2,0,3
144457.0,Graham Beau,MB,Australia,27.0,203.0,2021,Canada,Australia,2021-06-22,False,0,1,2,3,0,1,2,3,3,2,7,12,0,2,1,3,0,0,0,0,2,1,2,5
144457.0,Graham Beau,MB,Australia,27.0,203.0,2021,Australia,Netherlands,2021-06-23,False,0,1,3,4,0,0,0,0,0,3,1,4,0,1,0,1,0,0,0,0,1,0,0,1
144456.0,Dosanjh Arshdeep,S,Australia,25.0,205.0,2021,Germany,Australia,2021-05-28,False,0,5,2,7,12,3,36,51,2,0,1,3,1,2,0,3,0,0,0,0,3,1,0,4
144456.0,Dosanjh Arshdeep,S,Australia,25.0,205.0,2021,Australia,Bulgaria,2021-05-29,False,0,0,9,9,10,1,53,64,3,2,1,6,0,1,0,1,0,0,0,0,3,2,2,7
144456.0,Dosanjh Arshdeep,S,Australia,25.0,205.0,2021,Australia,France,2021-05-30,False,1,2,9,12,31,1,67,99,2,0,5,7,1,2,0,3,0,0,1,1,5,2,2,9
144456.0,Dosanjh Arshdeep,S,Australia,25.0,205.0,2021,Australia,Poland,2021-06-03,False,0,2,3,5,8,1,40,49,0,0,2,2,0,0,1,1,0,0,1,1,0,0,0,0
144456.0,Dosanjh Arshdeep,S,Australia,25.0,205.0,2021,Russia,Australia,2021-06-04,False,1,3,8,12,13,0,52,65,2,1,2,5,1,3,1,5,0,0,1,1,2,2,1,5
144456.0,Dosanjh Arshdeep,S,Australia,25.0,205.0,2021,USA,Australia,2021-06-05,False,0,2,6,8,14,1,51,66,2,0,3,5,0,2,0,2,0,0,0,0,4,4,3,11
144456.0,Dosanjh Arshdeep,S,Australia,25.0,205.0,2021,Japan,Australia,2021-06-09,False,0,2,11,13,26,1,75,102,2,1,4,7,2,4,2,8,0,0,1,1,9,5,1,15
144456.0,Dosanjh Arshdeep,S,Australia,25.0,205.0,2021,Argentina,Australia,2021-06-10,False,1,1,7,9,11,1,46,58,0,0,3,3,2,0,0,2,0,0,1,1,4,8,1,13
144456.0,Dosanjh Arshdeep,S,Australia,25.0,205.0,2021,Australia,Italy,2021-06-11,False,0,4,6,10,13,1,47,61,3,0,1,4,1,1,5,7,0,0,0,0,2,1,1,4
144456.0,Dosanjh Arshdeep,S,Australia,25.0,205.0,2021,Iran,Australia,2021-06-15,True,1,3,14,18,17,1,82,100,1,1,3,5,1,3,1,5,0,0,0,0,4,5,0,9
144456.0,Dosanjh Arshdeep,S,Australia,25.0,205.0,2021,Slovenia,Australia,2021-06-16,False,3,4,12,19,23,0,48,71,1,0,2,3,1,3,1,5,0,0,0,0,6,3,1,10
144456.0,Dosanjh Arshdeep,S,Australia,25.0,205.0,2021,Australia,Brazil,2021-06-17,False,0,1,7,8,7,0,50,57,2,0,3,5,0,2,1,3,0,0,0,0,5,3,1,9
144456.0,Dosanjh Arshdeep,S,Australia,25.0,205.0,2021,Australia,Serbia,2021-06-21,False,1,0,12,13,18,0,59,77,2,0,1,3,1,4,1,6,0,0,0,0,10,3,0,13
144456.0,Dosanjh Arshdeep,S,Australia,25.0,205.0,2021,Canada,Australia,2021-06-22,False,0,1,5,6,9,1,39,49,1,1,1,3,0,2,0,2,0,0,0,0,3,1,2,6
144456.0,Dosanjh Arshdeep,S,Australia,25.0,205.0,2021,Australia,Netherlands,2021-06-23,False,0,0,9,9,13,0,41,54,2,1,1,4,2,0,1,3,0,0,0,0,3,3,0,6
162262.0,Macdonald Steven,MB,Australia,24.0,207.0,2021,Australia,Bulgaria,2021-05-29,False,0,0,0,0,0,0,0,0,0,0,0,0,0,0,0,0,0,0,0,0,0,0,0,0
162262.0,Macdonald Steven,MB,Australia,24.0,207.0,2021,Australia,France,2021-05-30,False,0,0,0,0,0,0,0,0,0,0,0,0,0,0,0,0,0,0,0,0,0,0,0,0
162262.0,Macdonald Steven,MB,Australia,24.0,207.0,2021,Argentina,Australia,2021-06-10,False,0,0,3,3,0,0,0,0,0,0,0,0,0,1,0,1,0,0,0,0,0,0,0,0
162262.0,Macdonald Steven,MB,Australia,24.0,207.0,2021,Australia,Italy,2021-06-11,False,0,0,0,0,0,0,0,0,0,0,0,0,0,0,0,0,0,0,0,0,0,0,0,0
162262.0,Macdonald Steven,MB,Australia,24.0,207.0,2021,Australia,Serbia,2021-06-21,False,0,0,0,0,0,0,0,0,0,0,0,0,0,0,0,0,0,0,0,0,0,0,0,0
162262.0,Macdonald Steven,MB,Australia,24.0,207.0,2021,Canada,Australia,2021-06-22,False,0,0,0,0,0,0,0,0,0,0,0,0,0,0,0,0,0,0,0,0,0,0,0,0
162262.0,Macdonald Steven,MB,Australia,24.0,207.0,2021,Australia,Netherlands,2021-06-23,False,0,0,0,0,0,0,0,0,0,0,0,0,0,0,0,0,0,0,0,0,0,0,0,0
162077.0,Weir James,MB,Australia,26.0,204.0,2021,Germany,Australia,2021-05-28,False,0,1,10,11,0,0,0,0,2,0,1,3,1,3,1,5,0,0,0,0,1,2,0,3
162077.0,Weir James,MB,Australia,26.0,204.0,2021,Australia,Bulgaria,2021-05-29,False,0,3,5,8,0,0,0,0,2,0,0,2,0,0,1,1,0,1,1,2,0,0,0,0
162077.0,Weir James,MB,Australia,26.0,204.0,2021,Australia,France,2021-05-30,False,2,1,3,6,0,0,0,0,2,1,2,5,0,4,1,5,1,0,0,1,1,0,0,1
162077.0,Weir James,MB,Australia,26.0,204.0,2021,Australia,Poland,2021-06-03,False,1,1,3,5,0,0,0,0,1,2,2,5,0,3,0,3,0,0,0,0,0,1,0,1
162077.0,Weir James,MB,Australia,26.0,204.0,2021,Russia,Australia,2021-06-04,False,0,0,0,0,0,0,0,0,0,0,0,0,0,0,0,0,0,0,0,0,0,0,0,0
162077.0,Weir James,MB,Australia,26.0,204.0,2021,USA,Australia,2021-06-05,False,0,0,2,2,0,0,0,0,0,0,0,0,0,0,0,0,0,0,0,0,0,0,0,0
162077.0,Weir James,MB,Australia,26.0,204.0,2021,Japan,Australia,2021-06-09,False,0,0,1,1,0,0,0,0,0,0,0,0,0,0,0,0,0,0,0,0,0,0,0,0
162077.0,Weir James,MB,Australia,26.0,204.0,2021,Argentina,Australia,2021-06-10,False,0,2,4,6,0,0,2,2,3,3,2,8,0,1,1,2,0,0,0,0,1,3,0,4
162077.0,Weir James,MB,Australia,26.0,204.0,2021,Australia,Italy,2021-06-11,False,0,0,0,0,0,0,0,0,0,0,0,0,0,0,0,0,0,0,0,0,0,0,0,0
162077.0,Weir James,MB,Australia,26.0,204.0,2021,Iran,Australia,2021-06-15,True,0,0,1,1,0,0,0,0,0,0,0,0,0,0,0,0,0,0,0,0,0,0,0,0
162077.0,Weir James,MB,Australia,26.0,204.0,2021,Slovenia,Australia,2021-06-16,False,0,0,1,1,0,0,0,0,0,0,0,0,0,0,0,0,0,0,0,0,0,0,0,0
162077.0,Weir James,MB,Australia,26.0,204.0,2021,Australia,Brazil,2021-06-17,False,0,2,1,3,0,0,0,0,1,0,0,1,0,0,0,0,0,0,0,0,0,0,0,0
162077.0,Weir James,MB,Australia,26.0,204.0,2021,Australia,Serbia,2021-06-21,False,1,1,9,11,0,0,1,1,6,4,3,13,3,1,0,4,0,0,0,0,1,1,0,2
162077.0,Weir James,MB,Australia,26.0,204.0,2021,Canada,Australia,2021-06-22,False,0,2,6,8,0,0,2,2,1,1,5,7,0,2,1,3,0,0,0,0,1,0,1,2
162077.0,Weir James,MB,Australia,26.0,204.0,2021,Australia,Netherlands,2021-06-23,False,0,0,0,0,0,0,0,0,0,0,0,0,0,0,0,0,0,0,0,0,0,0,0,0
144464.0,O'Dea Trent,MB,Australia,27.0,201.0,2021,Germany,Australia,2021-05-28,False,0,0,0,0,0,0,0,0,0,0,0,0,0,0,0,0,0,0,0,0,0,0,0,0
144464.0,O'Dea Trent,MB,Australia,27.0,201.0,2021,Australia,Bulgaria,2021-05-29,False,0,0,2,2,0,0,0,0,1,0,3,4,0,1,2,3,0,0,0,0,0,0,0,0
144464.0,O'Dea Trent,MB,Australia,27.0,201.0,2021,Australia,France,2021-05-30,False,0,2,16,18,0,0,0,0,7,1,3,11,0,6,10,16,0,0,1,1,2,0,2,4
144464.0,O'Dea Trent,MB,Australia,27.0,201.0,2021,Australia,Poland,2021-06-03,False,0,0,3,3,0,0,0,0,1,0,2,3,0,1,0,1,0,2,0,2,0,0,0,0
144464.0,O'Dea Trent,MB,Australia,27.0,201.0,2021,Russia,Australia,2021-06-04,False,0,0,12,12,0,0,1,1,3,2,4,9,2,3,1,6,0,0,1,1,3,1,0,4
144464.0,O'Dea Trent,MB,Australia,27.0,201.0,2021,USA,Australia,2021-06-05,False,0,0,12,12,0,0,1,1,7,1,0,8,0,2,2,4,0,0,0,0,2,0,2,4
144464.0,O'Dea Trent,MB,Australia,27.0,201.0,2021,Japan,Australia,2021-06-09,False,0,3,10,13,0,0,0,0,8,1,5,14,0,5,6,11,1,0,0,1,1,1,0,2
144464.0,O'Dea Trent,MB,Australia,27.0,201.0,2021,Argentina,Australia,2021-06-10,False,0,0,9,9,0,0,1,1,4,1,7,12,3,4,0,7,1,0,0,1,0,1,0,1
144464.0,O'Dea Trent,MB,Australia,27.0,201.0,2021,Australia,Italy,2021-06-11,False,0,0,7,7,0,0,5,5,4,2,2,8,2,2,1,5,0,0,0,0,0,2,1,3
144464.0,O'Dea Trent,MB,Australia,27.0,201.0,2021,Iran,Australia,2021-06-15,True,0,2,11,13,0,0,0,0,13,2,4,19,4,2,0,6,1,0,0,1,1,0,0,1
144464.0,O'Dea Trent,MB,Australia,27.0,201.0,2021,Slovenia,Australia,2021-06-16,False,0,3,10,13,0,0,2,2,2,4,1,7,3,4,3,10,1,0,2,3,2,0,0,2
144464.0,O'Dea Trent,MB,Australia,27.0,201.0,2021,Australia,Brazil,2021-06-17,False,1,1,4,6,0,0,0,0,0,3,5,8,0,0,2,2,0,0,0,0,2,1,0,3
144464.0,O'Dea Trent,MB,Australia,27.0,201.0,2021,Australia,Serbia,2021-06-21,False,1,1,8,10,0,0,1,1,3,1,3,7,0,2,0,2,0,0,1,1,1,1,0,2
144464.0,O'Dea Trent,MB,Australia,27.0,201.0,2021,Canada,Australia,2021-06-22,False,0,2,2,4,0,0,0,0,2,0,2,4,0,2,2,4,0,0,2,2,1,0,0,1
144464.0,O'Dea Trent,MB,Australia,27.0,201.0,2021,Australia,Netherlands,2021-06-23,False,0,0,8,8,0,0,3,3,4,0,6,10,0,4,3,7,0,0,1,1,0,2,0,2
144578.0,Perry Luke,L,Australia,26.0,180.0,2021,Germany,Australia,2021-05-28,False,0,0,0,0,0,0,3,3,0,0,0,0,0,0,0,0,5,0,12,17,6,4,1,11
144578.0,Perry Luke,L,Australia,26.0,180.0,2021,Australia,Bulgaria,2021-05-29,False,0,0,0,0,0,0,3,3,0,0,0,0,0,0,0,0,6,3,9,18,12,3,1,16
144578.0,Perry Luke,L,Australia,26.0,180.0,2021,Australia,France,2021-05-30,False,0,0,0,0,0,0,7,7,0,0,0,0,0,0,0,0,6,1,11,18,17,0,0,17
144578.0,Perry Luke,L,Australia,26.0,180.0,2021,Australia,Poland,2021-06-03,False,0,0,0,0,0,0,7,7,0,0,0,0,0,0,0,0,10,2,8,20,2,1,0,3
144578.0,Perry Luke,L,Australia,26.0,180.0,2021,Russia,Australia,2021-06-04,False,0,0,0,0,0,0,10,10,0,0,0,0,0,0,0,0,8,0,6,14,5,0,0,5
144578.0,Perry Luke,L,Australia,26.0,180.0,2021,USA,Australia,2021-06-05,False,0,0,0,0,0,0,8,8,0,0,0,0,0,0,0,0,7,1,6,14,7,2,1,10
144578.0,Perry Luke,L,Australia,26.0,180.0,2021,Japan,Australia,2021-06-09,False,0,0,0,0,0,0,15,15,0,0,0,0,0,0,0,0,7,1,11,19,14,5,0,19
144578.0,Perry Luke,L,Australia,26.0,180.0,2021,Argentina,Australia,2021-06-10,False,0,0,0,0,0,0,10,10,0,0,0,0,0,0,0,0,7,1,7,15,4,1,0,5
144578.0,Perry Luke,L,Australia,26.0,180.0,2021,Australia,Italy,2021-06-11,False,0,0,0,0,0,0,9,9,0,0,0,0,0,0,0,0,2,0,11,13,10,1,2,13
144578.0,Perry Luke,L,Australia,26.0,180.0,2021,Iran,Australia,2021-06-15,True,0,0,0,0,0,0,14,14,0,0,0,0,0,0,0,0,13,0,5,18,14,8,2,24
144578.0,Perry Luke,L,Australia,26.0,180.0,2021,Slovenia,Australia,2021-06-16,False,0,0,0,0,0,0,13,13,0,0,0,0,0,0,0,0,9,2,6,17,11,4,3,18
144578.0,Perry Luke,L,Australia,26.0,180.0,2021,Australia,Brazil,2021-06-17,False,0,0,0,0,0,0,11,11,0,0,0,0,0,0,0,0,5,0,5,10,8,2,0,10
144578.0,Perry Luke,L,Australia,26.0,180.0,2021,Australia,Serbia,2021-06-21,False,0,0,0,0,0,0,10,10,0,0,0,0,0,0,0,0,8,0,8,16,4,3,0,7
144578.0,Perry Luke,L,Australia,26.0,180.0,2021,Canada,Australia,2021-06-22,False,0,0,0,0,0,0,9,9,0,0,0,0,0,0,0,0,3,0,7,10,7,2,4,13
144578.0,Perry Luke,L,Australia,26.0,180.0,2021,Australia,Netherlands,2021-06-23,False,0,0,0,0,0,0,5,5,0,0,0,0,0,0,0,0,3,0,2,5,8,3,0,11
144461.0,Mote Nehemiah,MB,Australia,28.0,203.0,2021,Germany,Australia,2021-05-28,False,0,1,8,9,0,0,0,0,5,1,4,10,1,3,2,6,1,0,1,2,2,0,0,2
144461.0,Mote Nehemiah,MB,Australia,28.0,203.0,2021,Australia,Bulgaria,2021-05-29,False,1,1,10,12,0,0,0,0,1,1,5,7,2,4,5,11,0,0,0,0,2,0,0,2
144461.0,Mote Nehemiah,MB,Australia,28.0,203.0,2021,Australia,France,2021-05-30,False,0,0,10,10,0,0,0,0,7,0,4,11,2,3,7,12,1,0,2,3,2,0,1,3
144461.0,Mote Nehemiah,MB,Australia,28.0,203.0,2021,Australia,Poland,2021-06-03,False,0,0,9,9,0,0,1,1,5,0,3,8,0,3,0,3,1,0,0,1,2,0,0,2
144461.0,Mote Nehemiah,MB,Australia,28.0,203.0,2021,Russia,Australia,2021-06-04,False,0,0,13,13,0,1,2,3,5,0,1,6,0,4,2,6,2,0,0,2,4,1,0,5
144461.0,Mote Nehemiah,MB,Australia,28.0,203.0,2021,USA,Australia,2021-06-05,False,0,0,10,10,0,0,3,3,3,1,4,8,0,3,4,7,0,0,0,0,3,3,1,7
144461.0,Mote Nehemiah,MB,Australia,28.0,203.0,2021,Japan,Australia,2021-06-09,False,0,3,14,17,0,0,1,1,11,2,2,15,3,2,6,11,2,0,1,3,6,4,2,12
144461.0,Mote Nehemiah,MB,Australia,28.0,203.0,2021,Australia,Italy,2021-06-11,False,0,2,10,12,1,1,0,2,7,1,5,13,1,5,4,10,0,0,2,2,3,2,0,5
144461.0,Mote Nehemiah,MB,Australia,28.0,203.0,2021,Iran,Australia,2021-06-15,True,0,1,11,12,0,0,1,1,8,3,7,18,4,1,0,5,3,0,1,4,1,2,0,3
144461.0,Mote Nehemiah,MB,Australia,28.0,203.0,2021,Slovenia,Australia,2021-06-16,False,0,0,11,11,0,0,1,1,9,3,7,19,2,3,4,9,1,0,0,1,4,0,0,4
144461.0,Mote Nehemiah,MB,Australia,28.0,203.0,2021,Australia,Brazil,2021-06-17,False,0,0,8,8,0,0,4,4,3,1,5,9,1,4,2,7,0,0,0,0,5,1,0,6
144461.0,Mote Nehemiah,MB,Australia,28.0,203.0,2021,Australia,Serbia,2021-06-21,False,0,0,0,0,0,0,0,0,0,0,0,0,0,0,0,0,0,0,0,0,0,0,0,0
144461.0,Mote Nehemiah,MB,Australia,28.0,203.0,2021,Canada,Australia,2021-06-22,False,1,1,5,7,0,0,0,0,2,0,6,8,0,3,2,5,0,0,1,1,3,0,0,3
144461.0,Mote Nehemiah,MB,Australia,28.0,203.0,2021,Australia,Netherlands,2021-06-23,False,0,1,10,11,0,0,0,0,8,2,0,10,2,4,0,6,0,0,2,2,2,1,0,3
120515.0,Smith Luke,OH,Australia,31.0,204.0,2021,Germany,Australia,2021-05-28,False,0,4,5,9,0,0,0,0,10,3,8,21,0,6,1,7,2,3,8,13,0,0,0,0
120515.0,Smith Luke,OH,Australia,31.0,204.0,2021,Australia,Bulgaria,2021-05-29,False,0,2,10,12,0,0,0,0,9,4,6,19,0,1,0,1,2,2,13,17,4,2,2,8
120515.0,Smith Luke,OH,Australia,31.0,204.0,2021,Australia,France,2021-05-30,False,0,5,8,13,0,0,0,0,8,3,11,22,4,3,0,7,7,3,17,27,6,0,0,6
120515.0,Smith Luke,OH,Australia,31.0,204.0,2021,Australia,Poland,2021-06-03,False,0,1,4,5,0,0,1,1,5,6,4,15,0,0,0,0,7,3,13,23,0,0,0,0
120515.0,Smith Luke,OH,Australia,31.0,204.0,2021,Russia,Australia,2021-06-04,False,1,1,7,9,0,0,1,1,11,2,12,25,1,2,2,5,9,2,10,21,4,3,0,7
120515.0,Smith Luke,OH,Australia,31.0,204.0,2021,USA,Australia,2021-06-05,False,0,0,12,12,0,0,1,1,6,2,9,17,0,3,2,5,3,1,15,19,1,1,1,3
120515.0,Smith Luke,OH,Australia,31.0,204.0,2021,Japan,Australia,2021-06-09,False,1,2,14,17,0,0,3,3,18,3,16,37,0,2,3,5,6,3,28,37,8,2,0,10
120515.0,Smith Luke,OH,Australia,31.0,204.0,2021,Argentina,Australia,2021-06-10,False,0,2,9,11,0,0,1,1,9,1,8,18,2,0,0,2,10,4,17,31,2,4,0,6
120515.0,Smith Luke,OH,Australia,31.0,204.0,2021,Australia,Italy,2021-06-11,False,1,2,7,10,1,0,5,6,8,2,8,18,0,2,1,3,9,0,15,24,5,3,0,8
120515.0,Smith Luke,OH,Australia,31.0,204.0,2021,Iran,Australia,2021-06-15,True,0,1,16,17,0,0,0,0,11,8,13,32,2,5,0,7,15,1,20,36,3,3,0,6
120515.0,Smith Luke,OH,Australia,31.0,204.0,2021,Slovenia,Australia,2021-06-16,False,0,1,11,12,0,0,1,1,12,2,8,22,2,1,0,3,10,1,25,36,4,4,0,8
120515.0,Smith Luke,OH,Australia,31.0,204.0,2021,Australia,Brazil,2021-06-17,False,1,0,10,11,0,0,0,0,8,1,10,19,2,3,2,7,6,1,17,24,5,2,0,7
132961.0,Douglas-Powell Thomas Ewen,OH,Australia,29.0,194.0,2021,Iran,Australia,2021-06-15,True,0,1,0,1,0,0,0,0,1,0,0,1,0,0,0,0,3,1,2,6,0,1,0,1
158841.0,Butler Nicholas,S,Australia,24.0,198.0,2021,Germany,Australia,2021-05-28,False,0,0,0,0,3,0,3,6,0,0,0,0,0,0,0,0,0,0,0,0,0,1,0,1
158841.0,Butler Nicholas,S,Australia,24.0,198.0,2021,Australia,Bulgaria,2021-05-29,False,0,0,0,0,0,0,0,0,0,0,0,0,0,0,0,0,0,0,0,0,0,0,0,0
158841.0,Butler Nicholas,S,Australia,24.0,198.0,2021,Australia,France,2021-05-30,False,0,0,0,0,0,0,0,0,0,0,0,0,0,0,0,0,0,0,0,0,2,0,0,2
158841.0,Butler Nicholas,S,Australia,24.0,198.0,2021,Australia,Poland,2021-06-03,False,0,0,0,0,0,0,8,8,0,0,0,0,0,0,0,0,0,0,0,0,0,0,0,0
158841.0,Butler Nicholas,S,Australia,24.0,198.0,2021,Russia,Australia,2021-06-04,False,0,0,0,0,0,0,0,0,0,0,0,0,0,0,0,0,0,0,0,0,0,0,0,0
158841.0,Butler Nicholas,S,Australia,24.0,198.0,2021,USA,Australia,2021-06-05,False,0,0,0,0,0,0,0,0,0,0,0,0,0,0,0,0,0,0,0,0,0,0,0,0
158841.0,Butler Nicholas,S,Australia,24.0,198.0,2021,Japan,Australia,2021-06-09,False,0,0,0,0,0,0,0,0,0,0,0,0,0,0,0,0,0,0,0,0,0,0,0,0
158841.0,Butler Nicholas,S,Australia,24.0,198.0,2021,Argentina,Australia,2021-06-10,False,0,0,1,1,0,0,0,0,0,0,0,0,0,0,0,0,0,0,0,0,0,0,0,0
158841.0,Butler Nicholas,S,Australia,24.0,198.0,2021,Australia,Italy,2021-06-11,False,0,0,0,0,0,0,0,0,0,0,0,0,0,0,0,0,0,0,0,0,0,0,0,0
158841.0,Butler Nicholas,S,Australia,24.0,198.0,2021,Iran,Australia,2021-06-15,True,0,0,0,0,2,0,4,6,0,0,0,0,0,0,0,0,0,0,0,0,2,0,0,2
158841.0,Butler Nicholas,S,Australia,24.0,198.0,2021,Slovenia,Australia,2021-06-16,False,0,0,0,0,2,0,2,4,0,0,0,0,0,0,0,0,0,0,0,0,1,0,0,1
158841.0,Butler Nicholas,S,Australia,24.0,198.0,2021,Australia,Brazil,2021-06-17,False,0,1,0,1,2,0,15,17,0,0,0,0,0,0,0,0,0,0,0,0,2,0,0,2
158841.0,Butler Nicholas,S,Australia,24.0,198.0,2021,Australia,Serbia,2021-06-21,False,0,0,0,0,1,0,3,4,0,0,0,0,0,0,0,0,0,0,0,0,0,1,0,1
158841.0,Butler Nicholas,S,Australia,24.0,198.0,2021,Canada,Australia,2021-06-22,False,0,0,1,1,2,0,9,11,1,0,0,1,1,1,0,2,0,0,0,0,0,0,0,0
158841.0,Butler Nicholas,S,Australia,24.0,198.0,2021,Australia,Netherlands,2021-06-23,False,0,0,0,0,0,0,0,0,0,0,0,0,0,0,0,0,0,0,0,0,0,0,0,0
162870.0,Senica Max,OH,Australia,22.0,191.0,2021,Germany,Australia,2021-05-28,False,0,0,0,0,0,0,0,0,0,0,0,0,0,0,0,0,0,0,0,0,0,0,0,0
162870.0,Senica Max,OH,Australia,22.0,191.0,2021,Australia,Bulgaria,2021-05-29,False,0,0,0,0,0,0,0,0,0,0,0,0,0,0,0,0,0,0,0,0,0,0,0,0
162870.0,Senica Max,OH,Australia,22.0,191.0,2021,Australia,France,2021-05-30,False,0,0,0,0,0,0,0,0,0,0,0,0,0,0,0,0,0,0,0,0,0,0,0,0
162870.0,Senica Max,OH,Australia,22.0,191.0,2021,Australia,Poland,2021-06-03,False,0,0,0,0,0,0,0,0,0,0,0,0,0,0,0,0,0,0,0,0,0,0,0,0
162870.0,Senica Max,OH,Australia,22.0,191.0,2021,Russia,Australia,2021-06-04,False,0,0,0,0,0,0,0,0,0,0,0,0,0,0,0,0,0,0,0,0,0,0,0,0
162870.0,Senica Max,OH,Australia,22.0,191.0,2021,USA,Australia,2021-06-05,False,1,1,1,3,0,0,0,0,3,2,0,5,0,1,0,1,1,0,6,7,0,0,0,0
162870.0,Senica Max,OH,Australia,22.0,191.0,2021,Japan,Australia,2021-06-09,False,0,1,12,13,0,0,1,1,7,3,9,19,3,1,3,7,2,0,15,17,4,0,1,5
162870.0,Senica Max,OH,Australia,22.0,191.0,2021,Argentina,Australia,2021-06-10,False,0,3,8,11,0,0,0,0,6,1,9,16,0,0,0,0,6,0,6,12,0,1,0,1
162870.0,Senica Max,OH,Australia,22.0,191.0,2021,Australia,Italy,2021-06-11,False,0,0,3,3,1,0,0,1,1,3,2,6,0,0,0,0,3,0,5,8,0,2,0,2
162870.0,Senica Max,OH,Australia,22.0,191.0,2021,Iran,Australia,2021-06-15,True,0,0,1,1,0,0,0,0,0,0,0,0,0,0,0,0,2,0,1,3,0,0,0,0
162870.0,Senica Max,OH,Australia,22.0,191.0,2021,Slovenia,Australia,2021-06-16,False,0,2,4,6,0,0,0,0,3,0,2,5,1,1,2,4,6,0,4,10,0,0,1,1
162870.0,Senica Max,OH,Australia,22.0,191.0,2021,Australia,Brazil,2021-06-17,False,0,0,2,2,0,0,0,0,0,0,0,0,0,0,0,0,0,1,2,3,1,0,1,2
162870.0,Senica Max,OH,Australia,22.0,191.0,2021,Australia,Serbia,2021-06-21,False,1,2,4,7,0,0,3,3,4,3,9,16,0,0,0,0,5,1,4,10,1,0,0,1
162870.0,Senica Max,OH,Australia,22.0,191.0,2021,Canada,Australia,2021-06-22,False,1,2,5,8,0,0,1,1,2,2,6,10,0,0,1,1,9,1,13,23,8,1,2,11
162870.0,Senica Max,OH,Australia,22.0,191.0,2021,Australia,Netherlands,2021-06-23,False,1,2,12,15,0,0,1,1,4,2,5,11,1,4,0,5,12,2,12,26,3,3,0,6
162267.0,Taylor Tim,OH,Australia,27.0,195.0,2021,Germany,Australia,2021-05-28,False,0,0,0,0,0,0,0,0,0,0,0,0,0,0,0,0,0,0,0,0,0,0,0,0
162267.0,Taylor Tim,OH,Australia,27.0,195.0,2021,Australia,Bulgaria,2021-05-29,False,0,1,4,5,0,0,0,0,2,1,4,7,1,1,1,3,1,3,3,7,1,2,0,3
162267.0,Taylor Tim,OH,Australia,27.0,195.0,2021,Australia,France,2021-05-30,False,0,0,0,0,0,0,0,0,1,3,3,7,0,0,0,0,0,2,0,2,1,0,0,1
162267.0,Taylor Tim,OH,Australia,27.0,195.0,2021,Australia,Poland,2021-06-03,False,0,1,0,1,0,0,1,1,1,2,1,4,0,0,0,0,2,1,3,6,0,0,0,0
162267.0,Taylor Tim,OH,Australia,27.0,195.0,2021,Russia,Australia,2021-06-04,False,0,1,1,2,0,0,0,0,0,1,4,5,0,0,0,0,2,1,3,6,1,0,0,1
162267.0,Taylor Tim,OH,Australia,27.0,195.0,2021,USA,Australia,2021-06-05,False,0,2,4,6,0,0,1,1,7,4,3,14,2,0,1,3,2,3,13,18,5,1,0,6
162267.0,Taylor Tim,OH,Australia,27.0,195.0,2021,Japan,Australia,2021-06-09,False,0,2,2,4,0,0,0,0,2,2,2,6,0,0,1,1,4,1,3,8,1,2,1,4
162267.0,Taylor Tim,OH,Australia,27.0,195.0,2021,Argentina,Australia,2021-06-10,False,0,0,0,0,0,0,0,0,0,0,0,0,0,0,0,0,0,0,0,0,0,0,0,0
162267.0,Taylor Tim,OH,Australia,27.0,195.0,2021,Australia,Italy,2021-06-11,False,0,1,5,6,0,0,1,1,4,1,5,10,0,2,0,2,1,3,8,12,4,0,0,4
162267.0,Taylor Tim,OH,Australia,27.0,195.0,2021,Iran,Australia,2021-06-15,True,0,0,0,0,0,0,0,0,0,0,0,0,0,0,0,0,0,0,0,0,0,0,0,0
162267.0,Taylor Tim,OH,Australia,27.0,195.0,2021,Slovenia,Australia,2021-06-16,False,0,1,0,1,0,0,0,0,3,0,0,3,0,0,0,0,0,0,0,0,0,0,0,0
162267.0,Taylor Tim,OH,Australia,27.0,195.0,2021,Australia,Brazil,2021-06-17,False,0,0,0,0,0,0,0,0,0,0,0,0,0,0,0,0,0,0,0,0,0,0,0,0
162267.0,Taylor Tim,OH,Australia,27.0,195.0,2021,Australia,Serbia,2021-06-21,False,0,1,0,1,0,0,0,0,2,1,1,4,0,0,0,0,1,2,6,9,0,0,0,0
162267.0,Taylor Tim,OH,Australia,27.0,195.0,2021,Canada,Australia,2021-06-22,False,0,0,0,0,0,0,0,0,0,0,0,0,0,0,0,0,0,0,0,0,0,0,0,0
162267.0,Taylor Tim,OH,Australia,27.0,195.0,2021,Australia,Netherlands,2021-06-23,False,0,0,0,0,0,0,0,0,0,0,0,0,0,0,0,0,0,0,0,0,0,0,0,0
169335.0,Garrett Ethan,OH,Australia,21.0,196.0,2021,Germany,Australia,2021-05-28,False,0,2,7,9,0,0,0,0,2,3,5,10,0,3,0,3,5,2,14,21,2,2,0,4
169335.0,Garrett Ethan,OH,Australia,21.0,196.0,2021,Australia,Bulgaria,2021-05-29,False,0,1,5,6,0,0,0,0,1,1,4,6,0,1,0,1,1,2,5,8,0,1,0,1
169335.0,Garrett Ethan,OH,Australia,21.0,196.0,2021,Australia,France,2021-05-30,False,0,6,7,13,0,0,0,0,7,4,9,20,0,5,2,7,9,0,16,25,4,2,1,7
169335.0,Garrett Ethan,OH,Australia,21.0,196.0,2021,Australia,Poland,2021-06-03,False,0,1,2,3,0,0,0,0,2,5,4,11,1,3,1,5,1,1,5,7,2,2,0,4
169335.0,Garrett Ethan,OH,Australia,21.0,196.0,2021,Russia,Australia,2021-06-04,False,0,1,5,6,0,0,1,1,2,1,6,9,0,1,0,1,5,1,6,12,0,1,0,1
169335.0,Garrett Ethan,OH,Australia,21.0,196.0,2021,Japan,Australia,2021-06-09,False,0,0,0,0,0,0,0,0,0,0,0,0,0,0,0,0,0,0,0,0,0,0,0,0
169335.0,Garrett Ethan,OH,Australia,21.0,196.0,2021,Iran,Australia,2021-06-15,True,1,6,8,15,0,0,1,1,8,11,9,28,1,3,2,6,11,3,6,20,0,1,0,1
169335.0,Garrett Ethan,OH,Australia,21.0,196.0,2021,Slovenia,Australia,2021-06-16,False,0,0,4,4,0,1,2,3,2,4,5,11,0,4,1,5,3,1,5,9,0,1,0,1
169335.0,Garrett Ethan,OH,Australia,21.0,196.0,2021,Australia,Brazil,2021-06-17,False,0,2,3,5,0,0,3,3,7,3,9,19,0,1,0,1,7,1,21,29,2,5,1,8
169335.0,Garrett Ethan,OH,Australia,21.0,196.0,2021,Australia,Serbia,2021-06-21,False,0,2,1,3,0,0,0,0,2,2,7,11,0,1,0,1,3,1,12,16,0,1,0,1
169335.0,Garrett Ethan,OH,Australia,21.0,196.0,2021,Canada,Australia,2021-06-22,False,0,1,3,4,0,0,2,2,0,3,3,6,0,3,1,4,1,0,5,6,0,0,1,1
169335.0,Garrett Ethan,OH,Australia,21.0,196.0,2021,Australia,Netherlands,2021-06-23,False,0,0,0,0,0,0,0,0,0,0,0,0,0,0,0,0,1,1,1,3,1,1,0,2
162265.0,Aubrey Matthew,O,Australia,24.0,209.0,2021,Germany,Australia,2021-05-28,False,0,0,0,0,0,0,0,0,0,1,1,2,0,1,0,1,0,0,0,0,0,0,0,0
162265.0,Aubrey Matthew,O,Australia,24.0,209.0,2021,Australia,Bulgaria,2021-05-29,False,0,1,1,2,0,0,0,0,1,0,1,2,0,2,0,2,0,0,0,0,2,0,3,5
162265.0,Aubrey Matthew,O,Australia,24.0,209.0,2021,Australia,France,2021-05-30,False,0,0,0,0,0,0,0,0,0,1,1,2,0,0,0,0,0,1,0,1,0,0,0,0
162265.0,Aubrey Matthew,O,Australia,24.0,209.0,2021,Australia,Poland,2021-06-03,False,0,0,0,0,0,0,0,0,0,0,0,0,0,0,0,0,0,0,0,0,0,0,0,0
162265.0,Aubrey Matthew,O,Australia,24.0,209.0,2021,Russia,Australia,2021-06-04,False,0,0,0,0,0,0,0,0,0,0,0,0,0,0,0,0,0,0,0,0,0,0,0,0
162265.0,Aubrey Matthew,O,Australia,24.0,209.0,2021,USA,Australia,2021-06-05,False,0,0,0,0,0,0,0,0,0,0,0,0,0,0,0,0,0,0,0,0,0,0,0,0
162265.0,Aubrey Matthew,O,Australia,24.0,209.0,2021,Japan,Australia,2021-06-09,False,0,0,0,0,0,0,0,0,0,0,0,0,0,0,0,0,0,0,0,0,0,0,0,0
162265.0,Aubrey Matthew,O,Australia,24.0,209.0,2021,Argentina,Australia,2021-06-10,False,0,0,0,0,0,0,0,0,0,0,0,0,0,0,0,0,0,0,0,0,0,0,0,0
162265.0,Aubrey Matthew,O,Australia,24.0,209.0,2021,Australia,Italy,2021-06-11,False,0,1,0,1,0,0,0,0,0,0,0,0,0,0,0,0,0,0,0,0,0,0,0,0
162265.0,Aubrey Matthew,O,Australia,24.0,209.0,2021,Iran,Australia,2021-06-15,True,0,0,0,0,0,0,0,0,0,0,0,0,0,0,0,0,0,0,0,0,0,0,0,0
162265.0,Aubrey Matthew,O,Australia,24.0,209.0,2021,Slovenia,Australia,2021-06-16,False,0,0,0,0,0,0,0,0,0,0,0,0,0,0,0,0,0,0,0,0,0,0,0,0
162265.0,Aubrey Matthew,O,Australia,24.0,209.0,2021,Australia,Brazil,2021-06-17,False,0,0,0,0,0,0,0,0,0,0,0,0,0,0,0,0,0,0,0,0,0,0,0,0
162265.0,Aubrey Matthew,O,Australia,24.0,209.0,2021,Australia,Serbia,2021-06-21,False,0,1,0,1,0,0,0,0,0,1,0,1,0,0,0,0,0,0,0,0,0,0,0,0
162265.0,Aubrey Matthew,O,Australia,24.0,209.0,2021,Canada,Australia,2021-06-22,False,0,0,0,0,0,0,0,0,0,0,0,0,0,0,0,0,0,0,0,0,0,0,0,0
162265.0,Aubrey Matthew,O,Australia,24.0,209.0,2021,Australia,Netherlands,2021-06-23,False,0,2,2,4,0,0,0,0,5,1,3,9,0,0,0,0,0,0,0,0,1,0,0,1
181257.0,Azeez Oluwatobi Elliot,OH,Australia,22.0,190.0,2021,Australia,Poland,2021-06-03,False,0,2,1,3,0,0,0,0,3,0,7,10,0,1,0,1,0,0,0,0,1,1,0,2
181257.0,Azeez Oluwatobi Elliot,OH,Australia,22.0,190.0,2021,Russia,Australia,2021-06-04,False,0,0,0,0,0,0,0,0,0,0,0,0,0,0,0,0,0,0,0,0,0,0,0,0
181257.0,Azeez Oluwatobi Elliot,OH,Australia,22.0,190.0,2021,USA,Australia,2021-06-05,False,0,0,2,2,0,0,2,2,1,2,3,6,0,1,0,1,0,1,0,1,2,0,0,2
181257.0,Azeez Oluwatobi Elliot,OH,Australia,22.0,190.0,2021,Japan,Australia,2021-06-09,False,0,2,5,7,0,0,0,0,6,1,11,18,0,2,0,2,0,0,0,0,1,0,1,2
181257.0,Azeez Oluwatobi Elliot,OH,Australia,22.0,190.0,2021,Argentina,Australia,2021-06-10,False,0,2,1,3,0,0,0,0,4,5,2,11,0,0,0,0,0,0,0,0,0,0,0,0
181257.0,Azeez Oluwatobi Elliot,OH,Australia,22.0,190.0,2021,Australia,Italy,2021-06-11,False,0,0,2,2,0,0,0,0,1,1,5,7,0,0,1,1,0,0,0,0,1,0,1,2
181257.0,Azeez Oluwatobi Elliot,OH,Australia,22.0,190.0,2021,Iran,Australia,2021-06-15,True,0,0,0,0,0,0,0,0,1,0,0,1,0,0,0,0,0,0,0,0,0,0,0,0
181257.0,Azeez Oluwatobi Elliot,OH,Australia,22.0,190.0,2021,Slovenia,Australia,2021-06-16,False,0,0,1,1,0,0,0,0,3,1,1,5,0,0,0,0,0,0,0,0,1,1,0,2
181257.0,Azeez Oluwatobi Elliot,OH,Australia,22.0,190.0,2021,Australia,Brazil,2021-06-17,False,0,1,0,1,0,0,0,0,4,1,4,9,0,0,0,0,0,0,0,0,0,0,0,0
181257.0,Azeez Oluwatobi Elliot,OH,Australia,22.0,190.0,2021,Australia,Serbia,2021-06-21,False,2,1,8,11,0,0,0,0,8,3,10,21,2,3,0,5,10,2,14,26,10,5,0,15
181257.0,Azeez Oluwatobi Elliot,OH,Australia,22.0,190.0,2021,Canada,Australia,2021-06-22,False,0,3,3,6,0,0,0,0,10,5,12,27,0,1,4,5,2,4,10,16,1,2,1,4
181257.0,Azeez Oluwatobi Elliot,OH,Australia,22.0,190.0,2021,Australia,Netherlands,2021-06-23,False,0,4,8,12,0,0,0,0,10,5,4,19,1,1,0,2,8,5,7,20,0,0,0,0
178207.0,Flowerday Sam,OH,Australia,19.0,191.0,2021,Germany,Australia,2021-05-28,False,0,0,0,0,0,0,0,0,0,0,0,0,0,0,0,0,0,0,0,0,0,0,0,0
178207.0,Flowerday Sam,OH,Australia,19.0,191.0,2021,Australia,Bulgaria,2021-05-29,False,0,0,0,0,0,0,0,0,0,0,0,0,0,0,0,0,0,0,0,0,0,0,0,0
178207.0,Flowerday Sam,OH,Australia,19.0,191.0,2021,Australia,France,2021-05-30,False,0,0,0,0,0,0,0,0,0,0,0,0,0,0,0,0,0,0,0,0,0,0,0,0
178207.0,Flowerday Sam,OH,Australia,19.0,191.0,2021,Australia,Poland,2021-06-03,False,0,1,0,1,0,0,0,0,0,2,0,2,0,0,0,0,0,1,0,1,0,0,0,0
178207.0,Flowerday Sam,OH,Australia,19.0,191.0,2021,USA,Australia,2021-06-05,False,0,0,0,0,0,0,0,0,0,0,0,0,0,0,0,0,0,0,0,0,0,0,0,0
178207.0,Flowerday Sam,OH,Australia,19.0,191.0,2021,Argentina,Australia,2021-06-10,False,0,0,0,0,0,0,0,0,0,0,0,0,0,0,0,0,0,0,0,0,0,0,0,0
178207.0,Flowerday Sam,OH,Australia,19.0,191.0,2021,Australia,Brazil,2021-06-17,False,0,0,0,0,0,0,0,0,0,0,0,0,0,0,0,0,0,0,0,0,0,0,0,0
181247.0,Greber Billy,L,Australia,19.0,183.0,2021,Germany,Australia,2021-05-28,False,0,0,0,0,0,0,0,0,0,0,0,0,0,0,0,0,0,0,0,0,0,0,0,0
181247.0,Greber Billy,L,Australia,19.0,183.0,2021,Russia,Australia,2021-06-04,False,0,0,0,0,0,0,0,0,0,0,0,0,0,0,0,0,0,0,0,0,0,0,0,0
181247.0,Greber Billy,L,Australia,19.0,183.0,2021,USA,Australia,2021-06-05,False,0,0,0,0,0,0,0,0,0,0,0,0,0,0,0,0,0,0,0,0,0,0,0,0
181247.0,Greber Billy,L,Australia,19.0,183.0,2021,Japan,Australia,2021-06-09,False,0,0,0,0,0,0,0,0,0,0,0,0,0,0,0,0,0,0,0,0,0,0,0,0
181247.0,Greber Billy,L,Australia,19.0,183.0,2021,Argentina,Australia,2021-06-10,False,0,0,0,0,0,0,0,0,0,0,0,0,0,0,0,0,0,0,0,0,0,0,0,0
181247.0,Greber Billy,L,Australia,19.0,183.0,2021,Australia,Italy,2021-06-11,False,0,0,0,0,0,0,0,0,0,0,0,0,0,0,0,0,0,0,0,0,0,0,0,0
181247.0,Greber Billy,L,Australia,19.0,183.0,2021,Slovenia,Australia,2021-06-16,False,0,0,0,0,0,0,0,0,0,0,0,0,0,0,0,0,0,0,0,0,0,0,0,0
181247.0,Greber Billy,L,Australia,19.0,183.0,2021,Australia,Serbia,2021-06-21,False,0,0,0,0,0,0,0,0,0,0,0,0,0,0,0,0,0,0,0,0,0,0,0,0
181247.0,Greber Billy,L,Australia,19.0,183.0,2021,Canada,Australia,2021-06-22,False,0,0,0,0,0,0,0,0,0,0,0,0,0,0,0,0,0,0,0,0,0,0,0,0
181247.0,Greber Billy,L,Australia,19.0,183.0,2021,Australia,Netherlands,2021-06-23,False,0,0,0,0,0,0,0,0,0,0,0,0,0,0,0,0,0,0,0,0,0,0,0,0
116099.0,Rezende Bruno Mossa,S,Brazil,35.0,190.0,2021,Brazil,Argentina,2021-05-28,True,2,3,11,16,19,0,52,71,2,0,1,3,0,2,0,2,0,0,1,1,6,3,0,9
116099.0,Rezende Bruno Mossa,S,Brazil,35.0,190.0,2021,USA,Brazil,2021-05-29,True,2,2,10,14,7,0,59,66,0,0,2,2,0,0,0,0,0,0,0,0,1,0,0,1
116099.0,Rezende Bruno Mossa,S,Brazil,35.0,190.0,2021,Canada,Brazil,2021-05-30,True,0,0,0,0,2,0,3,5,0,0,0,0,0,0,0,0,0,0,0,0,2,0,0,2
116099.0,Rezende Bruno Mossa,S,Brazil,35.0,190.0,2021,Brazil,France,2021-06-03,False,0,1,9,10,37,0,48,85,0,0,0,0,1,3,5,9,0,0,0,0,5,3,1,9
116099.0,Rezende Bruno Mossa,S,Brazil,35.0,190.0,2021,Brazil,Japan,2021-06-04,True,0,0,0,0,0,0,2,2,0,0,0,0,0,0,0,0,0,0,0,0,0,0,0,0
116099.0,Rezende Bruno Mossa,S,Brazil,35.0,190.0,2021,Brazil,Serbia,2021-06-05,True,0,0,16,16,39,1,41,81,1,0,0,1,2,2,2,6,0,0,0,0,6,1,2,9
116099.0,Rezende Bruno Mossa,S,Brazil,35.0,190.0,2021,Netherlands,Brazil,2021-06-09,True,0,0,11,11,18,1,49,68,2,0,1,3,1,0,3,4,0,0,0,0,8,0,0,8
116099.0,Rezende Bruno Mossa,S,Brazil,35.0,190.0,2021,Bulgaria,Brazil,2021-06-10,True,0,0,0,0,1,0,3,4,0,0,0,0,0,0,0,0,0,0,0,0,0,0,0,0
116099.0,Rezende Bruno Mossa,S,Brazil,35.0,190.0,2021,Poland,Brazil,2021-06-11,True,0,0,11,11,11,0,60,71,2,0,0,2,0,3,3,6,0,0,0,0,5,0,0,5
116099.0,Rezende Bruno Mossa,S,Brazil,35.0,190.0,2021,Brazil,Slovenia,2021-06-15,True,0,0,9,9,31,0,59,90,0,0,0,0,1,2,4,7,0,0,0,0,9,2,2,13
116099.0,Rezende Bruno Mossa,S,Brazil,35.0,190.0,2021,Iran,Brazil,2021-06-16,True,0,0,0,0,0,0,5,5,0,0,0,0,0,0,0,0,0,0,0,0,0,0,0,0
116099.0,Rezende Bruno Mossa,S,Brazil,35.0,190.0,2021,Australia,Brazil,2021-06-17,True,0,1,11,12,25,0,36,61,2,0,1,3,1,2,0,3,0,0,0,0,9,1,4,14
116099.0,Rezende Bruno Mossa,S,Brazil,35.0,190.0,2021,Brazil,Italy,2021-06-21,True,0,0,18,18,36,0,68,104,0,0,0,0,0,5,5,10,0,0,0,0,14,2,5,21
116099.0,Rezende Bruno Mossa,S,Brazil,35.0,190.0,2021,Brazil,Germany,2021-06-22,True,0,0,0,0,1,0,1,2,0,0,0,0,0,0,0,0,0,0,0,0,0,0,0,0
116099.0,Rezende Bruno Mossa,S,Brazil,35.0,190.0,2021,Brazil,Russia,2021-06-23,False,0,1,6,7,15,0,27,42,0,0,0,0,0,1,1,2,0,0,0,0,2,5,3,10
116099.0,Rezende Bruno Mossa,S,Brazil,35.0,190.0,2021,Brazil,France,2021-06-26,True,0,0,9,9,18,1,48,67,0,0,0,0,1,2,3,6,0,0,0,0,4,1,0,5
116099.0,Rezende Bruno Mossa,S,Brazil,35.0,190.0,2021,Brazil,Poland,2021-06-27,True,1,0,14,15,22,0,63,85,0,0,0,0,0,4,1,5,0,0,0,0,11,4,0,15
136955.0,De Barros Ferreira João Rafael,OH,Brazil,29.0,193.0,2021,Iran,Brazil,2021-06-16,True,0,0,1,1,0,0,0,0,0,0,2,2,0,0,0,0,0,0,0,0,0,0,0,0
136955.0,De Barros Ferreira João Rafael,OH,Brazil,29.0,193.0,2021,Australia,Brazil,2021-06-17,True,1,1,2,4,0,0,2,2,3,0,1,4,0,0,0,0,0,0,1,1,1,0,0,1
136955.0,De Barros Ferreira João Rafael,OH,Brazil,29.0,193.0,2021,Brazil,Italy,2021-06-21,True,0,1,2,3,0,0,0,0,0,0,0,0,0,0,0,0,0,0,0,0,0,0,0,0
136955.0,De Barros Ferreira João Rafael,OH,Brazil,29.0,193.0,2021,Brazil,Germany,2021-06-22,True,0,0,1,1,0,0,0,0,0,0,0,0,0,0,0,0,0,0,0,0,0,0,0,0
132030.0,Borges Almeida Silva Mauricio,OH,Brazil,33.0,2.0,2021,Brazil,Argentina,2021-05-28,True,0,0,0,0,0,0,0,0,0,0,0,0,0,0,0,0,0,0,0,0,0,0,0,0
132030.0,Borges Almeida Silva Mauricio,OH,Brazil,33.0,2.0,2021,USA,Brazil,2021-05-29,True,0,0,0,0,0,0,0,0,0,0,0,0,0,0,0,0,0,0,0,0,0,0,0,0
132030.0,Borges Almeida Silva Mauricio,OH,Brazil,33.0,2.0,2021,Canada,Brazil,2021-05-30,True,2,3,10,15,0,0,0,0,7,3,8,18,0,1,3,4,8,2,15,25,5,2,1,8
132030.0,Borges Almeida Silva Mauricio,OH,Brazil,33.0,2.0,2021,Brazil,France,2021-06-03,False,0,0,0,0,0,0,0,0,0,0,0,0,0,0,0,0,0,0,1,1,0,0,0,0
132030.0,Borges Almeida Silva Mauricio,OH,Brazil,33.0,2.0,2021,Brazil,Japan,2021-06-04,True,0,0,2,2,0,0,0,0,1,0,1,2,0,0,0,0,0,0,4,4,1,3,0,4
132030.0,Borges Almeida Silva Mauricio,OH,Brazil,33.0,2.0,2021,Brazil,Serbia,2021-06-05,True,0,0,0,0,0,0,0,0,0,0,0,0,0,0,0,0,0,0,0,0,0,0,0,0
132030.0,Borges Almeida Silva Mauricio,OH,Brazil,33.0,2.0,2021,Netherlands,Brazil,2021-06-09,True,0,1,13,14,0,0,5,5,3,6,7,16,0,2,3,5,11,4,7,22,2,0,0,2
132030.0,Borges Almeida Silva Mauricio,OH,Brazil,33.0,2.0,2021,Bulgaria,Brazil,2021-06-10,True,0,0,0,0,0,0,0,0,0,0,0,0,0,0,0,0,0,0,0,0,0,0,0,0
132030.0,Borges Almeida Silva Mauricio,OH,Brazil,33.0,2.0,2021,Poland,Brazil,2021-06-11,True,0,0,0,0,0,0,0,0,0,0,0,0,0,0,0,0,0,1,1,2,0,0,0,0
132030.0,Borges Almeida Silva Mauricio,OH,Brazil,33.0,2.0,2021,Brazil,Slovenia,2021-06-15,True,0,0,0,0,0,0,0,0,0,0,0,0,0,0,0,0,0,0,1,1,1,1,0,2
132030.0,Borges Almeida Silva Mauricio,OH,Brazil,33.0,2.0,2021,Iran,Brazil,2021-06-16,True,0,0,0,0,0,0,0,0,0,0,0,0,0,0,0,0,1,1,5,7,0,1,0,1
132030.0,Borges Almeida Silva Mauricio,OH,Brazil,33.0,2.0,2021,Australia,Brazil,2021-06-17,True,0,1,7,8,0,0,7,7,10,1,7,18,1,1,4,6,4,0,9,13,4,0,0,4
132030.0,Borges Almeida Silva Mauricio,OH,Brazil,33.0,2.0,2021,Brazil,Italy,2021-06-21,True,0,0,0,0,1,0,0,1,1,0,0,1,0,0,0,0,1,0,4,5,1,0,0,1
132030.0,Borges Almeida Silva Mauricio,OH,Brazil,33.0,2.0,2021,Brazil,Germany,2021-06-22,True,1,3,9,13,0,0,2,2,8,5,6,19,2,0,0,2,8,2,8,18,7,0,0,7
132030.0,Borges Almeida Silva Mauricio,OH,Brazil,33.0,2.0,2021,Brazil,Russia,2021-06-23,False,0,1,2,3,0,0,0,0,3,3,0,6,0,0,0,0,0,1,2,3,2,0,0,2
132030.0,Borges Almeida Silva Mauricio,OH,Brazil,33.0,2.0,2021,Brazil,France,2021-06-26,True,0,0,0,0,0,0,0,0,0,0,0,0,0,0,0,0,0,0,0,0,0,0,0,0
132030.0,Borges Almeida Silva Mauricio,OH,Brazil,33.0,2.0,2021,Brazil,Poland,2021-06-27,True,0,0,0,0,0,0,0,0,0,0,0,0,0,0,0,0,0,0,0,0,0,0,0,0
142744.0,Gil Kreling Fernando,S,Brazil,26.0,186.0,2021,Brazil,Argentina,2021-05-28,True,0,0,0,0,0,0,1,1,0,0,0,0,0,0,0,0,0,0,0,0,0,1,0,1
142744.0,Gil Kreling Fernando,S,Brazil,26.0,186.0,2021,USA,Brazil,2021-05-29,True,0,0,0,0,0,0,0,0,0,0,0,0,0,0,0,0,0,0,0,0,0,0,0,0
142744.0,Gil Kreling Fernando,S,Brazil,26.0,186.0,2021,Canada,Brazil,2021-05-30,True,1,0,12,13,24,2,76,102,0,0,1,1,1,2,0,3,0,0,1,1,8,2,0,10
142744.0,Gil Kreling Fernando,S,Brazil,26.0,186.0,2021,Brazil,France,2021-06-03,False,0,0,1,1,2,0,5,7,0,0,0,0,0,0,0,0,0,0,0,0,1,0,0,1
142744.0,Gil Kreling Fernando,S,Brazil,26.0,186.0,2021,Brazil,Japan,2021-06-04,True,0,1,6,7,31,0,34,65,0,0,1,1,0,1,2,3,0,0,0,0,10,1,1,12
142744.0,Gil Kreling Fernando,S,Brazil,26.0,186.0,2021,Brazil,Serbia,2021-06-05,True,0,0,0,0,0,0,1,1,0,0,0,0,0,0,0,0,0,0,0,0,0,0,0,0
142744.0,Gil Kreling Fernando,S,Brazil,26.0,186.0,2021,Netherlands,Brazil,2021-06-09,True,0,0,0,0,1,0,1,2,0,0,0,0,0,0,0,0,0,0,0,0,0,0,0,0
142744.0,Gil Kreling Fernando,S,Brazil,26.0,186.0,2021,Bulgaria,Brazil,2021-06-10,True,2,0,8,10,19,0,26,45,0,1,0,1,0,1,0,1,0,0,0,0,1,2,0,3
142744.0,Gil Kreling Fernando,S,Brazil,26.0,186.0,2021,Poland,Brazil,2021-06-11,True,0,0,0,0,0,0,0,0,0,0,0,0,0,0,0,0,0,0,0,0,0,0,0,0
142744.0,Gil Kreling Fernando,S,Brazil,26.0,186.0,2021,Brazil,Slovenia,2021-06-15,True,0,0,0,0,1,0,6,7,0,0,0,0,0,1,0,1,0,0,0,0,0,0,0,0
142744.0,Gil Kreling Fernando,S,Brazil,26.0,186.0,2021,Iran,Brazil,2021-06-16,True,0,2,15,17,7,0,77,84,2,0,0,2,1,2,0,3,0,0,1,1,9,2,0,11
142744.0,Gil Kreling Fernando,S,Brazil,26.0,186.0,2021,Australia,Brazil,2021-06-17,True,0,0,0,0,0,0,0,0,0,0,0,0,0,0,0,0,0,0,0,0,0,0,0,0
142744.0,Gil Kreling Fernando,S,Brazil,26.0,186.0,2021,Brazil,Italy,2021-06-21,True,0,0,0,0,1,0,0,1,0,0,0,0,0,0,0,0,0,0,0,0,0,0,0,0
142744.0,Gil Kreling Fernando,S,Brazil,26.0,186.0,2021,Brazil,Germany,2021-06-22,True,0,1,7,8,23,0,50,73,1,0,0,1,0,4,1,5,0,0,0,0,4,2,0,6
142744.0,Gil Kreling Fernando,S,Brazil,26.0,186.0,2021,Brazil,Russia,2021-06-23,False,0,1,3,4,3,0,15,18,0,0,0,0,0,0,1,1,0,0,0,0,1,0,0,1
142744.0,Gil Kreling Fernando,S,Brazil,26.0,186.0,2021,Brazil,France,2021-06-26,True,0,0,0,0,0,0,0,0,0,0,0,0,0,0,0,0,0,0,0,0,0,0,0,0
142744.0,Gil Kreling Fernando,S,Brazil,26.0,186.0,2021,Brazil,Poland,2021-06-27,True,0,0,0,0,0,0,0,0,0,0,0,0,0,0,0,0,0,0,0,0,0,0,0,0
112869.0,De Souza Wallace,O,Brazil,34.0,198.0,2021,Brazil,Argentina,2021-05-28,True,1,2,14,17,0,0,0,0,7,9,3,19,0,4,0,4,0,0,1,1,6,0,0,6
112869.0,De Souza Wallace,O,Brazil,34.0,198.0,2021,USA,Brazil,2021-05-29,True,0,1,4,5,0,0,0,0,4,1,0,5,0,0,0,0,0,0,0,0,0,0,0,0
112869.0,De Souza Wallace,O,Brazil,34.0,198.0,2021,Canada,Brazil,2021-05-30,True,0,2,12,14,3,0,0,3,19,2,12,33,0,1,0,1,0,0,0,0,7,1,1,9
112869.0,De Souza Wallace,O,Brazil,34.0,198.0,2021,Brazil,France,2021-06-03,False,1,1,8,10,0,0,2,2,5,5,3,13,0,1,0,1,0,0,1,1,1,2,0,3
112869.0,De Souza Wallace,O,Brazil,34.0,198.0,2021,Brazil,Japan,2021-06-04,True,1,2,10,13,0,0,0,0,15,1,10,26,0,0,2,2,0,0,1,1,6,1,1,8
112869.0,De Souza Wallace,O,Brazil,34.0,198.0,2021,Brazil,Serbia,2021-06-05,True,0,0,0,0,0,0,0,0,0,0,0,0,0,0,0,0,0,0,0,0,0,0,0,0
112869.0,De Souza Wallace,O,Brazil,34.0,198.0,2021,Netherlands,Brazil,2021-06-09,True,1,2,12,15,0,0,1,1,12,0,7,19,2,2,4,8,0,0,0,0,7,0,0,7
112869.0,De Souza Wallace,O,Brazil,34.0,198.0,2021,Bulgaria,Brazil,2021-06-10,True,0,0,0,0,0,0,0,0,0,0,0,0,0,0,0,0,0,0,0,0,0,0,0,0
112869.0,De Souza Wallace,O,Brazil,34.0,198.0,2021,Poland,Brazil,2021-06-11,True,0,2,12,14,0,0,2,2,17,4,6,27,1,2,0,3,0,0,1,1,3,2,0,5
112869.0,De Souza Wallace,O,Brazil,34.0,198.0,2021,Brazil,Slovenia,2021-06-15,True,1,4,15,20,0,0,3,3,17,2,7,26,0,4,3,7,0,0,0,0,5,3,2,10
112869.0,De Souza Wallace,O,Brazil,34.0,198.0,2021,Iran,Brazil,2021-06-16,True,0,0,0,0,0,0,0,0,0,0,0,0,0,0,0,0,0,0,0,0,0,0,0,0
112869.0,De Souza Wallace,O,Brazil,34.0,198.0,2021,Australia,Brazil,2021-06-17,True,0,0,0,0,0,0,0,0,0,0,0,0,0,0,0,0,0,0,0,0,0,0,0,0
112869.0,De Souza Wallace,O,Brazil,34.0,198.0,2021,Brazil,Italy,2021-06-21,True,0,4,11,15,0,0,1,1,19,3,7,29,1,5,4,10,0,0,3,3,4,1,0,5
112869.0,De Souza Wallace,O,Brazil,34.0,198.0,2021,Brazil,Germany,2021-06-22,True,0,0,0,0,0,0,0,0,0,0,0,0,0,0,0,0,0,0,0,0,0,0,0,0
112869.0,De Souza Wallace,O,Brazil,34.0,198.0,2021,Brazil,Russia,2021-06-23,False,2,3,4,9,0,0,0,0,6,3,2,11,2,2,2,6,0,0,0,0,4,0,1,5
112869.0,De Souza Wallace,O,Brazil,34.0,198.0,2021,Brazil,France,2021-06-26,True,1,0,11,12,0,0,1,1,11,2,6,19,1,0,4,5,0,0,0,0,2,0,0,2
112869.0,De Souza Wallace,O,Brazil,34.0,198.0,2021,Brazil,Poland,2021-06-27,True,1,4,14,19,0,0,1,1,18,7,6,31,3,3,6,12,1,0,0,1,4,2,0,6
118928.0,Leal Hidalgo Yoandy,OH,Brazil,33.0,202.0,2021,Brazil,Argentina,2021-05-28,True,0,0,7,7,0,0,0,0,7,2,5,14,3,2,0,5,5,2,10,17,3,0,0,3
118928.0,Leal Hidalgo Yoandy,OH,Brazil,33.0,202.0,2021,USA,Brazil,2021-05-29,True,2,2,9,13,0,0,0,0,9,1,3,13,2,0,0,2,2,2,16,20,0,0,0,0
118928.0,Leal Hidalgo Yoandy,OH,Brazil,33.0,202.0,2021,Brazil,France,2021-06-03,False,0,1,8,9,0,0,0,0,11,2,8,21,1,1,1,3,4,1,16,21,1,0,0,1
118928.0,Leal Hidalgo Yoandy,OH,Brazil,33.0,202.0,2021,Brazil,Japan,2021-06-04,True,3,1,10,14,0,0,1,1,7,5,4,16,2,1,4,7,3,0,12,15,6,0,0,6
118928.0,Leal Hidalgo Yoandy,OH,Brazil,33.0,202.0,2021,Brazil,Serbia,2021-06-05,True,0,0,0,0,0,0,0,0,0,0,0,0,0,0,0,0,0,0,0,0,0,0,0,0
118928.0,Leal Hidalgo Yoandy,OH,Brazil,33.0,202.0,2021,Netherlands,Brazil,2021-06-09,True,2,1,10,13,0,0,2,2,18,5,4,27,0,4,1,5,3,0,11,14,4,1,1,6
118928.0,Leal Hidalgo Yoandy,OH,Brazil,33.0,202.0,2021,Bulgaria,Brazil,2021-06-10,True,0,0,0,0,0,0,0,0,0,0,0,0,0,0,0,0,0,0,0,0,0,0,0,0
118928.0,Leal Hidalgo Yoandy,OH,Brazil,33.0,202.0,2021,Poland,Brazil,2021-06-11,True,1,2,15,18,0,0,1,1,10,5,14,29,0,2,2,4,3,1,16,20,3,3,0,6
118928.0,Leal Hidalgo Yoandy,OH,Brazil,33.0,202.0,2021,Brazil,Slovenia,2021-06-15,True,0,2,14,16,0,0,2,2,16,5,10,31,1,2,1,4,6,1,27,34,3,1,0,4
118928.0,Leal Hidalgo Yoandy,OH,Brazil,33.0,202.0,2021,Iran,Brazil,2021-06-16,True,1,2,3,6,0,0,0,0,2,1,4,7,1,1,0,2,2,0,3,5,2,2,0,4
118928.0,Leal Hidalgo Yoandy,OH,Brazil,33.0,202.0,2021,Australia,Brazil,2021-06-17,True,0,0,0,0,0,0,0,0,0,0,0,0,0,0,0,0,0,0,0,0,0,0,0,0
118928.0,Leal Hidalgo Yoandy,OH,Brazil,33.0,202.0,2021,Brazil,Italy,2021-06-21,True,1,3,13,17,0,0,3,3,19,2,14,35,0,3,4,7,6,2,22,30,5,2,0,7
118928.0,Leal Hidalgo Yoandy,OH,Brazil,33.0,202.0,2021,Brazil,Russia,2021-06-23,False,0,0,7,7,0,0,1,1,6,6,5,17,0,3,0,3,1,3,7,11,3,0,0,3
118928.0,Leal Hidalgo Yoandy,OH,Brazil,33.0,202.0,2021,Brazil,France,2021-06-26,True,2,4,9,15,0,0,1,1,18,1,8,27,0,2,4,6,5,1,11,17,8,1,0,9
118928.0,Leal Hidalgo Yoandy,OH,Brazil,33.0,202.0,2021,Brazil,Poland,2021-06-27,True,0,3,10,13,0,0,3,3,16,4,15,35,1,1,0,2,5,2,23,30,6,3,0,9
151789.0,Kavalkievicz Gabriel,OH,Brazil,25.0,191.0,2021,Brazil,Argentina,2021-05-28,True,0,0,0,0,0,0,0,0,0,0,0,0,0,0,0,0,0,0,0,0,0,0,0,0
151789.0,Kavalkievicz Gabriel,OH,Brazil,25.0,191.0,2021,Canada,Brazil,2021-05-30,True,0,0,0,0,0,0,0,0,1,0,0,1,0,0,0,0,0,0,0,0,0,0,0,0
151789.0,Kavalkievicz Gabriel,OH,Brazil,25.0,191.0,2021,Brazil,France,2021-06-03,False,0,0,0,0,0,0,0,0,0,0,0,0,0,0,0,0,0,0,0,0,0,0,0,0
151789.0,Kavalkievicz Gabriel,OH,Brazil,25.0,191.0,2021,Brazil,Serbia,2021-06-05,True,0,0,0,0,0,0,0,0,0,0,0,0,0,0,0,0,0,0,0,0,0,0,0,0
151789.0,Kavalkievicz Gabriel,OH,Brazil,25.0,191.0,2021,Netherlands,Brazil,2021-06-09,True,0,0,1,1,0,0,0,0,0,0,0,0,0,0,0,0,0,0,0,0,0,0,0,0
151789.0,Kavalkievicz Gabriel,OH,Brazil,25.0,191.0,2021,Bulgaria,Brazil,2021-06-10,True,0,0,1,1,0,0,0,0,2,1,0,3,0,0,0,0,0,0,1,1,0,0,0,0
151789.0,Kavalkievicz Gabriel,OH,Brazil,25.0,191.0,2021,Poland,Brazil,2021-06-11,True,0,0,1,1,0,0,0,0,0,0,0,0,0,0,0,0,0,0,0,0,0,0,0,0
151789.0,Kavalkievicz Gabriel,OH,Brazil,25.0,191.0,2021,Brazil,Slovenia,2021-06-15,True,0,1,0,1,0,0,0,0,0,0,0,0,0,0,0,0,0,0,0,0,0,0,0,0
151789.0,Kavalkievicz Gabriel,OH,Brazil,25.0,191.0,2021,Australia,Brazil,2021-06-17,True,0,1,2,3,0,0,1,1,3,1,2,6,1,1,1,3,2,0,1,3,1,0,0,1
151789.0,Kavalkievicz Gabriel,OH,Brazil,25.0,191.0,2021,Brazil,Germany,2021-06-22,True,0,0,0,0,0,0,0,0,0,0,0,0,0,1,0,1,0,0,0,0,0,0,0,0
119872.0,Santos Isac,MB,Brazil,31.0,208.0,2021,Brazil,Argentina,2021-05-28,True,1,1,12,14,0,0,0,0,7,3,2,12,2,1,0,3,1,0,0,1,1,0,0,1
119872.0,Santos Isac,MB,Brazil,31.0,208.0,2021,USA,Brazil,2021-05-29,True,1,2,9,12,0,0,1,1,5,0,1,6,3,0,0,3,1,0,1,2,1,0,0,1
119872.0,Santos Isac,MB,Brazil,31.0,208.0,2021,Canada,Brazil,2021-05-30,True,1,4,12,17,0,0,0,0,4,1,6,11,3,3,2,8,0,0,0,0,5,0,1,6
119872.0,Santos Isac,MB,Brazil,31.0,208.0,2021,Brazil,France,2021-06-03,False,2,4,9,15,0,0,0,0,5,1,4,10,3,7,4,14,0,0,0,0,3,1,2,6
119872.0,Santos Isac,MB,Brazil,31.0,208.0,2021,Brazil,Japan,2021-06-04,True,1,1,5,7,0,0,1,1,7,0,2,9,0,4,5,9,0,0,0,0,3,2,0,5
119872.0,Santos Isac,MB,Brazil,31.0,208.0,2021,Brazil,Serbia,2021-06-05,True,1,4,7,12,0,0,0,0,3,2,1,6,2,3,2,7,0,0,0,0,0,0,0,0
119872.0,Santos Isac,MB,Brazil,31.0,208.0,2021,Netherlands,Brazil,2021-06-09,True,0,0,0,0,0,0,0,0,0,0,0,0,0,0,0,0,0,0,0,0,0,0,0,0
119872.0,Santos Isac,MB,Brazil,31.0,208.0,2021,Bulgaria,Brazil,2021-06-10,True,0,3,7,10,0,0,0,0,5,0,2,7,0,3,3,6,1,0,0,1,1,1,0,2
119872.0,Santos Isac,MB,Brazil,31.0,208.0,2021,Poland,Brazil,2021-06-11,True,0,4,6,10,0,0,0,0,5,0,2,7,1,1,3,5,1,0,0,1,0,0,0,0
119872.0,Santos Isac,MB,Brazil,31.0,208.0,2021,Brazil,Slovenia,2021-06-15,True,1,2,5,8,0,0,0,0,4,0,0,4,3,1,0,4,0,0,1,1,1,0,0,1
119872.0,Santos Isac,MB,Brazil,31.0,208.0,2021,Iran,Brazil,2021-06-16,True,0,2,13,15,0,0,2,2,5,0,9,14,1,3,1,5,1,0,0,1,2,1,0,3
119872.0,Santos Isac,MB,Brazil,31.0,208.0,2021,Australia,Brazil,2021-06-17,True,2,1,10,13,0,0,0,0,7,1,5,13,2,2,6,10,0,0,0,0,1,0,0,1
119872.0,Santos Isac,MB,Brazil,31.0,208.0,2021,Brazil,Germany,2021-06-22,True,0,4,6,10,0,0,0,0,7,0,4,11,1,3,0,4,0,0,0,0,1,1,0,2
119872.0,Santos Isac,MB,Brazil,31.0,208.0,2021,Brazil,Russia,2021-06-23,False,0,1,1,2,0,0,1,1,1,1,2,4,0,2,1,3,0,0,0,0,0,0,0,0
119872.0,Santos Isac,MB,Brazil,31.0,208.0,2021,Brazil,France,2021-06-26,True,0,2,2,4,0,0,0,0,1,0,0,1,0,1,1,2,0,0,0,0,0,0,0,0
119872.0,Santos Isac,MB,Brazil,31.0,208.0,2021,Brazil,Poland,2021-06-27,True,0,1,0,1,0,0,0,0,0,0,0,0,0,0,0,0,0,0,0,0,0,0,0,0
136734.0,De Souza Mauricio Luiz,MB,Brazil,33.0,207.0,2021,Brazil,Japan,2021-06-04,True,0,1,5,6,0,0,0,0,1,0,0,1,0,2,1,3,0,0,0,0,0,0,0,0
136734.0,De Souza Mauricio Luiz,MB,Brazil,33.0,207.0,2021,Brazil,Serbia,2021-06-05,True,1,2,10,13,0,0,1,1,3,0,2,5,0,6,2,8,2,0,4,6,0,0,0,0
136734.0,De Souza Mauricio Luiz,MB,Brazil,33.0,207.0,2021,Netherlands,Brazil,2021-06-09,True,0,0,9,9,2,0,0,2,3,1,2,6,4,4,3,11,0,0,0,0,1,1,1,3
136734.0,De Souza Mauricio Luiz,MB,Brazil,33.0,207.0,2021,Bulgaria,Brazil,2021-06-10,True,0,0,0,0,0,0,0,0,0,0,0,0,0,0,0,0,0,0,0,0,0,0,0,0
136734.0,De Souza Mauricio Luiz,MB,Brazil,33.0,207.0,2021,Poland,Brazil,2021-06-11,True,0,1,12,13,0,0,1,1,4,1,1,6,2,1,3,6,0,0,1,1,0,1,0,1
136734.0,De Souza Mauricio Luiz,MB,Brazil,33.0,207.0,2021,Brazil,Slovenia,2021-06-15,True,0,1,9,10,0,0,0,0,3,1,2,6,0,5,0,5,0,0,0,0,1,1,0,2
136734.0,De Souza Mauricio Luiz,MB,Brazil,33.0,207.0,2021,Iran,Brazil,2021-06-16,True,1,3,12,16,0,0,4,4,5,1,2,8,3,6,1,10,0,0,1,1,1,0,1,2
136734.0,De Souza Mauricio Luiz,MB,Brazil,33.0,207.0,2021,Australia,Brazil,2021-06-17,True,0,0,0,0,0,0,0,0,0,0,0,0,0,0,0,0,0,0,0,0,0,0,0,0
136734.0,De Souza Mauricio Luiz,MB,Brazil,33.0,207.0,2021,Brazil,Italy,2021-06-21,True,0,0,16,16,0,0,1,1,8,2,7,17,0,4,10,14,0,0,0,0,0,0,1,1
136734.0,De Souza Mauricio Luiz,MB,Brazil,33.0,207.0,2021,Brazil,Germany,2021-06-22,True,0,0,0,0,0,0,0,0,0,0,0,0,0,0,0,0,0,0,0,0,0,0,0,0
136734.0,De Souza Mauricio Luiz,MB,Brazil,33.0,207.0,2021,Brazil,Russia,2021-06-23,False,0,0,7,7,0,0,2,2,3,0,3,6,1,2,2,5,0,0,0,0,0,0,0,0
136734.0,De Souza Mauricio Luiz,MB,Brazil,33.0,207.0,2021,Brazil,France,2021-06-26,True,0,1,9,10,0,0,0,0,3,0,1,4,5,7,4,16,0,0,0,0,1,0,0,1
136734.0,De Souza Mauricio Luiz,MB,Brazil,33.0,207.0,2021,Brazil,Poland,2021-06-27,True,1,2,8,11,0,0,1,1,3,0,2,5,4,2,6,12,0,0,0,0,2,1,0,3
142741.0,Correia De Souza Douglas,OH,Brazil,26.0,199.0,2021,Brazil,Argentina,2021-05-28,True,0,1,1,2,0,0,0,0,6,2,0,8,0,0,0,0,1,0,1,2,1,1,0,2
142741.0,Correia De Souza Douglas,OH,Brazil,26.0,199.0,2021,USA,Brazil,2021-05-29,True,0,0,0,0,0,0,0,0,0,0,0,0,0,0,0,0,0,0,0,0,0,0,0,0
142741.0,Correia De Souza Douglas,OH,Brazil,26.0,199.0,2021,Canada,Brazil,2021-05-30,True,1,1,13,15,0,0,0,0,20,9,3,32,1,2,3,6,4,0,15,19,3,2,1,6
142741.0,Correia De Souza Douglas,OH,Brazil,26.0,199.0,2021,Brazil,France,2021-06-03,False,0,1,2,3,0,0,2,2,6,2,0,8,0,0,1,1,1,0,3,4,1,0,1,2
142741.0,Correia De Souza Douglas,OH,Brazil,26.0,199.0,2021,Brazil,Japan,2021-06-04,True,2,3,9,14,0,0,4,4,11,4,5,20,0,1,1,2,2,2,7,11,6,0,1,7
142741.0,Correia De Souza Douglas,OH,Brazil,26.0,199.0,2021,Brazil,Serbia,2021-06-05,True,1,3,12,16,0,0,4,4,17,3,10,30,4,2,1,7,8,0,11,19,3,1,1,5
142741.0,Correia De Souza Douglas,OH,Brazil,26.0,199.0,2021,Netherlands,Brazil,2021-06-09,True,0,0,0,0,0,0,0,0,0,0,0,0,0,0,0,0,0,0,0,0,0,0,0,0
142741.0,Correia De Souza Douglas,OH,Brazil,26.0,199.0,2021,Bulgaria,Brazil,2021-06-10,True,0,1,8,9,0,0,3,3,7,3,3,13,1,3,1,5,5,0,5,10,1,2,0,3
142741.0,Correia De Souza Douglas,OH,Brazil,26.0,199.0,2021,Poland,Brazil,2021-06-11,True,0,0,0,0,0,0,0,0,0,0,0,0,0,0,0,0,0,0,0,0,0,0,0,0
142741.0,Correia De Souza Douglas,OH,Brazil,26.0,199.0,2021,Brazil,Slovenia,2021-06-15,True,3,3,7,13,0,0,4,4,8,4,11,23,0,2,1,3,5,2,6,13,4,2,1,7
142741.0,Correia De Souza Douglas,OH,Brazil,26.0,199.0,2021,Iran,Brazil,2021-06-16,True,0,2,6,8,0,0,5,5,5,2,12,19,1,4,0,5,5,4,10,19,3,1,0,4
142741.0,Correia De Souza Douglas,OH,Brazil,26.0,199.0,2021,Australia,Brazil,2021-06-17,True,0,0,10,10,0,0,5,5,10,1,2,13,0,4,2,6,11,2,6,19,2,2,0,4
142741.0,Correia De Souza Douglas,OH,Brazil,26.0,199.0,2021,Brazil,Italy,2021-06-21,True,0,0,1,1,0,0,0,0,0,0,0,0,0,0,0,0,0,0,0,0,0,0,0,0
142741.0,Correia De Souza Douglas,OH,Brazil,26.0,199.0,2021,Brazil,Germany,2021-06-22,True,2,3,13,18,0,0,4,4,8,3,12,23,1,1,2,4,8,0,8,16,6,0,0,6
142741.0,Correia De Souza Douglas,OH,Brazil,26.0,199.0,2021,Brazil,Russia,2021-06-23,False,1,2,2,5,0,0,1,1,2,1,1,4,0,0,1,1,1,0,10,11,2,0,1,3
142741.0,Correia De Souza Douglas,OH,Brazil,26.0,199.0,2021,Brazil,France,2021-06-26,True,0,0,0,0,0,0,0,0,0,0,0,0,0,0,0,0,0,0,0,0,0,0,0,0
142741.0,Correia De Souza Douglas,OH,Brazil,26.0,199.0,2021,Brazil,Poland,2021-06-27,True,0,0,1,1,0,0,0,0,1,0,0,1,0,0,0,0,0,0,0,0,0,0,0,0
161939.0,Nascimento Maique Reis,L,Brazil,24.0,187.0,2021,Brazil,Argentina,2021-05-28,True,0,0,0,0,5,0,0,5,0,0,0,0,0,0,0,0,0,0,0,0,0,0,0,0
161939.0,Nascimento Maique Reis,L,Brazil,24.0,187.0,2021,USA,Brazil,2021-05-29,True,0,0,0,0,0,0,0,0,0,0,0,0,0,0,0,0,0,0,0,0,0,0,0,0
161939.0,Nascimento Maique Reis,L,Brazil,24.0,187.0,2021,Canada,Brazil,2021-05-30,True,0,0,0,0,0,0,0,0,0,0,0,0,0,0,0,0,0,0,0,0,0,0,0,0
161939.0,Nascimento Maique Reis,L,Brazil,24.0,187.0,2021,Brazil,France,2021-06-03,False,0,0,0,0,0,0,0,0,0,0,0,0,0,0,0,0,0,0,0,0,0,0,0,0
161939.0,Nascimento Maique Reis,L,Brazil,24.0,187.0,2021,Brazil,Japan,2021-06-04,True,0,0,0,0,0,0,1,1,0,0,0,0,0,0,0,0,0,0,0,0,4,1,0,5
161939.0,Nascimento Maique Reis,L,Brazil,24.0,187.0,2021,Brazil,Serbia,2021-06-05,True,0,0,0,0,0,0,0,0,0,0,0,0,0,0,0,0,0,0,0,0,3,4,0,7
161939.0,Nascimento Maique Reis,L,Brazil,24.0,187.0,2021,Netherlands,Brazil,2021-06-09,True,0,0,0,0,0,0,0,0,0,0,0,0,0,0,0,0,0,0,0,0,0,0,1,1
161939.0,Nascimento Maique Reis,L,Brazil,24.0,187.0,2021,Bulgaria,Brazil,2021-06-10,True,0,0,0,0,0,0,1,1,0,0,0,0,0,0,0,0,4,0,9,13,7,1,1,9
161939.0,Nascimento Maique Reis,L,Brazil,24.0,187.0,2021,Poland,Brazil,2021-06-11,True,0,0,0,0,0,0,0,0,0,0,0,0,0,0,0,0,0,0,0,0,0,0,0,0
161939.0,Nascimento Maique Reis,L,Brazil,24.0,187.0,2021,Brazil,Slovenia,2021-06-15,True,0,0,0,0,0,0,0,0,0,0,0,0,0,0,0,0,0,0,0,0,0,0,0,0
161939.0,Nascimento Maique Reis,L,Brazil,24.0,187.0,2021,Iran,Brazil,2021-06-16,True,0,0,0,0,0,0,0,0,0,0,0,0,0,0,0,0,0,0,0,0,0,0,0,0
161939.0,Nascimento Maique Reis,L,Brazil,24.0,187.0,2021,Australia,Brazil,2021-06-17,True,0,0,0,0,0,0,0,0,0,0,0,0,0,0,0,0,4,0,1,5,13,2,1,16
161939.0,Nascimento Maique Reis,L,Brazil,24.0,187.0,2021,Brazil,Italy,2021-06-21,True,0,0,0,0,0,0,0,0,0,0,0,0,0,0,0,0,0,0,0,0,0,0,0,0
161939.0,Nascimento Maique Reis,L,Brazil,24.0,187.0,2021,Brazil,Germany,2021-06-22,True,0,0,0,0,0,0,0,0,0,0,0,0,0,0,0,0,0,0,0,0,0,0,0,0
161939.0,Nascimento Maique Reis,L,Brazil,24.0,187.0,2021,Brazil,Russia,2021-06-23,False,0,0,0,0,0,0,0,0,0,0,0,0,0,0,0,0,0,0,0,0,0,0,0,0
161939.0,Nascimento Maique Reis,L,Brazil,24.0,187.0,2021,Brazil,France,2021-06-26,True,0,0,0,0,0,0,0,0,0,0,0,0,0,0,0,0,0,0,0,0,0,0,0,0
161939.0,Nascimento Maique Reis,L,Brazil,24.0,187.0,2021,Brazil,Poland,2021-06-27,True,0,0,0,0,0,0,0,0,0,0,0,0,0,0,0,0,0,0,0,0,0,0,0,0
116081.0,Saatkamp Lucas,MB,Brazil,36.0,209.0,2021,Brazil,Italy,2021-06-21,True,1,5,6,12,0,0,1,1,5,2,7,14,1,7,3,11,0,0,1,1,1,0,0,1
116081.0,Saatkamp Lucas,MB,Brazil,36.0,209.0,2021,Brazil,Germany,2021-06-22,True,0,3,1,4,0,0,0,0,1,0,4,5,0,1,0,1,0,0,0,0,0,0,0,0
116081.0,Saatkamp Lucas,MB,Brazil,36.0,209.0,2021,Brazil,Russia,2021-06-23,False,0,0,4,4,0,0,0,0,4,1,1,6,0,5,3,8,0,0,0,0,0,0,0,0
116081.0,Saatkamp Lucas,MB,Brazil,36.0,209.0,2021,Brazil,France,2021-06-26,True,0,2,12,14,0,0,0,0,3,1,3,7,2,1,4,7,0,0,0,0,2,0,1,3
116081.0,Saatkamp Lucas,MB,Brazil,36.0,209.0,2021,Brazil,Poland,2021-06-27,True,1,3,14,18,0,0,0,0,6,1,2,9,0,2,1,3,0,0,0,0,0,0,0,0
118916.0,Hoss Thales,L,Brazil,32.0,190.0,2021,Brazil,Argentina,2021-05-28,True,0,0,0,0,0,0,8,8,0,0,0,0,0,0,0,0,8,0,3,11,7,3,0,10
118916.0,Hoss Thales,L,Brazil,32.0,190.0,2021,USA,Brazil,2021-05-29,True,0,0,0,0,0,0,5,5,0,0,0,0,0,0,0,0,6,1,8,15,2,0,1,3
118916.0,Hoss Thales,L,Brazil,32.0,190.0,2021,Canada,Brazil,2021-05-30,True,0,0,0,0,0,0,6,6,0,0,0,0,0,0,0,0,13,0,9,22,7,4,1,12
118916.0,Hoss Thales,L,Brazil,32.0,190.0,2021,Brazil,France,2021-06-03,False,0,0,0,0,0,0,3,3,0,0,0,0,0,0,0,0,8,1,9,18,9,4,3,16
118916.0,Hoss Thales,L,Brazil,32.0,190.0,2021,Brazil,Japan,2021-06-04,True,0,0,0,0,0,0,1,1,0,0,0,0,0,0,0,0,8,0,8,16,1,0,0,1
118916.0,Hoss Thales,L,Brazil,32.0,190.0,2021,Brazil,Serbia,2021-06-05,True,0,0,0,0,0,0,6,6,0,0,0,0,0,0,0,0,7,2,6,15,3,0,0,3
118916.0,Hoss Thales,L,Brazil,32.0,190.0,2021,Netherlands,Brazil,2021-06-09,True,0,0,0,0,0,0,2,2,0,0,0,0,0,0,0,0,5,0,12,17,6,1,0,7
118916.0,Hoss Thales,L,Brazil,32.0,190.0,2021,Bulgaria,Brazil,2021-06-10,True,0,0,0,0,0,0,0,0,0,0,0,0,0,0,0,0,0,0,0,0,0,0,0,0
118916.0,Hoss Thales,L,Brazil,32.0,190.0,2021,Poland,Brazil,2021-06-11,True,0,0,0,0,0,0,4,4,0,0,0,0,0,0,0,0,5,0,7,12,4,3,0,7
118916.0,Hoss Thales,L,Brazil,32.0,190.0,2021,Brazil,Slovenia,2021-06-15,True,0,0,0,0,0,0,3,3,0,0,0,0,0,0,0,0,8,0,12,20,8,3,1,12
118916.0,Hoss Thales,L,Brazil,32.0,190.0,2021,Iran,Brazil,2021-06-16,True,0,0,0,0,0,0,5,5,0,0,0,0,0,0,0,0,6,0,9,15,13,2,0,15
118916.0,Hoss Thales,L,Brazil,32.0,190.0,2021,Australia,Brazil,2021-06-17,True,0,0,0,0,0,0,0,0,0,0,0,0,0,0,0,0,0,0,0,0,0,0,0,0
118916.0,Hoss Thales,L,Brazil,32.0,190.0,2021,Brazil,Italy,2021-06-21,True,0,0,0,0,0,1,4,5,0,0,0,0,0,0,0,0,6,0,11,17,13,2,2,17
118916.0,Hoss Thales,L,Brazil,32.0,190.0,2021,Brazil,Germany,2021-06-22,True,0,0,0,0,0,0,3,3,0,0,0,0,0,0,0,0,7,1,6,14,10,2,0,12
118916.0,Hoss Thales,L,Brazil,32.0,190.0,2021,Brazil,Russia,2021-06-23,False,0,0,0,0,0,0,4,4,0,0,0,0,0,0,0,0,5,1,11,17,4,3,0,7
118916.0,Hoss Thales,L,Brazil,32.0,190.0,2021,Brazil,France,2021-06-26,True,0,0,0,0,0,0,5,5,0,0,0,0,0,0,0,0,4,1,6,11,8,2,0,10
118916.0,Hoss Thales,L,Brazil,32.0,190.0,2021,Brazil,Poland,2021-06-27,True,0,0,0,0,0,0,7,7,0,0,0,0,0,0,0,0,7,1,5,13,8,1,1,10
136468.0,Souza Ricardo Lucarelli,OH,Brazil,30.0,196.0,2021,Brazil,Argentina,2021-05-28,True,2,1,10,13,0,0,0,0,12,2,5,19,0,3,1,4,11,1,10,22,5,2,0,7
136468.0,Souza Ricardo Lucarelli,OH,Brazil,30.0,196.0,2021,USA,Brazil,2021-05-29,True,0,3,6,9,0,0,1,1,10,6,10,26,1,1,0,2,6,1,5,12,0,0,0,0
136468.0,Souza Ricardo Lucarelli,OH,Brazil,30.0,196.0,2021,Canada,Brazil,2021-05-30,True,0,0,2,2,0,0,0,0,2,0,4,6,0,0,1,1,0,0,3,3,3,0,0,3
136468.0,Souza Ricardo Lucarelli,OH,Brazil,30.0,196.0,2021,Brazil,France,2021-06-03,False,1,6,10,17,0,0,0,0,11,5,9,25,0,4,4,8,10,0,18,28,7,2,1,10
136468.0,Souza Ricardo Lucarelli,OH,Brazil,30.0,196.0,2021,Brazil,Japan,2021-06-04,True,0,0,0,0,0,0,0,0,0,0,0,0,0,0,0,0,0,0,0,0,0,0,0,0
136468.0,Souza Ricardo Lucarelli,OH,Brazil,30.0,196.0,2021,Brazil,Serbia,2021-06-05,True,0,3,15,18,0,0,2,2,14,3,5,22,4,4,3,11,12,2,20,34,7,0,1,8
136468.0,Souza Ricardo Lucarelli,OH,Brazil,30.0,196.0,2021,Netherlands,Brazil,2021-06-09,True,0,0,0,0,0,0,0,0,0,0,1,1,0,0,0,0,0,0,0,0,0,0,0,0
136468.0,Souza Ricardo Lucarelli,OH,Brazil,30.0,196.0,2021,Bulgaria,Brazil,2021-06-10,True,5,3,15,23,0,0,0,0,10,1,1,12,0,1,1,2,2,0,11,13,6,1,0,7
136468.0,Souza Ricardo Lucarelli,OH,Brazil,30.0,196.0,2021,Poland,Brazil,2021-06-11,True,1,3,6,10,0,0,9,9,14,1,7,22,1,1,0,2,3,0,9,12,6,4,0,10
136468.0,Souza Ricardo Lucarelli,OH,Brazil,30.0,196.0,2021,Brazil,Slovenia,2021-06-15,True,1,1,4,6,0,0,1,1,1,3,4,8,0,0,0,0,1,1,7,9,1,0,0,1
136468.0,Souza Ricardo Lucarelli,OH,Brazil,30.0,196.0,2021,Iran,Brazil,2021-06-16,True,1,3,18,22,0,0,4,4,17,5,9,31,2,0,2,4,2,0,10,12,5,1,0,6
136468.0,Souza Ricardo Lucarelli,OH,Brazil,30.0,196.0,2021,Brazil,Italy,2021-06-21,True,3,3,15,21,0,0,7,7,15,3,10,28,3,5,6,14,7,1,16,24,9,4,1,14
136468.0,Souza Ricardo Lucarelli,OH,Brazil,30.0,196.0,2021,Brazil,Russia,2021-06-23,False,1,2,7,10,0,0,3,3,6,3,1,10,0,0,1,1,4,2,13,19,5,2,0,7
136468.0,Souza Ricardo Lucarelli,OH,Brazil,30.0,196.0,2021,Brazil,France,2021-06-26,True,0,3,6,9,0,0,1,1,9,5,3,17,0,1,2,3,3,0,18,21,3,3,0,6
136468.0,Souza Ricardo Lucarelli,OH,Brazil,30.0,196.0,2021,Brazil,Poland,2021-06-27,True,2,4,12,18,0,0,6,6,10,1,10,21,1,1,3,5,4,0,14,18,12,4,3,19
136947.0,Souza Alan,O,Brazil,28.0,202.0,2021,USA,Brazil,2021-05-29,True,1,0,5,6,0,0,1,1,10,2,6,18,1,0,1,2,1,0,0,1,0,0,0,0
136947.0,Souza Alan,O,Brazil,28.0,202.0,2021,Canada,Brazil,2021-05-30,True,0,0,0,0,0,0,0,0,0,0,0,0,0,0,0,0,0,0,0,0,0,0,0,0
136947.0,Souza Alan,O,Brazil,28.0,202.0,2021,Brazil,France,2021-06-03,False,0,1,4,5,0,0,0,0,9,1,2,12,0,4,1,5,0,0,0,0,2,1,2,5
136947.0,Souza Alan,O,Brazil,28.0,202.0,2021,Brazil,Japan,2021-06-04,True,0,0,0,0,0,0,0,0,0,0,0,0,0,0,1,1,0,0,0,0,0,0,0,0
136947.0,Souza Alan,O,Brazil,28.0,202.0,2021,Brazil,Serbia,2021-06-05,True,0,5,8,13,0,0,0,0,17,2,8,27,2,4,2,8,0,0,0,0,7,2,1,10
136947.0,Souza Alan,O,Brazil,28.0,202.0,2021,Netherlands,Brazil,2021-06-09,True,0,0,0,0,0,0,0,0,1,0,0,1,0,0,0,0,0,0,0,0,0,0,0,0
136947.0,Souza Alan,O,Brazil,28.0,202.0,2021,Bulgaria,Brazil,2021-06-10,True,1,3,6,10,0,0,2,2,9,0,3,12,0,2,0,2,0,0,0,0,2,2,0,4
136947.0,Souza Alan,O,Brazil,28.0,202.0,2021,Poland,Brazil,2021-06-11,True,0,0,0,0,0,0,2,2,0,0,0,0,0,0,0,0,0,0,0,0,1,0,0,1
136947.0,Souza Alan,O,Brazil,28.0,202.0,2021,Brazil,Slovenia,2021-06-15,True,1,1,1,3,0,0,0,0,0,2,1,3,0,0,1,1,0,0,0,0,2,0,0,2
136947.0,Souza Alan,O,Brazil,28.0,202.0,2021,Iran,Brazil,2021-06-16,True,0,2,10,12,0,0,3,3,13,6,12,31,3,2,1,6,0,0,0,0,7,1,0,8
136947.0,Souza Alan,O,Brazil,28.0,202.0,2021,Australia,Brazil,2021-06-17,True,0,0,9,9,0,0,1,1,9,3,7,19,0,2,3,5,0,0,1,1,3,3,1,7
136947.0,Souza Alan,O,Brazil,28.0,202.0,2021,Brazil,Italy,2021-06-21,True,0,0,0,0,0,0,0,0,0,0,1,1,0,0,0,0,0,0,0,0,0,0,0,0
136947.0,Souza Alan,O,Brazil,28.0,202.0,2021,Brazil,Germany,2021-06-22,True,0,2,10,12,0,0,0,0,13,2,7,22,1,3,1,5,1,0,1,2,4,1,0,5
136947.0,Souza Alan,O,Brazil,28.0,202.0,2021,Brazil,Russia,2021-06-23,False,0,0,7,7,0,0,0,0,4,0,2,6,1,1,1,3,0,0,0,0,0,0,0,0
136947.0,Souza Alan,O,Brazil,28.0,202.0,2021,Brazil,France,2021-06-26,True,0,0,0,0,0,0,0,0,0,0,0,0,0,0,0,0,0,0,0,0,0,0,0,0
136947.0,Souza Alan,O,Brazil,28.0,202.0,2021,Brazil,Poland,2021-06-27,True,0,0,0,0,0,0,0,0,0,0,0,0,0,0,0,0,0,0,0,0,0,0,0,0
136956.0,Resende Gualberto Flavio,MB,Brazil,28.0,199.0,2021,Brazil,Argentina,2021-05-28,True,1,1,10,12,0,0,0,0,3,1,2,6,1,1,3,5,0,0,0,0,2,1,0,3
136956.0,Resende Gualberto Flavio,MB,Brazil,28.0,199.0,2021,USA,Brazil,2021-05-29,True,0,1,13,14,0,0,0,0,2,2,5,9,0,1,1,2,0,0,1,1,1,0,0,1
136956.0,Resende Gualberto Flavio,MB,Brazil,28.0,199.0,2021,Canada,Brazil,2021-05-30,True,1,2,15,18,0,0,0,0,6,2,6,14,1,4,2,7,1,0,0,1,4,2,0,6
136956.0,Resende Gualberto Flavio,MB,Brazil,28.0,199.0,2021,Brazil,France,2021-06-03,False,0,0,11,11,0,0,0,0,0,2,5,7,0,6,5,11,0,0,1,1,3,0,0,3
136956.0,Resende Gualberto Flavio,MB,Brazil,28.0,199.0,2021,Brazil,Japan,2021-06-04,True,0,0,9,9,0,0,5,5,4,2,0,6,0,2,2,4,0,0,0,0,2,0,0,2
136956.0,Resende Gualberto Flavio,MB,Brazil,28.0,199.0,2021,Brazil,Serbia,2021-06-05,True,0,2,7,9,0,0,0,0,3,1,2,6,0,5,2,7,0,0,0,0,1,0,1,2
136956.0,Resende Gualberto Flavio,MB,Brazil,28.0,199.0,2021,Netherlands,Brazil,2021-06-09,True,0,1,12,13,0,0,0,0,5,2,2,9,2,3,2,7,0,0,0,0,3,0,0,3
136956.0,Resende Gualberto Flavio,MB,Brazil,28.0,199.0,2021,Bulgaria,Brazil,2021-06-10,True,2,1,8,11,0,0,0,0,5,0,4,9,3,3,1,7,0,1,0,1,0,1,0,1
136956.0,Resende Gualberto Flavio,MB,Brazil,28.0,199.0,2021,Poland,Brazil,2021-06-11,True,0,0,0,0,0,0,0,0,0,0,0,0,0,0,0,0,0,0,0,0,0,0,0,0
136956.0,Resende Gualberto Flavio,MB,Brazil,28.0,199.0,2021,Brazil,Slovenia,2021-06-15,True,0,0,12,12,0,0,1,1,7,1,3,11,2,9,8,19,1,1,0,2,5,1,0,6
136956.0,Resende Gualberto Flavio,MB,Brazil,28.0,199.0,2021,Iran,Brazil,2021-06-16,True,0,0,0,0,0,0,0,0,0,0,0,0,0,0,0,0,0,0,0,0,0,0,0,0
136956.0,Resende Gualberto Flavio,MB,Brazil,28.0,199.0,2021,Australia,Brazil,2021-06-17,True,0,2,12,14,0,0,1,1,4,0,0,4,1,4,6,11,0,0,2,2,4,0,0,4
136956.0,Resende Gualberto Flavio,MB,Brazil,28.0,199.0,2021,Brazil,Italy,2021-06-21,True,0,0,0,0,0,0,0,0,0,0,0,0,0,0,0,0,0,0,0,0,0,0,0,0
136956.0,Resende Gualberto Flavio,MB,Brazil,28.0,199.0,2021,Brazil,Germany,2021-06-22,True,0,0,7,7,0,0,1,1,5,1,2,8,0,1,0,1,0,0,0,0,1,1,0,2
136956.0,Resende Gualberto Flavio,MB,Brazil,28.0,199.0,2021,Brazil,Russia,2021-06-23,False,0,0,4,4,0,0,1,1,1,0,1,2,0,0,0,0,0,0,0,0,0,0,0,0
136956.0,Resende Gualberto Flavio,MB,Brazil,28.0,199.0,2021,Brazil,France,2021-06-26,True,0,0,0,0,0,0,0,0,0,0,0,0,0,0,0,0,0,0,0,0,0,0,0,0
136956.0,Resende Gualberto Flavio,MB,Brazil,28.0,199.0,2021,Brazil,Poland,2021-06-27,True,0,0,0,0,0,0,0,0,0,0,0,0,0,0,0,0,0,0,0,0,0,0,0,0
174445.0,Karyagin Denis,OH,Bulgaria,19.0,206.0,2021,France,Bulgaria,2021-05-28,False,0,3,1,4,0,0,0,0,6,0,1,7,0,0,0,0,2,2,5,9,0,0,0,0
174445.0,Karyagin Denis,OH,Bulgaria,19.0,206.0,2021,Australia,Bulgaria,2021-05-29,True,0,1,1,2,0,0,0,0,0,0,0,0,0,0,0,0,0,0,0,0,0,0,0,0
174445.0,Karyagin Denis,OH,Bulgaria,19.0,206.0,2021,Germany,Bulgaria,2021-05-30,False,1,0,1,2,0,0,0,0,1,0,2,3,0,0,0,0,0,1,1,2,0,1,0,1
174445.0,Karyagin Denis,OH,Bulgaria,19.0,206.0,2021,Italy,Bulgaria,2021-06-03,False,0,0,2,2,0,0,0,0,2,2,1,5,0,0,0,0,0,1,4,5,1,1,0,2
174445.0,Karyagin Denis,OH,Bulgaria,19.0,206.0,2021,Canada,Bulgaria,2021-06-04,False,0,1,1,2,0,0,0,0,0,1,3,4,0,0,0,0,0,2,3,5,1,0,0,1
174445.0,Karyagin Denis,OH,Bulgaria,19.0,206.0,2021,Bulgaria,Iran,2021-06-05,False,0,4,6,10,0,0,4,4,6,2,4,12,0,2,1,3,1,3,13,17,4,1,1,6
174445.0,Karyagin Denis,OH,Bulgaria,19.0,206.0,2021,Poland,Bulgaria,2021-06-09,False,1,1,2,4,0,0,1,1,2,2,2,6,0,0,0,0,1,0,0,1,0,0,0,0
174445.0,Karyagin Denis,OH,Bulgaria,19.0,206.0,2021,Bulgaria,Brazil,2021-06-10,False,0,2,5,7,0,0,2,2,7,4,4,15,0,1,1,2,0,2,10,12,2,0,0,2
174445.0,Karyagin Denis,OH,Bulgaria,19.0,206.0,2021,Netherlands,Bulgaria,2021-06-11,True,1,0,9,10,0,0,1,1,14,1,9,24,0,1,2,3,0,0,0,0,0,3,0,3
174445.0,Karyagin Denis,OH,Bulgaria,19.0,206.0,2021,Argentina,Bulgaria,2021-06-15,False,0,1,2,3,0,0,1,1,3,1,4,8,0,0,1,1,0,0,0,0,0,1,0,1
174445.0,Karyagin Denis,OH,Bulgaria,19.0,206.0,2021,Serbia,Bulgaria,2021-06-16,False,0,0,1,1,0,0,0,0,1,1,2,4,0,0,1,1,0,0,0,0,0,0,0,0
174445.0,Karyagin Denis,OH,Bulgaria,19.0,206.0,2021,Bulgaria,Russia,2021-06-17,False,0,2,4,6,0,1,0,1,1,3,6,10,1,1,2,4,0,0,0,0,0,0,0,0
174445.0,Karyagin Denis,OH,Bulgaria,19.0,206.0,2021,Japan,Bulgaria,2021-06-21,False,0,0,5,5,0,0,0,0,6,3,10,19,0,1,0,1,0,0,0,0,4,1,0,5
174445.0,Karyagin Denis,OH,Bulgaria,19.0,206.0,2021,Bulgaria,USA,2021-06-22,False,0,0,1,1,0,1,0,1,0,3,2,5,0,0,0,0,0,0,0,0,1,0,0,1
174445.0,Karyagin Denis,OH,Bulgaria,19.0,206.0,2021,Slovenia,Bulgaria,2021-06-23,False,1,2,10,13,0,0,1,1,8,5,7,20,1,3,1,5,0,0,0,0,0,0,0,0
180588.0,Chavdarov Stefan,MB,Bulgaria,26.0,202.0,2021,France,Bulgaria,2021-05-28,False,0,0,3,3,0,0,0,0,0,0,0,0,0,0,0,0,0,0,0,0,0,0,0,0
180588.0,Chavdarov Stefan,MB,Bulgaria,26.0,202.0,2021,Australia,Bulgaria,2021-05-29,True,1,2,3,6,0,0,0,0,0,0,1,1,1,0,3,4,0,0,0,0,1,0,0,1
180588.0,Chavdarov Stefan,MB,Bulgaria,26.0,202.0,2021,Germany,Bulgaria,2021-05-30,False,0,0,1,1,0,0,0,0,0,0,2,2,0,0,1,1,1,0,0,1,0,0,0,0
180588.0,Chavdarov Stefan,MB,Bulgaria,26.0,202.0,2021,Italy,Bulgaria,2021-06-03,False,0,1,9,10,0,0,1,1,4,0,3,7,1,2,0,3,0,0,1,1,1,0,0,1
180588.0,Chavdarov Stefan,MB,Bulgaria,26.0,202.0,2021,Canada,Bulgaria,2021-06-04,False,0,3,5,8,0,0,0,0,3,0,2,5,0,2,1,3,0,0,0,0,2,2,0,4
180588.0,Chavdarov Stefan,MB,Bulgaria,26.0,202.0,2021,Bulgaria,Iran,2021-06-05,False,1,1,11,13,0,0,0,0,3,0,3,6,1,6,3,10,0,0,0,0,1,1,0,2
180588.0,Chavdarov Stefan,MB,Bulgaria,26.0,202.0,2021,Poland,Bulgaria,2021-06-09,False,0,0,0,0,0,0,0,0,0,0,0,0,0,0,0,0,0,0,0,0,0,0,0,0
180588.0,Chavdarov Stefan,MB,Bulgaria,26.0,202.0,2021,Argentina,Bulgaria,2021-06-15,False,0,2,5,7,0,0,0,0,4,2,0,6,0,2,2,4,0,0,0,0,3,1,0,4
180588.0,Chavdarov Stefan,MB,Bulgaria,26.0,202.0,2021,Serbia,Bulgaria,2021-06-16,False,0,4,7,11,0,0,0,0,5,0,4,9,2,1,0,3,1,0,2,3,2,1,1,4
180588.0,Chavdarov Stefan,MB,Bulgaria,26.0,202.0,2021,Bulgaria,Russia,2021-06-17,False,0,2,4,6,0,0,0,0,0,0,0,0,0,3,2,5,0,0,0,0,1,0,0,1
180588.0,Chavdarov Stefan,MB,Bulgaria,26.0,202.0,2021,Japan,Bulgaria,2021-06-21,False,0,3,8,11,0,0,0,0,2,0,2,4,1,4,3,8,0,0,1,1,2,0,0,2
180588.0,Chavdarov Stefan,MB,Bulgaria,26.0,202.0,2021,Bulgaria,USA,2021-06-22,False,0,1,5,6,0,0,0,0,4,0,2,6,0,4,6,10,0,0,2,2,4,1,0,5
180588.0,Chavdarov Stefan,MB,Bulgaria,26.0,202.0,2021,Slovenia,Bulgaria,2021-06-23,False,0,3,3,6,0,0,0,0,3,0,0,3,3,5,1,9,0,0,0,0,1,0,1,2
173067.0,Kolev Nikolay,MB,Bulgaria,24.0,204.0,2021,France,Bulgaria,2021-05-28,False,0,0,0,0,0,0,0,0,0,0,0,0,0,0,0,0,0,0,0,0,0,0,0,0
173067.0,Kolev Nikolay,MB,Bulgaria,24.0,204.0,2021,Australia,Bulgaria,2021-05-29,True,0,0,0,0,0,0,0,0,0,0,0,0,0,0,0,0,0,0,0,0,0,0,0,0
173067.0,Kolev Nikolay,MB,Bulgaria,24.0,204.0,2021,Germany,Bulgaria,2021-05-30,False,0,0,0,0,0,0,0,0,0,0,0,0,0,0,0,0,0,0,0,0,0,0,0,0
173067.0,Kolev Nikolay,MB,Bulgaria,24.0,204.0,2021,Italy,Bulgaria,2021-06-03,False,0,0,7,7,0,0,2,2,3,1,4,8,1,3,1,5,0,0,2,2,2,1,0,3
173067.0,Kolev Nikolay,MB,Bulgaria,24.0,204.0,2021,Canada,Bulgaria,2021-06-04,False,0,0,0,0,0,0,0,0,0,0,0,0,0,0,0,0,0,0,0,0,1,0,0,1
173067.0,Kolev Nikolay,MB,Bulgaria,24.0,204.0,2021,Bulgaria,Iran,2021-06-05,False,0,0,12,12,0,0,2,2,7,0,6,13,1,6,5,12,0,0,0,0,0,1,0,1
173067.0,Kolev Nikolay,MB,Bulgaria,24.0,204.0,2021,Poland,Bulgaria,2021-06-09,False,0,0,5,5,0,0,0,0,1,2,1,4,0,2,0,2,0,0,1,1,0,1,0,1
173067.0,Kolev Nikolay,MB,Bulgaria,24.0,204.0,2021,Bulgaria,Brazil,2021-06-10,False,1,3,6,10,0,0,0,0,3,0,1,4,0,4,0,4,0,0,1,1,0,0,0,0
173067.0,Kolev Nikolay,MB,Bulgaria,24.0,204.0,2021,Netherlands,Bulgaria,2021-06-11,True,0,0,12,12,0,0,1,1,7,0,1,8,1,6,4,11,0,0,0,0,2,0,1,3
173067.0,Kolev Nikolay,MB,Bulgaria,24.0,204.0,2021,Argentina,Bulgaria,2021-06-15,False,0,0,13,13,0,0,1,1,5,1,5,11,2,3,0,5,0,0,1,1,0,2,0,2
173067.0,Kolev Nikolay,MB,Bulgaria,24.0,204.0,2021,Serbia,Bulgaria,2021-06-16,False,0,0,6,6,0,0,0,0,1,2,0,3,0,5,2,7,0,0,1,1,0,0,1,1
173067.0,Kolev Nikolay,MB,Bulgaria,24.0,204.0,2021,Bulgaria,Russia,2021-06-17,False,1,1,8,10,0,0,2,2,6,0,5,11,0,8,5,13,0,0,0,0,1,1,0,2
173067.0,Kolev Nikolay,MB,Bulgaria,24.0,204.0,2021,Japan,Bulgaria,2021-06-21,False,0,0,6,6,0,0,1,1,5,0,3,8,3,3,3,9,0,0,2,2,0,1,0,1
173067.0,Kolev Nikolay,MB,Bulgaria,24.0,204.0,2021,Bulgaria,USA,2021-06-22,False,0,0,12,12,0,0,2,2,5,0,2,7,0,4,4,8,0,0,0,0,3,0,1,4
173067.0,Kolev Nikolay,MB,Bulgaria,24.0,204.0,2021,Slovenia,Bulgaria,2021-06-23,False,0,0,7,7,0,0,2,2,4,0,0,4,2,3,2,7,0,0,1,1,0,0,1,1
156676.0,Atanasov Martin,OH,Bulgaria,25.0,197.0,2021,France,Bulgaria,2021-05-28,False,2,3,5,10,0,0,0,0,2,4,8,14,1,2,0,3,2,0,6,8,0,0,0,0
156676.0,Atanasov Martin,OH,Bulgaria,25.0,197.0,2021,Australia,Bulgaria,2021-05-29,True,1,2,6,9,0,0,0,0,10,5,5,20,2,1,1,4,9,0,11,20,5,0,1,6
156676.0,Atanasov Martin,OH,Bulgaria,25.0,197.0,2021,Germany,Bulgaria,2021-05-30,False,3,5,6,14,0,0,0,0,6,7,9,22,1,2,0,3,6,2,16,24,5,1,0,6
156676.0,Atanasov Martin,OH,Bulgaria,25.0,197.0,2021,Italy,Bulgaria,2021-06-03,False,0,0,0,0,0,0,0,0,0,0,0,0,0,0,0,0,0,0,0,0,0,0,0,0
156676.0,Atanasov Martin,OH,Bulgaria,25.0,197.0,2021,Canada,Bulgaria,2021-06-04,False,0,0,0,0,0,0,0,0,0,0,0,0,0,0,0,0,0,0,0,0,0,0,0,0
156676.0,Atanasov Martin,OH,Bulgaria,25.0,197.0,2021,Bulgaria,Iran,2021-06-05,False,0,0,0,0,0,0,0,0,0,0,0,0,0,0,0,0,0,0,0,0,0,0,0,0
156676.0,Atanasov Martin,OH,Bulgaria,25.0,197.0,2021,Poland,Bulgaria,2021-06-09,False,0,0,0,0,0,0,0,0,0,0,0,0,0,0,0,0,0,0,0,0,0,0,0,0
156676.0,Atanasov Martin,OH,Bulgaria,25.0,197.0,2021,Bulgaria,Brazil,2021-06-10,False,0,0,0,0,0,0,0,0,0,0,0,0,0,0,0,0,0,0,0,0,0,0,0,0
156676.0,Atanasov Martin,OH,Bulgaria,25.0,197.0,2021,Netherlands,Bulgaria,2021-06-11,True,0,0,0,0,0,0,0,0,0,0,0,0,0,0,0,0,0,0,0,0,0,0,0,0
156676.0,Atanasov Martin,OH,Bulgaria,25.0,197.0,2021,Argentina,Bulgaria,2021-06-15,False,2,4,9,15,0,0,1,1,11,3,14,28,1,1,1,3,9,0,10,19,4,1,1,6
156676.0,Atanasov Martin,OH,Bulgaria,25.0,197.0,2021,Serbia,Bulgaria,2021-06-16,False,2,1,8,11,0,0,2,2,7,2,7,16,1,4,0,5,4,0,11,15,1,1,0,2
156676.0,Atanasov Martin,OH,Bulgaria,25.0,197.0,2021,Bulgaria,Russia,2021-06-17,False,2,2,9,13,0,0,3,3,7,5,6,18,0,1,0,1,4,0,13,17,6,4,1,11
156676.0,Atanasov Martin,OH,Bulgaria,25.0,197.0,2021,Japan,Bulgaria,2021-06-21,False,1,0,9,10,0,0,1,1,2,1,7,10,0,2,0,2,4,0,13,17,5,3,0,8
156676.0,Atanasov Martin,OH,Bulgaria,25.0,197.0,2021,Bulgaria,USA,2021-06-22,False,0,0,0,0,0,0,0,0,0,0,0,0,0,0,0,0,0,0,0,0,0,0,0,0
156676.0,Atanasov Martin,OH,Bulgaria,25.0,197.0,2021,Slovenia,Bulgaria,2021-06-23,False,0,0,0,0,0,0,0,0,0,0,0,0,0,0,0,0,0,0,0,0,0,0,0,0
162124.0,Stankov Vladimir,S,Bulgaria,25.0,190.0,2021,Italy,Bulgaria,2021-06-03,False,0,1,6,7,6,0,56,62,0,0,1,1,0,4,6,10,0,0,0,0,3,2,1,6
162124.0,Stankov Vladimir,S,Bulgaria,25.0,190.0,2021,Canada,Bulgaria,2021-06-04,False,0,0,0,0,0,0,0,0,0,0,0,0,0,0,0,0,0,0,0,0,0,0,0,0
162124.0,Stankov Vladimir,S,Bulgaria,25.0,190.0,2021,Bulgaria,Iran,2021-06-05,False,2,4,11,17,26,0,56,82,3,0,0,3,2,2,0,4,0,0,1,1,6,0,1,7
162124.0,Stankov Vladimir,S,Bulgaria,25.0,190.0,2021,Bulgaria,Brazil,2021-06-10,False,0,0,2,2,3,0,19,22,0,0,1,1,0,2,0,2,0,0,0,0,1,1,0,2
162124.0,Stankov Vladimir,S,Bulgaria,25.0,190.0,2021,Netherlands,Bulgaria,2021-06-11,True,0,1,0,1,3,0,5,8,0,0,0,0,0,0,1,1,0,0,0,0,1,0,1,2
162124.0,Stankov Vladimir,S,Bulgaria,25.0,190.0,2021,Serbia,Bulgaria,2021-06-16,False,0,0,1,1,1,1,6,8,0,0,0,0,0,0,0,0,0,0,0,0,0,0,0,0
162124.0,Stankov Vladimir,S,Bulgaria,25.0,190.0,2021,Bulgaria,Russia,2021-06-17,False,0,0,7,7,5,1,38,44,0,0,0,0,0,3,1,4,0,0,0,0,0,1,0,1
162124.0,Stankov Vladimir,S,Bulgaria,25.0,190.0,2021,Japan,Bulgaria,2021-06-21,False,0,1,1,2,6,0,6,12,0,0,0,0,0,0,0,0,0,0,1,1,0,0,0,0
162124.0,Stankov Vladimir,S,Bulgaria,25.0,190.0,2021,Bulgaria,USA,2021-06-22,False,0,4,7,11,11,1,49,61,0,1,0,1,1,1,1,3,0,0,0,0,3,1,1,5
162124.0,Stankov Vladimir,S,Bulgaria,25.0,190.0,2021,Slovenia,Bulgaria,2021-06-23,False,0,1,1,2,0,0,0,0,0,0,0,0,0,0,0,0,0,0,0,0,0,0,0,0
137012.0,Seganov Georgi,S,Bulgaria,28.0,197.0,2021,France,Bulgaria,2021-05-28,False,0,2,13,15,3,0,66,69,0,1,0,1,1,0,0,1,0,0,0,0,0,0,0,0
137012.0,Seganov Georgi,S,Bulgaria,28.0,197.0,2021,Australia,Bulgaria,2021-05-29,True,1,3,6,10,22,0,46,68,2,0,0,2,0,3,1,4,0,1,1,2,3,2,1,6
137012.0,Seganov Georgi,S,Bulgaria,28.0,197.0,2021,Germany,Bulgaria,2021-05-30,False,0,2,18,20,31,0,86,117,0,0,1,1,3,3,3,9,0,0,1,1,2,1,3,6
137012.0,Seganov Georgi,S,Bulgaria,28.0,197.0,2021,Italy,Bulgaria,2021-06-03,False,0,0,7,7,9,0,36,45,1,0,0,1,0,0,0,0,0,0,0,0,1,0,0,1
137012.0,Seganov Georgi,S,Bulgaria,28.0,197.0,2021,Canada,Bulgaria,2021-06-04,False,2,1,16,19,15,0,53,68,0,0,0,0,0,1,2,3,0,0,0,0,4,3,0,7
137012.0,Seganov Georgi,S,Bulgaria,28.0,197.0,2021,Bulgaria,Iran,2021-06-05,False,0,0,0,0,0,0,0,0,0,0,0,0,0,0,0,0,0,0,0,0,0,0,0,0
137012.0,Seganov Georgi,S,Bulgaria,28.0,197.0,2021,Poland,Bulgaria,2021-06-09,False,0,1,3,4,7,0,36,43,1,0,0,1,0,1,0,1,0,0,0,0,0,1,0,1
137012.0,Seganov Georgi,S,Bulgaria,28.0,197.0,2021,Bulgaria,Brazil,2021-06-10,False,0,1,4,5,11,0,22,33,1,0,0,1,0,0,0,0,0,0,0,0,0,0,0,0
137012.0,Seganov Georgi,S,Bulgaria,28.0,197.0,2021,Netherlands,Bulgaria,2021-06-11,True,3,1,12,16,26,2,45,73,2,0,0,2,1,2,1,4,0,0,0,0,7,0,0,7
137012.0,Seganov Georgi,S,Bulgaria,28.0,197.0,2021,Argentina,Bulgaria,2021-06-15,False,1,4,11,16,12,1,75,88,1,0,0,1,1,5,3,9,0,0,1,1,5,2,0,7
137012.0,Seganov Georgi,S,Bulgaria,28.0,197.0,2021,Serbia,Bulgaria,2021-06-16,False,0,1,6,7,15,1,39,55,1,0,2,3,1,0,1,2,0,0,0,0,3,2,1,6
137012.0,Seganov Georgi,S,Bulgaria,28.0,197.0,2021,Bulgaria,Russia,2021-06-17,False,0,0,0,0,0,0,0,0,0,0,0,0,0,0,0,0,0,0,0,0,0,0,0,0
137012.0,Seganov Georgi,S,Bulgaria,28.0,197.0,2021,Japan,Bulgaria,2021-06-21,False,0,1,8,9,13,0,44,57,0,1,0,1,2,0,3,5,0,0,0,0,2,3,0,5
137012.0,Seganov Georgi,S,Bulgaria,28.0,197.0,2021,Bulgaria,USA,2021-06-22,False,0,0,0,0,1,0,12,13,0,0,0,0,0,0,0,0,0,0,0,0,0,1,0,1
137012.0,Seganov Georgi,S,Bulgaria,28.0,197.0,2021,Slovenia,Bulgaria,2021-06-23,False,1,2,5,8,27,2,32,61,2,1,1,4,1,2,2,5,0,0,0,0,1,2,3,6
181285.0,Stankov Svetoslav,S,Bulgaria,25.0,195.0,2021,France,Bulgaria,2021-05-28,False,0,0,0,0,0,0,0,0,0,0,0,0,0,0,0,0,0,0,0,0,0,0,0,0
181285.0,Stankov Svetoslav,S,Bulgaria,25.0,195.0,2021,Australia,Bulgaria,2021-05-29,True,0,0,0,0,0,0,0,0,0,0,0,0,0,0,0,0,0,0,0,0,0,0,0,0
181285.0,Stankov Svetoslav,S,Bulgaria,25.0,195.0,2021,Germany,Bulgaria,2021-05-30,False,0,0,0,0,0,0,0,0,0,0,0,0,0,0,0,0,0,0,0,0,0,0,0,0
181285.0,Stankov Svetoslav,S,Bulgaria,25.0,195.0,2021,Bulgaria,Iran,2021-06-05,False,0,0,0,0,0,0,0,0,0,0,0,0,0,0,0,0,0,0,0,0,0,0,0,0
181285.0,Stankov Svetoslav,S,Bulgaria,25.0,195.0,2021,Poland,Bulgaria,2021-06-09,False,0,0,1,1,4,0,9,13,0,0,0,0,0,0,0,0,0,0,0,0,1,1,0,2
181285.0,Stankov Svetoslav,S,Bulgaria,25.0,195.0,2021,Argentina,Bulgaria,2021-06-15,False,0,0,0,0,0,0,4,4,0,0,0,0,0,0,0,0,0,0,0,0,0,0,0,0
181285.0,Stankov Svetoslav,S,Bulgaria,25.0,195.0,2021,Serbia,Bulgaria,2021-06-16,False,0,0,1,1,0,0,0,0,0,0,0,0,0,0,0,0,0,0,0,0,0,1,0,1
181285.0,Stankov Svetoslav,S,Bulgaria,25.0,195.0,2021,Bulgaria,Russia,2021-06-17,False,1,0,2,3,1,0,16,17,0,0,0,0,0,1,0,1,0,0,0,0,1,1,0,2
181285.0,Stankov Svetoslav,S,Bulgaria,25.0,195.0,2021,Slovenia,Bulgaria,2021-06-23,False,0,0,0,0,0,0,0,0,0,0,0,0,0,0,0,0,0,0,0,0,0,0,0,0
152619.0,Grozdanov Aleks,MB,Bulgaria,23.0,208.0,2021,France,Bulgaria,2021-05-28,False,0,3,6,9,0,0,2,2,3,3,1,7,0,3,0,3,0,0,0,0,0,0,0,0
152619.0,Grozdanov Aleks,MB,Bulgaria,23.0,208.0,2021,Australia,Bulgaria,2021-05-29,True,5,3,6,14,0,1,0,1,3,0,3,6,1,5,4,10,0,0,1,1,1,0,0,1
152619.0,Grozdanov Aleks,MB,Bulgaria,23.0,208.0,2021,Germany,Bulgaria,2021-05-30,False,0,3,10,13,1,0,0,1,5,1,4,10,6,5,10,21,3,0,1,4,4,0,1,5
173010.0,Petrov Georgi,OH,Bulgaria,22.0,197.0,2021,France,Bulgaria,2021-05-28,False,0,1,2,3,0,0,0,0,3,1,2,6,0,1,0,1,7,2,7,16,0,0,0,0
173010.0,Petrov Georgi,OH,Bulgaria,22.0,197.0,2021,Australia,Bulgaria,2021-05-29,True,0,0,0,0,0,0,0,0,0,0,0,0,0,0,0,0,0,0,0,0,0,0,0,0
173010.0,Petrov Georgi,OH,Bulgaria,22.0,197.0,2021,Germany,Bulgaria,2021-05-30,False,0,0,2,2,0,0,0,0,1,1,1,3,0,2,0,2,0,0,6,6,1,0,0,1
173010.0,Petrov Georgi,OH,Bulgaria,22.0,197.0,2021,Italy,Bulgaria,2021-06-03,False,0,1,3,4,0,0,1,1,2,2,1,5,0,3,0,3,2,1,7,10,1,0,0,1
173010.0,Petrov Georgi,OH,Bulgaria,22.0,197.0,2021,Canada,Bulgaria,2021-06-04,False,0,0,1,1,0,0,0,0,1,0,0,1,0,0,0,0,2,0,4,6,0,1,1,2
173010.0,Petrov Georgi,OH,Bulgaria,22.0,197.0,2021,Bulgaria,Iran,2021-06-05,False,0,4,3,7,0,0,2,2,8,4,11,23,0,2,4,6,1,1,21,23,7,0,0,7
173010.0,Petrov Georgi,OH,Bulgaria,22.0,197.0,2021,Poland,Bulgaria,2021-06-09,False,0,4,4,8,0,0,0,0,7,3,9,19,2,3,0,5,7,3,16,26,1,1,0,2
173010.0,Petrov Georgi,OH,Bulgaria,22.0,197.0,2021,Bulgaria,Brazil,2021-06-10,False,0,1,0,1,0,0,1,1,2,3,0,5,2,0,0,2,1,4,8,13,3,1,1,5
173010.0,Petrov Georgi,OH,Bulgaria,22.0,197.0,2021,Netherlands,Bulgaria,2021-06-11,True,0,1,0,1,0,0,0,0,0,1,0,1,0,2,0,2,1,1,0,2,0,0,0,0
173010.0,Petrov Georgi,OH,Bulgaria,22.0,197.0,2021,Argentina,Bulgaria,2021-06-15,False,0,0,0,0,0,0,0,0,0,0,0,0,0,0,0,0,0,0,0,0,0,0,0,0
173010.0,Petrov Georgi,OH,Bulgaria,22.0,197.0,2021,Serbia,Bulgaria,2021-06-16,False,0,1,2,3,0,0,0,0,1,0,2,3,1,0,0,1,0,2,6,8,1,0,0,1
173010.0,Petrov Georgi,OH,Bulgaria,22.0,197.0,2021,Bulgaria,Russia,2021-06-17,False,0,0,0,0,0,0,0,0,0,0,0,0,0,0,0,0,0,0,0,0,0,0,0,0
173010.0,Petrov Georgi,OH,Bulgaria,22.0,197.0,2021,Japan,Bulgaria,2021-06-21,False,0,0,0,0,0,0,0,0,0,0,0,0,0,0,0,0,0,0,0,0,0,0,0,0
173010.0,Petrov Georgi,OH,Bulgaria,22.0,197.0,2021,Bulgaria,USA,2021-06-22,False,0,0,7,7,0,0,0,0,7,1,8,16,0,2,4,6,5,1,11,17,3,0,0,3
173010.0,Petrov Georgi,OH,Bulgaria,22.0,197.0,2021,Slovenia,Bulgaria,2021-06-23,False,0,2,3,5,0,0,0,0,5,1,7,13,0,1,0,1,5,1,14,20,1,1,0,2
168269.0,Asparuhov Asparuh,OH,Bulgaria,21.0,201.0,2021,France,Bulgaria,2021-05-28,False,0,0,4,4,0,0,1,1,3,0,2,5,0,0,0,0,3,0,6,9,0,0,0,0
168269.0,Asparuhov Asparuh,OH,Bulgaria,21.0,201.0,2021,Australia,Bulgaria,2021-05-29,True,3,3,8,14,0,0,0,0,5,2,6,13,0,2,3,5,6,0,9,15,5,0,1,6
168269.0,Asparuhov Asparuh,OH,Bulgaria,21.0,201.0,2021,Germany,Bulgaria,2021-05-30,False,3,4,13,20,0,0,0,0,7,6,11,24,0,2,1,3,8,3,19,30,7,0,0,7
168269.0,Asparuhov Asparuh,OH,Bulgaria,21.0,201.0,2021,Italy,Bulgaria,2021-06-03,False,1,2,12,15,0,0,3,3,16,2,13,31,2,1,4,7,16,1,20,37,6,4,0,10
168269.0,Asparuhov Asparuh,OH,Bulgaria,21.0,201.0,2021,Canada,Bulgaria,2021-06-04,False,0,4,4,8,0,0,3,3,6,2,5,13,1,3,2,6,5,3,11,19,2,3,0,5
168269.0,Asparuhov Asparuh,OH,Bulgaria,21.0,201.0,2021,Bulgaria,Iran,2021-06-05,False,1,2,3,6,0,0,1,1,3,4,5,12,0,1,1,2,1,1,5,7,2,2,0,4
168269.0,Asparuhov Asparuh,OH,Bulgaria,21.0,201.0,2021,Poland,Bulgaria,2021-06-09,False,0,2,3,5,0,0,1,1,8,0,7,15,0,1,0,1,7,2,4,13,1,1,0,2
168269.0,Asparuhov Asparuh,OH,Bulgaria,21.0,201.0,2021,Bulgaria,Brazil,2021-06-10,False,0,0,6,6,0,0,3,3,8,1,3,12,0,1,0,1,2,1,7,10,2,2,0,4
168269.0,Asparuhov Asparuh,OH,Bulgaria,21.0,201.0,2021,Netherlands,Bulgaria,2021-06-11,True,1,3,12,16,0,0,4,4,9,2,9,20,2,2,3,7,7,5,21,33,7,4,0,11
168269.0,Asparuhov Asparuh,OH,Bulgaria,21.0,201.0,2021,Argentina,Bulgaria,2021-06-15,False,0,0,4,4,0,0,1,1,2,0,4,6,0,2,0,2,4,0,5,9,1,1,0,2
168269.0,Asparuhov Asparuh,OH,Bulgaria,21.0,201.0,2021,Serbia,Bulgaria,2021-06-16,False,1,2,5,8,0,0,3,3,4,2,6,12,0,3,1,4,3,5,12,20,1,1,1,3
168269.0,Asparuhov Asparuh,OH,Bulgaria,21.0,201.0,2021,Bulgaria,Russia,2021-06-17,False,0,2,4,6,0,0,1,1,9,1,7,17,1,3,3,7,5,4,12,21,2,1,0,3
168269.0,Asparuhov Asparuh,OH,Bulgaria,21.0,201.0,2021,Japan,Bulgaria,2021-06-21,False,1,2,4,7,0,0,0,0,14,3,6,23,2,2,2,6,3,3,14,20,3,3,0,6
168269.0,Asparuhov Asparuh,OH,Bulgaria,21.0,201.0,2021,Bulgaria,USA,2021-06-22,False,0,0,1,1,0,0,0,0,2,0,1,3,0,0,0,0,0,0,4,4,0,0,0,0
168269.0,Asparuhov Asparuh,OH,Bulgaria,21.0,201.0,2021,Slovenia,Bulgaria,2021-06-23,False,0,4,5,9,0,0,1,1,10,6,1,17,0,2,1,3,10,1,14,25,1,1,1,3
152624.0,Lyutskanov Gordan,OH,Bulgaria,24.0,197.0,2021,Poland,Bulgaria,2021-06-09,False,0,0,2,2,0,0,0,0,0,0,0,0,0,1,0,1,0,0,0,0,0,0,0,0
152624.0,Lyutskanov Gordan,OH,Bulgaria,24.0,197.0,2021,Bulgaria,Brazil,2021-06-10,False,0,0,3,3,0,0,0,0,0,1,1,2,0,0,0,0,2,0,2,4,0,0,0,0
152624.0,Lyutskanov Gordan,OH,Bulgaria,24.0,197.0,2021,Netherlands,Bulgaria,2021-06-11,True,0,1,3,4,0,0,0,0,0,0,0,0,0,0,0,0,0,0,0,0,0,1,0,1
152624.0,Lyutskanov Gordan,OH,Bulgaria,24.0,197.0,2021,Argentina,Bulgaria,2021-06-15,False,0,0,1,1,0,0,0,0,0,1,0,1,0,0,0,0,0,0,2,2,0,0,0,0
152624.0,Lyutskanov Gordan,OH,Bulgaria,24.0,197.0,2021,Serbia,Bulgaria,2021-06-16,False,0,0,0,0,0,0,0,0,1,0,0,1,0,1,0,1,0,0,1,1,1,0,0,1
152624.0,Lyutskanov Gordan,OH,Bulgaria,24.0,197.0,2021,Bulgaria,Russia,2021-06-17,False,0,0,0,0,0,0,0,0,0,0,0,0,0,0,0,0,0,0,0,0,0,0,0,0
152624.0,Lyutskanov Gordan,OH,Bulgaria,24.0,197.0,2021,Japan,Bulgaria,2021-06-21,False,0,0,1,1,0,0,0,0,1,0,2,3,0,1,0,1,1,0,4,5,1,0,0,1
152624.0,Lyutskanov Gordan,OH,Bulgaria,24.0,197.0,2021,Bulgaria,USA,2021-06-22,False,0,2,5,7,0,0,1,1,8,5,7,20,1,2,0,3,5,2,12,19,1,1,1,3
152624.0,Lyutskanov Gordan,OH,Bulgaria,24.0,197.0,2021,Slovenia,Bulgaria,2021-06-23,False,0,2,1,3,0,0,0,0,1,0,6,7,0,1,0,1,2,1,8,11,1,0,0,1
118484.0,Ivanov Vladislav,L,Bulgaria,35.0,188.0,2021,France,Bulgaria,2021-05-28,False,0,0,0,0,0,0,5,5,0,0,0,0,0,0,0,0,8,0,5,13,8,0,2,10
118484.0,Ivanov Vladislav,L,Bulgaria,35.0,188.0,2021,Australia,Bulgaria,2021-05-29,True,0,0,0,0,0,0,4,4,0,0,0,0,0,0,0,0,4,0,9,13,5,0,1,6
118484.0,Ivanov Vladislav,L,Bulgaria,35.0,188.0,2021,Germany,Bulgaria,2021-05-30,False,0,0,0,0,0,0,3,3,0,0,0,0,0,0,0,0,6,2,11,19,14,1,0,15
118484.0,Ivanov Vladislav,L,Bulgaria,35.0,188.0,2021,Italy,Bulgaria,2021-06-03,False,0,0,0,0,0,0,2,2,0,0,0,0,0,0,0,0,4,0,6,10,5,6,0,11
118484.0,Ivanov Vladislav,L,Bulgaria,35.0,188.0,2021,Canada,Bulgaria,2021-06-04,False,0,0,0,0,0,0,10,10,0,0,0,0,0,0,0,0,6,1,13,20,10,2,0,12
118484.0,Ivanov Vladislav,L,Bulgaria,35.0,188.0,2021,Poland,Bulgaria,2021-06-09,False,0,0,0,0,0,0,6,6,0,0,0,0,0,0,0,0,8,2,5,15,4,2,1,7
118484.0,Ivanov Vladislav,L,Bulgaria,35.0,188.0,2021,Bulgaria,Brazil,2021-06-10,False,0,0,0,0,0,0,2,2,0,0,0,0,0,0,0,0,3,2,5,10,5,4,0,9
118484.0,Ivanov Vladislav,L,Bulgaria,35.0,188.0,2021,Netherlands,Bulgaria,2021-06-11,True,0,0,0,0,0,0,10,10,0,0,0,0,0,0,0,0,5,3,16,24,9,6,1,16
118484.0,Ivanov Vladislav,L,Bulgaria,35.0,188.0,2021,Argentina,Bulgaria,2021-06-15,False,0,0,0,0,0,0,4,4,0,0,0,0,0,0,0,0,4,2,11,17,12,6,2,20
118484.0,Ivanov Vladislav,L,Bulgaria,35.0,188.0,2021,Serbia,Bulgaria,2021-06-16,False,0,0,0,0,0,0,4,4,0,0,0,0,0,0,0,0,5,2,11,18,5,4,1,10
118484.0,Ivanov Vladislav,L,Bulgaria,35.0,188.0,2021,Bulgaria,Russia,2021-06-17,False,0,0,0,0,0,0,2,2,0,0,0,0,0,0,0,0,1,1,5,7,3,2,0,5
118484.0,Ivanov Vladislav,L,Bulgaria,35.0,188.0,2021,Japan,Bulgaria,2021-06-21,False,0,0,0,0,0,0,8,8,0,0,0,0,0,0,0,0,3,0,10,13,8,5,0,13
118484.0,Ivanov Vladislav,L,Bulgaria,35.0,188.0,2021,Bulgaria,USA,2021-06-22,False,0,0,0,0,0,0,0,0,0,0,0,0,0,0,0,0,0,0,0,0,0,0,0,0
118484.0,Ivanov Vladislav,L,Bulgaria,35.0,188.0,2021,Slovenia,Bulgaria,2021-06-23,False,0,0,0,0,0,0,6,6,0,0,0,0,0,0,0,0,1,0,7,8,5,1,0,6
118488.0,Sokolov Tsvetan,O,Bulgaria,32.0,206.0,2021,France,Bulgaria,2021-05-28,False,2,3,8,13,0,0,0,0,15,5,11,31,2,1,0,3,0,0,0,0,0,0,0,0
118488.0,Sokolov Tsvetan,O,Bulgaria,32.0,206.0,2021,Australia,Bulgaria,2021-05-29,True,2,4,8,14,0,0,0,0,10,6,11,27,0,3,1,4,0,0,0,0,3,1,0,4
118488.0,Sokolov Tsvetan,O,Bulgaria,32.0,206.0,2021,Germany,Bulgaria,2021-05-30,False,1,5,11,17,0,0,0,0,23,7,13,43,2,4,1,7,0,0,0,0,7,2,3,12
118488.0,Sokolov Tsvetan,O,Bulgaria,32.0,206.0,2021,Italy,Bulgaria,2021-06-03,False,0,0,0,0,0,0,0,0,0,0,0,0,0,0,0,0,0,0,0,0,0,0,0,0
118488.0,Sokolov Tsvetan,O,Bulgaria,32.0,206.0,2021,Canada,Bulgaria,2021-06-04,False,2,4,6,12,0,0,1,1,20,8,11,39,1,4,1,6,0,0,3,3,5,1,1,7
118488.0,Sokolov Tsvetan,O,Bulgaria,32.0,206.0,2021,Bulgaria,Iran,2021-06-05,False,0,0,0,0,0,0,0,0,0,0,0,0,0,0,0,0,0,0,0,0,0,0,0,0
118488.0,Sokolov Tsvetan,O,Bulgaria,32.0,206.0,2021,Bulgaria,Brazil,2021-06-10,False,0,0,0,0,0,0,0,0,0,0,0,0,0,0,0,0,0,0,0,0,0,0,0,0
118488.0,Sokolov Tsvetan,O,Bulgaria,32.0,206.0,2021,Netherlands,Bulgaria,2021-06-11,True,0,0,0,0,0,0,0,0,0,0,0,0,0,0,0,0,0,0,0,0,0,0,0,0
162123.0,Kartev Nikolay,MB,Bulgaria,26.0,204.0,2021,France,Bulgaria,2021-05-28,False,0,2,8,10,0,0,1,1,4,1,0,5,1,0,2,3,0,0,1,1,1,0,0,1
162123.0,Kartev Nikolay,MB,Bulgaria,26.0,204.0,2021,Australia,Bulgaria,2021-05-29,True,0,1,4,5,0,0,0,0,4,1,0,5,1,4,0,5,0,0,0,0,0,0,2,2
162123.0,Kartev Nikolay,MB,Bulgaria,26.0,204.0,2021,Germany,Bulgaria,2021-05-30,False,1,3,14,18,0,0,0,0,7,1,3,11,2,7,4,13,0,0,0,0,1,1,0,2
162123.0,Kartev Nikolay,MB,Bulgaria,26.0,204.0,2021,Italy,Bulgaria,2021-06-03,False,0,1,17,18,0,0,0,0,8,1,2,11,1,9,0,10,0,1,0,1,0,0,0,0
162123.0,Kartev Nikolay,MB,Bulgaria,26.0,204.0,2021,Canada,Bulgaria,2021-06-04,False,0,0,11,11,0,0,1,1,4,3,3,10,2,1,1,4,0,0,0,0,1,2,0,3
162123.0,Kartev Nikolay,MB,Bulgaria,26.0,204.0,2021,Bulgaria,Iran,2021-06-05,False,0,0,0,0,0,0,0,0,0,0,0,0,0,2,0,2,0,0,0,0,0,0,0,0
162123.0,Kartev Nikolay,MB,Bulgaria,26.0,204.0,2021,Poland,Bulgaria,2021-06-09,False,0,2,6,8,0,0,1,1,2,1,0,3,0,0,0,0,0,0,0,0,1,1,0,2
162123.0,Kartev Nikolay,MB,Bulgaria,26.0,204.0,2021,Bulgaria,Brazil,2021-06-10,False,0,2,4,6,0,0,0,0,1,1,4,6,1,1,3,5,1,0,0,1,1,0,0,1
162123.0,Kartev Nikolay,MB,Bulgaria,26.0,204.0,2021,Netherlands,Bulgaria,2021-06-11,True,0,3,11,14,0,0,0,0,6,0,4,10,1,6,6,13,0,0,0,0,1,0,0,1
162123.0,Kartev Nikolay,MB,Bulgaria,26.0,204.0,2021,Argentina,Bulgaria,2021-06-15,False,0,1,1,2,0,0,1,1,0,0,2,2,0,1,0,1,0,0,0,0,2,0,0,2
162123.0,Kartev Nikolay,MB,Bulgaria,26.0,204.0,2021,Japan,Bulgaria,2021-06-21,False,0,0,0,0,0,0,0,0,0,0,0,0,0,0,0,0,0,0,0,0,0,0,0,0
162123.0,Kartev Nikolay,MB,Bulgaria,26.0,204.0,2021,Bulgaria,USA,2021-06-22,False,0,0,0,0,0,0,0,0,0,0,0,0,0,0,0,0,0,0,0,0,0,0,0,0
162123.0,Kartev Nikolay,MB,Bulgaria,26.0,204.0,2021,Slovenia,Bulgaria,2021-06-23,False,0,0,3,3,0,0,0,0,1,1,2,4,1,3,0,4,0,0,0,0,1,0,1,2
173009.0,Ivanov Martin,L,Bulgaria,30.0,190.0,2021,France,Bulgaria,2021-05-28,False,0,0,0,0,0,0,0,0,0,0,0,0,0,0,0,0,0,0,0,0,0,0,0,0
173009.0,Ivanov Martin,L,Bulgaria,30.0,190.0,2021,Australia,Bulgaria,2021-05-29,True,0,0,0,0,0,0,0,0,0,0,0,0,0,0,0,0,0,0,0,0,0,0,0,0
173009.0,Ivanov Martin,L,Bulgaria,30.0,190.0,2021,Germany,Bulgaria,2021-05-30,False,0,0,0,0,0,0,0,0,0,0,0,0,0,0,0,0,0,0,0,0,0,0,0,0
173009.0,Ivanov Martin,L,Bulgaria,30.0,190.0,2021,Italy,Bulgaria,2021-06-03,False,0,0,0,0,0,0,2,2,0,0,0,0,0,0,0,0,2,0,11,13,6,0,2,8
173009.0,Ivanov Martin,L,Bulgaria,30.0,190.0,2021,Canada,Bulgaria,2021-06-04,False,0,0,0,0,0,0,0,0,0,0,0,0,0,0,0,0,0,0,0,0,0,0,0,0
173009.0,Ivanov Martin,L,Bulgaria,30.0,190.0,2021,Bulgaria,Iran,2021-06-05,False,0,0,0,0,0,0,1,1,0,0,0,0,0,0,0,0,5,0,14,19,9,0,0,9
173009.0,Ivanov Martin,L,Bulgaria,30.0,190.0,2021,Poland,Bulgaria,2021-06-09,False,0,0,0,0,0,0,0,0,0,0,0,0,0,0,0,0,0,0,0,0,0,0,0,0
173009.0,Ivanov Martin,L,Bulgaria,30.0,190.0,2021,Bulgaria,Brazil,2021-06-10,False,0,0,0,0,0,0,2,2,0,0,0,0,0,0,0,0,0,0,2,2,0,0,0,0
173009.0,Ivanov Martin,L,Bulgaria,30.0,190.0,2021,Netherlands,Bulgaria,2021-06-11,True,0,0,0,0,0,0,0,0,0,0,0,0,0,0,0,0,0,0,0,0,0,0,0,0
173009.0,Ivanov Martin,L,Bulgaria,30.0,190.0,2021,Argentina,Bulgaria,2021-06-15,False,0,0,0,0,0,0,0,0,0,0,0,0,0,0,0,0,0,0,0,0,0,0,0,0
173009.0,Ivanov Martin,L,Bulgaria,30.0,190.0,2021,Serbia,Bulgaria,2021-06-16,False,0,0,0,0,0,0,0,0,0,0,0,0,0,0,0,0,0,0,0,0,0,0,0,0
173009.0,Ivanov Martin,L,Bulgaria,30.0,190.0,2021,Bulgaria,Russia,2021-06-17,False,0,0,0,0,0,0,0,0,0,0,0,0,0,0,0,0,3,1,3,7,3,0,0,3
173009.0,Ivanov Martin,L,Bulgaria,30.0,190.0,2021,Japan,Bulgaria,2021-06-21,False,0,0,0,0,0,0,0,0,0,0,0,0,0,0,0,0,0,0,0,0,0,0,0,0
173009.0,Ivanov Martin,L,Bulgaria,30.0,190.0,2021,Bulgaria,USA,2021-06-22,False,0,0,0,0,0,0,1,1,0,0,0,0,0,0,0,0,4,1,14,19,5,3,1,9
173009.0,Ivanov Martin,L,Bulgaria,30.0,190.0,2021,Slovenia,Bulgaria,2021-06-23,False,0,0,0,0,0,0,0,0,0,0,0,0,0,0,0,0,0,0,0,0,0,0,0,0
150277.0,Parapunov Radoslav,O,Bulgaria,24.0,205.0,2021,France,Bulgaria,2021-05-28,False,0,0,0,0,0,0,0,0,0,0,0,0,0,0,0,0,0,0,0,0,0,0,0,0
150277.0,Parapunov Radoslav,O,Bulgaria,24.0,205.0,2021,Australia,Bulgaria,2021-05-29,True,0,0,0,0,0,0,0,0,0,0,0,0,0,0,0,0,0,0,0,0,0,0,0,0
150277.0,Parapunov Radoslav,O,Bulgaria,24.0,205.0,2021,Germany,Bulgaria,2021-05-30,False,1,2,1,4,0,0,0,0,5,0,0,5,0,1,0,1,0,1,0,1,2,0,0,2
150277.0,Parapunov Radoslav,O,Bulgaria,24.0,205.0,2021,Italy,Bulgaria,2021-06-03,False,1,5,10,16,0,0,1,1,17,8,10,35,4,1,3,8,0,0,0,0,4,3,2,9
150277.0,Parapunov Radoslav,O,Bulgaria,24.0,205.0,2021,Canada,Bulgaria,2021-06-04,False,0,0,0,0,0,0,0,0,0,0,0,0,0,0,0,0,0,0,0,0,0,0,0,0
150277.0,Parapunov Radoslav,O,Bulgaria,24.0,205.0,2021,Bulgaria,Iran,2021-06-05,False,0,4,5,9,0,0,1,1,10,8,11,29,1,2,1,4,0,0,1,1,6,1,0,7
150277.0,Parapunov Radoslav,O,Bulgaria,24.0,205.0,2021,Poland,Bulgaria,2021-06-09,False,0,3,5,8,0,0,1,1,6,6,4,16,0,0,1,1,0,0,0,0,0,3,0,3
150277.0,Parapunov Radoslav,O,Bulgaria,24.0,205.0,2021,Bulgaria,Brazil,2021-06-10,False,0,2,3,5,0,0,0,0,7,4,3,14,1,1,1,3,0,0,0,0,0,0,0,0
150277.0,Parapunov Radoslav,O,Bulgaria,24.0,205.0,2021,Netherlands,Bulgaria,2021-06-11,True,0,4,3,7,0,0,1,1,7,2,7,16,1,4,2,7,0,0,0,0,2,2,0,4
150277.0,Parapunov Radoslav,O,Bulgaria,24.0,205.0,2021,Argentina,Bulgaria,2021-06-15,False,0,4,6,10,0,0,1,1,11,4,5,20,2,3,5,10,0,0,0,0,2,3,0,5
150277.0,Parapunov Radoslav,O,Bulgaria,24.0,205.0,2021,Serbia,Bulgaria,2021-06-16,False,0,1,5,6,0,0,0,0,11,5,5,21,2,0,1,3,0,0,0,0,4,2,1,7
150277.0,Parapunov Radoslav,O,Bulgaria,24.0,205.0,2021,Bulgaria,Russia,2021-06-17,False,1,1,4,6,0,0,0,0,1,3,5,9,1,0,2,3,0,0,0,0,3,0,0,3
150277.0,Parapunov Radoslav,O,Bulgaria,24.0,205.0,2021,Japan,Bulgaria,2021-06-21,False,0,1,2,3,0,0,0,0,3,3,4,10,0,0,0,0,0,0,0,0,0,1,0,1
150277.0,Parapunov Radoslav,O,Bulgaria,24.0,205.0,2021,Bulgaria,USA,2021-06-22,False,0,2,6,8,0,0,1,1,4,9,8,21,0,4,3,7,0,0,0,0,2,2,0,4
150277.0,Parapunov Radoslav,O,Bulgaria,24.0,205.0,2021,Slovenia,Bulgaria,2021-06-23,False,0,1,1,2,0,0,0,0,0,2,0,2,0,0,0,0,0,0,0,0,0,0,0,0
164812.0,Ivanov Svetoslav,OH,Bulgaria,21.0,197.0,2021,Italy,Bulgaria,2021-06-03,False,0,1,7,8,0,0,0,0,7,2,4,13,0,1,1,2,4,3,5,12,2,2,0,4
164812.0,Ivanov Svetoslav,OH,Bulgaria,21.0,197.0,2021,Canada,Bulgaria,2021-06-04,False,0,2,3,5,0,0,0,0,5,1,5,11,0,2,1,3,6,1,6,13,2,0,0,2
164812.0,Ivanov Svetoslav,OH,Bulgaria,21.0,197.0,2021,Bulgaria,Iran,2021-06-05,False,0,0,0,0,0,0,0,0,0,0,0,0,0,0,0,0,0,0,0,0,0,0,0,0
164812.0,Ivanov Svetoslav,OH,Bulgaria,21.0,197.0,2021,Poland,Bulgaria,2021-06-09,False,0,0,2,2,0,0,0,0,0,0,1,1,0,0,0,0,0,1,2,3,0,1,0,1
164812.0,Ivanov Svetoslav,OH,Bulgaria,21.0,197.0,2021,Bulgaria,Brazil,2021-06-10,False,0,1,5,6,0,0,2,2,2,1,3,6,0,0,0,0,3,1,6,10,3,1,0,4
164812.0,Ivanov Svetoslav,OH,Bulgaria,21.0,197.0,2021,Netherlands,Bulgaria,2021-06-11,True,2,1,15,18,0,0,2,2,8,4,9,21,3,2,1,6,5,1,15,21,3,2,1,6
164812.0,Ivanov Svetoslav,OH,Bulgaria,21.0,197.0,2021,Argentina,Bulgaria,2021-06-15,False,1,0,10,11,0,0,0,0,8,0,11,19,1,1,0,2,7,4,11,22,0,1,0,1
164812.0,Ivanov Svetoslav,OH,Bulgaria,21.0,197.0,2021,Serbia,Bulgaria,2021-06-16,False,0,0,0,0,0,0,0,0,0,0,0,0,0,0,0,0,0,0,0,0,0,0,0,0
164812.0,Ivanov Svetoslav,OH,Bulgaria,21.0,197.0,2021,Bulgaria,Russia,2021-06-17,False,0,0,0,0,0,0,0,0,0,0,0,0,0,0,0,0,0,0,0,0,0,0,0,0
164812.0,Ivanov Svetoslav,OH,Bulgaria,21.0,197.0,2021,Japan,Bulgaria,2021-06-21,False,0,1,2,3,0,0,0,0,1,1,2,4,0,1,0,1,0,0,7,7,0,2,0,2
164812.0,Ivanov Svetoslav,OH,Bulgaria,21.0,197.0,2021,Bulgaria,USA,2021-06-22,False,0,0,0,0,0,0,0,0,0,0,1,1,0,0,0,0,0,1,1,2,0,0,0,0
136299.0,Sanders Tyler,S,Canada,30.0,191.0,2021,Iran,Canada,2021-06-03,False,0,0,3,3,12,1,18,31,0,0,0,0,0,1,0,1,0,0,0,0,1,2,0,3
136299.0,Sanders Tyler,S,Canada,30.0,191.0,2021,Canada,Bulgaria,2021-06-04,True,0,0,11,11,17,0,42,59,0,0,0,0,0,1,1,2,0,0,1,1,2,1,1,4
136299.0,Sanders Tyler,S,Canada,30.0,191.0,2021,Canada,Italy,2021-06-05,False,0,1,3,4,4,0,22,26,0,0,0,0,0,0,2,2,0,0,0,0,2,0,1,3
136299.0,Sanders Tyler,S,Canada,30.0,191.0,2021,Slovenia,Canada,2021-06-09,False,1,2,8,11,9,1,49,59,0,0,0,0,0,1,0,1,0,0,0,0,2,3,0,5
136299.0,Sanders Tyler,S,Canada,30.0,191.0,2021,Russia,Canada,2021-06-10,False,0,0,0,0,0,0,0,0,0,0,0,0,0,0,0,0,0,0,0,0,0,0,0,0
136299.0,Sanders Tyler,S,Canada,30.0,191.0,2021,Canada,France,2021-06-11,False,0,1,12,13,26,2,73,101,1,0,1,2,3,3,2,8,0,0,0,0,7,1,0,8
136299.0,Sanders Tyler,S,Canada,30.0,191.0,2021,Canada,Poland,2021-06-15,False,0,2,9,11,15,1,47,63,0,0,0,0,0,4,2,6,0,0,0,0,6,0,0,6
136299.0,Sanders Tyler,S,Canada,30.0,191.0,2021,Japan,Canada,2021-06-17,True,0,0,12,12,28,1,35,64,0,0,3,3,0,1,2,3,0,0,0,0,9,1,2,12
124556.0,Perrin John Gordon,OH,Canada,32.0,201.0,2021,USA,Canada,2021-05-28,False,0,1,8,9,0,1,0,1,6,0,12,18,0,2,2,4,3,1,9,13,4,1,0,5
124556.0,Perrin John Gordon,OH,Canada,32.0,201.0,2021,Argentina,Canada,2021-05-29,True,1,3,9,13,0,1,0,1,10,1,7,18,1,2,1,4,4,1,8,13,9,0,0,9
124556.0,Perrin John Gordon,OH,Canada,32.0,201.0,2021,Iran,Canada,2021-06-03,False,0,3,16,19,0,0,5,5,13,3,8,24,3,5,1,9,5,1,18,24,3,2,1,6
124556.0,Perrin John Gordon,OH,Canada,32.0,201.0,2021,Canada,Bulgaria,2021-06-04,True,1,3,12,16,0,0,4,4,8,1,8,17,2,3,2,7,1,1,11,13,7,1,0,8
124556.0,Perrin John Gordon,OH,Canada,32.0,201.0,2021,Canada,Italy,2021-06-05,False,0,0,3,3,0,0,2,2,9,1,8,18,1,2,1,4,3,2,2,7,1,0,0,1
124556.0,Perrin John Gordon,OH,Canada,32.0,201.0,2021,Slovenia,Canada,2021-06-09,False,0,2,14,16,0,0,1,1,10,1,12,23,0,1,1,2,4,1,7,12,3,5,1,9
124556.0,Perrin John Gordon,OH,Canada,32.0,201.0,2021,Russia,Canada,2021-06-10,False,0,0,0,0,0,0,1,1,0,0,0,0,0,0,0,0,0,0,0,0,0,0,0,0
124556.0,Perrin John Gordon,OH,Canada,32.0,201.0,2021,Canada,France,2021-06-11,False,1,4,10,15,0,0,4,4,12,6,12,30,2,1,4,7,8,1,16,25,5,1,0,6
124556.0,Perrin John Gordon,OH,Canada,32.0,201.0,2021,Canada,Poland,2021-06-15,False,1,2,9,12,0,0,2,2,7,1,7,15,1,1,1,3,3,2,12,17,3,4,2,9
124556.0,Perrin John Gordon,OH,Canada,32.0,201.0,2021,Japan,Canada,2021-06-17,True,2,2,12,16,0,0,6,6,12,1,9,22,0,1,2,3,7,1,12,20,4,2,1,7
124556.0,Perrin John Gordon,OH,Canada,32.0,201.0,2021,Canada,Netherlands,2021-06-21,True,0,2,6,8,0,0,1,1,11,2,7,20,0,2,1,3,6,0,7,13,7,2,1,10
124556.0,Perrin John Gordon,OH,Canada,32.0,201.0,2021,Canada,Australia,2021-06-22,True,0,0,0,0,0,0,0,0,0,0,0,0,0,0,0,0,0,0,0,0,0,0,0,0
124556.0,Perrin John Gordon,OH,Canada,32.0,201.0,2021,Canada,Serbia,2021-06-23,True,1,3,19,23,0,0,4,4,11,3,16,30,2,4,5,11,10,4,15,29,9,2,0,11
139429.0,Marshall Steven,L,Canada,32.0,191.0,2021,Canada,Brazil,2021-05-30,False,0,0,0,0,0,0,0,0,0,0,0,0,0,0,0,0,1,0,3,4,2,1,0,3
139429.0,Marshall Steven,L,Canada,32.0,191.0,2021,Iran,Canada,2021-06-03,False,0,1,8,9,0,0,0,0,0,2,2,4,0,1,1,2,1,0,5,6,3,0,1,4
139429.0,Marshall Steven,L,Canada,32.0,191.0,2021,Canada,Bulgaria,2021-06-04,True,0,0,0,0,0,0,0,0,0,0,0,0,0,0,0,0,0,0,0,0,0,0,0,0
139429.0,Marshall Steven,L,Canada,32.0,191.0,2021,Canada,Italy,2021-06-05,False,0,0,0,0,0,0,0,0,0,0,0,0,0,0,0,0,0,0,0,0,0,0,0,0
139429.0,Marshall Steven,L,Canada,32.0,191.0,2021,Slovenia,Canada,2021-06-09,False,0,0,0,0,0,0,2,2,0,0,0,0,0,0,0,0,5,2,8,15,2,4,1,7
139429.0,Marshall Steven,L,Canada,32.0,191.0,2021,Russia,Canada,2021-06-10,False,0,0,0,0,0,0,3,3,0,0,0,0,0,0,0,0,11,3,15,29,10,5,0,15
139429.0,Marshall Steven,L,Canada,32.0,191.0,2021,Canada,France,2021-06-11,False,0,0,0,0,0,0,3,3,0,0,0,0,0,0,0,0,14,1,14,29,14,2,2,18
139429.0,Marshall Steven,L,Canada,32.0,191.0,2021,Canada,Poland,2021-06-15,False,0,0,0,0,0,0,4,4,0,0,0,0,0,0,0,0,2,2,18,22,5,1,1,7
139429.0,Marshall Steven,L,Canada,32.0,191.0,2021,Canada,Germany,2021-06-16,True,0,0,0,0,0,0,0,0,0,0,0,0,0,0,0,0,1,0,1,2,0,0,0,0
139429.0,Marshall Steven,L,Canada,32.0,191.0,2021,Japan,Canada,2021-06-17,True,0,0,0,0,0,0,0,0,0,0,0,0,0,0,0,0,0,0,0,0,0,0,0,0
139429.0,Marshall Steven,L,Canada,32.0,191.0,2021,Canada,Netherlands,2021-06-21,True,0,0,0,0,0,0,0,0,0,0,0,0,0,0,0,0,0,0,0,0,0,0,0,0
139429.0,Marshall Steven,L,Canada,32.0,191.0,2021,Canada,Australia,2021-06-22,True,0,1,6,7,0,0,1,1,2,1,1,4,0,2,0,2,1,0,2,3,2,0,0,2
139429.0,Marshall Steven,L,Canada,32.0,191.0,2021,Canada,Serbia,2021-06-23,True,0,1,8,9,0,0,4,4,1,3,10,14,6,0,2,8,3,1,4,8,9,0,0,9
136291.0,Hoag Nicholas,OH,Canada,29.0,200.0,2021,USA,Canada,2021-05-28,False,0,0,2,2,0,0,0,0,0,0,1,1,0,0,0,0,0,0,0,0,0,0,0,0
136291.0,Hoag Nicholas,OH,Canada,29.0,200.0,2021,Argentina,Canada,2021-05-29,True,2,3,6,11,0,0,0,0,5,4,7,16,2,3,1,6,5,0,5,10,4,2,0,6
136291.0,Hoag Nicholas,OH,Canada,29.0,200.0,2021,Canada,Brazil,2021-05-30,False,0,3,10,13,0,0,0,0,7,5,9,21,1,0,1,2,10,3,15,28,5,2,0,7
136291.0,Hoag Nicholas,OH,Canada,29.0,200.0,2021,Iran,Canada,2021-06-03,False,0,1,4,5,0,0,1,1,0,0,0,0,0,0,0,0,0,0,0,0,0,0,0,0
136291.0,Hoag Nicholas,OH,Canada,29.0,200.0,2021,Canada,Bulgaria,2021-06-04,True,4,2,11,17,0,0,1,1,12,3,7,22,0,1,1,2,5,1,14,20,2,2,3,7
136291.0,Hoag Nicholas,OH,Canada,29.0,200.0,2021,Canada,Italy,2021-06-05,False,1,5,16,22,0,0,7,7,16,10,16,42,1,2,0,3,16,0,18,34,5,0,1,6
136291.0,Hoag Nicholas,OH,Canada,29.0,200.0,2021,Slovenia,Canada,2021-06-09,False,1,3,4,8,0,0,1,1,14,3,6,23,1,3,0,4,4,2,22,28,2,0,1,3
136291.0,Hoag Nicholas,OH,Canada,29.0,200.0,2021,Russia,Canada,2021-06-10,False,2,4,10,16,0,0,3,3,10,5,8,23,1,1,1,3,8,2,17,27,4,3,0,7
136291.0,Hoag Nicholas,OH,Canada,29.0,200.0,2021,Canada,France,2021-06-11,False,0,1,2,3,0,0,0,0,3,1,3,7,0,0,1,1,0,0,1,1,1,1,0,2
136291.0,Hoag Nicholas,OH,Canada,29.0,200.0,2021,Canada,Poland,2021-06-15,False,1,4,4,9,0,0,3,3,9,3,10,22,1,3,4,8,1,0,16,17,1,2,2,5
136291.0,Hoag Nicholas,OH,Canada,29.0,200.0,2021,Canada,Germany,2021-06-16,True,0,3,11,14,0,0,4,4,9,4,6,19,1,0,0,1,5,2,8,15,2,3,1,6
136291.0,Hoag Nicholas,OH,Canada,29.0,200.0,2021,Japan,Canada,2021-06-17,True,0,0,0,0,0,0,0,0,0,0,0,0,0,0,0,0,0,0,0,0,0,0,0,0
136291.0,Hoag Nicholas,OH,Canada,29.0,200.0,2021,Canada,Netherlands,2021-06-21,True,4,3,8,15,0,1,1,2,6,6,5,17,1,2,6,9,5,0,8,13,5,0,0,5
136291.0,Hoag Nicholas,OH,Canada,29.0,200.0,2021,Canada,Australia,2021-06-22,True,2,0,10,12,0,0,3,3,4,1,3,8,0,0,3,3,4,0,6,10,5,1,1,7
136291.0,Hoag Nicholas,OH,Canada,29.0,200.0,2021,Canada,Serbia,2021-06-23,True,0,0,0,0,0,0,1,1,0,0,0,0,0,0,0,0,0,0,0,0,0,0,0,0
157334.0,Pereira Jordan,L,Canada,24.0,185.0,2021,USA,Canada,2021-05-28,False,0,0,0,0,0,0,0,0,0,0,0,0,0,0,0,0,0,0,0,0,0,0,0,0
157334.0,Pereira Jordan,L,Canada,24.0,185.0,2021,Argentina,Canada,2021-05-29,True,0,0,0,0,0,0,0,0,0,0,0,0,0,0,0,0,0,0,0,0,0,0,0,0
157334.0,Pereira Jordan,L,Canada,24.0,185.0,2021,Canada,Brazil,2021-05-30,False,0,0,0,0,0,0,2,2,0,0,0,0,0,0,0,0,0,0,0,0,5,4,1,10
157334.0,Pereira Jordan,L,Canada,24.0,185.0,2021,Iran,Canada,2021-06-03,False,0,0,0,0,0,0,0,0,0,0,0,0,0,0,0,0,0,0,0,0,0,0,0,0
157334.0,Pereira Jordan,L,Canada,24.0,185.0,2021,Canada,Bulgaria,2021-06-04,True,0,0,0,0,0,0,0,0,0,0,0,0,0,0,0,0,0,0,0,0,0,0,0,0
157334.0,Pereira Jordan,L,Canada,24.0,185.0,2021,Canada,Italy,2021-06-05,False,0,0,0,0,0,0,0,0,0,0,0,0,0,0,0,0,0,0,0,0,0,0,0,0
157334.0,Pereira Jordan,L,Canada,24.0,185.0,2021,Slovenia,Canada,2021-06-09,False,0,0,0,0,0,0,0,0,0,0,0,0,0,0,0,0,0,0,0,0,0,0,0,0
157334.0,Pereira Jordan,L,Canada,24.0,185.0,2021,Russia,Canada,2021-06-10,False,0,0,0,0,0,0,0,0,0,0,0,0,0,0,0,0,0,0,0,0,1,0,0,1
157334.0,Pereira Jordan,L,Canada,24.0,185.0,2021,Canada,France,2021-06-11,False,0,0,0,0,0,0,0,0,0,0,0,0,0,0,0,0,0,0,0,0,0,0,0,0
157334.0,Pereira Jordan,L,Canada,24.0,185.0,2021,Canada,Poland,2021-06-15,False,0,0,0,0,0,0,0,0,0,0,0,0,0,0,0,0,0,0,0,0,0,0,0,0
157334.0,Pereira Jordan,L,Canada,24.0,185.0,2021,Canada,Germany,2021-06-16,True,0,0,0,0,0,0,0,0,0,0,0,0,0,0,0,0,0,0,0,0,0,0,0,0
157334.0,Pereira Jordan,L,Canada,24.0,185.0,2021,Japan,Canada,2021-06-17,True,0,0,0,0,0,0,0,0,0,0,0,0,0,0,0,0,0,0,0,0,0,0,0,0
140061.0,Maar Stephen Timothy,OH,Canada,27.0,201.0,2021,USA,Canada,2021-05-28,False,0,4,1,5,0,0,0,0,8,5,5,18,1,0,1,2,2,1,10,13,5,1,0,6
140061.0,Maar Stephen Timothy,OH,Canada,27.0,201.0,2021,Argentina,Canada,2021-05-29,True,0,0,0,0,0,0,0,0,0,0,0,0,0,0,0,0,0,0,0,0,0,0,0,0
140061.0,Maar Stephen Timothy,OH,Canada,27.0,201.0,2021,Canada,Brazil,2021-05-30,False,0,0,0,0,0,0,0,0,0,0,0,0,0,0,0,0,0,0,0,0,0,0,0,0
140061.0,Maar Stephen Timothy,OH,Canada,27.0,201.0,2021,Slovenia,Canada,2021-06-09,False,0,0,0,0,0,0,0,0,0,0,0,0,0,0,0,0,0,0,0,0,0,0,0,0
140061.0,Maar Stephen Timothy,OH,Canada,27.0,201.0,2021,Canada,Poland,2021-06-15,False,0,0,0,0,0,0,0,0,1,2,1,4,0,0,0,0,0,0,0,0,1,0,0,1
140061.0,Maar Stephen Timothy,OH,Canada,27.0,201.0,2021,Canada,Germany,2021-06-16,True,0,3,5,8,0,0,2,2,10,1,10,21,1,2,0,3,4,1,14,19,2,0,1,3
140061.0,Maar Stephen Timothy,OH,Canada,27.0,201.0,2021,Japan,Canada,2021-06-17,True,1,2,7,10,0,0,1,1,8,3,10,21,2,2,2,6,2,0,11,13,5,2,3,10
140061.0,Maar Stephen Timothy,OH,Canada,27.0,201.0,2021,Canada,Netherlands,2021-06-21,True,0,0,0,0,0,0,0,0,1,0,0,1,0,0,0,0,0,0,0,0,1,0,0,1
140061.0,Maar Stephen Timothy,OH,Canada,27.0,201.0,2021,Canada,Australia,2021-06-22,True,1,5,6,12,0,0,3,3,10,1,9,20,2,1,2,5,5,0,4,9,5,0,0,5
140061.0,Maar Stephen Timothy,OH,Canada,27.0,201.0,2021,Canada,Serbia,2021-06-23,True,0,0,3,3,0,1,3,4,2,2,8,12,1,2,1,4,4,3,6,13,1,0,1,2
124553.0,Blankenau Jay,S,Canada,32.0,194.0,2021,USA,Canada,2021-05-28,False,0,0,6,6,14,0,58,72,2,0,1,3,1,1,1,3,0,0,1,1,6,3,1,10
124553.0,Blankenau Jay,S,Canada,32.0,194.0,2021,Argentina,Canada,2021-05-29,True,0,0,0,0,0,0,0,0,0,0,0,0,0,0,0,0,0,0,0,0,0,0,0,0
124553.0,Blankenau Jay,S,Canada,32.0,194.0,2021,Canada,Brazil,2021-05-30,False,0,0,0,0,0,0,0,0,0,0,0,0,0,0,0,0,0,0,0,0,0,0,0,0
124553.0,Blankenau Jay,S,Canada,32.0,194.0,2021,Iran,Canada,2021-06-03,False,0,2,7,9,25,0,28,53,2,0,1,3,0,1,0,1,0,0,1,1,6,1,0,7
124553.0,Blankenau Jay,S,Canada,32.0,194.0,2021,Canada,Italy,2021-06-05,False,1,1,10,12,23,0,62,85,1,0,3,4,0,3,2,5,0,0,0,0,5,5,1,11
124553.0,Blankenau Jay,S,Canada,32.0,194.0,2021,Slovenia,Canada,2021-06-09,False,0,0,1,1,0,0,3,3,0,0,0,0,0,0,0,0,0,0,0,0,0,0,0,0
124553.0,Blankenau Jay,S,Canada,32.0,194.0,2021,Russia,Canada,2021-06-10,False,0,2,10,12,19,0,68,87,1,0,2,3,1,1,0,2,0,1,1,2,5,6,1,12
124553.0,Blankenau Jay,S,Canada,32.0,194.0,2021,Canada,France,2021-06-11,False,0,0,0,0,0,0,0,0,0,0,0,0,0,0,0,0,0,0,0,0,0,0,0,0
124553.0,Blankenau Jay,S,Canada,32.0,194.0,2021,Canada,Poland,2021-06-15,False,0,0,0,0,2,0,4,6,0,0,0,0,0,0,0,0,0,0,0,0,1,0,0,1
124553.0,Blankenau Jay,S,Canada,32.0,194.0,2021,Canada,Germany,2021-06-16,True,1,1,15,17,8,0,51,59,2,0,1,3,0,2,0,2,0,0,0,0,9,2,0,11
124553.0,Blankenau Jay,S,Canada,32.0,194.0,2021,Japan,Canada,2021-06-17,True,0,0,0,0,0,0,0,0,0,0,0,0,0,0,0,0,0,0,0,0,0,0,0,0
124553.0,Blankenau Jay,S,Canada,32.0,194.0,2021,Canada,Netherlands,2021-06-21,True,0,2,13,15,20,2,35,57,1,0,0,1,1,0,2,3,0,0,1,1,3,0,2,5
124553.0,Blankenau Jay,S,Canada,32.0,194.0,2021,Canada,Australia,2021-06-22,True,0,1,10,11,22,1,30,53,2,0,2,4,0,1,2,3,0,0,0,0,8,3,1,12
124553.0,Blankenau Jay,S,Canada,32.0,194.0,2021,Canada,Serbia,2021-06-23,True,0,0,18,18,20,0,79,99,0,1,4,5,0,4,1,5,0,0,0,0,9,2,2,13
140428.0,Sclater Ryan Joseph,O,Canada,28.0,200.0,2021,USA,Canada,2021-05-28,False,0,0,2,2,0,0,0,0,1,1,3,5,1,0,0,1,0,0,0,0,0,0,0,0
140428.0,Sclater Ryan Joseph,O,Canada,28.0,200.0,2021,Argentina,Canada,2021-05-29,True,1,4,11,16,0,0,0,0,11,3,0,14,2,2,0,4,0,0,0,0,4,1,0,5
140428.0,Sclater Ryan Joseph,O,Canada,28.0,200.0,2021,Canada,Brazil,2021-05-30,False,0,0,4,4,0,0,0,0,0,0,0,0,0,0,0,0,0,0,0,0,0,0,0,0
140428.0,Sclater Ryan Joseph,O,Canada,28.0,200.0,2021,Iran,Canada,2021-06-03,False,1,3,8,12,0,0,0,0,16,7,14,37,0,6,5,11,0,0,1,1,8,2,0,10
140428.0,Sclater Ryan Joseph,O,Canada,28.0,200.0,2021,Canada,Bulgaria,2021-06-04,True,0,0,0,0,0,0,0,0,0,0,0,0,0,0,0,0,0,0,0,0,0,0,0,0
140428.0,Sclater Ryan Joseph,O,Canada,28.0,200.0,2021,Canada,Italy,2021-06-05,False,1,1,4,6,0,0,0,0,2,6,8,16,0,4,3,7,0,0,0,0,4,0,0,4
140428.0,Sclater Ryan Joseph,O,Canada,28.0,200.0,2021,Slovenia,Canada,2021-06-09,False,0,1,3,4,0,0,0,0,1,0,3,4,0,1,1,2,0,0,0,0,2,0,0,2
140428.0,Sclater Ryan Joseph,O,Canada,28.0,200.0,2021,Russia,Canada,2021-06-10,False,0,1,2,3,0,0,0,0,0,0,0,0,0,0,0,0,0,0,0,0,0,1,0,1
140428.0,Sclater Ryan Joseph,O,Canada,28.0,200.0,2021,Canada,France,2021-06-11,False,0,3,7,10,0,0,4,4,11,7,12,30,0,5,3,8,0,0,0,0,8,4,0,12
140428.0,Sclater Ryan Joseph,O,Canada,28.0,200.0,2021,Canada,Poland,2021-06-15,False,0,0,3,3,0,0,0,0,0,0,0,0,0,0,0,0,0,0,0,0,1,0,0,1
140428.0,Sclater Ryan Joseph,O,Canada,28.0,200.0,2021,Canada,Germany,2021-06-16,True,0,0,0,0,0,0,0,0,0,0,0,0,0,0,0,0,0,0,0,0,0,0,0,0
140428.0,Sclater Ryan Joseph,O,Canada,28.0,200.0,2021,Japan,Canada,2021-06-17,True,1,4,6,11,0,0,2,2,15,1,8,24,0,5,4,9,0,0,0,0,2,2,3,7
140428.0,Sclater Ryan Joseph,O,Canada,28.0,200.0,2021,Canada,Netherlands,2021-06-21,True,0,0,3,3,0,0,0,0,0,0,0,0,0,0,0,0,0,0,0,0,1,0,0,1
140428.0,Sclater Ryan Joseph,O,Canada,28.0,200.0,2021,Canada,Australia,2021-06-22,True,2,2,10,14,0,0,0,0,12,1,9,22,2,3,3,8,0,0,0,0,7,0,0,7
140428.0,Sclater Ryan Joseph,O,Canada,28.0,200.0,2021,Canada,Serbia,2021-06-23,True,0,1,8,9,0,0,0,0,16,4,9,29,1,5,6,12,0,0,1,1,8,1,2,11
139499.0,Jansen Vandoorn Daniel,MB,Canada,32.0,207.0,2021,USA,Canada,2021-05-28,False,0,0,5,5,0,0,0,0,3,0,0,3,0,1,1,2,0,0,0,0,0,0,0,0
139499.0,Jansen Vandoorn Daniel,MB,Canada,32.0,207.0,2021,Argentina,Canada,2021-05-29,True,0,2,10,12,0,0,0,0,1,1,1,3,1,2,2,5,0,0,1,1,0,0,0,0
139499.0,Jansen Vandoorn Daniel,MB,Canada,32.0,207.0,2021,Canada,Brazil,2021-05-30,False,0,0,0,0,0,0,0,0,0,0,0,0,0,0,0,0,0,0,0,0,0,0,0,0
139499.0,Jansen Vandoorn Daniel,MB,Canada,32.0,207.0,2021,Iran,Canada,2021-06-03,False,0,0,0,0,0,0,0,0,0,0,0,0,0,0,0,0,0,0,0,0,0,0,0,0
139499.0,Jansen Vandoorn Daniel,MB,Canada,32.0,207.0,2021,Canada,Bulgaria,2021-06-04,True,0,0,10,10,0,0,0,0,3,2,1,6,2,4,0,6,0,0,1,1,3,3,0,6
139499.0,Jansen Vandoorn Daniel,MB,Canada,32.0,207.0,2021,Canada,Italy,2021-06-05,False,0,2,7,9,0,0,2,2,5,2,4,11,1,5,1,7,0,0,2,2,3,1,0,4
139499.0,Jansen Vandoorn Daniel,MB,Canada,32.0,207.0,2021,Slovenia,Canada,2021-06-09,False,0,0,5,5,0,0,0,0,2,0,0,2,1,1,1,3,0,0,0,0,0,0,0,0
139499.0,Jansen Vandoorn Daniel,MB,Canada,32.0,207.0,2021,Russia,Canada,2021-06-10,False,0,2,10,12,0,0,1,1,4,2,4,10,1,0,1,2,1,0,1,2,2,1,0,3
139499.0,Jansen Vandoorn Daniel,MB,Canada,32.0,207.0,2021,Canada,France,2021-06-11,False,0,3,2,5,0,0,0,0,5,3,1,9,1,4,5,10,1,0,1,2,2,1,0,3
139499.0,Jansen Vandoorn Daniel,MB,Canada,32.0,207.0,2021,Canada,Poland,2021-06-15,False,0,0,0,0,0,0,0,0,0,0,0,0,0,0,0,0,0,0,0,0,0,0,0,0
139499.0,Jansen Vandoorn Daniel,MB,Canada,32.0,207.0,2021,Canada,Germany,2021-06-16,True,0,1,11,12,0,0,0,0,2,0,4,6,1,4,1,6,1,0,1,2,2,0,0,2
139499.0,Jansen Vandoorn Daniel,MB,Canada,32.0,207.0,2021,Japan,Canada,2021-06-17,True,0,0,0,0,0,0,0,0,0,0,0,0,0,0,0,0,0,0,0,0,0,0,0,0
139499.0,Jansen Vandoorn Daniel,MB,Canada,32.0,207.0,2021,Canada,Netherlands,2021-06-21,True,0,0,0,0,0,0,0,0,0,0,0,0,0,0,0,0,0,0,0,0,0,0,0,0
139499.0,Jansen Vandoorn Daniel,MB,Canada,32.0,207.0,2021,Canada,Australia,2021-06-22,True,0,1,7,8,0,0,0,0,7,0,1,8,2,1,6,9,1,0,0,1,0,1,1,2
139499.0,Jansen Vandoorn Daniel,MB,Canada,32.0,207.0,2021,Canada,Serbia,2021-06-23,True,0,0,0,0,0,0,0,0,0,0,0,0,0,0,0,0,0,0,0,0,0,0,0,0
136296.0,Van Berkel Lucas,MB,Canada,30.0,210.0,2021,Argentina,Canada,2021-05-29,True,0,0,1,1,0,0,0,0,0,0,0,0,0,0,0,0,0,0,0,0,0,0,0,0
136296.0,Van Berkel Lucas,MB,Canada,30.0,210.0,2021,Canada,Brazil,2021-05-30,False,1,0,14,15,0,0,0,0,4,0,2,6,3,7,2,12,2,0,3,5,0,0,0,0
136296.0,Van Berkel Lucas,MB,Canada,30.0,210.0,2021,Iran,Canada,2021-06-03,False,0,0,11,11,0,0,3,3,7,1,2,10,2,5,5,12,0,1,4,5,4,2,0,6
136296.0,Van Berkel Lucas,MB,Canada,30.0,210.0,2021,Canada,Bulgaria,2021-06-04,True,0,0,0,0,0,0,0,0,0,0,0,0,0,0,0,0,0,0,0,0,0,0,0,0
136296.0,Van Berkel Lucas,MB,Canada,30.0,210.0,2021,Canada,Italy,2021-06-05,False,0,0,12,12,0,0,1,1,6,1,3,10,2,6,3,11,0,0,1,1,4,2,0,6
136296.0,Van Berkel Lucas,MB,Canada,30.0,210.0,2021,Slovenia,Canada,2021-06-09,False,0,0,4,4,0,0,0,0,3,0,1,4,2,3,3,8,0,0,2,2,0,0,0,0
136296.0,Van Berkel Lucas,MB,Canada,30.0,210.0,2021,Russia,Canada,2021-06-10,False,0,0,0,0,0,0,0,0,0,0,0,0,0,0,0,0,0,0,0,0,0,0,0,0
136296.0,Van Berkel Lucas,MB,Canada,30.0,210.0,2021,Canada,France,2021-06-11,False,0,2,13,15,0,0,0,0,2,2,2,6,3,3,1,7,0,0,0,0,3,0,0,3
136296.0,Van Berkel Lucas,MB,Canada,30.0,210.0,2021,Canada,Poland,2021-06-15,False,0,0,9,9,0,0,0,0,5,0,4,9,1,7,4,12,0,0,2,2,3,0,0,3
136296.0,Van Berkel Lucas,MB,Canada,30.0,210.0,2021,Canada,Germany,2021-06-16,True,0,0,0,0,0,0,0,0,0,0,0,0,0,0,0,0,0,0,0,0,0,0,0,0
136296.0,Van Berkel Lucas,MB,Canada,30.0,210.0,2021,Japan,Canada,2021-06-17,True,0,0,0,0,0,0,0,0,0,0,0,0,0,0,0,0,0,0,0,0,0,0,0,0
136296.0,Van Berkel Lucas,MB,Canada,30.0,210.0,2021,Canada,Netherlands,2021-06-21,True,0,1,11,12,0,0,0,0,7,0,3,10,2,2,4,8,1,0,0,1,0,1,0,1
136296.0,Van Berkel Lucas,MB,Canada,30.0,210.0,2021,Canada,Australia,2021-06-22,True,0,0,0,0,0,0,0,0,0,0,0,0,0,0,0,0,0,0,0,0,0,0,0,0
136296.0,Van Berkel Lucas,MB,Canada,30.0,210.0,2021,Canada,Serbia,2021-06-23,True,0,1,21,22,1,0,2,3,4,1,3,8,5,5,2,12,1,0,0,1,0,0,0,0
157321.0,Vernon-Evans Sharone,O,Canada,23.0,206.0,2021,USA,Canada,2021-05-28,False,2,1,9,12,0,0,0,0,4,6,7,17,1,1,2,4,0,0,0,0,4,0,0,4
157321.0,Vernon-Evans Sharone,O,Canada,23.0,206.0,2021,Argentina,Canada,2021-05-29,True,0,0,0,0,0,0,0,0,0,0,0,0,0,0,0,0,0,0,0,0,0,0,0,0
157321.0,Vernon-Evans Sharone,O,Canada,23.0,206.0,2021,Canada,Brazil,2021-05-30,False,1,6,7,14,0,0,0,0,21,5,18,44,2,4,2,8,0,0,1,1,5,4,2,11
157321.0,Vernon-Evans Sharone,O,Canada,23.0,206.0,2021,Iran,Canada,2021-06-03,False,0,2,0,2,0,0,0,0,1,1,1,3,0,0,0,0,0,0,0,0,0,0,0,0
157321.0,Vernon-Evans Sharone,O,Canada,23.0,206.0,2021,Canada,Bulgaria,2021-06-04,True,0,2,7,9,0,0,4,4,9,2,8,19,3,6,0,9,0,0,0,0,2,1,0,3
157321.0,Vernon-Evans Sharone,O,Canada,23.0,206.0,2021,Canada,Italy,2021-06-05,False,4,6,7,17,0,0,1,1,6,5,3,14,2,2,1,5,0,0,0,0,9,0,1,10
157321.0,Vernon-Evans Sharone,O,Canada,23.0,206.0,2021,Slovenia,Canada,2021-06-09,False,0,4,3,7,0,0,1,1,4,3,1,8,0,1,0,1,0,0,0,0,4,1,1,6
157321.0,Vernon-Evans Sharone,O,Canada,23.0,206.0,2021,Russia,Canada,2021-06-10,False,1,7,7,15,0,0,0,0,13,6,12,31,1,2,0,3,0,0,1,1,2,2,0,4
157321.0,Vernon-Evans Sharone,O,Canada,23.0,206.0,2021,Canada,France,2021-06-11,False,0,0,0,0,0,0,0,0,0,0,0,0,0,0,0,0,0,0,0,0,0,0,0,0
157321.0,Vernon-Evans Sharone,O,Canada,23.0,206.0,2021,Canada,Poland,2021-06-15,False,2,3,7,12,0,0,1,1,13,3,4,20,1,7,3,11,1,0,2,3,5,0,0,5
157321.0,Vernon-Evans Sharone,O,Canada,23.0,206.0,2021,Canada,Germany,2021-06-16,True,0,3,9,12,1,0,4,5,14,3,11,28,1,1,0,2,0,0,0,0,4,4,0,8
157321.0,Vernon-Evans Sharone,O,Canada,23.0,206.0,2021,Japan,Canada,2021-06-17,True,0,0,0,0,0,0,0,0,0,0,0,0,0,0,0,0,0,0,0,0,0,0,0,0
157321.0,Vernon-Evans Sharone,O,Canada,23.0,206.0,2021,Canada,Netherlands,2021-06-21,True,0,1,6,7,0,0,1,1,11,1,2,14,3,1,4,8,0,0,0,0,4,4,0,8
157321.0,Vernon-Evans Sharone,O,Canada,23.0,206.0,2021,Canada,Australia,2021-06-22,True,0,0,0,0,0,0,0,0,0,0,0,0,0,0,0,0,0,0,0,0,0,0,0,0
157321.0,Vernon-Evans Sharone,O,Canada,23.0,206.0,2021,Canada,Serbia,2021-06-23,True,0,3,4,7,0,0,2,2,7,2,7,16,2,1,1,4,0,0,1,1,0,4,0,4
157327.0,Loeppky Eric,OH,Canada,23.0,197.0,2021,USA,Canada,2021-05-28,False,0,1,2,3,0,0,0,0,0,2,2,4,0,0,0,0,2,1,6,9,1,1,0,2
157327.0,Loeppky Eric,OH,Canada,23.0,197.0,2021,Argentina,Canada,2021-05-29,True,0,0,0,0,0,0,0,0,0,0,0,0,0,0,0,0,0,0,0,0,0,0,0,0
157327.0,Loeppky Eric,OH,Canada,23.0,197.0,2021,Canada,Brazil,2021-05-30,False,0,1,12,13,0,0,0,0,13,2,11,26,1,2,2,5,6,0,15,21,7,3,2,12
157327.0,Loeppky Eric,OH,Canada,23.0,197.0,2021,Iran,Canada,2021-06-03,False,1,2,5,8,0,0,1,1,5,3,5,13,0,2,1,3,3,3,8,14,1,1,0,2
157327.0,Loeppky Eric,OH,Canada,23.0,197.0,2021,Canada,Bulgaria,2021-06-04,True,0,0,0,0,0,0,0,0,0,0,0,0,0,0,0,0,0,0,0,0,0,0,0,0
157327.0,Loeppky Eric,OH,Canada,23.0,197.0,2021,Canada,Italy,2021-06-05,False,1,2,12,15,0,0,2,2,13,6,6,25,1,4,2,7,7,1,16,24,9,1,0,10
157327.0,Loeppky Eric,OH,Canada,23.0,197.0,2021,Slovenia,Canada,2021-06-09,False,0,0,0,0,0,0,0,0,0,0,0,0,0,1,0,1,0,0,0,0,0,0,0,0
157327.0,Loeppky Eric,OH,Canada,23.0,197.0,2021,Russia,Canada,2021-06-10,False,0,1,8,9,0,1,5,6,10,5,12,27,0,2,2,4,4,0,11,15,6,3,0,9
157327.0,Loeppky Eric,OH,Canada,23.0,197.0,2021,Canada,France,2021-06-11,False,0,2,15,17,0,0,4,4,17,5,11,33,0,6,1,7,7,2,18,27,7,1,2,10
157327.0,Loeppky Eric,OH,Canada,23.0,197.0,2021,Canada,Poland,2021-06-15,False,0,0,0,0,0,0,0,0,0,0,0,0,0,0,0,0,0,0,0,0,0,0,0,0
157327.0,Loeppky Eric,OH,Canada,23.0,197.0,2021,Canada,Germany,2021-06-16,True,0,0,0,0,0,0,0,0,0,0,0,0,0,0,0,0,0,0,0,0,0,0,0,0
157327.0,Loeppky Eric,OH,Canada,23.0,197.0,2021,Canada,Netherlands,2021-06-21,True,0,0,0,0,0,0,0,0,0,0,0,0,0,0,0,0,0,0,0,0,0,0,0,0
157327.0,Loeppky Eric,OH,Canada,23.0,197.0,2021,Canada,Australia,2021-06-22,True,0,0,0,0,0,0,0,0,0,0,0,0,0,0,0,0,0,0,0,0,0,0,0,0
157327.0,Loeppky Eric,OH,Canada,23.0,197.0,2021,Canada,Serbia,2021-06-23,True,0,0,0,0,0,0,0,0,0,0,0,0,0,0,0,0,0,0,0,0,0,0,0,0
124551.0,Vigrass Graham,MB,Canada,32.0,205.0,2021,USA,Canada,2021-05-28,False,0,0,10,10,0,1,0,1,5,0,3,8,1,2,2,5,1,1,0,2,2,0,0,2
124551.0,Vigrass Graham,MB,Canada,32.0,205.0,2021,Argentina,Canada,2021-05-29,True,0,1,10,11,0,0,0,0,6,0,1,7,0,1,2,3,1,0,0,1,0,2,0,2
124551.0,Vigrass Graham,MB,Canada,32.0,205.0,2021,Canada,Poland,2021-06-15,False,0,0,0,0,0,0,0,0,0,0,0,0,0,0,0,0,0,0,0,0,0,0,0,0
124551.0,Vigrass Graham,MB,Canada,32.0,205.0,2021,Canada,Germany,2021-06-16,True,0,0,7,7,0,0,0,0,2,0,1,3,1,3,2,6,0,0,0,0,2,3,0,5
124551.0,Vigrass Graham,MB,Canada,32.0,205.0,2021,Japan,Canada,2021-06-17,True,2,0,10,12,0,0,1,1,3,0,5,8,0,5,2,7,0,0,2,2,1,0,0,1
124551.0,Vigrass Graham,MB,Canada,32.0,205.0,2021,Canada,Netherlands,2021-06-21,True,1,0,13,14,0,0,1,1,5,0,0,5,4,2,2,8,0,0,0,0,1,2,1,4
124551.0,Vigrass Graham,MB,Canada,32.0,205.0,2021,Canada,Australia,2021-06-22,True,0,0,0,0,0,0,0,0,0,0,0,0,0,0,0,0,0,0,0,0,0,0,0,0
124551.0,Vigrass Graham,MB,Canada,32.0,205.0,2021,Canada,Serbia,2021-06-23,True,0,3,8,11,0,0,0,0,5,1,4,10,2,7,5,14,0,0,0,0,4,1,0,5
139490.0,Bann Blair Cameron,L,Canada,34.0,184.0,2021,USA,Canada,2021-05-28,False,0,0,0,0,0,0,2,2,0,0,0,0,0,0,0,0,9,0,10,19,12,5,0,17
139490.0,Bann Blair Cameron,L,Canada,34.0,184.0,2021,Argentina,Canada,2021-05-29,True,0,0,0,0,0,0,0,0,0,0,0,0,0,0,0,0,7,1,7,15,3,2,0,5
139490.0,Bann Blair Cameron,L,Canada,34.0,184.0,2021,Canada,Brazil,2021-05-30,False,0,0,0,0,0,0,1,1,0,0,0,0,0,0,0,0,9,2,15,26,4,1,1,6
139490.0,Bann Blair Cameron,L,Canada,34.0,184.0,2021,Iran,Canada,2021-06-03,False,0,0,0,0,0,0,7,7,0,0,0,0,0,0,0,0,10,1,14,25,8,3,0,11
139490.0,Bann Blair Cameron,L,Canada,34.0,184.0,2021,Canada,Bulgaria,2021-06-04,True,0,0,0,0,0,0,4,4,0,0,0,0,0,0,0,0,6,2,7,15,7,2,2,11
139490.0,Bann Blair Cameron,L,Canada,34.0,184.0,2021,Canada,Italy,2021-06-05,False,0,0,0,0,0,0,15,15,0,0,0,0,0,0,0,0,9,2,15,26,13,3,0,16
139490.0,Bann Blair Cameron,L,Canada,34.0,184.0,2021,Canada,Germany,2021-06-16,True,0,0,0,0,0,0,6,6,0,0,0,0,0,0,0,0,8,0,3,11,9,3,0,12
139490.0,Bann Blair Cameron,L,Canada,34.0,184.0,2021,Japan,Canada,2021-06-17,True,0,0,0,0,0,1,6,7,0,0,0,0,0,0,0,0,5,0,13,18,6,0,2,8
139490.0,Bann Blair Cameron,L,Canada,34.0,184.0,2021,Canada,Netherlands,2021-06-21,True,0,0,0,0,0,0,3,3,0,0,0,0,0,0,0,0,2,0,12,14,6,3,0,9
139490.0,Bann Blair Cameron,L,Canada,34.0,184.0,2021,Canada,Australia,2021-06-22,True,0,0,0,0,0,0,5,5,0,0,0,0,0,0,0,0,6,2,3,11,11,2,1,14
139490.0,Bann Blair Cameron,L,Canada,34.0,184.0,2021,Canada,Serbia,2021-06-23,True,0,0,0,0,0,0,6,6,0,0,0,0,0,0,0,0,7,0,16,23,17,3,1,21
151871.0,Szwarc Arthur,O,Canada,26.0,209.0,2021,USA,Canada,2021-05-28,False,1,1,6,8,0,0,1,1,1,2,0,3,1,3,2,6,0,0,0,0,0,0,0,0
151871.0,Szwarc Arthur,O,Canada,26.0,209.0,2021,Argentina,Canada,2021-05-29,True,0,0,0,0,0,0,0,0,0,0,0,0,0,0,0,0,0,0,0,0,0,0,0,0
151871.0,Szwarc Arthur,O,Canada,26.0,209.0,2021,Canada,Brazil,2021-05-30,False,0,3,11,14,0,0,0,0,6,2,3,11,4,3,2,9,0,1,0,1,4,0,0,4
151871.0,Szwarc Arthur,O,Canada,26.0,209.0,2021,Iran,Canada,2021-06-03,False,1,2,11,14,0,0,1,1,7,2,4,13,2,4,3,9,0,0,0,0,2,2,0,4
151871.0,Szwarc Arthur,O,Canada,26.0,209.0,2021,Canada,Bulgaria,2021-06-04,True,2,3,8,13,0,0,0,0,9,2,1,12,3,4,2,9,1,0,0,1,2,0,0,2
151871.0,Szwarc Arthur,O,Canada,26.0,209.0,2021,Canada,Italy,2021-06-05,False,0,1,4,5,0,0,0,0,3,3,0,6,0,0,0,0,0,0,1,1,0,2,0,2
151871.0,Szwarc Arthur,O,Canada,26.0,209.0,2021,Slovenia,Canada,2021-06-09,False,0,2,6,8,0,2,4,6,0,0,3,3,1,2,3,6,1,0,1,2,0,1,0,1
151871.0,Szwarc Arthur,O,Canada,26.0,209.0,2021,Russia,Canada,2021-06-10,False,4,0,14,18,0,0,1,1,6,3,2,11,1,2,2,5,1,0,1,2,0,1,0,1
151871.0,Szwarc Arthur,O,Canada,26.0,209.0,2021,Canada,France,2021-06-11,False,0,0,0,0,0,0,0,0,0,0,0,0,0,0,0,0,0,0,0,0,0,0,0,0
151871.0,Szwarc Arthur,O,Canada,26.0,209.0,2021,Canada,Poland,2021-06-15,False,1,3,5,9,0,1,1,2,4,0,3,7,0,1,4,5,0,0,0,0,2,0,2,4
151871.0,Szwarc Arthur,O,Canada,26.0,209.0,2021,Canada,Germany,2021-06-16,True,0,0,3,3,0,0,0,0,0,0,0,0,1,2,0,3,0,0,0,0,0,0,0,0
151871.0,Szwarc Arthur,O,Canada,26.0,209.0,2021,Japan,Canada,2021-06-17,True,1,3,9,13,0,0,0,0,6,0,1,7,4,10,5,19,1,0,0,1,3,0,0,3
151871.0,Szwarc Arthur,O,Canada,26.0,209.0,2021,Canada,Netherlands,2021-06-21,True,0,0,0,0,0,0,0,0,0,0,0,0,0,0,0,0,0,0,0,0,0,0,0,0
151871.0,Szwarc Arthur,O,Canada,26.0,209.0,2021,Canada,Australia,2021-06-22,True,0,5,4,9,0,0,0,0,4,0,4,8,3,2,6,11,0,0,0,0,2,0,1,3
151871.0,Szwarc Arthur,O,Canada,26.0,209.0,2021,Canada,Serbia,2021-06-23,True,0,2,0,2,0,0,0,0,1,0,1,2,0,1,3,4,0,0,0,0,0,0,0,0
143745.0,Walsh Brett James,S,Canada,28.0,196.0,2021,USA,Canada,2021-05-28,False,0,1,0,1,4,0,0,4,0,0,0,0,0,0,0,0,0,0,1,1,2,0,0,2
143745.0,Walsh Brett James,S,Canada,28.0,196.0,2021,Argentina,Canada,2021-05-29,True,0,0,9,9,17,0,38,55,0,0,2,2,1,3,1,5,0,0,0,0,2,3,0,5
143745.0,Walsh Brett James,S,Canada,28.0,196.0,2021,Canada,Brazil,2021-05-30,False,0,4,11,15,24,1,78,103,1,1,1,3,1,1,4,6,0,0,0,0,3,4,0,7
143745.0,Walsh Brett James,S,Canada,28.0,196.0,2021,Canada,Bulgaria,2021-06-04,True,0,1,0,1,0,0,2,2,0,0,1,1,0,0,0,0,0,0,0,0,0,0,0,0
143745.0,Walsh Brett James,S,Canada,28.0,196.0,2021,Russia,Canada,2021-06-10,False,0,0,0,0,0,0,0,0,0,0,0,0,0,0,0,0,0,0,0,0,0,0,0,0
143745.0,Walsh Brett James,S,Canada,28.0,196.0,2021,Canada,France,2021-06-11,False,0,0,0,0,1,0,5,6,0,0,0,0,0,0,0,0,0,0,0,0,0,0,0,0
143745.0,Walsh Brett James,S,Canada,28.0,196.0,2021,Canada,Germany,2021-06-16,True,0,0,0,0,0,0,1,1,0,0,0,0,0,0,0,0,0,0,0,0,0,0,0,0
143745.0,Walsh Brett James,S,Canada,28.0,196.0,2021,Canada,Netherlands,2021-06-21,True,0,0,0,0,1,0,3,4,0,0,0,0,0,0,0,0,0,0,0,0,0,0,0,0
143745.0,Walsh Brett James,S,Canada,28.0,196.0,2021,Canada,Australia,2021-06-22,True,0,0,0,0,0,0,4,4,0,0,0,0,1,0,0,1,0,0,0,0,0,0,0,0
143745.0,Walsh Brett James,S,Canada,28.0,196.0,2021,Canada,Serbia,2021-06-23,True,0,0,0,0,0,0,1,1,0,0,0,0,0,0,0,0,0,0,0,0,0,0,0,0
140042.0,Demyanenko Danny,MB,Canada,27.0,196.0,2021,USA,Canada,2021-05-28,False,0,0,0,0,0,0,0,0,0,0,0,0,0,0,0,0,0,0,0,0,0,0,0,0
140042.0,Demyanenko Danny,MB,Canada,27.0,196.0,2021,Canada,Brazil,2021-05-30,False,0,0,0,0,0,0,0,0,0,0,0,0,0,0,0,0,0,0,0,0,0,0,0,0
140042.0,Demyanenko Danny,MB,Canada,27.0,196.0,2021,Iran,Canada,2021-06-03,False,0,0,0,0,0,0,0,0,0,0,0,0,0,0,0,0,0,0,0,0,0,0,0,0
140042.0,Demyanenko Danny,MB,Canada,27.0,196.0,2021,Canada,Bulgaria,2021-06-04,True,0,0,0,0,0,0,0,0,0,0,0,0,0,0,0,0,0,0,0,0,0,0,0,0
140042.0,Demyanenko Danny,MB,Canada,27.0,196.0,2021,Canada,Italy,2021-06-05,False,0,0,0,0,0,0,0,0,0,0,0,0,0,0,0,0,0,0,0,0,0,0,0,0
140042.0,Demyanenko Danny,MB,Canada,27.0,196.0,2021,Slovenia,Canada,2021-06-09,False,0,0,0,0,0,0,0,0,0,0,0,0,0,0,0,0,0,0,0,0,0,0,0,0
140042.0,Demyanenko Danny,MB,Canada,27.0,196.0,2021,Russia,Canada,2021-06-10,False,0,0,0,0,0,0,0,0,0,0,0,0,0,0,0,0,0,0,0,0,0,0,0,0
140042.0,Demyanenko Danny,MB,Canada,27.0,196.0,2021,Canada,France,2021-06-11,False,0,1,7,8,0,0,0,0,1,1,1,3,0,1,3,4,0,0,0,0,0,0,0,0
152494.0,Chinenyeze Barthélémy,MB,France,24.0,204.0,2021,France,Bulgaria,2021-05-28,True,0,2,7,9,0,0,1,1,5,1,2,8,2,0,0,2,0,0,0,0,0,0,0,0
152494.0,Chinenyeze Barthélémy,MB,France,24.0,204.0,2021,Germany,France,2021-05-29,True,0,4,12,16,0,0,0,0,8,1,4,13,3,3,3,9,2,0,0,2,0,0,0,0
152494.0,Chinenyeze Barthélémy,MB,France,24.0,204.0,2021,Australia,France,2021-05-30,True,0,0,1,1,0,0,0,0,3,0,0,3,0,1,0,1,0,0,0,0,2,0,0,2
152494.0,Chinenyeze Barthélémy,MB,France,24.0,204.0,2021,Brazil,France,2021-06-03,True,0,1,10,11,0,0,2,2,6,1,4,11,1,9,4,14,1,0,1,2,4,0,0,4
152494.0,Chinenyeze Barthélémy,MB,France,24.0,204.0,2021,Serbia,France,2021-06-04,False,0,2,11,13,0,0,0,0,3,1,4,8,0,8,2,10,3,1,0,4,2,0,1,3
152494.0,Chinenyeze Barthélémy,MB,France,24.0,204.0,2021,France,Japan,2021-06-05,True,1,1,13,15,0,0,1,1,8,1,6,15,3,5,2,10,1,0,0,1,3,0,0,3
152494.0,Chinenyeze Barthélémy,MB,France,24.0,204.0,2021,France,Russia,2021-06-09,True,0,1,8,9,0,0,3,3,2,0,6,8,3,5,8,16,0,0,0,0,4,1,1,6
152494.0,Chinenyeze Barthélémy,MB,France,24.0,204.0,2021,France,Slovenia,2021-06-10,False,0,0,0,0,0,0,0,0,0,0,0,0,0,0,0,0,0,0,0,0,0,0,0,0
152494.0,Chinenyeze Barthélémy,MB,France,24.0,204.0,2021,Canada,France,2021-06-11,True,0,0,16,16,1,0,4,5,3,1,5,9,2,6,2,10,0,0,0,0,2,1,0,3
152494.0,Chinenyeze Barthélémy,MB,France,24.0,204.0,2021,Netherlands,France,2021-06-15,False,0,2,15,17,0,0,1,1,11,1,3,15,2,7,4,13,0,0,0,0,1,0,0,1
152494.0,Chinenyeze Barthélémy,MB,France,24.0,204.0,2021,USA,France,2021-06-16,True,0,2,13,15,0,1,1,2,6,1,5,12,2,3,7,12,2,0,0,2,4,0,3,7
152494.0,Chinenyeze Barthélémy,MB,France,24.0,204.0,2021,France,Italy,2021-06-17,False,1,1,11,13,0,0,0,0,2,1,5,8,2,1,2,5,0,0,1,1,1,0,0,1
152494.0,Chinenyeze Barthélémy,MB,France,24.0,204.0,2021,France,Iran,2021-06-21,True,0,2,7,9,0,0,0,0,5,0,2,7,2,2,0,4,0,0,0,0,2,1,0,3
152494.0,Chinenyeze Barthélémy,MB,France,24.0,204.0,2021,France,Argentina,2021-06-22,True,2,0,14,16,0,0,0,0,7,1,1,9,0,6,1,7,1,0,0,1,4,2,0,6
152494.0,Chinenyeze Barthélémy,MB,France,24.0,204.0,2021,France,Poland,2021-06-23,True,0,3,17,20,0,0,1,1,6,1,5,12,0,3,2,5,0,0,0,0,2,0,0,2
152494.0,Chinenyeze Barthélémy,MB,France,24.0,204.0,2021,Brazil,France,2021-06-26,False,0,0,10,10,1,0,1,2,5,2,1,8,0,5,3,8,0,0,1,1,1,1,0,2
152494.0,Chinenyeze Barthélémy,MB,France,24.0,204.0,2021,France,Slovenia,2021-06-27,True,0,0,9,9,0,0,1,1,4,2,0,6,1,3,5,9,0,0,0,0,1,1,0,2
119792.0,Grebennikov Jenia,L,France,31.0,188.0,2021,Brazil,France,2021-06-03,True,0,0,0,0,0,0,4,4,0,0,0,0,0,0,0,0,7,1,14,22,13,6,3,22
119792.0,Grebennikov Jenia,L,France,31.0,188.0,2021,Serbia,France,2021-06-04,False,0,0,0,0,0,0,4,4,0,0,0,0,0,0,0,0,7,1,16,24,10,3,3,16
119792.0,Grebennikov Jenia,L,France,31.0,188.0,2021,France,Japan,2021-06-05,True,0,0,0,0,0,0,3,3,0,0,0,0,0,0,0,0,6,3,13,22,8,6,1,15
119792.0,Grebennikov Jenia,L,France,31.0,188.0,2021,France,Russia,2021-06-09,True,0,0,0,0,0,0,4,4,0,0,0,0,0,0,0,0,6,0,10,16,15,2,1,18
119792.0,Grebennikov Jenia,L,France,31.0,188.0,2021,France,Slovenia,2021-06-10,False,0,0,0,0,0,0,3,3,0,0,0,0,0,0,0,0,9,1,3,13,10,4,3,17
119792.0,Grebennikov Jenia,L,France,31.0,188.0,2021,Canada,France,2021-06-11,True,0,0,0,0,0,0,7,7,0,0,0,0,0,0,0,0,8,0,16,24,8,4,0,12
119792.0,Grebennikov Jenia,L,France,31.0,188.0,2021,Netherlands,France,2021-06-15,False,0,0,0,0,0,0,7,7,0,0,0,0,0,0,0,0,8,0,12,20,17,2,1,20
119792.0,Grebennikov Jenia,L,France,31.0,188.0,2021,USA,France,2021-06-16,True,0,0,0,0,0,0,10,10,0,0,0,0,0,0,0,0,8,0,16,24,11,5,2,18
119792.0,Grebennikov Jenia,L,France,31.0,188.0,2021,France,Italy,2021-06-17,False,0,0,0,0,0,0,3,3,0,0,0,0,0,0,0,0,0,0,2,2,4,2,0,6
119792.0,Grebennikov Jenia,L,France,31.0,188.0,2021,France,Iran,2021-06-21,True,0,0,0,0,0,0,0,0,0,0,0,0,0,0,0,0,13,0,11,24,5,6,2,13
119792.0,Grebennikov Jenia,L,France,31.0,188.0,2021,France,Argentina,2021-06-22,True,0,0,0,0,0,0,6,6,0,0,0,0,0,0,0,0,5,0,6,11,12,2,0,14
119792.0,Grebennikov Jenia,L,France,31.0,188.0,2021,France,Poland,2021-06-23,True,0,0,0,0,0,0,2,2,0,0,0,0,0,0,0,0,10,1,10,21,12,2,0,14
119792.0,Grebennikov Jenia,L,France,31.0,188.0,2021,Brazil,France,2021-06-26,False,0,0,0,0,0,0,2,2,0,0,0,0,0,0,0,0,3,1,9,13,6,5,2,13
119792.0,Grebennikov Jenia,L,France,31.0,188.0,2021,France,Slovenia,2021-06-27,True,0,0,0,0,1,0,7,8,0,0,0,0,0,0,0,0,6,0,4,10,6,1,1,8
142694.0,Patry Jean,O,France,25.0,207.0,2021,France,Bulgaria,2021-05-28,True,1,4,7,12,0,0,0,0,8,4,13,25,1,0,0,1,0,0,0,0,1,0,0,1
142694.0,Patry Jean,O,France,25.0,207.0,2021,Germany,France,2021-05-29,True,0,0,1,1,0,0,0,0,0,0,0,0,0,1,0,1,0,0,0,0,1,0,0,1
142694.0,Patry Jean,O,France,25.0,207.0,2021,Australia,France,2021-05-30,True,2,2,15,19,0,0,0,0,14,6,6,26,1,3,3,7,0,0,0,0,7,0,1,8
142694.0,Patry Jean,O,France,25.0,207.0,2021,Brazil,France,2021-06-03,True,0,3,14,17,0,0,0,0,20,4,15,39,0,4,0,4,0,0,0,0,5,0,0,5
142694.0,Patry Jean,O,France,25.0,207.0,2021,France,Japan,2021-06-05,True,1,8,12,21,0,0,1,1,16,4,16,36,2,4,0,6,0,0,0,0,2,3,1,6
142694.0,Patry Jean,O,France,25.0,207.0,2021,France,Russia,2021-06-09,True,4,3,15,22,0,0,2,2,14,5,13,32,0,3,4,7,0,0,0,0,5,5,0,10
142694.0,Patry Jean,O,France,25.0,207.0,2021,Canada,France,2021-06-11,True,0,2,11,13,0,0,5,5,13,2,9,24,0,0,4,4,0,0,0,0,3,1,1,5
142694.0,Patry Jean,O,France,25.0,207.0,2021,USA,France,2021-06-16,True,0,1,12,13,0,0,6,6,13,4,9,26,1,1,6,8,0,0,0,0,8,2,0,10
142694.0,Patry Jean,O,France,25.0,207.0,2021,France,Italy,2021-06-17,False,0,0,0,0,0,0,0,0,0,0,0,0,0,0,0,0,0,0,0,0,0,0,0,0
142694.0,Patry Jean,O,France,25.0,207.0,2021,France,Iran,2021-06-21,True,0,0,0,0,0,0,0,0,0,0,0,0,0,0,0,0,0,0,0,0,0,0,0,0
142694.0,Patry Jean,O,France,25.0,207.0,2021,France,Argentina,2021-06-22,True,1,1,9,11,0,0,1,1,12,7,8,27,1,1,1,3,0,0,0,0,3,2,1,6
142694.0,Patry Jean,O,France,25.0,207.0,2021,France,Poland,2021-06-23,True,2,1,8,11,0,0,0,0,6,6,7,19,1,5,3,9,0,0,0,0,8,1,2,11
142694.0,Patry Jean,O,France,25.0,207.0,2021,Brazil,France,2021-06-26,False,0,2,4,6,0,0,0,0,11,0,8,19,1,5,1,7,0,0,0,0,3,0,1,4
142694.0,Patry Jean,O,France,25.0,207.0,2021,France,Slovenia,2021-06-27,True,0,0,0,0,0,0,0,0,0,0,0,0,0,0,0,0,0,0,0,0,0,0,0,0
119804.0,Toniutti Benjamin,S,France,32.0,183.0,2021,France,Bulgaria,2021-05-28,True,0,0,0,0,0,0,0,0,0,0,0,0,0,0,0,0,0,0,0,0,0,0,0,0
119804.0,Toniutti Benjamin,S,France,32.0,183.0,2021,Germany,France,2021-05-29,True,0,2,11,13,25,0,0,25,1,0,0,1,1,0,0,1,0,0,0,0,3,2,0,5
119804.0,Toniutti Benjamin,S,France,32.0,183.0,2021,Brazil,France,2021-06-03,True,0,1,10,11,34,0,52,86,0,0,0,0,1,3,3,7,0,0,0,0,5,1,0,6
119804.0,Toniutti Benjamin,S,France,32.0,183.0,2021,Serbia,France,2021-06-04,False,0,3,12,15,19,1,90,110,0,0,2,2,0,3,2,5,0,0,1,1,4,4,1,9
119804.0,Toniutti Benjamin,S,France,32.0,183.0,2021,France,Russia,2021-06-09,True,0,0,0,0,0,0,0,0,0,0,0,0,0,0,0,0,0,0,0,0,0,0,0,0
119804.0,Toniutti Benjamin,S,France,32.0,183.0,2021,France,Slovenia,2021-06-10,False,0,1,13,14,38,0,33,71,0,0,0,0,0,3,3,6,0,0,0,0,2,3,0,5
119804.0,Toniutti Benjamin,S,France,32.0,183.0,2021,Canada,France,2021-06-11,True,0,0,8,8,9,1,31,41,0,0,0,0,0,1,1,2,0,0,0,0,4,1,2,7
119804.0,Toniutti Benjamin,S,France,32.0,183.0,2021,Netherlands,France,2021-06-15,False,0,0,0,0,0,0,0,0,0,0,0,0,0,0,0,0,0,0,0,0,0,0,0,0
119804.0,Toniutti Benjamin,S,France,32.0,183.0,2021,USA,France,2021-06-16,True,0,1,13,14,13,0,50,63,0,0,0,0,0,1,0,1,0,0,0,0,9,0,1,10
119804.0,Toniutti Benjamin,S,France,32.0,183.0,2021,France,Italy,2021-06-17,False,0,1,7,8,13,0,46,59,0,0,0,0,1,1,0,2,0,0,0,0,3,2,0,5
119804.0,Toniutti Benjamin,S,France,32.0,183.0,2021,France,Iran,2021-06-21,True,0,1,11,12,17,0,49,66,0,0,0,0,0,1,3,4,0,0,0,0,5,3,0,8
119804.0,Toniutti Benjamin,S,France,32.0,183.0,2021,France,Argentina,2021-06-22,True,0,0,0,0,0,0,0,0,0,0,0,0,0,0,0,0,0,0,0,0,0,0,0,0
119804.0,Toniutti Benjamin,S,France,32.0,183.0,2021,France,Poland,2021-06-23,True,1,1,7,9,4,1,47,52,0,0,0,0,0,1,2,3,0,0,0,0,3,0,0,3
119804.0,Toniutti Benjamin,S,France,32.0,183.0,2021,Brazil,France,2021-06-26,False,0,0,6,6,7,0,30,37,0,0,0,0,0,0,0,0,0,0,0,0,1,0,0,1
119804.0,Toniutti Benjamin,S,France,32.0,183.0,2021,France,Slovenia,2021-06-27,True,0,0,0,0,0,0,0,0,0,0,0,0,0,0,0,0,0,0,0,0,0,0,0,0
124518.0,Tillie Kevin,OH,France,31.0,200.0,2021,France,Bulgaria,2021-05-28,True,1,1,13,15,0,0,1,1,7,1,5,13,0,1,0,1,6,2,13,21,1,0,0,1
124518.0,Tillie Kevin,OH,France,31.0,200.0,2021,Germany,France,2021-05-29,True,0,1,2,3,0,0,0,0,0,0,0,0,0,0,0,0,0,0,0,0,0,0,0,0
124518.0,Tillie Kevin,OH,France,31.0,200.0,2021,Australia,France,2021-05-30,True,2,2,14,18,0,0,0,0,12,0,8,20,2,3,4,9,5,0,9,14,9,1,4,14
124518.0,Tillie Kevin,OH,France,31.0,200.0,2021,Brazil,France,2021-06-03,True,1,4,14,19,0,0,4,4,12,3,7,22,0,2,1,3,4,1,10,15,5,5,2,12
124518.0,Tillie Kevin,OH,France,31.0,200.0,2021,France,Japan,2021-06-05,True,1,1,13,15,0,0,2,2,13,2,6,21,1,3,0,4,7,1,12,20,1,2,0,3
124518.0,Tillie Kevin,OH,France,31.0,200.0,2021,France,Russia,2021-06-09,True,0,1,4,5,0,0,0,0,0,0,0,0,0,0,0,0,0,0,0,0,2,0,0,2
124518.0,Tillie Kevin,OH,France,31.0,200.0,2021,France,Slovenia,2021-06-10,False,0,2,2,4,0,0,0,0,5,1,5,11,0,1,0,1,3,2,7,12,1,1,0,2
124518.0,Tillie Kevin,OH,France,31.0,200.0,2021,Canada,France,2021-06-11,True,0,1,9,10,0,0,2,2,13,2,15,30,4,1,4,9,12,1,9,22,7,1,0,8
124518.0,Tillie Kevin,OH,France,31.0,200.0,2021,Netherlands,France,2021-06-15,False,0,1,1,2,0,0,0,0,2,0,1,3,0,0,1,1,1,1,2,4,1,3,1,5
124518.0,Tillie Kevin,OH,France,31.0,200.0,2021,USA,France,2021-06-16,True,0,1,6,7,0,0,2,2,7,1,4,12,0,1,2,3,4,0,7,11,4,2,0,6
124518.0,Tillie Kevin,OH,France,31.0,200.0,2021,France,Italy,2021-06-17,False,0,1,4,5,0,0,2,2,10,1,3,14,0,1,0,1,3,2,10,15,1,1,0,2
124518.0,Tillie Kevin,OH,France,31.0,200.0,2021,France,Iran,2021-06-21,True,0,0,7,7,0,0,0,0,8,1,3,12,0,0,1,1,4,0,6,10,1,2,0,3
124518.0,Tillie Kevin,OH,France,31.0,200.0,2021,France,Argentina,2021-06-22,True,0,0,0,0,0,0,0,0,0,0,0,0,0,0,0,0,0,0,0,0,0,0,0,0
124518.0,Tillie Kevin,OH,France,31.0,200.0,2021,France,Poland,2021-06-23,True,0,3,6,9,0,0,2,2,4,4,6,14,2,1,0,3,5,0,13,18,2,3,1,6
124518.0,Tillie Kevin,OH,France,31.0,200.0,2021,Brazil,France,2021-06-26,False,0,0,3,3,0,0,1,1,3,3,5,11,0,0,0,0,1,0,4,5,3,0,0,3
124518.0,Tillie Kevin,OH,France,31.0,200.0,2021,France,Slovenia,2021-06-27,True,0,1,2,3,0,0,0,0,0,0,0,0,0,0,0,0,0,0,0,0,0,1,0,1
119798.0,Lyneel Julien,OH,France,31.0,192.0,2021,France,Bulgaria,2021-05-28,True,0,0,0,0,0,0,0,0,0,0,0,0,0,0,0,0,0,0,0,0,0,0,0,0
119798.0,Lyneel Julien,OH,France,31.0,192.0,2021,Germany,France,2021-05-29,True,0,0,0,0,0,0,0,0,0,0,0,0,0,0,0,0,3,0,10,13,6,2,0,8
119798.0,Lyneel Julien,OH,France,31.0,192.0,2021,Australia,France,2021-05-30,True,0,0,0,0,0,0,2,2,0,0,0,0,0,0,0,0,2,1,4,7,3,0,0,3
119798.0,Lyneel Julien,OH,France,31.0,192.0,2021,Serbia,France,2021-06-04,False,0,2,9,11,0,0,2,2,4,2,1,7,0,1,0,1,6,0,5,11,2,2,0,4
119798.0,Lyneel Julien,OH,France,31.0,192.0,2021,France,Japan,2021-06-05,True,0,1,8,9,0,0,0,0,1,2,2,5,0,0,0,0,1,0,4,5,1,0,0,1
119798.0,Lyneel Julien,OH,France,31.0,192.0,2021,France,Slovenia,2021-06-10,False,1,2,2,5,0,0,0,0,0,0,0,0,0,0,0,0,0,0,0,0,0,0,0,0
119798.0,Lyneel Julien,OH,France,31.0,192.0,2021,Canada,France,2021-06-11,True,1,1,5,7,0,0,1,1,1,3,3,7,1,0,0,1,4,0,9,13,2,5,0,7
119800.0,Ngapeth Earvin,OH,France,31.0,194.0,2021,Australia,France,2021-05-30,True,0,1,5,6,0,0,0,0,6,5,11,22,0,1,0,1,7,0,17,24,4,1,1,6
119800.0,Ngapeth Earvin,OH,France,31.0,194.0,2021,Brazil,France,2021-06-03,True,1,7,4,12,0,0,5,5,11,1,12,24,0,5,0,5,6,2,15,23,6,1,1,8
119800.0,Ngapeth Earvin,OH,France,31.0,194.0,2021,Serbia,France,2021-06-04,False,3,1,9,13,0,0,1,1,5,1,2,8,0,4,0,4,4,0,4,8,0,3,1,4
119800.0,Ngapeth Earvin,OH,France,31.0,194.0,2021,France,Russia,2021-06-09,True,3,4,13,20,0,0,7,7,18,6,7,31,0,1,2,3,8,1,20,29,8,1,2,11
119800.0,Ngapeth Earvin,OH,France,31.0,194.0,2021,France,Slovenia,2021-06-10,False,1,4,8,13,0,0,4,4,12,2,2,16,1,1,2,4,8,2,6,16,4,1,1,6
119800.0,Ngapeth Earvin,OH,France,31.0,194.0,2021,Netherlands,France,2021-06-15,False,0,4,7,11,0,0,4,4,7,2,5,14,0,1,0,1,4,0,14,18,3,2,1,6
119800.0,Ngapeth Earvin,OH,France,31.0,194.0,2021,USA,France,2021-06-16,True,3,5,11,19,0,0,7,7,12,7,16,35,1,2,1,4,4,1,19,24,10,4,0,14
119800.0,Ngapeth Earvin,OH,France,31.0,194.0,2021,France,Iran,2021-06-21,True,2,3,15,20,0,0,3,3,7,5,2,14,0,3,0,3,5,2,10,17,3,1,1,5
119800.0,Ngapeth Earvin,OH,France,31.0,194.0,2021,France,Argentina,2021-06-22,True,0,0,0,0,0,0,0,0,0,0,0,0,0,0,0,0,0,0,0,0,0,0,0,0
119800.0,Ngapeth Earvin,OH,France,31.0,194.0,2021,France,Poland,2021-06-23,True,1,5,11,17,0,0,12,12,15,6,7,28,2,2,1,5,14,2,15,31,7,2,0,9
119800.0,Ngapeth Earvin,OH,France,31.0,194.0,2021,Brazil,France,2021-06-26,False,1,4,8,13,0,0,5,5,4,5,7,16,0,2,1,3,9,1,14,24,8,0,0,8
119800.0,Ngapeth Earvin,OH,France,31.0,194.0,2021,France,Slovenia,2021-06-27,True,3,4,9,16,0,0,7,7,14,3,0,17,1,4,1,6,4,2,14,20,3,1,0,4
136851.0,Brizard Antoine,S,France,27.0,196.0,2021,France,Bulgaria,2021-05-28,True,0,6,6,12,3,0,62,65,3,0,0,3,1,0,0,1,0,0,0,0,0,0,0,0
136851.0,Brizard Antoine,S,France,27.0,196.0,2021,Germany,France,2021-05-29,True,0,0,8,8,15,0,2,17,1,0,2,3,1,2,0,3,0,0,0,0,2,1,2,5
136851.0,Brizard Antoine,S,France,27.0,196.0,2021,Australia,France,2021-05-30,True,0,2,8,10,26,0,42,68,4,1,1,6,3,2,2,7,0,0,1,1,4,1,1,6
136851.0,Brizard Antoine,S,France,27.0,196.0,2021,Serbia,France,2021-06-04,False,0,0,0,0,0,0,0,0,0,0,0,0,0,0,0,0,0,0,0,0,0,0,0,0
136851.0,Brizard Antoine,S,France,27.0,196.0,2021,France,Japan,2021-06-05,True,1,4,12,17,25,0,82,107,4,0,1,5,2,2,1,5,0,0,0,0,3,5,0,8
136851.0,Brizard Antoine,S,France,27.0,196.0,2021,France,Russia,2021-06-09,True,0,3,13,16,33,0,53,86,2,0,0,2,0,5,4,9,0,0,2,2,4,0,1,5
136851.0,Brizard Antoine,S,France,27.0,196.0,2021,France,Slovenia,2021-06-10,False,0,0,2,2,9,0,9,18,0,0,0,0,0,1,2,3,0,0,0,0,1,2,0,3
136851.0,Brizard Antoine,S,France,27.0,196.0,2021,Canada,France,2021-06-11,True,0,3,7,10,9,1,36,46,1,0,0,1,0,1,1,2,0,0,0,0,7,2,2,11
136851.0,Brizard Antoine,S,France,27.0,196.0,2021,Netherlands,France,2021-06-15,False,0,3,14,17,38,0,69,107,1,0,2,3,2,2,4,8,0,0,0,0,5,2,1,8
136851.0,Brizard Antoine,S,France,27.0,196.0,2021,USA,France,2021-06-16,True,0,1,3,4,9,0,27,36,0,0,1,1,0,1,1,2,0,0,0,0,3,0,0,3
136851.0,Brizard Antoine,S,France,27.0,196.0,2021,France,Italy,2021-06-17,False,0,3,9,12,9,0,46,55,0,1,0,1,1,2,0,3,0,0,0,0,3,0,0,3
136851.0,Brizard Antoine,S,France,27.0,196.0,2021,France,Iran,2021-06-21,True,0,0,0,0,0,0,0,0,0,0,0,0,0,0,0,0,0,0,0,0,0,0,0,0
136851.0,Brizard Antoine,S,France,27.0,196.0,2021,France,Argentina,2021-06-22,True,2,3,9,14,24,2,44,70,3,0,2,5,2,1,1,4,0,0,2,2,5,2,0,7
136851.0,Brizard Antoine,S,France,27.0,196.0,2021,France,Poland,2021-06-23,True,1,2,6,9,17,0,31,48,3,0,0,3,1,0,2,3,0,0,0,0,2,2,0,4
136851.0,Brizard Antoine,S,France,27.0,196.0,2021,Brazil,France,2021-06-26,False,1,1,3,5,8,0,22,30,0,0,2,2,1,0,0,1,0,0,0,0,2,0,0,2
136851.0,Brizard Antoine,S,France,27.0,196.0,2021,France,Slovenia,2021-06-27,True,1,3,9,13,14,0,34,48,4,0,1,5,3,0,3,6,0,0,1,1,2,0,0,2
142710.0,Boyer Stephen,O,France,25.0,196.0,2021,France,Bulgaria,2021-05-28,True,0,0,0,0,0,0,0,0,0,0,0,0,0,0,0,0,0,0,0,0,0,0,0,0
142710.0,Boyer Stephen,O,France,25.0,196.0,2021,Germany,France,2021-05-29,True,0,3,11,14,0,0,0,0,17,5,10,32,3,1,6,10,0,0,0,0,7,4,0,11
142710.0,Boyer Stephen,O,France,25.0,196.0,2021,Australia,France,2021-05-30,True,0,0,0,0,0,0,0,0,0,0,0,0,0,0,0,0,0,0,0,0,0,0,0,0
142710.0,Boyer Stephen,O,France,25.0,196.0,2021,Brazil,France,2021-06-03,True,0,0,0,0,0,0,0,0,0,0,0,0,0,0,0,0,0,0,0,0,0,0,0,0
142710.0,Boyer Stephen,O,France,25.0,196.0,2021,Serbia,France,2021-06-04,False,2,3,12,17,0,0,0,0,22,5,12,39,2,4,0,6,0,0,0,0,5,5,2,12
142710.0,Boyer Stephen,O,France,25.0,196.0,2021,France,Russia,2021-06-09,True,0,0,0,0,0,0,0,0,0,0,0,0,0,0,0,0,0,0,0,0,0,0,0,0
142710.0,Boyer Stephen,O,France,25.0,196.0,2021,France,Slovenia,2021-06-10,False,0,5,7,12,0,0,1,1,8,7,7,22,0,1,3,4,0,0,0,0,2,4,2,8
142710.0,Boyer Stephen,O,France,25.0,196.0,2021,Netherlands,France,2021-06-15,False,0,0,0,0,0,0,0,0,0,0,0,0,0,0,0,0,0,0,0,0,0,0,0,0
142710.0,Boyer Stephen,O,France,25.0,196.0,2021,USA,France,2021-06-16,True,0,2,3,5,0,0,1,1,10,2,4,16,0,1,1,2,0,0,0,0,2,2,1,5
142710.0,Boyer Stephen,O,France,25.0,196.0,2021,France,Italy,2021-06-17,False,0,3,13,16,0,0,1,1,21,7,21,49,0,3,1,4,0,0,0,0,3,6,0,9
142710.0,Boyer Stephen,O,France,25.0,196.0,2021,France,Iran,2021-06-21,True,1,5,3,9,0,0,1,1,15,3,8,26,1,2,1,4,0,0,0,0,1,1,1,3
142710.0,Boyer Stephen,O,France,25.0,196.0,2021,France,Argentina,2021-06-22,True,0,0,0,0,0,0,0,0,0,0,0,0,0,0,0,0,0,0,0,0,0,0,0,0
142710.0,Boyer Stephen,O,France,25.0,196.0,2021,France,Poland,2021-06-23,True,0,1,6,7,0,0,0,0,5,4,3,12,3,0,2,5,0,0,0,0,3,0,0,3
142710.0,Boyer Stephen,O,France,25.0,196.0,2021,Brazil,France,2021-06-26,False,0,0,1,1,0,0,0,0,2,1,2,5,0,0,1,1,0,0,0,0,0,1,0,1
142710.0,Boyer Stephen,O,France,25.0,196.0,2021,France,Slovenia,2021-06-27,True,1,2,7,10,0,0,3,3,13,3,8,24,1,5,2,8,0,0,2,2,7,0,1,8
125073.0,Le Goff Nicolas,MB,France,30.0,206.0,2021,France,Bulgaria,2021-05-28,True,1,1,6,8,0,0,1,1,4,2,3,9,2,2,0,4,0,0,1,1,0,0,0,0
125073.0,Le Goff Nicolas,MB,France,30.0,206.0,2021,Germany,France,2021-05-29,True,0,0,0,0,0,0,0,0,0,0,0,0,0,0,0,0,0,0,0,0,0,0,0,0
125073.0,Le Goff Nicolas,MB,France,30.0,206.0,2021,Australia,France,2021-05-30,True,0,2,8,10,0,0,0,0,1,0,3,4,1,4,7,12,0,0,0,0,2,0,1,3
125073.0,Le Goff Nicolas,MB,France,30.0,206.0,2021,Brazil,France,2021-06-03,True,1,1,13,15,0,0,2,2,2,1,1,4,4,6,4,14,0,0,0,0,1,2,0,3
125073.0,Le Goff Nicolas,MB,France,30.0,206.0,2021,Serbia,France,2021-06-04,False,0,0,0,0,0,0,0,0,0,0,0,0,0,0,0,0,0,0,0,0,0,0,0,0
125073.0,Le Goff Nicolas,MB,France,30.0,206.0,2021,France,Japan,2021-06-05,True,0,0,0,0,0,0,0,0,0,0,0,0,0,0,0,0,0,0,0,0,0,0,0,0
125073.0,Le Goff Nicolas,MB,France,30.0,206.0,2021,France,Russia,2021-06-09,True,0,1,9,10,0,0,0,0,7,1,2,10,5,3,6,14,0,0,0,0,1,0,0,1
125073.0,Le Goff Nicolas,MB,France,30.0,206.0,2021,France,Slovenia,2021-06-10,False,0,1,13,14,0,0,2,2,4,1,1,6,2,1,4,7,0,0,1,1,2,0,0,2
125073.0,Le Goff Nicolas,MB,France,30.0,206.0,2021,Canada,France,2021-06-11,True,0,0,0,0,0,0,0,0,0,0,0,0,0,0,0,0,0,0,0,0,0,0,0,0
125073.0,Le Goff Nicolas,MB,France,30.0,206.0,2021,Netherlands,France,2021-06-15,False,0,3,11,14,0,0,2,2,11,2,4,17,4,3,5,12,0,0,0,0,3,0,1,4
125073.0,Le Goff Nicolas,MB,France,30.0,206.0,2021,USA,France,2021-06-16,True,0,0,15,15,0,0,2,2,4,1,3,8,0,4,4,8,1,0,1,2,2,0,0,2
125073.0,Le Goff Nicolas,MB,France,30.0,206.0,2021,France,Italy,2021-06-17,False,0,0,0,0,0,0,0,0,0,0,0,0,0,0,0,0,0,0,0,0,0,0,0,0
125073.0,Le Goff Nicolas,MB,France,30.0,206.0,2021,France,Iran,2021-06-21,True,1,1,10,12,0,0,1,1,4,1,1,6,4,2,1,7,0,0,1,1,2,0,0,2
125073.0,Le Goff Nicolas,MB,France,30.0,206.0,2021,France,Argentina,2021-06-22,True,0,0,0,0,0,0,0,0,0,0,0,0,0,0,0,0,0,0,0,0,0,0,0,0
125073.0,Le Goff Nicolas,MB,France,30.0,206.0,2021,France,Poland,2021-06-23,True,0,2,14,16,0,0,1,1,8,1,7,16,2,7,11,20,0,0,0,0,3,0,0,3
125073.0,Le Goff Nicolas,MB,France,30.0,206.0,2021,Brazil,France,2021-06-26,False,0,1,6,7,0,0,0,0,3,2,1,6,1,1,1,3,0,0,0,0,1,2,1,4
125073.0,Le Goff Nicolas,MB,France,30.0,206.0,2021,France,Slovenia,2021-06-27,True,0,1,11,12,0,0,2,2,3,1,4,8,3,1,3,7,0,0,0,0,3,0,0,3
142677.0,Bultor Daryl,MB,France,26.0,197.0,2021,France,Bulgaria,2021-05-28,True,0,0,0,0,0,0,0,0,0,0,0,0,0,0,0,0,0,0,0,0,0,0,0,0
142677.0,Bultor Daryl,MB,France,26.0,197.0,2021,Germany,France,2021-05-29,True,0,5,9,14,0,0,0,0,12,1,0,13,1,5,2,8,0,0,0,0,2,0,0,2
142677.0,Bultor Daryl,MB,France,26.0,197.0,2021,Australia,France,2021-05-30,True,0,4,7,11,0,0,0,0,0,2,7,9,2,4,4,10,0,1,1,2,2,3,1,6
142677.0,Bultor Daryl,MB,France,26.0,197.0,2021,Brazil,France,2021-06-03,True,0,0,0,0,0,0,0,0,0,0,0,0,0,0,0,0,0,0,0,0,0,0,0,0
142677.0,Bultor Daryl,MB,France,26.0,197.0,2021,Serbia,France,2021-06-04,False,1,4,6,11,0,0,0,0,8,3,2,13,3,4,5,12,2,0,0,2,2,0,1,3
142677.0,Bultor Daryl,MB,France,26.0,197.0,2021,France,Japan,2021-06-05,True,1,1,8,10,0,0,0,0,7,3,1,11,0,5,0,5,1,0,0,1,0,1,0,1
142677.0,Bultor Daryl,MB,France,26.0,197.0,2021,France,Russia,2021-06-09,True,0,0,0,0,0,0,0,0,0,0,0,0,0,0,0,0,0,0,0,0,0,0,0,0
142677.0,Bultor Daryl,MB,France,26.0,197.0,2021,France,Slovenia,2021-06-10,False,2,3,10,15,0,0,0,0,5,3,8,16,0,8,5,13,0,0,1,1,2,1,0,3
142677.0,Bultor Daryl,MB,France,26.0,197.0,2021,Canada,France,2021-06-11,True,2,2,15,19,0,0,0,0,4,2,2,8,2,2,2,6,0,0,0,0,2,1,0,3
142677.0,Bultor Daryl,MB,France,26.0,197.0,2021,Netherlands,France,2021-06-15,False,0,0,0,0,0,0,0,0,0,0,0,0,0,0,0,0,0,0,0,0,0,0,0,0
142677.0,Bultor Daryl,MB,France,26.0,197.0,2021,USA,France,2021-06-16,True,0,0,0,0,0,0,0,0,0,0,0,0,0,0,0,0,0,0,0,0,0,0,0,0
142677.0,Bultor Daryl,MB,France,26.0,197.0,2021,France,Italy,2021-06-17,False,2,4,10,16,0,0,0,0,10,1,3,14,1,0,3,4,0,0,0,0,2,1,0,3
142677.0,Bultor Daryl,MB,France,26.0,197.0,2021,France,Iran,2021-06-21,True,0,0,0,0,0,0,0,0,0,0,0,0,0,0,0,0,0,0,0,0,0,0,0,0
142677.0,Bultor Daryl,MB,France,26.0,197.0,2021,France,Argentina,2021-06-22,True,0,4,4,8,0,0,0,0,6,0,2,8,2,1,2,5,0,0,1,1,2,0,0,2
142677.0,Bultor Daryl,MB,France,26.0,197.0,2021,France,Poland,2021-06-23,True,0,0,0,0,0,0,0,0,0,0,0,0,0,0,0,0,0,0,0,0,0,0,0,0
142677.0,Bultor Daryl,MB,France,26.0,197.0,2021,Brazil,France,2021-06-26,False,0,0,0,0,0,0,0,0,0,0,0,0,0,0,0,0,0,0,0,0,0,0,0,0
142677.0,Bultor Daryl,MB,France,26.0,197.0,2021,France,Slovenia,2021-06-27,True,0,0,0,0,0,0,0,0,0,0,0,0,0,0,0,0,0,0,0,0,0,0,0,0
132948.0,Clevenot Trevor,OH,France,27.0,199.0,2021,France,Bulgaria,2021-05-28,True,0,0,7,7,0,0,0,0,4,0,1,5,0,0,0,0,4,0,2,6,0,0,0,0
132948.0,Clevenot Trevor,OH,France,27.0,199.0,2021,Germany,France,2021-05-29,True,5,1,18,24,0,0,1,1,14,5,9,28,2,4,2,8,17,0,12,29,9,2,1,12
132948.0,Clevenot Trevor,OH,France,27.0,199.0,2021,Australia,France,2021-05-30,True,0,0,1,1,0,0,0,0,0,0,0,0,0,0,0,0,0,0,0,0,0,1,0,1
132948.0,Clevenot Trevor,OH,France,27.0,199.0,2021,Brazil,France,2021-06-03,True,0,0,3,3,0,0,0,0,3,0,2,5,0,0,1,1,4,0,3,7,0,1,1,2
132948.0,Clevenot Trevor,OH,France,27.0,199.0,2021,France,Japan,2021-06-05,True,0,2,11,13,0,0,0,0,12,2,3,17,1,2,0,3,8,0,10,18,4,1,0,5
132948.0,Clevenot Trevor,OH,France,27.0,199.0,2021,France,Russia,2021-06-09,True,0,3,13,16,0,0,2,2,13,2,9,24,1,2,2,5,5,2,14,21,5,3,2,10
132948.0,Clevenot Trevor,OH,France,27.0,199.0,2021,Canada,France,2021-06-11,True,1,0,8,9,0,0,3,3,7,3,4,14,4,1,1,6,3,0,7,10,4,2,0,6
132948.0,Clevenot Trevor,OH,France,27.0,199.0,2021,USA,France,2021-06-16,True,0,2,6,8,0,0,2,2,5,6,7,18,2,1,1,4,6,2,5,13,5,0,0,5
132948.0,Clevenot Trevor,OH,France,27.0,199.0,2021,France,Italy,2021-06-17,False,0,1,9,10,0,0,1,1,5,1,4,10,1,1,0,2,1,0,10,11,1,2,0,3
132948.0,Clevenot Trevor,OH,France,27.0,199.0,2021,France,Iran,2021-06-21,True,1,1,2,4,0,0,0,0,2,1,2,5,1,0,0,1,0,0,0,0,1,0,0,1
132948.0,Clevenot Trevor,OH,France,27.0,199.0,2021,France,Argentina,2021-06-22,True,0,3,8,11,0,0,1,1,8,4,7,19,1,3,4,8,4,0,16,20,3,2,1,6
132948.0,Clevenot Trevor,OH,France,27.0,199.0,2021,France,Poland,2021-06-23,True,0,1,6,7,0,0,1,1,10,2,6,18,0,2,1,3,5,0,4,9,2,0,0,2
132948.0,Clevenot Trevor,OH,France,27.0,199.0,2021,Brazil,France,2021-06-26,False,0,1,5,6,0,0,0,0,3,3,6,12,0,2,0,2,6,1,11,18,1,2,0,3
132948.0,Clevenot Trevor,OH,France,27.0,199.0,2021,France,Slovenia,2021-06-27,True,0,1,8,9,0,0,2,2,6,1,8,15,2,3,1,6,7,1,7,15,8,1,0,9
136867.0,Rossard Thibault,OH,France,28.0,194.0,2021,France,Bulgaria,2021-05-28,True,0,1,2,3,0,0,0,0,0,0,0,0,0,0,0,0,0,0,0,0,0,0,0,0
136867.0,Rossard Thibault,OH,France,28.0,194.0,2021,Germany,France,2021-05-29,True,0,3,11,14,0,0,0,0,9,1,11,21,0,1,0,1,7,2,10,19,2,2,1,5
136867.0,Rossard Thibault,OH,France,28.0,194.0,2021,Australia,France,2021-05-30,True,2,2,4,8,0,0,0,0,5,1,3,9,0,0,1,1,4,0,3,7,2,0,0,2
136867.0,Rossard Thibault,OH,France,28.0,194.0,2021,Brazil,France,2021-06-03,True,0,1,4,5,0,0,0,0,0,0,0,0,0,0,0,0,0,0,0,0,2,0,0,2
136867.0,Rossard Thibault,OH,France,28.0,194.0,2021,Serbia,France,2021-06-04,False,2,4,9,15,0,0,1,1,5,4,5,14,0,2,0,2,9,1,13,23,2,2,0,4
136867.0,Rossard Thibault,OH,France,28.0,194.0,2021,France,Russia,2021-06-09,True,0,2,1,3,0,0,0,0,0,0,0,0,0,0,0,0,0,0,0,0,0,0,0,0
136867.0,Rossard Thibault,OH,France,28.0,194.0,2021,France,Slovenia,2021-06-10,False,2,4,12,18,0,0,1,1,12,3,11,26,0,2,2,4,12,0,14,26,10,6,1,17
136867.0,Rossard Thibault,OH,France,28.0,194.0,2021,Netherlands,France,2021-06-15,False,2,3,6,11,0,0,3,3,8,2,2,12,0,1,0,1,6,1,7,14,3,2,1,6
136867.0,Rossard Thibault,OH,France,28.0,194.0,2021,USA,France,2021-06-16,True,0,0,2,2,0,0,1,1,0,0,0,0,0,0,0,0,0,0,0,0,0,0,0,0
136867.0,Rossard Thibault,OH,France,28.0,194.0,2021,France,Italy,2021-06-17,False,0,1,11,12,0,0,1,1,8,4,2,14,0,0,0,0,6,1,7,14,0,1,0,1
120735.0,Louati Yacine,OH,France,30.0,198.0,2021,France,Bulgaria,2021-05-28,True,1,4,4,9,0,1,0,1,8,0,6,14,1,1,1,3,7,2,4,13,0,0,1,1
120735.0,Louati Yacine,OH,France,30.0,198.0,2021,Germany,France,2021-05-29,True,0,1,3,4,0,0,0,0,1,2,4,7,0,1,0,1,7,0,2,9,2,0,0,2
120735.0,Louati Yacine,OH,France,30.0,198.0,2021,Serbia,France,2021-06-04,False,1,2,8,11,0,0,0,0,11,4,11,26,0,2,0,2,4,0,11,15,5,1,0,6
120735.0,Louati Yacine,OH,France,30.0,198.0,2021,France,Japan,2021-06-05,True,1,1,7,9,0,0,1,1,4,2,6,12,0,2,0,2,8,1,11,20,1,0,0,1
120735.0,Louati Yacine,OH,France,30.0,198.0,2021,Canada,France,2021-06-11,True,0,0,0,0,0,0,0,0,0,0,0,0,0,0,0,0,0,0,0,0,0,0,0,0
120735.0,Louati Yacine,OH,France,30.0,198.0,2021,Netherlands,France,2021-06-15,False,0,2,11,13,0,0,2,2,10,4,11,25,1,6,3,10,7,5,25,37,6,2,0,8
120735.0,Louati Yacine,OH,France,30.0,198.0,2021,USA,France,2021-06-16,True,0,0,0,0,0,0,0,0,0,0,0,0,0,0,0,0,0,0,0,0,0,0,0,0
120735.0,Louati Yacine,OH,France,30.0,198.0,2021,France,Italy,2021-06-17,False,0,3,3,6,0,0,0,0,4,2,10,16,0,2,0,2,4,2,24,30,5,6,0,11
120735.0,Louati Yacine,OH,France,30.0,198.0,2021,France,Iran,2021-06-21,True,0,0,0,0,0,0,0,0,0,0,0,0,0,0,0,0,0,0,0,0,0,0,0,0
120735.0,Louati Yacine,OH,France,30.0,198.0,2021,France,Argentina,2021-06-22,True,1,2,11,14,0,0,2,2,5,3,7,15,2,0,0,2,5,0,13,18,4,1,0,5
120735.0,Louati Yacine,OH,France,30.0,198.0,2021,France,Poland,2021-06-23,True,0,1,1,2,0,0,0,0,0,0,0,0,0,0,0,0,0,0,0,0,0,0,1,1
120735.0,Louati Yacine,OH,France,30.0,198.0,2021,Brazil,France,2021-06-26,False,0,1,1,2,0,0,0,0,0,0,0,0,0,0,0,0,0,0,0,0,0,0,0,0
120735.0,Louati Yacine,OH,France,30.0,198.0,2021,France,Slovenia,2021-06-27,True,0,0,1,1,0,0,0,0,0,0,0,0,0,0,0,0,0,0,0,0,0,1,0,1
152506.0,Diez Benjamin,L,France,23.0,183.0,2021,France,Bulgaria,2021-05-28,True,0,0,0,0,0,0,5,5,0,0,0,0,0,0,0,0,7,0,6,13,9,0,1,10
152506.0,Diez Benjamin,L,France,23.0,183.0,2021,Germany,France,2021-05-29,True,0,0,0,0,0,0,0,0,0,0,0,0,0,0,0,0,2,3,4,9,3,4,0,7
152506.0,Diez Benjamin,L,France,23.0,183.0,2021,Australia,France,2021-05-30,True,0,0,0,0,0,0,3,3,0,0,0,0,0,0,0,0,4,1,7,12,6,2,1,9
152506.0,Diez Benjamin,L,France,23.0,183.0,2021,Brazil,France,2021-06-03,True,0,0,0,0,0,0,0,0,0,0,0,0,0,0,0,0,0,0,0,0,0,0,0,0
152506.0,Diez Benjamin,L,France,23.0,183.0,2021,Serbia,France,2021-06-04,False,0,0,0,0,0,0,0,0,0,0,0,0,0,0,0,0,0,0,0,0,0,0,0,0
152506.0,Diez Benjamin,L,France,23.0,183.0,2021,France,Japan,2021-06-05,True,0,0,0,0,0,0,0,0,0,0,0,0,0,0,0,0,0,0,0,0,1,0,0,1
152506.0,Diez Benjamin,L,France,23.0,183.0,2021,France,Russia,2021-06-09,True,0,0,0,0,0,0,0,0,0,0,0,0,0,0,0,0,0,0,0,0,0,0,0,0
152506.0,Diez Benjamin,L,France,23.0,183.0,2021,France,Slovenia,2021-06-10,False,0,0,0,0,0,0,0,0,0,0,0,0,0,0,0,0,0,0,0,0,0,0,0,0
152506.0,Diez Benjamin,L,France,23.0,183.0,2021,Canada,France,2021-06-11,True,0,0,0,0,0,0,0,0,0,0,0,0,0,0,0,0,0,0,0,0,0,0,0,0
152506.0,Diez Benjamin,L,France,23.0,183.0,2021,Netherlands,France,2021-06-15,False,0,0,0,0,0,0,0,0,0,0,0,0,0,0,0,0,0,0,0,0,0,0,0,0
152506.0,Diez Benjamin,L,France,23.0,183.0,2021,USA,France,2021-06-16,True,0,0,0,0,0,0,0,0,0,0,0,0,0,0,0,0,0,0,0,0,0,0,0,0
152506.0,Diez Benjamin,L,France,23.0,183.0,2021,France,Italy,2021-06-17,False,0,0,0,0,0,0,4,4,0,0,0,0,0,0,0,0,10,1,8,19,6,6,0,12
152506.0,Diez Benjamin,L,France,23.0,183.0,2021,France,Iran,2021-06-21,True,0,0,0,0,0,0,0,0,0,0,0,0,0,0,0,0,0,0,0,0,0,0,0,0
152506.0,Diez Benjamin,L,France,23.0,183.0,2021,France,Argentina,2021-06-22,True,0,0,0,0,0,0,0,0,0,0,0,0,0,0,0,0,0,0,0,0,0,0,0,0
152506.0,Diez Benjamin,L,France,23.0,183.0,2021,France,Poland,2021-06-23,True,0,0,0,0,0,0,0,0,0,0,0,0,0,0,0,0,0,0,0,0,0,0,0,0
152506.0,Diez Benjamin,L,France,23.0,183.0,2021,Brazil,France,2021-06-26,False,0,0,0,0,0,0,0,0,0,0,0,0,0,0,0,0,0,0,0,0,0,0,0,0
152506.0,Diez Benjamin,L,France,23.0,183.0,2021,France,Slovenia,2021-06-27,True,0,0,0,0,0,0,0,0,0,0,0,0,0,0,0,0,0,0,0,0,0,0,0,0
163309.0,Faure Théo,O,France,22.0,202.0,2021,Serbia,France,2021-06-04,False,0,0,0,0,0,0,0,0,0,0,0,0,0,0,0,0,0,0,0,0,0,0,0,0
163309.0,Faure Théo,O,France,22.0,202.0,2021,France,Japan,2021-06-05,True,0,0,0,0,0,0,0,0,0,0,0,0,0,0,0,0,0,0,0,0,0,0,0,0
163309.0,Faure Théo,O,France,22.0,202.0,2021,France,Slovenia,2021-06-10,False,0,0,4,4,0,0,0,0,2,2,2,6,0,0,2,2,0,0,0,0,1,1,2,4
163309.0,Faure Théo,O,France,22.0,202.0,2021,Canada,France,2021-06-11,True,0,1,1,2,0,0,0,0,4,5,4,13,1,1,2,4,0,0,0,0,0,2,0,2
163309.0,Faure Théo,O,France,22.0,202.0,2021,Netherlands,France,2021-06-15,False,4,6,22,32,0,0,2,2,23,3,14,40,3,7,7,17,0,0,0,0,8,5,2,15
152514.0,Meyer Léo,S,France,25.0,194.0,2021,Australia,France,2021-05-30,True,0,1,4,5,11,0,16,27,1,0,0,1,1,1,1,3,0,0,0,0,0,1,0,1
152514.0,Meyer Léo,S,France,25.0,194.0,2021,Brazil,France,2021-06-03,True,0,0,0,0,0,0,0,0,0,0,0,0,0,0,0,0,0,0,0,0,0,0,0,0
152514.0,Meyer Léo,S,France,25.0,194.0,2021,France,Japan,2021-06-05,True,0,0,0,0,0,0,0,0,0,0,0,0,0,0,0,0,0,0,0,0,0,0,0,0
181197.0,Gueye Mousse,MB,France,25.0,198.0,2021,France,Bulgaria,2021-05-28,True,0,0,0,0,0,0,0,0,0,0,0,0,0,0,0,0,0,0,0,0,0,0,0,0
181197.0,Gueye Mousse,MB,France,25.0,198.0,2021,Germany,France,2021-05-29,True,0,0,0,0,0,0,0,0,0,0,0,0,0,0,0,0,0,0,0,0,0,0,0,0
181197.0,Gueye Mousse,MB,France,25.0,198.0,2021,Australia,France,2021-05-30,True,1,2,5,8,0,0,0,0,3,2,2,7,0,3,1,4,0,0,1,1,1,0,0,1
181197.0,Gueye Mousse,MB,France,25.0,198.0,2021,Brazil,France,2021-06-03,True,0,0,0,0,0,0,0,0,0,0,0,0,0,0,0,0,0,0,0,0,0,0,0,0
181197.0,Gueye Mousse,MB,France,25.0,198.0,2021,Serbia,France,2021-06-04,False,0,0,0,0,0,0,0,0,0,0,0,0,0,0,0,0,0,0,0,0,0,0,0,0
181197.0,Gueye Mousse,MB,France,25.0,198.0,2021,France,Japan,2021-06-05,True,0,0,0,0,0,0,0,0,0,0,0,0,0,0,0,0,0,0,0,0,0,0,0,0
181197.0,Gueye Mousse,MB,France,25.0,198.0,2021,France,Russia,2021-06-09,True,0,0,0,0,0,0,0,0,0,0,0,0,0,0,0,0,0,0,0,0,0,0,0,0
181197.0,Gueye Mousse,MB,France,25.0,198.0,2021,France,Slovenia,2021-06-10,False,0,0,0,0,0,0,0,0,0,0,0,0,0,0,0,0,0,0,0,0,0,0,0,0
181197.0,Gueye Mousse,MB,France,25.0,198.0,2021,Canada,France,2021-06-11,True,0,0,0,0,0,0,0,0,0,0,0,0,0,0,0,0,0,0,0,0,0,0,0,0
181197.0,Gueye Mousse,MB,France,25.0,198.0,2021,Netherlands,France,2021-06-15,False,0,0,0,0,0,0,0,0,0,0,0,0,0,0,0,0,0,0,0,0,0,0,0,0
181197.0,Gueye Mousse,MB,France,25.0,198.0,2021,France,Italy,2021-06-17,False,0,0,4,4,0,0,0,0,5,0,2,7,2,3,1,6,0,0,0,0,1,0,0,1
181197.0,Gueye Mousse,MB,France,25.0,198.0,2021,France,Iran,2021-06-21,True,0,0,0,0,0,0,0,0,0,0,0,0,0,0,0,0,0,0,0,0,0,0,0,0
181197.0,Gueye Mousse,MB,France,25.0,198.0,2021,France,Argentina,2021-06-22,True,0,0,0,0,0,0,0,0,0,0,0,0,0,0,0,0,0,0,0,0,0,0,0,0
181197.0,Gueye Mousse,MB,France,25.0,198.0,2021,France,Poland,2021-06-23,True,0,0,0,0,0,0,0,0,0,0,0,0,0,0,0,0,0,0,0,0,0,0,0,0
181197.0,Gueye Mousse,MB,France,25.0,198.0,2021,Brazil,France,2021-06-26,False,0,0,0,0,0,0,0,0,0,0,0,0,0,0,0,0,0,0,0,0,0,0,0,0
181197.0,Gueye Mousse,MB,France,25.0,198.0,2021,France,Slovenia,2021-06-27,True,0,0,0,0,0,0,0,0,0,0,0,0,0,0,0,0,0,0,0,0,0,0,0,0
119779.0,Fromm Christian,OH,Germany,31.0,204.0,2021,Germany,Australia,2021-05-28,True,0,4,9,13,0,0,1,1,14,1,5,20,1,4,1,6,2,0,4,6,2,0,0,2
119779.0,Fromm Christian,OH,Germany,31.0,204.0,2021,Germany,France,2021-05-29,False,0,0,0,0,0,0,0,0,0,0,0,0,0,0,0,0,0,0,0,0,0,0,0,0
119779.0,Fromm Christian,OH,Germany,31.0,204.0,2021,Germany,Bulgaria,2021-05-30,True,0,2,6,8,0,0,0,0,6,1,4,11,0,0,2,2,0,1,3,4,2,1,0,3
119779.0,Fromm Christian,OH,Germany,31.0,204.0,2021,Germany,Argentina,2021-06-03,False,0,0,0,0,0,0,0,0,0,0,0,0,0,0,0,0,0,0,0,0,0,0,0,0
119779.0,Fromm Christian,OH,Germany,31.0,204.0,2021,Netherlands,Germany,2021-06-04,False,2,2,1,5,0,0,2,2,2,0,1,3,0,1,0,1,2,1,5,8,0,0,0,0
119779.0,Fromm Christian,OH,Germany,31.0,204.0,2021,Slovenia,Germany,2021-06-05,True,1,4,5,10,0,0,1,1,18,2,16,36,1,0,2,3,7,2,8,17,7,0,0,7
119779.0,Fromm Christian,OH,Germany,31.0,204.0,2021,Serbia,Germany,2021-06-09,False,0,2,4,6,0,0,1,1,8,3,9,20,0,2,2,4,2,1,2,5,4,2,1,7
119779.0,Fromm Christian,OH,Germany,31.0,204.0,2021,Germany,USA,2021-06-10,False,0,1,3,4,0,1,2,3,3,3,6,12,0,0,0,0,1,0,12,13,2,0,0,2
119779.0,Fromm Christian,OH,Germany,31.0,204.0,2021,Iran,Germany,2021-06-11,True,0,0,0,0,0,0,0,0,0,0,0,0,0,0,0,0,0,0,0,0,0,0,0,0
119779.0,Fromm Christian,OH,Germany,31.0,204.0,2021,Japan,Germany,2021-06-15,False,0,0,0,0,0,0,0,0,0,0,0,0,0,0,0,0,0,0,0,0,0,0,0,0
119779.0,Fromm Christian,OH,Germany,31.0,204.0,2021,Canada,Germany,2021-06-16,False,0,0,0,0,0,0,0,0,1,0,0,1,0,1,0,1,0,0,0,0,0,0,0,0
119779.0,Fromm Christian,OH,Germany,31.0,204.0,2021,Germany,Poland,2021-06-17,False,0,3,7,10,0,0,3,3,11,5,11,27,0,3,1,4,4,0,12,16,4,1,0,5
119779.0,Fromm Christian,OH,Germany,31.0,204.0,2021,Germany,Russia,2021-06-21,False,0,0,0,0,0,0,1,1,0,0,1,1,0,0,0,0,0,0,0,0,0,0,0,0
119779.0,Fromm Christian,OH,Germany,31.0,204.0,2021,Brazil,Germany,2021-06-22,False,0,2,8,10,0,0,3,3,3,3,13,19,0,1,1,2,3,2,11,16,1,2,0,3
119779.0,Fromm Christian,OH,Germany,31.0,204.0,2021,Italy,Germany,2021-06-23,False,0,0,0,0,0,0,0,0,0,0,0,0,0,0,0,0,0,0,0,0,0,0,0,0
136441.0,Schott Ruben,OH,Germany,27.0,193.0,2021,Germany,Australia,2021-05-28,True,1,1,2,4,0,0,0,0,0,0,0,0,0,0,0,0,0,0,0,0,0,0,0,0
136441.0,Schott Ruben,OH,Germany,27.0,193.0,2021,Germany,France,2021-05-29,False,1,1,17,19,0,0,0,0,9,1,5,15,0,3,0,3,13,1,16,30,7,0,0,7
136441.0,Schott Ruben,OH,Germany,27.0,193.0,2021,Germany,Bulgaria,2021-05-30,True,3,2,10,15,0,0,0,0,5,4,8,17,0,2,2,4,4,2,13,19,8,0,0,8
136441.0,Schott Ruben,OH,Germany,27.0,193.0,2021,Germany,Argentina,2021-06-03,False,1,5,13,19,0,0,8,8,6,2,10,18,1,6,6,13,15,1,15,31,5,3,1,9
136441.0,Schott Ruben,OH,Germany,27.0,193.0,2021,Netherlands,Germany,2021-06-04,False,1,5,16,22,0,0,2,2,10,2,7,19,0,2,2,4,16,3,13,32,7,4,1,12
136441.0,Schott Ruben,OH,Germany,27.0,193.0,2021,Slovenia,Germany,2021-06-05,True,2,3,8,13,0,1,5,6,9,3,5,17,0,1,1,2,3,1,11,15,8,4,2,14
136441.0,Schott Ruben,OH,Germany,27.0,193.0,2021,Serbia,Germany,2021-06-09,False,4,3,10,17,0,1,7,8,9,5,7,21,0,0,2,2,10,3,23,36,8,3,3,14
136441.0,Schott Ruben,OH,Germany,27.0,193.0,2021,Germany,USA,2021-06-10,False,0,3,8,11,0,0,4,4,3,3,7,13,0,2,1,3,6,1,5,12,4,1,1,6
136441.0,Schott Ruben,OH,Germany,27.0,193.0,2021,Iran,Germany,2021-06-11,True,1,3,3,7,0,0,1,1,1,0,3,4,1,2,0,3,2,1,2,5,2,2,0,4
136441.0,Schott Ruben,OH,Germany,27.0,193.0,2021,Japan,Germany,2021-06-15,False,0,2,3,5,0,0,0,0,7,1,8,16,0,1,1,2,6,2,10,18,2,5,0,7
136441.0,Schott Ruben,OH,Germany,27.0,193.0,2021,Canada,Germany,2021-06-16,False,0,3,7,10,0,0,1,1,4,4,8,16,0,5,0,5,13,1,6,20,6,6,0,12
136441.0,Schott Ruben,OH,Germany,27.0,193.0,2021,Germany,Poland,2021-06-17,False,0,0,0,0,0,0,0,0,0,0,0,0,0,0,0,0,0,0,0,0,0,0,0,0
136441.0,Schott Ruben,OH,Germany,27.0,193.0,2021,Germany,Russia,2021-06-21,False,0,2,3,5,0,0,0,0,0,0,0,0,0,0,0,0,0,0,0,0,0,0,0,0
136441.0,Schott Ruben,OH,Germany,27.0,193.0,2021,Brazil,Germany,2021-06-22,False,1,4,5,10,0,0,5,5,12,0,10,22,0,4,1,5,10,1,10,21,1,5,0,6
136441.0,Schott Ruben,OH,Germany,27.0,193.0,2021,Italy,Germany,2021-06-23,False,3,3,15,21,0,1,8,9,10,5,16,31,1,5,0,6,15,2,26,43,10,1,1,12
139386.0,Reichert Moritz,OH,Germany,27.0,194.0,2021,Germany,Australia,2021-05-28,True,0,1,0,1,0,0,1,1,0,0,0,0,0,0,0,0,0,0,1,1,0,0,0,0
139386.0,Reichert Moritz,OH,Germany,27.0,194.0,2021,Germany,France,2021-05-29,False,0,6,8,14,0,0,0,0,15,7,23,45,4,1,1,6,12,0,16,28,7,3,1,11
139386.0,Reichert Moritz,OH,Germany,27.0,194.0,2021,Germany,Bulgaria,2021-05-30,True,0,3,5,8,0,0,0,0,6,3,7,16,1,1,0,2,4,0,14,18,3,0,0,3
139386.0,Reichert Moritz,OH,Germany,27.0,194.0,2021,Germany,Argentina,2021-06-03,False,0,2,17,19,0,1,3,4,9,3,8,20,0,2,0,2,11,1,15,27,3,1,1,5
139386.0,Reichert Moritz,OH,Germany,27.0,194.0,2021,Netherlands,Germany,2021-06-04,False,1,3,13,17,0,0,3,3,9,3,9,21,0,3,4,7,3,2,7,12,5,0,0,5
139386.0,Reichert Moritz,OH,Germany,27.0,194.0,2021,Slovenia,Germany,2021-06-05,True,0,0,2,2,1,0,0,1,0,0,0,0,0,0,0,0,0,0,2,2,1,0,0,1
139386.0,Reichert Moritz,OH,Germany,27.0,194.0,2021,Serbia,Germany,2021-06-09,False,0,2,6,8,0,0,0,0,4,1,5,10,0,1,0,1,0,1,2,3,4,1,1,6
139386.0,Reichert Moritz,OH,Germany,27.0,194.0,2021,Germany,USA,2021-06-10,False,0,1,0,1,0,0,0,0,0,0,0,0,0,0,0,0,0,1,0,1,1,0,0,1
139386.0,Reichert Moritz,OH,Germany,27.0,194.0,2021,Iran,Germany,2021-06-11,True,0,4,17,21,0,0,0,0,7,1,9,17,0,2,0,2,5,0,8,13,2,2,2,6
139386.0,Reichert Moritz,OH,Germany,27.0,194.0,2021,Japan,Germany,2021-06-15,False,2,2,8,12,0,0,1,1,8,1,8,17,0,1,1,2,3,0,7,10,2,0,0,2
139386.0,Reichert Moritz,OH,Germany,27.0,194.0,2021,Canada,Germany,2021-06-16,False,0,0,0,0,0,0,0,0,0,0,0,0,0,0,0,0,0,0,0,0,0,0,0,0
139386.0,Reichert Moritz,OH,Germany,27.0,194.0,2021,Germany,Poland,2021-06-17,False,0,0,0,0,0,0,0,0,2,0,0,2,0,0,0,0,0,0,1,1,0,1,0,1
139386.0,Reichert Moritz,OH,Germany,27.0,194.0,2021,Germany,Russia,2021-06-21,False,0,3,11,14,0,0,5,5,12,4,13,29,0,4,2,6,8,3,13,24,3,1,1,5
139386.0,Reichert Moritz,OH,Germany,27.0,194.0,2021,Brazil,Germany,2021-06-22,False,0,0,1,1,0,0,1,1,0,0,0,0,0,0,0,0,1,0,1,2,0,0,0,0
139386.0,Reichert Moritz,OH,Germany,27.0,194.0,2021,Italy,Germany,2021-06-23,False,1,3,9,13,0,0,2,2,6,6,9,21,2,0,2,4,4,1,6,11,6,3,0,9
119775.0,Kaliberda Denys,OH,Germany,31.0,193.0,2021,Germany,Australia,2021-05-28,True,1,3,7,11,0,0,0,0,7,1,7,15,1,1,0,2,4,0,10,14,7,0,0,7
119775.0,Kaliberda Denys,OH,Germany,31.0,193.0,2021,Germany,France,2021-05-29,False,0,0,0,0,0,0,0,0,0,0,0,0,0,0,0,0,0,0,0,0,0,0,0,0
119775.0,Kaliberda Denys,OH,Germany,31.0,193.0,2021,Germany,Bulgaria,2021-05-30,True,1,4,14,19,0,0,0,0,10,6,10,26,1,0,2,3,2,4,4,10,7,1,1,9
119775.0,Kaliberda Denys,OH,Germany,31.0,193.0,2021,Germany,Argentina,2021-06-03,False,0,0,0,0,0,0,0,0,0,0,0,0,0,0,0,0,0,0,0,0,0,0,0,0
119775.0,Kaliberda Denys,OH,Germany,31.0,193.0,2021,Netherlands,Germany,2021-06-04,False,0,0,0,0,0,0,0,0,0,0,0,0,0,0,0,0,0,0,0,0,0,0,0,0
119775.0,Kaliberda Denys,OH,Germany,31.0,193.0,2021,Germany,USA,2021-06-10,False,0,0,0,0,0,0,0,0,0,0,0,0,0,0,0,0,0,0,0,0,0,0,0,0
119775.0,Kaliberda Denys,OH,Germany,31.0,193.0,2021,Iran,Germany,2021-06-11,True,0,3,13,16,0,0,3,3,12,1,10,23,1,0,4,5,3,0,17,20,6,3,0,9
119775.0,Kaliberda Denys,OH,Germany,31.0,193.0,2021,Japan,Germany,2021-06-15,False,0,1,5,6,0,0,3,3,3,3,3,9,0,1,0,1,6,0,10,16,1,1,0,2
119775.0,Kaliberda Denys,OH,Germany,31.0,193.0,2021,Canada,Germany,2021-06-16,False,0,2,10,12,0,0,3,3,6,0,7,13,1,2,0,3,6,0,15,21,7,2,0,9
119775.0,Kaliberda Denys,OH,Germany,31.0,193.0,2021,Germany,Poland,2021-06-17,False,0,0,0,0,0,0,0,0,0,0,0,0,0,0,0,0,0,0,0,0,0,0,0,0
119775.0,Kaliberda Denys,OH,Germany,31.0,193.0,2021,Germany,Russia,2021-06-21,False,0,4,12,16,0,0,5,5,9,1,7,17,1,3,1,5,8,2,19,29,6,1,3,10
119775.0,Kaliberda Denys,OH,Germany,31.0,193.0,2021,Brazil,Germany,2021-06-22,False,0,0,0,0,0,0,0,0,0,0,0,0,0,0,0,0,0,0,0,0,0,0,0,0
119775.0,Kaliberda Denys,OH,Germany,31.0,193.0,2021,Italy,Germany,2021-06-23,False,0,0,0,0,0,0,0,0,0,0,0,0,0,0,0,0,0,0,0,0,0,0,0,0
156599.0,Sossenheimer David,L,Germany,25.0,193.0,2021,Germany,Australia,2021-05-28,True,0,0,0,0,0,0,0,0,0,0,0,0,0,0,0,0,0,0,0,0,0,0,0,0
156599.0,Sossenheimer David,L,Germany,25.0,193.0,2021,Germany,France,2021-05-29,False,2,2,6,10,0,0,0,0,0,0,0,0,0,0,0,0,0,0,0,0,0,0,0,0
156599.0,Sossenheimer David,L,Germany,25.0,193.0,2021,Germany,Bulgaria,2021-05-30,True,2,1,5,8,1,0,0,1,0,0,0,0,0,0,0,0,0,0,0,0,0,0,0,0
156599.0,Sossenheimer David,L,Germany,25.0,193.0,2021,Germany,Argentina,2021-06-03,False,0,1,4,5,0,0,0,0,3,1,1,5,1,1,0,2,0,0,2,2,0,0,1,1
156599.0,Sossenheimer David,L,Germany,25.0,193.0,2021,Netherlands,Germany,2021-06-04,False,0,2,3,5,0,0,0,0,0,0,0,0,0,0,0,0,0,0,0,0,1,0,0,1
156599.0,Sossenheimer David,L,Germany,25.0,193.0,2021,Slovenia,Germany,2021-06-05,True,0,3,5,8,0,0,6,6,5,2,6,13,0,3,1,4,1,2,6,9,4,2,0,6
156599.0,Sossenheimer David,L,Germany,25.0,193.0,2021,Japan,Germany,2021-06-15,False,0,1,1,2,0,0,0,0,0,0,0,0,0,0,0,0,0,0,0,0,0,0,0,0
156599.0,Sossenheimer David,L,Germany,25.0,193.0,2021,Canada,Germany,2021-06-16,False,0,2,0,2,0,0,0,0,0,0,0,0,0,0,0,0,0,0,0,0,0,0,0,0
156599.0,Sossenheimer David,L,Germany,25.0,193.0,2021,Germany,Poland,2021-06-17,False,1,3,5,9,0,0,3,3,8,2,5,15,0,0,3,3,4,0,19,23,6,3,0,9
156599.0,Sossenheimer David,L,Germany,25.0,193.0,2021,Germany,Russia,2021-06-21,False,0,1,1,2,0,0,0,0,0,0,0,0,0,0,0,0,0,0,0,0,0,0,0,0
156599.0,Sossenheimer David,L,Germany,25.0,193.0,2021,Brazil,Germany,2021-06-22,False,0,0,1,1,0,0,0,0,0,0,0,0,0,0,0,0,0,0,0,0,0,0,0,0
156599.0,Sossenheimer David,L,Germany,25.0,193.0,2021,Italy,Germany,2021-06-23,False,0,4,5,9,0,0,2,2,1,2,5,8,0,1,2,3,0,1,8,9,2,0,1,3
116015.0,Böhme Marcus,MB,Germany,36.0,212.0,2021,Germany,Australia,2021-05-28,True,0,0,0,0,0,0,0,0,0,0,0,0,0,0,0,0,0,0,0,0,0,0,0,0
116015.0,Böhme Marcus,MB,Germany,36.0,212.0,2021,Germany,France,2021-05-29,False,0,0,6,6,0,0,0,0,8,0,4,12,1,5,0,6,0,0,1,1,0,1,0,1
116015.0,Böhme Marcus,MB,Germany,36.0,212.0,2021,Germany,Bulgaria,2021-05-30,True,0,0,6,6,0,0,0,0,5,1,2,8,1,3,3,7,0,0,0,0,1,0,1,2
116015.0,Böhme Marcus,MB,Germany,36.0,212.0,2021,Germany,Argentina,2021-06-03,False,0,0,8,8,0,0,0,0,4,0,2,6,1,7,4,12,0,0,0,0,0,0,1,1
116015.0,Böhme Marcus,MB,Germany,36.0,212.0,2021,Netherlands,Germany,2021-06-04,False,0,0,2,2,0,0,0,0,1,0,2,3,0,1,0,1,0,0,0,0,1,1,0,2
116015.0,Böhme Marcus,MB,Germany,36.0,212.0,2021,Slovenia,Germany,2021-06-05,True,0,0,0,0,0,0,0,0,0,0,0,0,0,0,0,0,0,0,0,0,0,0,0,0
116015.0,Böhme Marcus,MB,Germany,36.0,212.0,2021,Serbia,Germany,2021-06-09,False,0,0,0,0,0,0,0,0,0,0,0,0,0,0,0,0,0,0,0,0,0,0,0,0
116015.0,Böhme Marcus,MB,Germany,36.0,212.0,2021,Japan,Germany,2021-06-15,False,0,0,0,0,0,0,0,0,0,0,0,0,0,0,0,0,0,0,0,0,0,0,0,0
116015.0,Böhme Marcus,MB,Germany,36.0,212.0,2021,Canada,Germany,2021-06-16,False,0,0,0,0,0,0,0,0,0,0,0,0,0,0,0,0,0,0,0,0,0,0,0,0
116015.0,Böhme Marcus,MB,Germany,36.0,212.0,2021,Germany,Poland,2021-06-17,False,0,1,10,11,0,0,0,0,3,2,1,6,1,6,2,9,0,0,1,1,1,1,0,2
116015.0,Böhme Marcus,MB,Germany,36.0,212.0,2021,Germany,Russia,2021-06-21,False,0,0,0,0,0,0,0,0,0,0,0,0,0,0,0,0,0,0,0,0,0,0,0,0
116015.0,Böhme Marcus,MB,Germany,36.0,212.0,2021,Brazil,Germany,2021-06-22,False,0,0,0,0,0,0,0,0,0,0,0,0,0,0,0,0,0,0,0,0,0,0,0,0
116015.0,Böhme Marcus,MB,Germany,36.0,212.0,2021,Italy,Germany,2021-06-23,False,0,1,6,7,0,0,0,0,4,1,2,7,0,5,0,5,0,0,1,1,1,0,1,2
152470.0,Zenger Julian,L,Germany,24.0,190.0,2021,Germany,Australia,2021-05-28,True,0,0,0,0,1,0,2,3,0,0,0,0,0,0,0,0,8,0,10,18,9,0,1,10
152470.0,Zenger Julian,L,Germany,24.0,190.0,2021,Germany,France,2021-05-29,False,0,0,0,0,0,0,0,0,0,0,0,0,0,0,0,0,10,3,14,27,7,1,1,9
152470.0,Zenger Julian,L,Germany,24.0,190.0,2021,Germany,Bulgaria,2021-05-30,True,0,0,0,0,0,0,7,7,0,0,0,0,0,0,0,0,15,2,16,33,14,6,2,22
152470.0,Zenger Julian,L,Germany,24.0,190.0,2021,Germany,Argentina,2021-06-03,False,0,0,0,0,0,0,5,5,0,0,0,0,0,0,0,0,6,0,13,19,8,5,2,15
152470.0,Zenger Julian,L,Germany,24.0,190.0,2021,Netherlands,Germany,2021-06-04,False,0,0,0,0,0,0,2,2,0,0,0,0,0,0,0,0,17,3,16,36,12,6,4,22
152470.0,Zenger Julian,L,Germany,24.0,190.0,2021,Slovenia,Germany,2021-06-05,True,0,0,0,0,0,0,5,5,0,0,0,0,0,0,0,0,7,0,13,20,15,6,0,21
152470.0,Zenger Julian,L,Germany,24.0,190.0,2021,Serbia,Germany,2021-06-09,False,0,0,0,0,0,1,5,6,0,0,0,0,0,0,0,0,4,2,17,23,14,2,2,18
152470.0,Zenger Julian,L,Germany,24.0,190.0,2021,Germany,USA,2021-06-10,False,0,0,0,0,0,0,1,1,0,0,0,0,0,0,0,0,4,2,11,17,7,2,0,9
152470.0,Zenger Julian,L,Germany,24.0,190.0,2021,Iran,Germany,2021-06-11,True,0,0,0,0,0,0,3,3,0,0,0,0,0,0,0,0,12,2,17,31,13,8,1,22
152470.0,Zenger Julian,L,Germany,24.0,190.0,2021,Japan,Germany,2021-06-15,False,0,0,0,0,0,0,4,4,0,0,0,0,0,0,0,0,4,2,11,17,2,6,1,9
152470.0,Zenger Julian,L,Germany,24.0,190.0,2021,Canada,Germany,2021-06-16,False,0,0,0,0,0,0,5,5,0,0,0,0,0,0,0,0,9,0,11,20,7,3,2,12
152470.0,Zenger Julian,L,Germany,24.0,190.0,2021,Germany,Poland,2021-06-17,False,0,0,0,0,0,0,7,7,0,0,0,0,0,0,0,0,5,1,7,13,6,3,2,11
152470.0,Zenger Julian,L,Germany,24.0,190.0,2021,Germany,Russia,2021-06-21,False,0,0,0,0,0,0,4,4,0,0,0,0,0,0,0,0,7,2,11,20,8,2,1,11
152470.0,Zenger Julian,L,Germany,24.0,190.0,2021,Brazil,Germany,2021-06-22,False,0,0,0,0,0,0,4,4,0,0,0,0,0,0,0,0,5,0,10,15,8,2,1,11
152470.0,Zenger Julian,L,Germany,24.0,190.0,2021,Italy,Germany,2021-06-23,False,0,0,0,0,0,0,7,7,0,0,0,0,0,0,0,0,8,1,13,22,11,6,3,20
136253.0,Hirsch Simon,O,Germany,29.0,205.0,2021,Germany,Australia,2021-05-28,True,0,0,0,0,0,0,0,0,0,0,0,0,1,0,0,1,0,0,0,0,0,0,0,0
136253.0,Hirsch Simon,O,Germany,29.0,205.0,2021,Germany,France,2021-05-29,False,0,4,9,13,0,0,0,0,14,4,8,26,1,5,2,8,0,0,0,0,6,1,0,7
136253.0,Hirsch Simon,O,Germany,29.0,205.0,2021,Germany,Bulgaria,2021-05-30,True,1,3,9,13,0,0,0,0,10,4,9,23,1,4,1,6,0,0,0,0,4,1,1,6
136253.0,Hirsch Simon,O,Germany,29.0,205.0,2021,Germany,Argentina,2021-06-03,False,0,2,4,6,0,0,0,0,6,1,5,12,2,1,1,4,0,0,0,0,0,0,0,0
136253.0,Hirsch Simon,O,Germany,29.0,205.0,2021,Netherlands,Germany,2021-06-04,False,0,0,4,4,0,0,1,1,2,1,2,5,0,0,0,0,0,0,0,0,0,1,1,2
136253.0,Hirsch Simon,O,Germany,29.0,205.0,2021,Serbia,Germany,2021-06-09,False,0,0,0,0,0,0,0,0,0,0,0,0,0,0,0,0,0,0,0,0,0,0,0,0
136253.0,Hirsch Simon,O,Germany,29.0,205.0,2021,Germany,USA,2021-06-10,False,0,0,0,0,0,0,0,0,0,0,0,0,0,0,0,0,0,0,0,0,0,0,0,0
136253.0,Hirsch Simon,O,Germany,29.0,205.0,2021,Iran,Germany,2021-06-11,True,0,0,0,0,0,0,0,0,0,0,0,0,0,0,0,0,0,0,0,0,0,0,0,0
136253.0,Hirsch Simon,O,Germany,29.0,205.0,2021,Japan,Germany,2021-06-15,False,0,0,0,0,0,0,1,1,0,0,0,0,0,0,0,0,0,0,0,0,0,0,0,0
136253.0,Hirsch Simon,O,Germany,29.0,205.0,2021,Canada,Germany,2021-06-16,False,0,0,0,0,0,0,0,0,2,0,3,5,0,0,1,1,0,0,0,0,0,0,0,0
136253.0,Hirsch Simon,O,Germany,29.0,205.0,2021,Germany,Poland,2021-06-17,False,1,2,10,13,0,0,3,3,7,4,12,23,0,3,3,6,0,1,0,1,3,1,0,4
136253.0,Hirsch Simon,O,Germany,29.0,205.0,2021,Germany,Russia,2021-06-21,False,0,1,11,12,0,0,2,2,9,5,13,27,1,3,2,6,1,0,0,1,7,2,0,9
136253.0,Hirsch Simon,O,Germany,29.0,205.0,2021,Brazil,Germany,2021-06-22,False,0,0,0,0,0,0,0,0,1,0,1,2,0,0,0,0,0,0,0,0,0,0,0,0
136253.0,Hirsch Simon,O,Germany,29.0,205.0,2021,Italy,Germany,2021-06-23,False,1,1,17,19,0,0,4,4,12,6,15,33,2,1,2,5,0,0,1,1,8,2,0,10
156596.0,Baxpöhler Noah,MB,Germany,28.0,210.0,2021,Germany,Australia,2021-05-28,True,0,0,0,0,0,0,0,0,0,0,0,0,0,0,0,0,0,0,0,0,0,0,0,0
156596.0,Baxpöhler Noah,MB,Germany,28.0,210.0,2021,Germany,France,2021-05-29,False,0,0,0,0,0,0,0,0,0,0,0,0,0,0,0,0,0,0,0,0,0,0,0,0
156596.0,Baxpöhler Noah,MB,Germany,28.0,210.0,2021,Germany,Bulgaria,2021-05-30,True,0,1,0,1,0,0,0,0,0,0,0,0,0,0,0,0,0,0,0,0,0,0,0,0
156596.0,Baxpöhler Noah,MB,Germany,28.0,210.0,2021,Netherlands,Germany,2021-06-04,False,0,1,9,10,0,0,0,0,5,1,0,6,3,5,3,11,0,0,0,0,0,1,0,1
156596.0,Baxpöhler Noah,MB,Germany,28.0,210.0,2021,Slovenia,Germany,2021-06-05,True,0,0,0,0,0,0,0,0,0,0,0,0,0,0,0,0,0,0,0,0,0,0,0,0
156596.0,Baxpöhler Noah,MB,Germany,28.0,210.0,2021,Serbia,Germany,2021-06-09,False,0,0,3,3,0,0,0,0,0,0,0,0,0,3,0,3,0,0,0,0,0,0,0,0
156596.0,Baxpöhler Noah,MB,Germany,28.0,210.0,2021,Germany,USA,2021-06-10,False,0,0,0,0,0,0,0,0,0,0,0,0,0,0,0,0,0,0,0,0,0,0,0,0
156596.0,Baxpöhler Noah,MB,Germany,28.0,210.0,2021,Iran,Germany,2021-06-11,True,0,0,2,2,0,0,0,0,1,0,2,3,0,0,1,1,0,0,0,0,0,0,0,0
156596.0,Baxpöhler Noah,MB,Germany,28.0,210.0,2021,Germany,Poland,2021-06-17,False,0,1,11,12,0,1,0,1,3,0,0,3,0,2,1,3,0,0,1,1,1,1,0,2
156596.0,Baxpöhler Noah,MB,Germany,28.0,210.0,2021,Italy,Germany,2021-06-23,False,0,1,4,5,0,0,0,0,2,0,2,4,1,1,3,5,0,0,0,0,2,0,0,2
162788.0,Burggräf Eric,S,Germany,23.0,184.0,2021,Germany,Australia,2021-05-28,True,0,0,0,0,0,0,0,0,0,0,0,0,0,0,0,0,0,0,0,0,0,0,0,0
162788.0,Burggräf Eric,S,Germany,23.0,184.0,2021,Germany,France,2021-05-29,False,0,1,1,2,0,0,0,0,0,0,0,0,0,0,0,0,0,0,0,0,0,0,0,0
162788.0,Burggräf Eric,S,Germany,23.0,184.0,2021,Germany,Bulgaria,2021-05-30,True,0,1,0,1,0,0,0,0,0,0,0,0,0,0,0,0,0,0,0,0,0,0,0,0
162788.0,Burggräf Eric,S,Germany,23.0,184.0,2021,Germany,Argentina,2021-06-03,False,0,0,3,3,0,0,0,0,0,0,0,0,0,0,0,0,0,0,0,0,1,0,0,1
162788.0,Burggräf Eric,S,Germany,23.0,184.0,2021,Netherlands,Germany,2021-06-04,False,0,0,0,0,0,0,1,1,0,0,0,0,0,0,0,0,0,0,0,0,0,0,0,0
162788.0,Burggräf Eric,S,Germany,23.0,184.0,2021,Slovenia,Germany,2021-06-05,True,0,0,0,0,0,0,0,0,0,0,0,0,0,0,0,0,0,0,0,0,0,0,0,0
162788.0,Burggräf Eric,S,Germany,23.0,184.0,2021,Serbia,Germany,2021-06-09,False,0,0,1,1,0,0,0,0,0,0,0,0,0,0,0,0,0,0,0,0,0,0,0,0
162788.0,Burggräf Eric,S,Germany,23.0,184.0,2021,Germany,USA,2021-06-10,False,0,1,0,1,1,0,4,5,0,0,0,0,0,0,0,0,0,0,0,0,0,1,0,1
162788.0,Burggräf Eric,S,Germany,23.0,184.0,2021,Iran,Germany,2021-06-11,True,1,1,1,3,0,0,0,0,0,0,0,0,0,0,0,0,0,0,0,0,0,0,0,0
162788.0,Burggräf Eric,S,Germany,23.0,184.0,2021,Japan,Germany,2021-06-15,False,0,0,0,0,0,0,1,1,0,0,0,0,0,0,0,0,0,0,0,0,0,0,0,0
162788.0,Burggräf Eric,S,Germany,23.0,184.0,2021,Canada,Germany,2021-06-16,False,0,0,0,0,3,1,5,9,0,0,0,0,0,0,0,0,0,0,1,1,0,0,0,0
162788.0,Burggräf Eric,S,Germany,23.0,184.0,2021,Germany,Poland,2021-06-17,False,0,0,0,0,1,0,4,5,0,0,0,0,0,0,0,0,0,0,0,0,0,1,1,2
162788.0,Burggräf Eric,S,Germany,23.0,184.0,2021,Germany,Russia,2021-06-21,False,0,0,1,1,0,0,7,7,0,0,0,0,0,0,0,0,0,0,0,0,1,0,0,1
162788.0,Burggräf Eric,S,Germany,23.0,184.0,2021,Brazil,Germany,2021-06-22,False,1,2,2,5,1,0,5,6,0,0,0,0,0,0,0,0,0,0,0,0,0,0,0,0
162788.0,Burggräf Eric,S,Germany,23.0,184.0,2021,Italy,Germany,2021-06-23,False,0,0,0,0,0,0,0,0,0,0,0,0,0,0,0,0,0,0,0,0,0,0,0,0
136442.0,Zimmermann Jan,S,Germany,29.0,190.0,2021,Germany,Australia,2021-05-28,True,1,1,10,12,20,0,46,66,0,0,0,0,0,2,1,3,0,0,1,1,4,0,0,4
136442.0,Zimmermann Jan,S,Germany,29.0,190.0,2021,Germany,France,2021-05-29,False,1,2,9,12,45,2,0,47,1,0,0,1,2,1,3,6,0,0,1,1,3,3,2,8
136442.0,Zimmermann Jan,S,Germany,29.0,190.0,2021,Germany,Bulgaria,2021-05-30,True,2,0,14,16,21,0,90,111,0,0,0,0,0,0,5,5,0,0,0,0,7,5,1,13
136442.0,Zimmermann Jan,S,Germany,29.0,190.0,2021,Germany,Argentina,2021-06-03,False,1,2,13,16,19,1,75,95,0,0,1,1,2,2,2,6,0,0,0,0,9,5,1,15
136442.0,Zimmermann Jan,S,Germany,29.0,190.0,2021,Netherlands,Germany,2021-06-04,False,0,2,13,15,11,2,85,98,1,0,1,2,0,2,2,4,0,0,0,0,6,3,0,9
136442.0,Zimmermann Jan,S,Germany,29.0,190.0,2021,Slovenia,Germany,2021-06-05,True,0,3,10,13,24,1,70,95,1,0,2,3,1,4,2,7,0,0,0,0,12,2,1,15
136442.0,Zimmermann Jan,S,Germany,29.0,190.0,2021,Serbia,Germany,2021-06-09,False,1,2,8,11,33,0,49,82,0,1,1,2,0,1,1,2,0,0,0,0,1,2,2,5
136442.0,Zimmermann Jan,S,Germany,29.0,190.0,2021,Germany,USA,2021-06-10,False,0,1,7,8,21,0,39,60,0,0,1,1,0,1,4,5,0,0,0,0,4,1,0,5
136442.0,Zimmermann Jan,S,Germany,29.0,190.0,2021,Iran,Germany,2021-06-11,True,1,2,14,17,20,0,58,78,1,1,0,2,2,4,0,6,0,1,1,2,1,3,0,4
136442.0,Zimmermann Jan,S,Germany,29.0,190.0,2021,Japan,Germany,2021-06-15,False,0,1,8,9,5,0,65,70,1,0,0,1,0,1,0,1,0,0,1,1,3,2,0,5
136442.0,Zimmermann Jan,S,Germany,29.0,190.0,2021,Canada,Germany,2021-06-16,False,0,1,9,10,15,2,49,66,1,0,1,2,0,0,0,0,0,0,0,0,0,3,0,3
136442.0,Zimmermann Jan,S,Germany,29.0,190.0,2021,Germany,Poland,2021-06-17,False,0,2,6,8,14,1,41,56,0,0,0,0,1,0,2,3,0,0,1,1,5,2,1,8
136442.0,Zimmermann Jan,S,Germany,29.0,190.0,2021,Germany,Russia,2021-06-21,False,0,3,8,11,20,1,51,72,0,0,2,2,0,4,2,6,0,0,0,0,5,5,1,11
136442.0,Zimmermann Jan,S,Germany,29.0,190.0,2021,Brazil,Germany,2021-06-22,False,0,2,7,9,10,0,50,60,0,0,0,0,0,0,1,1,0,0,2,2,4,1,0,5
136442.0,Zimmermann Jan,S,Germany,29.0,190.0,2021,Italy,Germany,2021-06-23,False,0,4,10,14,33,0,74,107,2,0,0,2,0,5,3,8,0,0,0,0,9,2,1,12
162790.0,Krage Florian,MB,Germany,25.0,203.0,2021,Germany,Australia,2021-05-28,True,0,1,9,10,0,0,0,0,4,1,4,9,1,4,0,5,0,0,0,0,0,0,1,1
162790.0,Krage Florian,MB,Germany,25.0,203.0,2021,Germany,France,2021-05-29,False,0,0,6,6,0,0,0,0,1,1,0,2,1,4,1,6,1,1,1,3,1,1,0,2
162790.0,Krage Florian,MB,Germany,25.0,203.0,2021,Germany,Bulgaria,2021-05-30,True,0,3,8,11,0,0,0,0,6,1,2,9,2,7,2,11,0,1,0,1,1,0,0,1
162790.0,Krage Florian,MB,Germany,25.0,203.0,2021,Germany,Argentina,2021-06-03,False,1,0,5,6,0,0,0,0,2,0,1,3,0,1,0,1,0,0,0,0,0,0,1,1
162790.0,Krage Florian,MB,Germany,25.0,203.0,2021,Netherlands,Germany,2021-06-04,False,0,2,8,10,0,0,1,1,8,3,2,13,1,7,2,10,0,0,0,0,1,0,0,1
162790.0,Krage Florian,MB,Germany,25.0,203.0,2021,Slovenia,Germany,2021-06-05,True,1,1,16,18,0,0,1,1,1,0,4,5,1,4,2,7,0,0,2,2,3,2,0,5
162790.0,Krage Florian,MB,Germany,25.0,203.0,2021,Serbia,Germany,2021-06-09,False,0,2,11,13,0,0,0,0,2,2,1,5,1,2,3,6,0,0,0,0,0,0,0,0
162790.0,Krage Florian,MB,Germany,25.0,203.0,2021,Germany,USA,2021-06-10,False,0,0,7,7,0,0,0,0,5,1,1,7,1,5,3,9,0,0,1,1,1,1,0,2
162790.0,Krage Florian,MB,Germany,25.0,203.0,2021,Iran,Germany,2021-06-11,True,1,1,12,14,0,0,0,0,9,0,1,10,3,6,0,9,0,0,0,0,0,0,0,0
162790.0,Krage Florian,MB,Germany,25.0,203.0,2021,Japan,Germany,2021-06-15,False,0,0,8,8,0,0,0,0,3,1,3,7,1,1,0,2,0,0,0,0,2,2,0,4
162790.0,Krage Florian,MB,Germany,25.0,203.0,2021,Canada,Germany,2021-06-16,False,0,1,5,6,0,0,0,0,5,1,4,10,1,3,1,5,0,0,0,0,0,1,0,1
162790.0,Krage Florian,MB,Germany,25.0,203.0,2021,Germany,Russia,2021-06-21,False,0,0,8,8,0,0,0,0,2,3,2,7,4,2,0,6,0,1,0,1,1,0,0,1
162790.0,Krage Florian,MB,Germany,25.0,203.0,2021,Brazil,Germany,2021-06-22,False,1,1,9,11,0,0,0,0,2,0,1,3,3,7,0,10,1,0,0,1,1,1,0,2
174660.0,Röhrs Erik,OH,Germany,20.0,194.0,2021,Germany,Bulgaria,2021-05-30,True,0,0,0,0,0,0,0,0,0,0,0,0,0,0,0,0,0,0,0,0,0,0,0,0
174660.0,Röhrs Erik,OH,Germany,20.0,194.0,2021,Germany,Argentina,2021-06-03,False,0,0,0,0,0,0,0,0,0,0,0,0,0,0,0,0,0,0,0,0,0,0,0,0
174660.0,Röhrs Erik,OH,Germany,20.0,194.0,2021,Netherlands,Germany,2021-06-04,False,0,0,0,0,0,0,0,0,0,0,0,0,0,0,0,0,0,0,0,0,0,0,0,0
174660.0,Röhrs Erik,OH,Germany,20.0,194.0,2021,Slovenia,Germany,2021-06-05,True,0,0,0,0,0,0,0,0,0,0,0,0,0,0,0,0,0,0,0,0,0,0,0,0
174660.0,Röhrs Erik,OH,Germany,20.0,194.0,2021,Serbia,Germany,2021-06-09,False,0,1,0,1,0,0,0,0,1,0,1,2,0,0,0,0,0,0,1,1,0,0,0,0
174660.0,Röhrs Erik,OH,Germany,20.0,194.0,2021,Germany,USA,2021-06-10,False,2,2,3,7,0,0,0,0,4,3,3,10,0,2,1,3,0,2,10,12,2,0,0,2
174660.0,Röhrs Erik,OH,Germany,20.0,194.0,2021,Iran,Germany,2021-06-11,True,0,0,0,0,0,0,0,0,0,0,0,0,0,0,0,0,0,0,0,0,0,0,0,0
174660.0,Röhrs Erik,OH,Germany,20.0,194.0,2021,Japan,Germany,2021-06-15,False,0,0,0,0,0,0,0,0,0,0,0,0,0,0,0,0,0,0,0,0,0,0,0,0
174660.0,Röhrs Erik,OH,Germany,20.0,194.0,2021,Canada,Germany,2021-06-16,False,0,0,0,0,0,0,0,0,0,0,0,0,0,0,0,0,0,0,0,0,0,0,0,0
174660.0,Röhrs Erik,OH,Germany,20.0,194.0,2021,Germany,Poland,2021-06-17,False,0,0,0,0,0,0,0,0,0,0,0,0,0,0,0,0,0,0,0,0,0,0,0,0
174660.0,Röhrs Erik,OH,Germany,20.0,194.0,2021,Germany,Russia,2021-06-21,False,0,0,0,0,0,0,0,0,0,0,0,0,0,0,0,0,0,0,0,0,0,0,0,0
174660.0,Röhrs Erik,OH,Germany,20.0,194.0,2021,Brazil,Germany,2021-06-22,False,0,0,0,0,0,0,0,0,0,0,0,0,0,0,0,0,0,0,0,0,0,0,0,0
174660.0,Röhrs Erik,OH,Germany,20.0,194.0,2021,Italy,Germany,2021-06-23,False,0,0,0,0,0,0,0,0,0,0,0,0,0,0,0,0,0,0,0,0,0,0,0,0
162082.0,Weber Linus,O,Germany,22.0,203.0,2021,Germany,Australia,2021-05-28,True,1,5,8,14,0,0,0,0,12,3,4,19,1,2,0,3,0,0,0,0,5,2,0,7
162082.0,Weber Linus,O,Germany,22.0,203.0,2021,Germany,France,2021-05-29,False,1,3,7,11,0,0,0,0,7,2,4,13,1,1,0,2,0,0,0,0,3,0,0,3
162082.0,Weber Linus,O,Germany,22.0,203.0,2021,Germany,Argentina,2021-06-03,False,1,3,9,13,0,0,0,0,13,4,10,27,0,3,3,6,0,0,0,0,1,1,0,2
162082.0,Weber Linus,O,Germany,22.0,203.0,2021,Netherlands,Germany,2021-06-04,False,1,2,9,12,0,0,0,0,17,4,16,37,2,1,4,7,0,0,0,0,1,0,1,2
162082.0,Weber Linus,O,Germany,22.0,203.0,2021,Slovenia,Germany,2021-06-05,True,1,4,13,18,0,0,0,0,10,3,17,30,1,4,2,7,0,0,0,0,3,2,3,8
162082.0,Weber Linus,O,Germany,22.0,203.0,2021,Serbia,Germany,2021-06-09,False,1,4,5,10,0,0,1,1,13,4,8,25,1,2,4,7,1,0,0,1,1,0,1,2
162082.0,Weber Linus,O,Germany,22.0,203.0,2021,Germany,USA,2021-06-10,False,1,6,3,10,0,0,1,1,8,7,10,25,1,2,2,5,0,0,0,0,2,1,0,3
162082.0,Weber Linus,O,Germany,22.0,203.0,2021,Iran,Germany,2021-06-11,True,2,8,9,19,0,0,2,2,11,6,8,25,2,0,1,3,0,0,0,0,5,1,0,6
162082.0,Weber Linus,O,Germany,22.0,203.0,2021,Japan,Germany,2021-06-15,False,0,6,5,11,0,0,1,1,13,1,10,24,2,3,1,6,1,0,0,1,0,1,0,1
162082.0,Weber Linus,O,Germany,22.0,203.0,2021,Canada,Germany,2021-06-16,False,3,2,8,13,0,0,0,0,12,5,7,24,1,3,2,6,0,0,0,0,1,1,0,2
162082.0,Weber Linus,O,Germany,22.0,203.0,2021,Germany,Russia,2021-06-21,False,0,0,0,0,0,0,0,0,0,1,1,2,0,0,0,0,0,0,0,0,1,0,0,1
162082.0,Weber Linus,O,Germany,22.0,203.0,2021,Brazil,Germany,2021-06-22,False,0,3,5,8,0,0,0,0,10,6,8,24,2,2,0,4,0,0,0,0,1,1,1,3
162082.0,Weber Linus,O,Germany,22.0,203.0,2021,Italy,Germany,2021-06-23,False,0,1,1,2,0,0,0,0,2,3,4,9,0,0,0,0,0,0,0,0,0,1,1,2
152349.0,Krick Tobias,MB,Germany,23.0,210.0,2021,Germany,Australia,2021-05-28,True,1,3,3,7,0,0,0,0,5,0,2,7,0,2,5,7,0,0,0,0,3,0,0,3
152349.0,Krick Tobias,MB,Germany,23.0,210.0,2021,Germany,France,2021-05-29,False,0,3,7,10,0,0,0,0,7,2,3,12,2,2,1,5,0,0,1,1,1,0,0,1
152349.0,Krick Tobias,MB,Germany,23.0,210.0,2021,Germany,Bulgaria,2021-05-30,True,0,2,2,4,0,0,0,0,5,3,2,10,6,2,6,14,0,0,2,2,0,0,1,1
152349.0,Krick Tobias,MB,Germany,23.0,210.0,2021,Germany,Argentina,2021-06-03,False,0,3,7,10,0,0,0,0,13,0,4,17,2,6,6,14,0,0,0,0,4,0,0,4
152349.0,Krick Tobias,MB,Germany,23.0,210.0,2021,Slovenia,Germany,2021-06-05,True,2,4,5,11,0,0,0,0,4,0,4,8,4,3,9,16,1,0,1,2,2,0,0,2
152349.0,Krick Tobias,MB,Germany,23.0,210.0,2021,Serbia,Germany,2021-06-09,False,0,5,6,11,0,0,0,0,4,3,1,8,3,3,9,15,0,0,1,1,3,0,0,3
152349.0,Krick Tobias,MB,Germany,23.0,210.0,2021,Germany,USA,2021-06-10,False,1,4,5,10,0,0,0,0,1,0,2,3,1,2,2,5,0,0,0,0,4,0,1,5
152349.0,Krick Tobias,MB,Germany,23.0,210.0,2021,Iran,Germany,2021-06-11,True,0,3,4,7,0,0,0,0,5,1,1,7,4,5,4,13,0,1,0,1,2,1,0,3
152349.0,Krick Tobias,MB,Germany,23.0,210.0,2021,Japan,Germany,2021-06-15,False,0,4,4,8,0,0,0,0,3,1,3,7,2,3,0,5,1,0,0,1,0,0,0,0
152349.0,Krick Tobias,MB,Germany,23.0,210.0,2021,Canada,Germany,2021-06-16,False,0,4,7,11,0,1,0,1,7,1,5,13,0,4,1,5,0,0,0,0,0,0,0,0
152349.0,Krick Tobias,MB,Germany,23.0,210.0,2021,Germany,Poland,2021-06-17,False,0,0,0,0,0,0,0,0,0,0,0,0,0,0,0,0,0,0,0,0,0,0,0,0
152349.0,Krick Tobias,MB,Germany,23.0,210.0,2021,Germany,Russia,2021-06-21,False,0,2,6,8,0,0,1,1,10,1,2,13,1,4,5,10,0,0,2,2,2,0,0,2
152349.0,Krick Tobias,MB,Germany,23.0,210.0,2021,Brazil,Germany,2021-06-22,False,0,3,9,12,0,0,1,1,6,1,2,9,0,2,3,5,0,0,0,0,0,0,0,0
152349.0,Krick Tobias,MB,Germany,23.0,210.0,2021,Italy,Germany,2021-06-23,False,0,3,6,9,0,0,0,0,13,2,1,16,3,5,2,10,0,0,0,0,4,0,0,4
152352.0,Maase Lukas,MB,Germany,23.0,208.0,2021,Slovenia,Germany,2021-06-05,True,0,0,0,0,0,0,0,0,0,0,0,0,0,0,0,0,0,0,0,0,0,0,0,0
152352.0,Maase Lukas,MB,Germany,23.0,208.0,2021,Serbia,Germany,2021-06-09,False,0,0,0,0,0,0,0,0,0,0,0,0,0,2,0,2,0,0,0,0,0,1,0,1
152352.0,Maase Lukas,MB,Germany,23.0,208.0,2021,Germany,USA,2021-06-10,False,0,0,0,0,0,0,0,0,0,0,2,2,0,0,0,0,0,0,0,0,0,1,0,1
152352.0,Maase Lukas,MB,Germany,23.0,208.0,2021,Iran,Germany,2021-06-11,True,0,0,0,0,0,0,1,1,0,0,0,0,0,0,1,1,0,0,0,0,0,0,0,0
152352.0,Maase Lukas,MB,Germany,23.0,208.0,2021,Germany,Poland,2021-06-17,False,0,0,0,0,0,0,0,0,0,0,1,1,0,0,1,1,0,0,0,0,0,0,0,0
136751.0,Ebadipour Ghara H. Milad,OH,Iran,28.0,196.0,2021,Japan,Iran,2021-05-28,False,0,2,9,11,0,0,2,2,7,5,9,21,4,0,0,4,19,0,18,37,0,0,0,0
136751.0,Ebadipour Ghara H. Milad,OH,Iran,28.0,196.0,2021,Iran,Russia,2021-05-29,False,0,0,0,0,0,0,0,0,0,0,0,0,0,0,0,0,0,0,0,0,0,0,0,0
136751.0,Ebadipour Ghara H. Milad,OH,Iran,28.0,196.0,2021,Iran,Canada,2021-06-03,True,0,3,13,16,0,0,0,0,11,5,7,23,1,5,0,6,7,1,16,24,10,3,0,13
136751.0,Ebadipour Ghara H. Milad,OH,Iran,28.0,196.0,2021,Iran,Italy,2021-06-04,True,2,3,11,16,0,0,3,3,6,3,11,20,0,2,0,2,5,3,10,18,5,1,0,6
136751.0,Ebadipour Ghara H. Milad,OH,Iran,28.0,196.0,2021,Iran,USA,2021-06-09,True,0,1,11,12,0,0,5,5,6,3,12,21,0,2,1,3,7,1,15,23,5,1,1,7
136751.0,Ebadipour Ghara H. Milad,OH,Iran,28.0,196.0,2021,Serbia,Iran,2021-06-10,False,0,0,0,0,0,0,0,0,0,0,0,0,0,0,0,0,0,0,0,0,0,0,0,0
136751.0,Ebadipour Ghara H. Milad,OH,Iran,28.0,196.0,2021,Iran,Germany,2021-06-11,False,0,6,10,16,0,0,3,3,7,7,4,18,1,1,1,3,12,3,12,27,8,4,1,13
136751.0,Ebadipour Ghara H. Milad,OH,Iran,28.0,196.0,2021,Iran,Australia,2021-06-15,False,1,3,11,15,0,0,2,2,8,6,8,22,0,1,0,1,20,1,16,37,5,5,0,10
136751.0,Ebadipour Ghara H. Milad,OH,Iran,28.0,196.0,2021,Iran,Brazil,2021-06-16,False,0,4,9,13,0,0,5,5,10,3,6,19,1,3,0,4,19,2,9,30,2,1,0,3
136751.0,Ebadipour Ghara H. Milad,OH,Iran,28.0,196.0,2021,Iran,Slovenia,2021-06-17,False,1,3,14,18,0,0,3,3,10,2,10,22,1,1,2,4,8,0,14,22,1,7,1,9
136751.0,Ebadipour Ghara H. Milad,OH,Iran,28.0,196.0,2021,France,Iran,2021-06-21,False,0,3,5,8,0,0,4,4,5,2,8,15,2,2,0,4,6,1,10,17,2,1,0,3
136751.0,Ebadipour Ghara H. Milad,OH,Iran,28.0,196.0,2021,Iran,Poland,2021-06-22,False,0,0,0,0,0,0,0,0,0,0,0,0,0,0,0,0,0,0,0,0,0,0,0,0
136751.0,Ebadipour Ghara H. Milad,OH,Iran,28.0,196.0,2021,Iran,Argentina,2021-06-23,False,2,4,10,16,0,0,2,2,12,2,9,23,1,5,2,8,4,1,10,15,3,0,0,3
150817.0,Abedini Reza,MB,Iran,30.0,203.0,2021,Japan,Iran,2021-05-28,False,0,0,0,0,0,0,0,0,0,0,0,0,0,0,0,0,0,0,0,0,0,0,0,0
150817.0,Abedini Reza,MB,Iran,30.0,203.0,2021,Iran,Italy,2021-06-04,True,0,0,3,3,0,0,0,0,0,0,0,0,0,0,0,0,0,0,0,0,0,0,0,0
150817.0,Abedini Reza,MB,Iran,30.0,203.0,2021,Bulgaria,Iran,2021-06-05,True,0,1,14,15,0,0,1,1,1,1,0,2,4,6,3,13,0,0,1,1,3,1,1,5
150817.0,Abedini Reza,MB,Iran,30.0,203.0,2021,Iran,USA,2021-06-09,True,0,0,0,0,0,0,0,0,0,0,0,0,0,0,0,0,0,0,0,0,0,0,0,0
150817.0,Abedini Reza,MB,Iran,30.0,203.0,2021,Serbia,Iran,2021-06-10,False,1,2,13,16,0,0,1,1,7,1,1,9,3,2,2,7,0,0,0,0,1,0,1,2
150817.0,Abedini Reza,MB,Iran,30.0,203.0,2021,Iran,Germany,2021-06-11,False,0,1,1,2,0,0,0,0,0,0,0,0,0,0,1,1,0,0,0,0,0,0,0,0
150817.0,Abedini Reza,MB,Iran,30.0,203.0,2021,Iran,Australia,2021-06-15,False,0,0,0,0,0,0,0,0,0,0,0,0,0,0,0,0,0,0,0,0,0,0,0,0
150817.0,Abedini Reza,MB,Iran,30.0,203.0,2021,Iran,Brazil,2021-06-16,False,0,2,0,2,0,0,0,0,0,1,0,1,1,1,0,2,0,0,0,0,0,0,0,0
150817.0,Abedini Reza,MB,Iran,30.0,203.0,2021,Iran,Slovenia,2021-06-17,False,0,0,0,0,0,0,0,0,0,0,0,0,0,0,0,0,0,0,0,0,0,0,0,0
150817.0,Abedini Reza,MB,Iran,30.0,203.0,2021,Iran,Poland,2021-06-22,False,0,0,2,2,0,0,1,1,0,0,0,0,1,0,0,1,0,0,0,0,0,0,0,0
150817.0,Abedini Reza,MB,Iran,30.0,203.0,2021,Iran,Argentina,2021-06-23,False,0,0,0,0,0,0,0,0,0,0,0,0,0,0,0,0,0,0,0,0,0,0,0,0
117478.0,Marouflakrani Mir Saeid,S,Iran,36.0,189.0,2021,Netherlands,Iran,2021-05-30,True,0,0,0,0,6,0,0,6,0,0,0,0,0,0,0,0,0,0,0,0,0,0,0,0
117478.0,Marouflakrani Mir Saeid,S,Iran,36.0,189.0,2021,Iran,Canada,2021-06-03,True,0,1,10,11,35,1,49,85,1,0,0,1,0,1,1,2,0,0,0,0,6,3,1,10
117478.0,Marouflakrani Mir Saeid,S,Iran,36.0,189.0,2021,Iran,Italy,2021-06-04,True,0,2,12,14,20,0,89,109,0,0,2,2,0,2,2,4,0,0,0,0,7,4,0,11
117478.0,Marouflakrani Mir Saeid,S,Iran,36.0,189.0,2021,Bulgaria,Iran,2021-06-05,True,0,0,3,3,3,0,13,16,0,0,0,0,0,0,1,1,0,0,1,1,4,1,0,5
117478.0,Marouflakrani Mir Saeid,S,Iran,36.0,189.0,2021,Iran,USA,2021-06-09,True,0,1,10,11,12,3,61,76,2,0,3,5,0,1,5,6,0,0,1,1,2,2,0,4
117478.0,Marouflakrani Mir Saeid,S,Iran,36.0,189.0,2021,Serbia,Iran,2021-06-10,False,0,0,2,2,5,1,4,10,0,0,0,0,0,0,0,0,0,0,0,0,0,0,1,1
117478.0,Marouflakrani Mir Saeid,S,Iran,36.0,189.0,2021,Iran,Germany,2021-06-11,False,1,2,15,18,34,2,47,83,2,0,0,2,0,1,3,4,0,0,1,1,7,0,0,7
117478.0,Marouflakrani Mir Saeid,S,Iran,36.0,189.0,2021,Iran,Australia,2021-06-15,False,1,2,17,20,19,0,91,110,1,0,1,2,0,1,0,1,0,0,1,1,8,4,1,13
117478.0,Marouflakrani Mir Saeid,S,Iran,36.0,189.0,2021,Iran,Brazil,2021-06-16,False,0,0,8,8,10,0,47,57,0,0,4,4,0,0,0,0,0,0,1,1,2,2,0,4
117478.0,Marouflakrani Mir Saeid,S,Iran,36.0,189.0,2021,Iran,Slovenia,2021-06-17,False,0,0,14,14,19,2,61,82,1,0,1,2,0,2,0,2,0,1,0,1,4,5,0,9
117478.0,Marouflakrani Mir Saeid,S,Iran,36.0,189.0,2021,France,Iran,2021-06-21,False,0,0,2,2,8,1,11,20,0,0,1,1,0,1,0,1,0,0,0,0,1,0,0,1
117478.0,Marouflakrani Mir Saeid,S,Iran,36.0,189.0,2021,Iran,Poland,2021-06-22,False,0,0,0,0,3,0,9,12,0,0,0,0,0,0,0,0,0,0,0,0,3,0,0,3
117478.0,Marouflakrani Mir Saeid,S,Iran,36.0,189.0,2021,Iran,Argentina,2021-06-23,False,0,1,6,7,18,1,31,50,1,0,0,1,0,2,2,4,0,0,0,0,1,0,0,1
118827.0,Mousavi Eraghi Seyed Mohammad,MB,Iran,34.0,203.0,2021,Japan,Iran,2021-05-28,False,0,2,5,7,0,0,0,0,5,0,4,9,0,0,0,0,1,0,0,1,1,0,0,1
118827.0,Mousavi Eraghi Seyed Mohammad,MB,Iran,34.0,203.0,2021,Iran,Russia,2021-05-29,False,0,0,0,0,0,0,0,0,0,0,0,0,0,0,0,0,0,0,0,0,0,0,0,0
118827.0,Mousavi Eraghi Seyed Mohammad,MB,Iran,34.0,203.0,2021,Netherlands,Iran,2021-05-30,True,0,4,5,9,0,0,0,0,9,0,1,10,1,2,2,5,0,0,0,0,0,0,1,1
118827.0,Mousavi Eraghi Seyed Mohammad,MB,Iran,34.0,203.0,2021,Iran,Canada,2021-06-03,True,1,5,7,13,0,0,3,3,9,1,2,12,6,7,6,19,0,0,1,1,0,1,2,3
118827.0,Mousavi Eraghi Seyed Mohammad,MB,Iran,34.0,203.0,2021,Iran,Italy,2021-06-04,True,0,0,0,0,0,0,0,0,0,0,0,0,0,0,0,0,0,0,0,0,0,0,0,0
118827.0,Mousavi Eraghi Seyed Mohammad,MB,Iran,34.0,203.0,2021,Bulgaria,Iran,2021-06-05,True,3,3,8,14,0,0,1,1,4,1,4,9,3,5,6,14,0,0,1,1,6,0,1,7
118827.0,Mousavi Eraghi Seyed Mohammad,MB,Iran,34.0,203.0,2021,Iran,USA,2021-06-09,True,0,0,11,11,0,0,2,2,5,0,5,10,2,2,3,7,0,0,1,1,2,1,4,7
118827.0,Mousavi Eraghi Seyed Mohammad,MB,Iran,34.0,203.0,2021,Iran,Germany,2021-06-11,False,0,7,7,14,0,0,1,1,9,3,4,16,1,5,5,11,2,0,1,3,3,0,0,3
118827.0,Mousavi Eraghi Seyed Mohammad,MB,Iran,34.0,203.0,2021,Iran,Australia,2021-06-15,False,1,2,9,12,0,0,4,4,8,6,7,21,5,6,1,12,0,0,3,3,0,2,0,2
118827.0,Mousavi Eraghi Seyed Mohammad,MB,Iran,34.0,203.0,2021,Iran,Brazil,2021-06-16,False,1,4,5,10,0,0,2,2,4,3,6,13,2,5,1,8,0,0,0,0,1,0,0,1
118827.0,Mousavi Eraghi Seyed Mohammad,MB,Iran,34.0,203.0,2021,Iran,Slovenia,2021-06-17,False,1,3,10,14,0,0,1,1,4,2,2,8,5,4,0,9,0,1,2,3,1,1,0,2
118827.0,Mousavi Eraghi Seyed Mohammad,MB,Iran,34.0,203.0,2021,France,Iran,2021-06-21,False,0,1,5,6,0,0,2,2,2,1,1,4,2,6,1,9,1,0,0,1,0,0,0,0
118827.0,Mousavi Eraghi Seyed Mohammad,MB,Iran,34.0,203.0,2021,Iran,Poland,2021-06-22,False,0,0,0,0,0,0,0,0,0,0,0,0,0,0,0,0,0,0,0,0,0,0,0,0
118827.0,Mousavi Eraghi Seyed Mohammad,MB,Iran,34.0,203.0,2021,Iran,Argentina,2021-06-23,False,0,4,10,14,0,1,1,2,7,1,1,9,3,8,3,14,0,0,1,1,2,1,1,4
162173.0,Fayazi D. Purya,OH,Iran,29.0,195.0,2021,Japan,Iran,2021-05-28,False,0,1,11,12,1,0,1,2,2,1,6,9,0,0,0,0,6,2,10,18,1,0,0,1
162173.0,Fayazi D. Purya,OH,Iran,29.0,195.0,2021,Iran,Russia,2021-05-29,False,0,0,1,1,0,0,0,0,0,0,1,1,0,0,0,0,1,1,1,3,1,0,0,1
162173.0,Fayazi D. Purya,OH,Iran,29.0,195.0,2021,Netherlands,Iran,2021-05-30,True,0,0,0,0,0,0,0,0,0,0,0,0,0,0,0,0,0,0,1,1,0,1,0,1
162173.0,Fayazi D. Purya,OH,Iran,29.0,195.0,2021,Iran,Canada,2021-06-03,True,0,0,0,0,0,0,0,0,0,0,0,0,0,0,0,0,0,0,0,0,0,0,0,0
162173.0,Fayazi D. Purya,OH,Iran,29.0,195.0,2021,Iran,Italy,2021-06-04,True,0,0,2,2,0,1,0,1,0,0,3,3,0,2,0,2,1,1,6,8,2,0,0,2
162173.0,Fayazi D. Purya,OH,Iran,29.0,195.0,2021,Bulgaria,Iran,2021-06-05,True,0,0,2,2,0,0,0,0,0,0,3,3,0,0,3,3,0,0,1,1,0,0,0,0
162173.0,Fayazi D. Purya,OH,Iran,29.0,195.0,2021,Iran,USA,2021-06-09,True,0,0,0,0,0,0,0,0,0,0,0,0,0,0,0,0,0,0,0,0,0,1,0,1
162173.0,Fayazi D. Purya,OH,Iran,29.0,195.0,2021,Serbia,Iran,2021-06-10,False,0,0,0,0,0,0,0,0,0,0,0,0,0,0,0,0,0,1,6,7,1,0,0,1
162173.0,Fayazi D. Purya,OH,Iran,29.0,195.0,2021,Iran,Germany,2021-06-11,False,0,0,0,0,0,0,0,0,0,0,0,0,0,0,0,0,0,0,0,0,0,0,0,0
162173.0,Fayazi D. Purya,OH,Iran,29.0,195.0,2021,Iran,Australia,2021-06-15,False,0,0,0,0,0,0,0,0,0,0,0,0,0,0,0,0,0,0,0,0,0,0,0,0
162173.0,Fayazi D. Purya,OH,Iran,29.0,195.0,2021,Iran,Argentina,2021-06-23,False,0,0,0,0,0,0,0,0,0,0,0,0,0,0,0,0,0,0,0,0,0,0,0,0
163176.0,Hazratpourtalatappeh Mohammadreza,L,Iran,22.0,187.0,2021,Japan,Iran,2021-05-28,False,0,0,0,0,0,0,4,4,0,0,0,0,0,0,0,0,4,0,4,8,3,0,0,3
163176.0,Hazratpourtalatappeh Mohammadreza,L,Iran,22.0,187.0,2021,Netherlands,Iran,2021-05-30,True,0,0,0,0,0,0,0,0,0,0,0,0,0,0,0,0,0,0,0,0,0,0,0,0
163176.0,Hazratpourtalatappeh Mohammadreza,L,Iran,22.0,187.0,2021,Iran,Canada,2021-06-03,True,0,0,0,0,0,0,4,4,0,0,0,0,0,0,0,0,8,0,8,16,1,3,1,5
163176.0,Hazratpourtalatappeh Mohammadreza,L,Iran,22.0,187.0,2021,Iran,Italy,2021-06-04,True,0,0,0,0,0,0,0,0,0,0,0,0,0,0,0,0,0,0,0,0,0,0,0,0
163176.0,Hazratpourtalatappeh Mohammadreza,L,Iran,22.0,187.0,2021,Bulgaria,Iran,2021-06-05,True,0,0,0,0,0,0,2,2,0,0,0,0,0,0,0,0,4,2,11,17,6,4,2,12
163176.0,Hazratpourtalatappeh Mohammadreza,L,Iran,22.0,187.0,2021,Serbia,Iran,2021-06-10,False,0,0,0,0,0,0,13,13,0,0,0,0,0,0,0,0,9,0,10,19,3,3,2,8
163176.0,Hazratpourtalatappeh Mohammadreza,L,Iran,22.0,187.0,2021,Iran,Germany,2021-06-11,False,0,0,0,0,0,0,0,0,0,0,0,0,0,0,0,0,0,0,0,0,0,0,0,0
163176.0,Hazratpourtalatappeh Mohammadreza,L,Iran,22.0,187.0,2021,Iran,Australia,2021-06-15,False,0,0,0,0,0,0,1,1,0,0,0,0,0,0,0,0,5,0,10,15,3,2,0,5
163176.0,Hazratpourtalatappeh Mohammadreza,L,Iran,22.0,187.0,2021,Iran,Brazil,2021-06-16,False,0,0,0,0,0,0,0,0,0,0,0,0,0,0,0,0,0,0,0,0,0,0,0,0
163176.0,Hazratpourtalatappeh Mohammadreza,L,Iran,22.0,187.0,2021,Iran,Slovenia,2021-06-17,False,0,0,0,0,0,0,0,0,0,0,0,0,0,0,0,0,0,0,0,0,0,0,0,0
163176.0,Hazratpourtalatappeh Mohammadreza,L,Iran,22.0,187.0,2021,France,Iran,2021-06-21,False,0,0,0,0,0,0,0,0,0,0,0,0,0,0,0,0,0,0,0,0,0,0,0,0
163176.0,Hazratpourtalatappeh Mohammadreza,L,Iran,22.0,187.0,2021,Iran,Poland,2021-06-22,False,0,0,0,0,0,0,0,0,0,0,0,0,0,0,0,0,0,0,0,0,0,0,0,0
163176.0,Hazratpourtalatappeh Mohammadreza,L,Iran,22.0,187.0,2021,Iran,Argentina,2021-06-23,False,0,0,0,0,0,0,4,4,0,0,0,0,0,0,0,0,8,0,8,16,8,3,1,12
142078.0,Gholami Masoud,MB,Iran,31.0,204.0,2021,Japan,Iran,2021-05-28,False,0,0,0,0,0,0,0,0,0,0,0,0,0,0,0,0,0,0,0,0,0,0,0,0
142078.0,Gholami Masoud,MB,Iran,31.0,204.0,2021,Iran,Russia,2021-05-29,False,1,3,9,13,0,0,0,0,5,1,4,10,1,4,7,12,2,0,1,3,2,1,0,3
142078.0,Gholami Masoud,MB,Iran,31.0,204.0,2021,Netherlands,Iran,2021-05-30,True,0,0,0,0,0,0,0,0,0,0,0,0,0,0,0,0,0,0,0,0,0,0,0,0
142078.0,Gholami Masoud,MB,Iran,31.0,204.0,2021,Iran,Canada,2021-06-03,True,0,0,15,15,0,0,3,3,8,0,2,10,4,5,3,12,0,0,0,0,2,1,1,4
142078.0,Gholami Masoud,MB,Iran,31.0,204.0,2021,Iran,Italy,2021-06-04,True,2,1,16,19,0,0,1,1,3,1,6,10,3,4,2,9,1,0,0,1,1,5,0,6
142078.0,Gholami Masoud,MB,Iran,31.0,204.0,2021,Bulgaria,Iran,2021-06-05,True,0,0,0,0,0,0,0,0,0,0,0,0,0,0,0,0,0,0,0,0,0,0,0,0
142078.0,Gholami Masoud,MB,Iran,31.0,204.0,2021,Iran,USA,2021-06-09,True,0,2,10,12,0,0,0,0,6,1,1,8,2,2,2,6,0,0,0,0,4,0,0,4
142078.0,Gholami Masoud,MB,Iran,31.0,204.0,2021,Serbia,Iran,2021-06-10,False,0,0,0,0,0,0,0,0,0,0,0,0,0,0,0,0,0,0,0,0,0,0,0,0
142078.0,Gholami Masoud,MB,Iran,31.0,204.0,2021,Iran,Germany,2021-06-11,False,0,2,12,14,0,0,4,4,5,2,2,9,0,3,2,5,1,0,0,1,2,0,0,2
142078.0,Gholami Masoud,MB,Iran,31.0,204.0,2021,Iran,Australia,2021-06-15,False,0,0,13,13,0,0,0,0,3,0,1,4,1,2,1,4,0,0,0,0,0,1,0,1
142078.0,Gholami Masoud,MB,Iran,31.0,204.0,2021,Iran,Brazil,2021-06-16,False,0,0,0,0,0,0,0,0,0,0,0,0,0,0,0,0,0,0,0,0,0,0,0,0
142078.0,Gholami Masoud,MB,Iran,31.0,204.0,2021,Iran,Slovenia,2021-06-17,False,1,0,17,18,0,0,2,2,5,1,4,10,3,5,0,8,0,0,0,0,1,1,0,2
142078.0,Gholami Masoud,MB,Iran,31.0,204.0,2021,France,Iran,2021-06-21,False,0,0,0,0,0,0,0,0,0,0,0,0,0,0,0,0,0,0,0,0,0,0,0,0
142078.0,Gholami Masoud,MB,Iran,31.0,204.0,2021,Iran,Poland,2021-06-22,False,0,2,6,8,0,1,0,1,1,1,5,7,0,4,4,8,1,0,0,1,0,0,0,0
142078.0,Gholami Masoud,MB,Iran,31.0,204.0,2021,Iran,Argentina,2021-06-23,False,1,0,18,19,1,1,0,2,5,2,1,8,3,3,2,8,0,0,1,1,1,2,0,3
124584.0,Ghafour Amir,O,Iran,30.0,202.0,2021,Japan,Iran,2021-05-28,False,0,3,5,8,0,0,2,2,15,4,7,26,0,0,0,0,0,0,0,0,0,0,1,1
124584.0,Ghafour Amir,O,Iran,30.0,202.0,2021,Iran,Russia,2021-05-29,False,0,0,0,0,0,0,0,0,0,0,0,0,0,0,0,0,0,0,0,0,0,0,0,0
124584.0,Ghafour Amir,O,Iran,30.0,202.0,2021,France,Iran,2021-06-21,False,0,1,3,4,0,0,1,1,5,3,1,9,2,2,1,5,0,0,1,1,0,0,0,0
124584.0,Ghafour Amir,O,Iran,30.0,202.0,2021,Iran,Poland,2021-06-22,False,0,0,5,5,1,0,7,8,1,1,2,4,0,1,1,2,0,0,0,0,0,0,0,0
124584.0,Ghafour Amir,O,Iran,30.0,202.0,2021,Iran,Argentina,2021-06-23,False,0,4,5,9,0,0,3,3,12,5,2,19,1,1,2,4,1,0,3,4,1,2,2,5
164188.0,Kazemi Saber,O,Iran,23.0,205.0,2021,Japan,Iran,2021-05-28,False,0,1,1,2,0,0,0,0,0,0,0,0,0,0,0,0,0,0,0,0,0,0,0,0
164188.0,Kazemi Saber,O,Iran,23.0,205.0,2021,Iran,Russia,2021-05-29,False,0,4,12,16,0,0,0,0,18,4,14,36,0,2,2,4,0,0,0,0,3,1,2,6
164188.0,Kazemi Saber,O,Iran,23.0,205.0,2021,Netherlands,Iran,2021-05-30,True,1,6,10,17,0,0,0,0,10,5,10,25,0,1,0,1,0,0,1,1,3,1,2,6
164188.0,Kazemi Saber,O,Iran,23.0,205.0,2021,Iran,Canada,2021-06-03,True,0,4,10,14,0,0,1,1,15,6,11,32,2,2,1,5,0,1,0,1,7,2,1,10
164188.0,Kazemi Saber,O,Iran,23.0,205.0,2021,Iran,Italy,2021-06-04,True,3,4,11,18,0,0,0,0,20,4,29,53,1,6,0,7,0,0,1,1,4,4,0,8
164188.0,Kazemi Saber,O,Iran,23.0,205.0,2021,Bulgaria,Iran,2021-06-05,True,0,0,2,2,0,0,1,1,2,1,5,8,0,0,0,0,0,0,0,0,0,0,0,0
164188.0,Kazemi Saber,O,Iran,23.0,205.0,2021,Iran,USA,2021-06-09,True,5,3,10,18,0,0,1,1,12,4,11,27,2,2,4,8,0,0,1,1,7,1,2,10
164188.0,Kazemi Saber,O,Iran,23.0,205.0,2021,Serbia,Iran,2021-06-10,False,0,0,2,2,0,0,0,0,4,0,2,6,0,2,1,3,0,0,0,0,0,0,1,1
164188.0,Kazemi Saber,O,Iran,23.0,205.0,2021,Iran,Germany,2021-06-11,False,2,6,9,17,0,0,1,1,23,3,12,38,2,2,1,5,0,0,0,0,5,3,0,8
164188.0,Kazemi Saber,O,Iran,23.0,205.0,2021,Iran,Australia,2021-06-15,False,0,1,5,6,0,0,1,1,9,5,9,23,2,1,1,4,0,0,1,1,1,1,0,2
164188.0,Kazemi Saber,O,Iran,23.0,205.0,2021,Iran,Brazil,2021-06-16,False,1,6,7,14,0,0,0,0,9,4,15,28,0,3,0,3,0,0,0,0,3,0,0,3
164188.0,Kazemi Saber,O,Iran,23.0,205.0,2021,Iran,Slovenia,2021-06-17,False,1,3,7,11,0,0,1,1,14,3,12,29,1,5,0,6,0,0,0,0,5,3,0,8
164188.0,Kazemi Saber,O,Iran,23.0,205.0,2021,France,Iran,2021-06-21,False,1,0,9,10,0,0,2,2,9,5,5,19,0,3,0,3,0,0,0,0,1,0,0,1
164188.0,Kazemi Saber,O,Iran,23.0,205.0,2021,Iran,Argentina,2021-06-23,False,1,1,10,12,0,0,2,2,7,3,6,16,0,0,1,1,0,0,1,1,2,3,2,7
152742.0,Sharifi Morteza,OH,Iran,22.0,193.0,2021,Iran,Russia,2021-05-29,False,0,0,0,0,0,0,0,0,0,0,0,0,0,0,0,0,0,0,0,0,0,0,0,0
152742.0,Sharifi Morteza,OH,Iran,22.0,193.0,2021,Netherlands,Iran,2021-05-30,True,0,0,0,0,0,0,0,0,0,0,0,0,0,0,0,0,0,0,0,0,0,0,0,0
152742.0,Sharifi Morteza,OH,Iran,22.0,193.0,2021,Bulgaria,Iran,2021-06-05,True,0,0,0,0,0,0,0,0,0,0,0,0,0,0,0,0,0,0,0,0,0,0,0,0
152742.0,Sharifi Morteza,OH,Iran,22.0,193.0,2021,Iran,USA,2021-06-09,True,0,0,0,0,0,0,0,0,0,0,0,0,0,0,0,0,0,0,0,0,0,0,0,0
152742.0,Sharifi Morteza,OH,Iran,22.0,193.0,2021,Serbia,Iran,2021-06-10,False,3,4,11,18,0,0,1,1,10,5,7,22,1,4,3,8,7,2,27,36,6,1,2,9
152742.0,Sharifi Morteza,OH,Iran,22.0,193.0,2021,Iran,Germany,2021-06-11,False,0,0,0,0,0,0,0,0,0,0,0,0,0,0,0,0,0,0,0,0,0,0,0,0
152742.0,Sharifi Morteza,OH,Iran,22.0,193.0,2021,Iran,Brazil,2021-06-16,False,0,0,0,0,0,0,0,0,0,0,0,0,0,0,0,0,0,0,0,0,0,0,0,0
152742.0,Sharifi Morteza,OH,Iran,22.0,193.0,2021,Iran,Slovenia,2021-06-17,False,0,0,0,0,0,0,0,0,0,0,0,0,0,0,0,0,0,0,0,0,0,0,0,0
152742.0,Sharifi Morteza,OH,Iran,22.0,193.0,2021,France,Iran,2021-06-21,False,0,0,0,0,0,0,0,0,0,0,0,0,0,0,0,0,0,0,0,0,0,0,0,0
152742.0,Sharifi Morteza,OH,Iran,22.0,193.0,2021,Iran,Poland,2021-06-22,False,0,2,7,9,0,1,0,1,10,3,10,23,1,1,1,3,5,5,21,31,8,0,0,8
152742.0,Sharifi Morteza,OH,Iran,22.0,193.0,2021,Iran,Argentina,2021-06-23,False,0,1,1,2,0,0,1,1,1,0,4,5,0,2,0,2,0,0,2,2,0,0,0,0
152743.0,Mojarad Aliasghar,MB,Iran,24.0,205.0,2021,Japan,Iran,2021-05-28,False,0,2,4,6,0,0,0,0,6,0,3,9,2,0,0,2,0,0,0,0,0,0,0,0
152743.0,Mojarad Aliasghar,MB,Iran,24.0,205.0,2021,Iran,Russia,2021-05-29,False,0,1,0,1,0,0,0,0,1,0,0,1,0,3,0,3,0,0,0,0,0,0,0,0
152743.0,Mojarad Aliasghar,MB,Iran,24.0,205.0,2021,Netherlands,Iran,2021-05-30,True,1,5,7,13,0,0,0,0,3,0,2,5,4,5,3,12,0,0,1,1,1,0,1,2
152743.0,Mojarad Aliasghar,MB,Iran,24.0,205.0,2021,Iran,Canada,2021-06-03,True,0,0,0,0,0,0,0,0,0,0,0,0,0,0,0,0,0,0,0,0,0,0,0,0
152743.0,Mojarad Aliasghar,MB,Iran,24.0,205.0,2021,Iran,Italy,2021-06-04,True,0,0,16,16,0,0,1,1,5,1,2,8,5,4,3,12,0,0,1,1,1,1,0,2
152743.0,Mojarad Aliasghar,MB,Iran,24.0,205.0,2021,Bulgaria,Iran,2021-06-05,True,0,0,0,0,0,0,0,0,0,0,0,0,0,0,0,0,0,0,0,0,0,0,0,0
152743.0,Mojarad Aliasghar,MB,Iran,24.0,205.0,2021,Iran,Australia,2021-06-15,False,0,2,4,6,0,0,0,0,2,1,2,5,2,0,0,2,0,1,1,2,0,0,0,0
152743.0,Mojarad Aliasghar,MB,Iran,24.0,205.0,2021,Iran,Brazil,2021-06-16,False,0,1,5,6,0,0,0,0,4,0,1,5,1,2,0,3,0,0,0,0,1,0,0,1
152743.0,Mojarad Aliasghar,MB,Iran,24.0,205.0,2021,Iran,Slovenia,2021-06-17,False,0,0,0,0,0,0,0,0,0,0,0,0,0,0,0,0,0,0,0,0,0,0,0,0
152743.0,Mojarad Aliasghar,MB,Iran,24.0,205.0,2021,France,Iran,2021-06-21,False,0,2,7,9,0,0,0,0,1,3,1,5,1,2,3,6,0,0,0,0,1,1,0,2
152743.0,Mojarad Aliasghar,MB,Iran,24.0,205.0,2021,Iran,Poland,2021-06-22,False,0,2,5,7,0,0,3,3,3,0,3,6,1,5,1,7,0,0,2,2,2,0,0,2
162557.0,Salehi Meisam,OH,Iran,23.0,198.0,2021,Japan,Iran,2021-05-28,False,0,2,3,5,0,0,0,0,6,2,2,10,0,0,0,0,1,0,3,4,0,0,0,0
162557.0,Salehi Meisam,OH,Iran,23.0,198.0,2021,Iran,Russia,2021-05-29,False,0,4,8,12,0,0,0,0,11,6,6,23,1,2,2,5,5,0,15,20,6,0,0,6
162557.0,Salehi Meisam,OH,Iran,23.0,198.0,2021,Netherlands,Iran,2021-05-30,True,1,1,10,12,0,0,0,0,8,1,3,12,3,2,0,5,2,2,10,14,4,1,1,6
162557.0,Salehi Meisam,OH,Iran,23.0,198.0,2021,Iran,Canada,2021-06-03,True,4,5,10,19,0,0,1,1,9,2,5,16,1,2,2,5,10,1,23,34,3,1,0,4
162557.0,Salehi Meisam,OH,Iran,23.0,198.0,2021,Iran,Italy,2021-06-04,True,0,0,7,7,0,0,1,1,9,1,5,15,0,2,0,2,6,0,11,17,1,2,0,3
162557.0,Salehi Meisam,OH,Iran,23.0,198.0,2021,Bulgaria,Iran,2021-06-05,True,0,3,11,14,0,0,1,1,9,1,3,13,0,1,3,4,3,1,10,14,6,0,1,7
162557.0,Salehi Meisam,OH,Iran,23.0,198.0,2021,Iran,USA,2021-06-09,True,0,3,6,9,0,0,3,3,13,5,1,19,1,1,1,3,5,0,12,17,3,0,1,4
162557.0,Salehi Meisam,OH,Iran,23.0,198.0,2021,Serbia,Iran,2021-06-10,False,0,0,0,0,0,0,0,0,0,0,0,0,0,0,0,0,0,0,0,0,0,0,0,0
162557.0,Salehi Meisam,OH,Iran,23.0,198.0,2021,Iran,Germany,2021-06-11,False,0,5,9,14,0,0,1,1,12,6,3,21,3,3,1,7,6,1,16,23,3,2,0,5
162557.0,Salehi Meisam,OH,Iran,23.0,198.0,2021,Iran,Australia,2021-06-15,False,1,6,15,22,0,0,1,1,9,3,8,20,2,4,1,7,4,2,11,17,5,2,0,7
162557.0,Salehi Meisam,OH,Iran,23.0,198.0,2021,Iran,Brazil,2021-06-16,False,2,3,8,13,0,0,1,1,12,4,10,26,1,2,0,3,8,0,13,21,3,0,0,3
162557.0,Salehi Meisam,OH,Iran,23.0,198.0,2021,Iran,Slovenia,2021-06-17,False,0,3,13,16,0,0,0,0,15,4,6,25,2,2,0,4,10,1,17,28,5,4,0,9
162557.0,Salehi Meisam,OH,Iran,23.0,198.0,2021,France,Iran,2021-06-21,False,0,2,8,10,0,0,3,3,12,1,9,22,0,2,1,3,8,2,5,15,2,0,0,2
162557.0,Salehi Meisam,OH,Iran,23.0,198.0,2021,Iran,Poland,2021-06-22,False,0,0,0,0,0,0,0,0,0,0,0,0,0,0,0,0,0,0,0,0,0,0,0,0
162557.0,Salehi Meisam,OH,Iran,23.0,198.0,2021,Iran,Argentina,2021-06-23,False,0,2,17,19,0,1,0,1,13,8,7,28,0,4,2,6,9,2,22,33,5,4,2,11
119750.0,Vadi Mohammad Taher,S,Iran,32.0,194.0,2021,Japan,Iran,2021-05-28,False,1,2,8,11,8,1,66,75,0,0,0,0,2,0,0,2,0,0,0,0,0,0,0,0
119750.0,Vadi Mohammad Taher,S,Iran,32.0,194.0,2021,Iran,Russia,2021-05-29,False,0,2,7,9,29,0,0,29,1,0,1,2,0,1,1,2,0,0,1,1,9,1,1,11
119750.0,Vadi Mohammad Taher,S,Iran,32.0,194.0,2021,Netherlands,Iran,2021-05-30,True,1,0,9,10,15,0,47,62,1,0,1,2,0,0,0,0,0,0,0,0,7,5,0,12
119750.0,Vadi Mohammad Taher,S,Iran,32.0,194.0,2021,Iran,Canada,2021-06-03,True,0,0,0,0,0,0,0,0,0,0,0,0,0,0,0,0,0,0,0,0,0,0,0,0
119750.0,Vadi Mohammad Taher,S,Iran,32.0,194.0,2021,Iran,Italy,2021-06-04,True,0,0,0,0,0,0,2,2,0,0,0,0,0,0,0,0,0,0,0,0,0,0,0,0
119750.0,Vadi Mohammad Taher,S,Iran,32.0,194.0,2021,Bulgaria,Iran,2021-06-05,True,0,0,10,10,12,0,41,53,1,0,0,1,0,2,1,3,0,0,0,0,1,1,1,3
119750.0,Vadi Mohammad Taher,S,Iran,32.0,194.0,2021,Iran,USA,2021-06-09,True,0,0,0,0,0,0,0,0,0,0,0,0,0,0,0,0,0,0,0,0,0,0,0,0
119750.0,Vadi Mohammad Taher,S,Iran,32.0,194.0,2021,Serbia,Iran,2021-06-10,False,0,2,12,14,23,1,56,80,0,0,3,3,1,2,1,4,0,0,0,0,6,5,0,11
119750.0,Vadi Mohammad Taher,S,Iran,32.0,194.0,2021,Iran,Germany,2021-06-11,False,0,0,1,1,1,0,3,4,0,0,0,0,0,0,0,0,0,0,0,0,0,0,0,0
181182.0,Salehi Arman,L,Iran,29.0,180.0,2021,Japan,Iran,2021-05-28,False,0,0,0,0,0,0,0,0,0,0,0,0,0,0,0,0,0,0,0,0,0,0,0,0
181182.0,Salehi Arman,L,Iran,29.0,180.0,2021,Iran,Russia,2021-05-29,False,0,0,0,0,0,0,0,0,0,0,0,0,0,0,0,0,13,1,16,30,12,2,0,14
181182.0,Salehi Arman,L,Iran,29.0,180.0,2021,Netherlands,Iran,2021-05-30,True,0,0,0,0,0,0,4,4,0,0,0,0,0,0,0,0,10,0,10,20,5,4,1,10
181182.0,Salehi Arman,L,Iran,29.0,180.0,2021,Iran,Canada,2021-06-03,True,0,0,0,0,0,0,0,0,0,0,0,0,0,0,0,0,0,0,0,0,0,0,0,0
181182.0,Salehi Arman,L,Iran,29.0,180.0,2021,Iran,Italy,2021-06-04,True,0,0,0,0,0,0,7,7,0,0,0,0,0,0,0,0,8,2,8,18,11,6,1,18
181182.0,Salehi Arman,L,Iran,29.0,180.0,2021,Bulgaria,Iran,2021-06-05,True,0,0,0,0,0,0,0,0,0,0,0,0,0,0,0,0,0,0,0,0,0,0,0,0
181182.0,Salehi Arman,L,Iran,29.0,180.0,2021,Iran,USA,2021-06-09,True,0,0,0,0,0,0,5,5,0,0,0,0,0,0,0,0,8,0,6,14,13,2,1,16
181182.0,Salehi Arman,L,Iran,29.0,180.0,2021,Serbia,Iran,2021-06-10,False,0,0,0,0,0,0,0,0,0,0,0,0,0,0,0,0,0,0,0,0,0,0,0,0
181182.0,Salehi Arman,L,Iran,29.0,180.0,2021,Iran,Germany,2021-06-11,False,0,0,0,0,0,0,7,7,0,0,0,0,0,0,0,0,9,2,13,24,11,5,0,16
181182.0,Salehi Arman,L,Iran,29.0,180.0,2021,Iran,Australia,2021-06-15,False,0,0,0,0,0,0,3,3,0,0,0,0,0,0,0,0,5,1,7,13,5,4,0,9
181182.0,Salehi Arman,L,Iran,29.0,180.0,2021,Iran,Brazil,2021-06-16,False,0,0,0,0,0,0,7,7,0,0,0,0,0,0,0,0,13,1,14,28,18,4,0,22
181182.0,Salehi Arman,L,Iran,29.0,180.0,2021,Iran,Slovenia,2021-06-17,False,0,0,0,0,0,0,6,6,0,0,0,0,0,0,0,0,11,0,10,21,5,5,0,10
181182.0,Salehi Arman,L,Iran,29.0,180.0,2021,France,Iran,2021-06-21,False,0,0,0,0,0,0,4,4,0,0,0,0,0,0,0,0,14,0,9,23,7,1,1,9
181182.0,Salehi Arman,L,Iran,29.0,180.0,2021,Iran,Poland,2021-06-22,False,0,0,0,0,0,1,11,12,0,0,0,0,0,0,0,0,5,0,11,16,8,2,1,11
181182.0,Salehi Arman,L,Iran,29.0,180.0,2021,Iran,Argentina,2021-06-23,False,0,0,0,0,0,0,3,3,0,0,0,0,0,0,0,0,5,0,10,15,2,4,1,7
152752.0,Esfandiar Amirhossein,OH,Iran,23.0,209.0,2021,Japan,Iran,2021-05-28,False,0,1,3,4,0,0,0,0,0,0,0,0,0,0,0,0,0,0,0,0,0,0,0,0
152752.0,Esfandiar Amirhossein,OH,Iran,23.0,209.0,2021,Iran,Russia,2021-05-29,False,2,2,11,15,0,1,0,1,12,3,10,25,0,6,3,9,6,2,10,18,1,2,0,3
152752.0,Esfandiar Amirhossein,OH,Iran,23.0,209.0,2021,Netherlands,Iran,2021-05-30,True,3,3,9,15,0,0,0,0,10,2,2,14,1,1,1,3,7,3,11,21,3,1,1,5
152752.0,Esfandiar Amirhossein,OH,Iran,23.0,209.0,2021,Iran,Canada,2021-06-03,True,1,2,5,8,0,0,1,1,0,0,0,0,0,0,0,0,0,0,0,0,0,0,0,0
152752.0,Esfandiar Amirhossein,OH,Iran,23.0,209.0,2021,Iran,Italy,2021-06-04,True,0,3,1,4,0,0,1,1,5,1,6,12,1,2,1,4,3,2,10,15,2,2,0,4
152752.0,Esfandiar Amirhossein,OH,Iran,23.0,209.0,2021,Bulgaria,Iran,2021-06-05,True,1,2,10,13,0,0,0,0,9,4,8,21,1,3,5,9,3,1,16,20,2,1,0,3
152752.0,Esfandiar Amirhossein,OH,Iran,23.0,209.0,2021,Iran,USA,2021-06-09,True,0,0,0,0,0,0,0,0,0,0,0,0,0,0,0,0,0,0,0,0,0,0,0,0
152752.0,Esfandiar Amirhossein,OH,Iran,23.0,209.0,2021,Serbia,Iran,2021-06-10,False,2,5,7,14,0,0,1,1,14,3,8,25,1,2,2,5,15,5,7,27,4,3,1,8
152752.0,Esfandiar Amirhossein,OH,Iran,23.0,209.0,2021,Iran,Germany,2021-06-11,False,2,2,3,7,0,0,0,0,2,0,0,2,0,0,0,0,0,0,2,2,1,0,0,1
152752.0,Esfandiar Amirhossein,OH,Iran,23.0,209.0,2021,Iran,Australia,2021-06-15,False,0,0,1,1,0,0,0,0,0,0,0,0,0,0,0,0,0,0,0,0,0,1,0,1
152752.0,Esfandiar Amirhossein,OH,Iran,23.0,209.0,2021,Iran,Brazil,2021-06-16,False,1,2,9,12,0,0,0,0,1,1,3,5,0,1,0,1,0,0,1,1,0,1,0,1
152752.0,Esfandiar Amirhossein,OH,Iran,23.0,209.0,2021,Iran,Slovenia,2021-06-17,False,0,0,1,1,0,0,0,0,0,0,0,0,0,0,0,0,0,0,0,0,0,0,0,0
152752.0,Esfandiar Amirhossein,OH,Iran,23.0,209.0,2021,France,Iran,2021-06-21,False,0,1,6,7,0,0,0,0,1,0,1,2,0,0,0,0,0,2,1,3,0,0,0,0
152752.0,Esfandiar Amirhossein,OH,Iran,23.0,209.0,2021,Iran,Poland,2021-06-22,False,0,4,6,10,0,0,0,0,6,7,7,20,1,2,1,4,1,1,14,16,5,1,1,7
168551.0,Saadat Bardia,O,Iran,19.0,205.0,2021,Iran,Russia,2021-05-29,False,0,0,0,0,0,0,0,0,1,0,0,1,0,1,1,2,0,0,0,0,0,0,0,0
168551.0,Saadat Bardia,O,Iran,19.0,205.0,2021,Netherlands,Iran,2021-05-30,True,0,1,1,2,0,0,0,0,3,1,1,5,0,0,1,1,0,0,0,0,1,0,0,1
168551.0,Saadat Bardia,O,Iran,19.0,205.0,2021,Iran,Canada,2021-06-03,True,0,0,0,0,0,0,0,0,2,0,0,2,0,0,0,0,0,0,0,0,0,0,0,0
168551.0,Saadat Bardia,O,Iran,19.0,205.0,2021,Iran,Italy,2021-06-04,True,0,0,1,1,0,0,0,0,2,0,1,3,0,0,0,0,0,0,0,0,0,0,0,0
168551.0,Saadat Bardia,O,Iran,19.0,205.0,2021,Bulgaria,Iran,2021-06-05,True,1,5,3,9,0,0,2,2,15,3,3,21,1,4,0,5,0,0,0,0,1,0,1,2
168551.0,Saadat Bardia,O,Iran,19.0,205.0,2021,Iran,USA,2021-06-09,True,0,0,0,0,0,0,0,0,0,0,1,1,0,0,0,0,0,0,0,0,0,0,0,0
168551.0,Saadat Bardia,O,Iran,19.0,205.0,2021,Serbia,Iran,2021-06-10,False,1,2,11,14,0,0,0,0,15,7,13,35,0,6,2,8,0,0,0,0,2,1,0,3
168551.0,Saadat Bardia,O,Iran,19.0,205.0,2021,Iran,Germany,2021-06-11,False,0,0,0,0,0,0,0,0,0,0,0,0,0,0,1,1,0,0,0,0,0,0,0,0
168551.0,Saadat Bardia,O,Iran,19.0,205.0,2021,Iran,Australia,2021-06-15,False,1,2,10,13,0,0,0,0,14,5,8,27,1,2,1,4,0,0,0,0,0,1,0,1
168551.0,Saadat Bardia,O,Iran,19.0,205.0,2021,Iran,Brazil,2021-06-16,False,0,1,2,3,0,0,1,1,8,3,4,15,0,0,0,0,0,0,0,0,2,0,0,2
168551.0,Saadat Bardia,O,Iran,19.0,205.0,2021,Iran,Slovenia,2021-06-17,False,0,1,1,2,0,0,0,0,2,2,0,4,0,1,0,1,0,0,0,0,0,0,0,0
168551.0,Saadat Bardia,O,Iran,19.0,205.0,2021,France,Iran,2021-06-21,False,0,0,0,0,0,0,0,0,0,0,0,0,0,0,0,0,0,0,0,0,0,0,0,0
168551.0,Saadat Bardia,O,Iran,19.0,205.0,2021,Iran,Poland,2021-06-22,False,2,3,6,11,0,0,0,0,6,7,8,21,0,2,1,3,0,0,0,0,2,0,0,2
168551.0,Saadat Bardia,O,Iran,19.0,205.0,2021,Iran,Argentina,2021-06-23,False,0,0,0,0,0,0,1,1,0,0,0,0,0,0,1,1,0,0,0,0,0,0,0,0
152755.0,Karimisouchelmaei Javad,S,Iran,24.0,204.0,2021,Iran,Australia,2021-06-15,False,0,0,0,0,0,0,1,1,0,0,0,0,0,0,0,0,0,0,0,0,0,0,0,0
152755.0,Karimisouchelmaei Javad,S,Iran,24.0,204.0,2021,Iran,Brazil,2021-06-16,False,0,1,3,4,8,0,29,37,0,1,1,2,1,0,0,1,0,0,0,0,0,1,0,1
152755.0,Karimisouchelmaei Javad,S,Iran,24.0,204.0,2021,Iran,Slovenia,2021-06-17,False,0,0,1,1,0,0,2,2,0,0,0,0,0,0,0,0,0,0,0,0,0,1,0,1
152755.0,Karimisouchelmaei Javad,S,Iran,24.0,204.0,2021,France,Iran,2021-06-21,False,1,1,5,7,7,2,31,40,0,0,0,0,1,1,0,2,0,0,0,0,1,1,0,2
152755.0,Karimisouchelmaei Javad,S,Iran,24.0,204.0,2021,Iran,Poland,2021-06-22,False,1,2,3,6,9,0,42,51,0,0,1,1,1,0,2,3,0,0,0,0,6,1,1,8
152755.0,Karimisouchelmaei Javad,S,Iran,24.0,204.0,2021,Iran,Argentina,2021-06-23,False,1,2,4,7,13,0,29,42,1,0,1,2,1,0,0,1,0,0,1,1,2,0,0,2
152422.0,Gardini Davide,OH,Italy,23.0,205.0,2021,Italy,Slovenia,2021-05-29,False,0,0,0,0,0,0,0,0,0,0,0,0,0,0,0,0,0,0,0,0,0,0,0,0
152422.0,Gardini Davide,OH,Italy,23.0,205.0,2021,Serbia,Italy,2021-05-30,False,0,0,0,0,0,0,0,0,0,0,0,0,0,0,0,0,0,1,0,1,0,0,0,0
152422.0,Gardini Davide,OH,Italy,23.0,205.0,2021,Iran,Italy,2021-06-04,False,0,0,0,0,0,0,0,0,0,0,0,0,0,0,0,0,0,0,0,0,0,0,0,0
152422.0,Gardini Davide,OH,Italy,23.0,205.0,2021,Canada,Italy,2021-06-05,True,0,0,0,0,0,0,0,0,0,0,0,0,0,0,0,0,0,0,0,0,0,0,0,0
152422.0,Gardini Davide,OH,Italy,23.0,205.0,2021,Argentina,Italy,2021-06-09,True,0,0,0,0,0,0,0,0,0,0,0,0,0,0,0,0,0,0,0,0,0,0,0,0
152422.0,Gardini Davide,OH,Italy,23.0,205.0,2021,Japan,Italy,2021-06-10,False,0,0,1,1,0,0,1,1,0,0,3,3,0,0,0,0,0,1,1,2,1,0,0,1
152422.0,Gardini Davide,OH,Italy,23.0,205.0,2021,Australia,Italy,2021-06-11,True,0,0,0,0,0,0,0,0,0,0,0,0,0,0,0,0,0,0,0,0,0,0,0,0
152422.0,Gardini Davide,OH,Italy,23.0,205.0,2021,Italy,USA,2021-06-15,False,0,2,3,5,0,0,0,0,5,1,5,11,0,0,1,1,1,2,7,10,2,2,0,4
152422.0,Gardini Davide,OH,Italy,23.0,205.0,2021,Netherlands,Italy,2021-06-16,True,0,0,0,0,0,0,0,0,0,0,0,0,0,0,0,0,0,0,0,0,0,0,0,0
152422.0,Gardini Davide,OH,Italy,23.0,205.0,2021,France,Italy,2021-06-17,True,0,0,0,0,0,0,0,0,0,0,0,0,0,0,0,0,0,0,0,0,0,0,0,0
152422.0,Gardini Davide,OH,Italy,23.0,205.0,2021,Brazil,Italy,2021-06-21,False,0,0,0,0,0,0,0,0,0,0,0,0,0,0,0,0,0,0,0,0,0,0,0,0
152422.0,Gardini Davide,OH,Italy,23.0,205.0,2021,Russia,Italy,2021-06-22,False,0,0,0,0,0,0,0,0,0,0,0,0,0,0,0,0,0,0,0,0,0,0,0,0
150436.0,Balaso Fabio,L,Italy,26.0,178.0,2021,Poland,Italy,2021-05-28,False,0,0,0,0,0,0,0,0,0,0,0,0,0,0,0,0,6,4,15,25,7,2,1,10
150436.0,Balaso Fabio,L,Italy,26.0,178.0,2021,Italy,Slovenia,2021-05-29,False,0,0,0,0,0,0,7,7,0,0,0,0,0,0,0,0,7,4,6,17,6,0,1,7
150436.0,Balaso Fabio,L,Italy,26.0,178.0,2021,Serbia,Italy,2021-05-30,False,0,0,0,0,0,0,8,8,0,0,0,0,0,0,0,0,8,1,15,24,14,5,2,21
150436.0,Balaso Fabio,L,Italy,26.0,178.0,2021,Italy,Bulgaria,2021-06-03,True,0,0,0,0,0,0,9,9,0,0,0,0,0,0,0,0,8,1,13,22,20,4,1,25
150436.0,Balaso Fabio,L,Italy,26.0,178.0,2021,Iran,Italy,2021-06-04,False,0,0,0,0,0,0,8,8,0,0,0,0,0,0,0,0,11,1,6,18,16,6,0,22
150436.0,Balaso Fabio,L,Italy,26.0,178.0,2021,Canada,Italy,2021-06-05,True,0,0,0,0,0,0,5,5,0,0,0,0,0,0,0,0,0,3,10,13,1,1,2,4
150436.0,Balaso Fabio,L,Italy,26.0,178.0,2021,Argentina,Italy,2021-06-09,True,0,0,0,0,0,0,9,9,0,0,0,0,0,0,0,0,10,1,9,20,8,5,1,14
150436.0,Balaso Fabio,L,Italy,26.0,178.0,2021,Japan,Italy,2021-06-10,False,0,0,0,0,0,0,7,7,0,0,0,0,0,0,0,0,7,2,14,23,18,2,4,24
150436.0,Balaso Fabio,L,Italy,26.0,178.0,2021,Australia,Italy,2021-06-11,True,0,0,0,0,0,0,4,4,0,0,0,0,0,0,0,0,7,0,7,14,13,3,0,16
150436.0,Balaso Fabio,L,Italy,26.0,178.0,2021,Italy,USA,2021-06-15,False,0,0,0,0,0,0,9,9,0,0,0,0,0,0,0,0,4,2,8,14,6,2,2,10
150436.0,Balaso Fabio,L,Italy,26.0,178.0,2021,Netherlands,Italy,2021-06-16,True,0,0,0,0,0,0,9,9,0,0,0,0,0,0,0,0,6,1,17,24,7,3,4,14
150436.0,Balaso Fabio,L,Italy,26.0,178.0,2021,France,Italy,2021-06-17,True,0,0,0,0,0,0,7,7,0,0,0,0,0,0,0,0,14,0,8,22,10,2,0,12
150436.0,Balaso Fabio,L,Italy,26.0,178.0,2021,Brazil,Italy,2021-06-21,False,0,0,0,0,0,0,6,6,0,0,0,0,0,0,0,0,6,1,24,31,13,6,4,23
150436.0,Balaso Fabio,L,Italy,26.0,178.0,2021,Russia,Italy,2021-06-22,False,0,0,0,0,0,0,11,11,0,0,0,0,0,0,0,0,6,3,12,21,10,3,2,15
150436.0,Balaso Fabio,L,Italy,26.0,178.0,2021,Italy,Germany,2021-06-23,True,0,0,0,0,0,0,12,12,0,0,0,0,0,0,0,0,5,3,15,23,12,4,1,17
152370.0,Sbertoli Riccardo,S,Italy,23.0,188.0,2021,Poland,Italy,2021-05-28,False,0,1,7,8,22,0,1,23,1,1,0,2,1,1,2,4,0,0,1,1,5,1,3,9
152370.0,Sbertoli Riccardo,S,Italy,23.0,188.0,2021,Italy,Slovenia,2021-05-29,False,2,0,10,12,23,0,42,65,1,0,0,1,0,1,0,1,0,0,1,1,0,0,0,0
152370.0,Sbertoli Riccardo,S,Italy,23.0,188.0,2021,Serbia,Italy,2021-05-30,False,0,3,7,10,15,0,93,108,0,0,0,0,1,2,1,4,0,0,0,0,8,3,1,12
152370.0,Sbertoli Riccardo,S,Italy,23.0,188.0,2021,Italy,Bulgaria,2021-06-03,True,1,2,15,18,25,0,74,99,0,0,2,2,0,1,2,3,0,0,0,0,6,2,1,9
152370.0,Sbertoli Riccardo,S,Italy,23.0,188.0,2021,Iran,Italy,2021-06-04,False,2,3,12,17,24,2,81,107,0,1,3,4,0,3,2,5,0,0,1,1,8,3,1,12
152370.0,Sbertoli Riccardo,S,Italy,23.0,188.0,2021,Canada,Italy,2021-06-05,True,0,0,0,0,1,0,2,3,0,0,0,0,0,0,0,0,0,0,0,0,1,1,0,2
152370.0,Sbertoli Riccardo,S,Italy,23.0,188.0,2021,Argentina,Italy,2021-06-09,True,0,1,13,14,14,0,64,78,2,0,0,2,1,5,2,8,0,0,0,0,2,2,2,6
152370.0,Sbertoli Riccardo,S,Italy,23.0,188.0,2021,Japan,Italy,2021-06-10,False,0,0,0,0,3,0,10,13,0,0,0,0,0,1,1,2,0,0,0,0,0,0,0,0
152370.0,Sbertoli Riccardo,S,Italy,23.0,188.0,2021,Australia,Italy,2021-06-11,True,0,2,8,10,25,0,45,70,1,0,0,1,0,4,2,6,0,0,0,0,2,0,0,2
152370.0,Sbertoli Riccardo,S,Italy,23.0,188.0,2021,Italy,USA,2021-06-15,False,0,1,4,5,15,0,34,49,0,1,0,1,0,2,0,2,0,0,1,1,5,4,1,10
152370.0,Sbertoli Riccardo,S,Italy,23.0,188.0,2021,Netherlands,Italy,2021-06-16,True,0,2,10,12,14,1,60,75,1,0,1,2,1,3,2,6,0,0,0,0,6,1,2,9
152370.0,Sbertoli Riccardo,S,Italy,23.0,188.0,2021,France,Italy,2021-06-17,True,0,0,0,0,0,0,0,0,0,0,0,0,0,0,0,0,0,0,0,0,0,0,0,0
152370.0,Sbertoli Riccardo,S,Italy,23.0,188.0,2021,Brazil,Italy,2021-06-21,False,0,2,9,11,23,2,65,90,0,0,0,0,1,2,3,6,0,0,0,0,5,5,1,11
152370.0,Sbertoli Riccardo,S,Italy,23.0,188.0,2021,Russia,Italy,2021-06-22,False,0,0,1,1,3,0,6,9,0,0,0,0,0,0,0,0,0,0,0,0,1,1,0,2
152370.0,Sbertoli Riccardo,S,Italy,23.0,188.0,2021,Italy,Germany,2021-06-23,True,0,2,10,12,21,2,44,67,1,0,2,3,1,3,8,12,0,0,0,0,8,1,1,10
171191.0,Michieletto Alessandro,OH,Italy,20.0,205.0,2021,Poland,Italy,2021-05-28,False,0,2,9,11,0,0,0,0,7,1,13,21,0,0,1,1,2,3,15,20,2,0,1,3
171191.0,Michieletto Alessandro,OH,Italy,20.0,205.0,2021,Italy,Slovenia,2021-05-29,False,0,3,4,7,0,0,2,2,6,2,4,12,0,0,0,0,4,2,10,16,1,0,0,1
171191.0,Michieletto Alessandro,OH,Italy,20.0,205.0,2021,Serbia,Italy,2021-05-30,False,0,3,15,18,0,0,0,0,9,4,17,30,2,0,4,6,5,1,14,20,6,2,1,9
171191.0,Michieletto Alessandro,OH,Italy,20.0,205.0,2021,Italy,Bulgaria,2021-06-03,True,0,2,19,21,0,0,1,1,18,0,14,32,3,5,0,8,6,0,23,29,9,4,1,14
171191.0,Michieletto Alessandro,OH,Italy,20.0,205.0,2021,Iran,Italy,2021-06-04,False,1,3,6,10,0,0,2,2,13,4,7,24,0,0,0,0,4,3,13,20,4,0,0,4
171191.0,Michieletto Alessandro,OH,Italy,20.0,205.0,2021,Canada,Italy,2021-06-05,True,0,0,1,1,0,0,0,0,2,0,2,4,0,0,0,0,0,0,2,2,0,1,0,1
171191.0,Michieletto Alessandro,OH,Italy,20.0,205.0,2021,Argentina,Italy,2021-06-09,True,0,3,5,8,0,0,2,2,14,0,11,25,4,1,1,6,8,0,17,25,2,1,0,3
171191.0,Michieletto Alessandro,OH,Italy,20.0,205.0,2021,Japan,Italy,2021-06-10,False,0,1,2,3,0,0,1,1,7,1,3,11,1,0,0,1,1,1,14,16,2,2,1,5
171191.0,Michieletto Alessandro,OH,Italy,20.0,205.0,2021,Australia,Italy,2021-06-11,True,2,3,9,14,0,0,1,1,9,4,7,20,2,0,2,4,6,0,7,13,7,1,0,8
171191.0,Michieletto Alessandro,OH,Italy,20.0,205.0,2021,Italy,USA,2021-06-15,False,0,0,0,0,0,0,0,0,0,0,0,0,0,0,0,0,2,0,0,2,2,0,0,2
171191.0,Michieletto Alessandro,OH,Italy,20.0,205.0,2021,Netherlands,Italy,2021-06-16,True,5,2,18,25,0,0,2,2,14,3,11,28,1,3,3,7,8,2,22,32,9,2,0,11
171191.0,Michieletto Alessandro,OH,Italy,20.0,205.0,2021,France,Italy,2021-06-17,True,0,2,18,20,0,0,4,4,14,1,10,25,1,2,0,3,10,1,13,24,6,2,0,8
171191.0,Michieletto Alessandro,OH,Italy,20.0,205.0,2021,Brazil,Italy,2021-06-21,False,0,2,11,13,0,0,2,2,18,2,12,32,2,2,4,8,4,2,14,20,5,1,1,7
171191.0,Michieletto Alessandro,OH,Italy,20.0,205.0,2021,Russia,Italy,2021-06-22,False,0,1,1,2,0,0,1,1,4,0,1,5,0,0,1,1,2,0,6,8,4,0,0,4
171191.0,Michieletto Alessandro,OH,Italy,20.0,205.0,2021,Italy,Germany,2021-06-23,True,2,4,15,21,0,0,4,4,17,5,13,35,3,2,2,7,5,0,15,20,13,2,1,16
137823.0,Nelli Gabriele,O,Italy,28.0,210.0,2021,Poland,Italy,2021-05-28,False,0,5,4,9,0,0,0,0,10,5,8,23,0,1,1,2,0,0,0,0,7,3,5,15
137823.0,Nelli Gabriele,O,Italy,28.0,210.0,2021,Italy,Slovenia,2021-05-29,False,1,2,7,10,0,1,1,2,6,1,9,16,0,0,1,1,0,0,0,0,1,0,0,1
137823.0,Nelli Gabriele,O,Italy,28.0,210.0,2021,Serbia,Italy,2021-05-30,False,0,1,0,1,0,0,0,0,0,1,1,2,0,0,2,2,0,0,0,0,0,0,0,0
137823.0,Nelli Gabriele,O,Italy,28.0,210.0,2021,Italy,Bulgaria,2021-06-03,True,0,0,2,2,0,0,1,1,0,0,0,0,0,0,0,0,0,0,0,0,0,0,0,0
137823.0,Nelli Gabriele,O,Italy,28.0,210.0,2021,Iran,Italy,2021-06-04,False,3,6,7,16,0,0,4,4,16,5,15,36,1,2,1,4,0,0,0,0,3,4,1,8
137823.0,Nelli Gabriele,O,Italy,28.0,210.0,2021,Canada,Italy,2021-06-05,True,2,5,13,20,0,0,4,4,17,3,13,33,0,2,2,4,0,0,0,0,6,3,1,10
137823.0,Nelli Gabriele,O,Italy,28.0,210.0,2021,Argentina,Italy,2021-06-09,True,2,3,5,10,0,0,0,0,6,5,8,19,0,4,1,5,0,0,0,0,5,2,0,7
137823.0,Nelli Gabriele,O,Italy,28.0,210.0,2021,Japan,Italy,2021-06-10,False,1,3,12,16,0,0,3,3,15,4,12,31,0,2,3,5,1,0,0,1,7,1,2,10
137823.0,Nelli Gabriele,O,Italy,28.0,210.0,2021,Netherlands,Italy,2021-06-16,True,0,0,0,0,0,0,0,0,0,0,0,0,0,0,0,0,0,0,0,0,0,0,0,0
137823.0,Nelli Gabriele,O,Italy,28.0,210.0,2021,France,Italy,2021-06-17,True,1,3,12,16,0,1,2,3,19,5,7,31,1,2,5,8,0,0,0,0,1,6,0,7
137823.0,Nelli Gabriele,O,Italy,28.0,210.0,2021,Brazil,Italy,2021-06-21,False,1,1,7,9,0,0,1,1,4,4,5,13,0,4,3,7,0,0,0,0,2,2,0,4
137823.0,Nelli Gabriele,O,Italy,28.0,210.0,2021,Russia,Italy,2021-06-22,False,1,3,3,7,0,0,1,1,5,2,7,14,1,3,1,5,0,0,0,0,1,2,0,3
137823.0,Nelli Gabriele,O,Italy,28.0,210.0,2021,Italy,Germany,2021-06-23,True,0,5,5,10,0,0,3,3,10,3,11,24,2,5,5,12,0,0,0,0,13,1,2,16
143692.0,Spirito Luca,S,Italy,28.0,196.0,2021,Poland,Italy,2021-05-28,False,0,0,0,0,1,0,0,1,0,0,0,0,0,0,0,0,0,0,0,0,1,1,0,2
143692.0,Spirito Luca,S,Italy,28.0,196.0,2021,Italy,Slovenia,2021-05-29,False,0,0,0,0,1,0,1,2,0,0,0,0,0,0,0,0,0,0,0,0,0,0,0,0
143692.0,Spirito Luca,S,Italy,28.0,196.0,2021,Serbia,Italy,2021-05-30,False,0,0,1,1,2,0,2,4,0,0,0,0,0,1,1,2,0,0,0,0,1,1,0,2
143692.0,Spirito Luca,S,Italy,28.0,196.0,2021,Italy,Bulgaria,2021-06-03,True,0,0,0,0,1,0,4,5,0,0,0,0,0,0,0,0,0,0,0,0,0,0,0,0
143692.0,Spirito Luca,S,Italy,28.0,196.0,2021,Iran,Italy,2021-06-04,False,0,0,2,2,3,0,5,8,0,0,0,0,0,0,0,0,0,0,0,0,0,0,0,0
143692.0,Spirito Luca,S,Italy,28.0,196.0,2021,Canada,Italy,2021-06-05,True,0,1,10,11,10,1,75,86,0,1,3,4,3,1,4,8,0,0,0,0,11,3,0,14
143692.0,Spirito Luca,S,Italy,28.0,196.0,2021,Argentina,Italy,2021-06-09,True,0,0,0,0,0,0,0,0,0,1,0,1,0,0,0,0,0,0,0,0,0,0,0,0
143692.0,Spirito Luca,S,Italy,28.0,196.0,2021,Japan,Italy,2021-06-10,False,0,0,12,12,29,1,74,104,2,0,1,3,2,1,3,6,0,0,0,0,7,2,2,11
143692.0,Spirito Luca,S,Italy,28.0,196.0,2021,Australia,Italy,2021-06-11,True,0,0,0,0,0,0,0,0,0,0,0,0,0,0,0,0,0,0,0,0,0,0,0,0
143692.0,Spirito Luca,S,Italy,28.0,196.0,2021,Italy,USA,2021-06-15,False,0,0,3,3,2,0,10,12,0,0,1,1,0,0,2,2,0,0,0,0,0,0,0,0
143692.0,Spirito Luca,S,Italy,28.0,196.0,2021,Netherlands,Italy,2021-06-16,True,0,0,3,3,3,0,10,13,1,0,0,1,0,0,0,0,0,0,0,0,0,0,0,0
143692.0,Spirito Luca,S,Italy,28.0,196.0,2021,France,Italy,2021-06-17,True,1,2,12,15,20,0,85,105,1,0,0,1,4,1,3,8,0,0,0,0,4,3,0,7
143692.0,Spirito Luca,S,Italy,28.0,196.0,2021,Brazil,Italy,2021-06-21,False,0,0,2,2,5,0,14,19,1,0,0,1,0,1,0,1,0,0,0,0,0,0,0,0
143692.0,Spirito Luca,S,Italy,28.0,196.0,2021,Russia,Italy,2021-06-22,False,1,1,12,14,18,2,64,84,0,2,2,4,1,0,1,2,0,0,1,1,3,3,1,7
143692.0,Spirito Luca,S,Italy,28.0,196.0,2021,Italy,Germany,2021-06-23,True,0,0,4,4,9,0,25,34,0,0,1,1,0,0,2,2,0,0,0,0,2,0,0,2
162518.0,Pinali Giulio,O,Italy,24.0,199.0,2021,Poland,Italy,2021-05-28,False,0,0,0,0,0,0,0,0,0,0,1,1,0,0,0,0,0,0,0,0,0,0,0,0
162518.0,Pinali Giulio,O,Italy,24.0,199.0,2021,Italy,Slovenia,2021-05-29,False,0,1,0,1,0,0,0,0,0,0,0,0,0,0,0,0,0,0,0,0,0,0,0,0
162518.0,Pinali Giulio,O,Italy,24.0,199.0,2021,Serbia,Italy,2021-05-30,False,1,3,12,16,0,0,0,0,21,4,14,39,0,5,1,6,0,0,0,0,3,5,0,8
162518.0,Pinali Giulio,O,Italy,24.0,199.0,2021,Italy,Bulgaria,2021-06-03,True,0,2,12,14,0,0,2,2,18,3,9,30,0,3,1,4,0,0,1,1,6,4,0,10
162518.0,Pinali Giulio,O,Italy,24.0,199.0,2021,Iran,Italy,2021-06-04,False,0,0,1,1,0,0,0,0,1,1,3,5,0,1,0,1,0,0,0,0,0,1,0,1
162518.0,Pinali Giulio,O,Italy,24.0,199.0,2021,Canada,Italy,2021-06-05,True,0,0,0,0,0,0,0,0,0,0,0,0,0,0,0,0,0,0,0,0,0,0,0,0
162518.0,Pinali Giulio,O,Italy,24.0,199.0,2021,Argentina,Italy,2021-06-09,True,0,1,2,3,0,0,0,0,2,0,2,4,0,0,0,0,0,0,0,0,0,0,0,0
162518.0,Pinali Giulio,O,Italy,24.0,199.0,2021,Japan,Italy,2021-06-10,False,0,1,3,4,0,0,0,0,0,1,4,5,0,4,1,5,0,0,0,0,0,1,0,1
162518.0,Pinali Giulio,O,Italy,24.0,199.0,2021,Australia,Italy,2021-06-11,True,1,2,11,14,0,0,0,0,11,1,6,18,1,3,2,6,0,0,0,0,4,4,2,10
162518.0,Pinali Giulio,O,Italy,24.0,199.0,2021,Italy,USA,2021-06-15,False,2,3,5,10,0,0,0,0,5,3,9,17,0,2,7,9,0,1,1,2,5,1,0,6
162518.0,Pinali Giulio,O,Italy,24.0,199.0,2021,Netherlands,Italy,2021-06-16,True,1,3,8,12,0,0,0,0,13,4,7,24,3,9,6,18,0,0,0,0,4,0,0,4
162518.0,Pinali Giulio,O,Italy,24.0,199.0,2021,France,Italy,2021-06-17,True,0,0,1,1,0,0,0,0,0,0,0,0,0,0,0,0,0,0,0,0,1,0,0,1
162518.0,Pinali Giulio,O,Italy,24.0,199.0,2021,Brazil,Italy,2021-06-21,False,1,3,5,9,0,0,2,2,11,1,5,17,0,4,1,5,0,0,0,0,5,1,0,6
162518.0,Pinali Giulio,O,Italy,24.0,199.0,2021,Russia,Italy,2021-06-22,False,2,2,5,9,0,0,1,1,8,2,1,11,0,0,0,0,0,0,0,0,0,4,0,4
162518.0,Pinali Giulio,O,Italy,24.0,199.0,2021,Italy,Germany,2021-06-23,True,1,3,2,6,0,0,0,0,2,3,4,9,1,0,0,1,0,0,0,0,2,0,0,2
152492.0,Cavuto Oreste,OH,Italy,25.0,196.0,2021,Poland,Italy,2021-05-28,False,0,0,0,0,0,0,0,0,0,0,0,0,0,0,0,0,0,0,0,0,0,0,0,0
152492.0,Cavuto Oreste,OH,Italy,25.0,196.0,2021,Italy,Slovenia,2021-05-29,False,0,0,2,2,0,0,0,0,1,2,1,4,0,0,0,0,0,0,1,1,0,0,0,0
152492.0,Cavuto Oreste,OH,Italy,25.0,196.0,2021,Serbia,Italy,2021-05-30,False,0,0,0,0,0,0,0,0,0,0,0,0,0,0,0,0,0,0,0,0,0,0,0,0
152492.0,Cavuto Oreste,OH,Italy,25.0,196.0,2021,Italy,Bulgaria,2021-06-03,True,1,2,10,13,0,0,0,0,15,7,7,29,1,1,2,4,5,1,17,23,0,2,1,3
152492.0,Cavuto Oreste,OH,Italy,25.0,196.0,2021,Iran,Italy,2021-06-04,False,0,1,12,13,0,1,1,2,10,5,14,29,0,5,1,6,11,2,14,27,7,5,0,12
152492.0,Cavuto Oreste,OH,Italy,25.0,196.0,2021,Canada,Italy,2021-06-05,True,0,0,0,0,0,0,0,0,0,0,0,0,0,0,0,0,0,0,0,0,0,0,0,0
152492.0,Cavuto Oreste,OH,Italy,25.0,196.0,2021,Argentina,Italy,2021-06-09,True,0,0,0,0,0,0,0,0,0,0,0,0,0,0,0,0,0,0,0,0,0,0,0,0
152492.0,Cavuto Oreste,OH,Italy,25.0,196.0,2021,Japan,Italy,2021-06-10,False,0,1,0,1,0,0,0,0,0,0,0,0,0,0,0,0,0,0,0,0,0,0,0,0
152492.0,Cavuto Oreste,OH,Italy,25.0,196.0,2021,Australia,Italy,2021-06-11,True,0,4,7,11,0,0,2,2,6,1,8,15,0,1,1,2,1,0,18,19,5,3,0,8
152492.0,Cavuto Oreste,OH,Italy,25.0,196.0,2021,Italy,USA,2021-06-15,False,0,0,3,3,0,0,1,1,4,3,1,8,1,0,0,1,3,2,4,9,1,0,0,1
152492.0,Cavuto Oreste,OH,Italy,25.0,196.0,2021,Netherlands,Italy,2021-06-16,True,0,0,0,0,0,0,0,0,0,0,0,0,0,0,0,0,0,0,0,0,0,0,0,0
152492.0,Cavuto Oreste,OH,Italy,25.0,196.0,2021,France,Italy,2021-06-17,True,0,0,0,0,0,0,0,0,0,0,0,0,0,0,0,0,0,0,0,0,0,0,0,0
152492.0,Cavuto Oreste,OH,Italy,25.0,196.0,2021,Brazil,Italy,2021-06-21,False,0,0,0,0,0,0,0,0,0,0,0,0,0,0,0,0,0,0,0,0,0,0,0,0
152492.0,Cavuto Oreste,OH,Italy,25.0,196.0,2021,Russia,Italy,2021-06-22,False,0,0,2,2,0,0,1,1,6,0,2,8,0,2,1,3,0,0,8,8,1,0,0,1
152492.0,Cavuto Oreste,OH,Italy,25.0,196.0,2021,Italy,Germany,2021-06-23,True,1,1,1,3,0,0,0,0,3,0,2,5,0,0,1,1,3,0,7,10,0,1,0,1
150435.0,Vitelli Marco,MB,Italy,25.0,203.0,2021,Italy,Slovenia,2021-05-29,False,0,2,1,3,0,0,0,0,2,0,1,3,0,0,0,0,0,0,0,0,0,0,0,0
150435.0,Vitelli Marco,MB,Italy,25.0,203.0,2021,Serbia,Italy,2021-05-30,False,0,0,0,0,0,0,0,0,0,0,0,0,0,0,0,0,0,0,0,0,0,0,0,0
150435.0,Vitelli Marco,MB,Italy,25.0,203.0,2021,Italy,Bulgaria,2021-06-03,True,1,2,3,6,0,0,0,0,0,1,1,2,0,0,0,0,0,0,0,0,0,0,0,0
150435.0,Vitelli Marco,MB,Italy,25.0,203.0,2021,Argentina,Italy,2021-06-09,True,2,4,7,13,0,0,0,0,1,1,4,6,4,0,1,5,0,0,0,0,1,2,0,3
150435.0,Vitelli Marco,MB,Italy,25.0,203.0,2021,Japan,Italy,2021-06-10,False,0,2,14,16,0,0,3,3,5,0,7,12,2,7,8,17,0,0,1,1,5,1,3,9
150435.0,Vitelli Marco,MB,Italy,25.0,203.0,2021,Australia,Italy,2021-06-11,True,0,1,1,2,0,0,0,0,0,0,0,0,0,0,0,0,0,0,0,0,0,0,0,0
150435.0,Vitelli Marco,MB,Italy,25.0,203.0,2021,Italy,USA,2021-06-15,False,0,2,1,3,0,0,0,0,0,0,0,0,0,0,0,0,0,0,0,0,0,1,0,1
150435.0,Vitelli Marco,MB,Italy,25.0,203.0,2021,France,Italy,2021-06-17,True,0,3,6,9,0,0,1,1,2,1,0,3,0,0,1,1,1,0,1,2,1,1,0,2
150435.0,Vitelli Marco,MB,Italy,25.0,203.0,2021,Brazil,Italy,2021-06-21,False,0,1,12,13,0,0,0,0,2,0,3,5,2,5,3,10,0,0,1,1,3,1,1,5
150435.0,Vitelli Marco,MB,Italy,25.0,203.0,2021,Russia,Italy,2021-06-22,False,0,1,4,5,0,0,0,0,2,0,0,2,0,1,2,3,0,0,0,0,1,0,0,1
150435.0,Vitelli Marco,MB,Italy,25.0,203.0,2021,Italy,Germany,2021-06-23,True,0,2,8,10,0,0,0,0,1,0,0,1,0,0,0,0,0,0,0,0,0,0,0,0
163028.0,Cortesia Lorenzo,MB,Italy,22.0,198.0,2021,Poland,Italy,2021-05-28,False,0,1,7,8,0,0,0,0,1,0,1,2,1,2,4,7,0,0,0,0,0,0,0,0
163028.0,Cortesia Lorenzo,MB,Italy,22.0,198.0,2021,Italy,Slovenia,2021-05-29,False,0,1,3,4,0,0,0,0,1,2,2,5,0,0,0,0,0,0,1,1,0,0,0,0
163028.0,Cortesia Lorenzo,MB,Italy,22.0,198.0,2021,Italy,Bulgaria,2021-06-03,True,2,2,8,12,0,0,0,0,7,1,1,9,2,7,6,15,0,0,0,0,0,1,0,1
163028.0,Cortesia Lorenzo,MB,Italy,22.0,198.0,2021,Iran,Italy,2021-06-04,False,1,1,12,14,0,0,0,0,8,1,3,12,0,3,2,5,0,0,0,0,1,3,0,4
163028.0,Cortesia Lorenzo,MB,Italy,22.0,198.0,2021,Canada,Italy,2021-06-05,True,1,1,24,26,0,0,0,0,1,0,2,3,5,5,6,16,0,0,1,1,2,0,0,2
163028.0,Cortesia Lorenzo,MB,Italy,22.0,198.0,2021,Argentina,Italy,2021-06-09,True,1,1,11,13,0,0,0,0,2,0,4,6,4,1,3,8,0,0,0,0,1,0,0,1
163028.0,Cortesia Lorenzo,MB,Italy,22.0,198.0,2021,Japan,Italy,2021-06-10,False,0,1,7,8,0,0,1,1,2,1,4,7,3,4,2,9,0,0,0,0,2,0,2,4
163028.0,Cortesia Lorenzo,MB,Italy,22.0,198.0,2021,Australia,Italy,2021-06-11,True,0,0,0,0,0,0,0,0,0,0,0,0,0,0,0,0,0,0,0,0,0,0,0,0
163028.0,Cortesia Lorenzo,MB,Italy,22.0,198.0,2021,Italy,USA,2021-06-15,False,1,1,10,12,0,0,1,1,5,0,5,10,0,5,1,6,0,0,1,1,4,1,0,5
163028.0,Cortesia Lorenzo,MB,Italy,22.0,198.0,2021,Netherlands,Italy,2021-06-16,True,2,1,18,21,0,0,1,1,4,0,3,7,0,5,3,8,1,0,0,1,4,0,0,4
163028.0,Cortesia Lorenzo,MB,Italy,22.0,198.0,2021,France,Italy,2021-06-17,True,1,1,19,21,0,0,0,0,8,0,2,10,4,6,0,10,0,0,0,0,2,0,0,2
163028.0,Cortesia Lorenzo,MB,Italy,22.0,198.0,2021,Brazil,Italy,2021-06-21,False,0,1,3,4,0,0,0,0,1,0,2,3,0,2,4,6,0,0,0,0,2,1,0,3
163028.0,Cortesia Lorenzo,MB,Italy,22.0,198.0,2021,Russia,Italy,2021-06-22,False,0,0,14,14,0,0,1,1,6,1,2,9,6,4,3,13,0,0,0,0,8,2,0,10
163028.0,Cortesia Lorenzo,MB,Italy,22.0,198.0,2021,Italy,Germany,2021-06-23,True,0,0,21,21,0,0,3,3,3,0,1,4,3,5,2,10,0,0,0,0,0,2,0,2
181128.0,Scanferla Leonardo,L,Italy,23.0,184.0,2021,Poland,Italy,2021-05-28,False,0,0,0,0,0,0,0,0,0,0,0,0,0,0,0,0,0,0,0,0,0,0,0,0
181128.0,Scanferla Leonardo,L,Italy,23.0,184.0,2021,Italy,USA,2021-06-15,False,0,0,0,0,0,0,0,0,0,0,0,0,0,0,0,0,0,0,0,0,0,0,0,0
181128.0,Scanferla Leonardo,L,Italy,23.0,184.0,2021,Italy,Germany,2021-06-23,True,0,0,0,0,0,0,0,0,0,0,0,0,0,0,0,0,0,0,0,0,0,0,0,0
163033.0,Recine Francesco,OH,Italy,23.0,186.0,2021,Poland,Italy,2021-05-28,False,0,1,2,3,0,0,0,0,1,0,0,1,0,1,0,1,1,0,4,5,1,0,1,2
163033.0,Recine Francesco,OH,Italy,23.0,186.0,2021,Italy,Slovenia,2021-05-29,False,0,1,1,2,0,0,0,0,2,1,3,6,0,0,0,0,1,1,4,6,0,0,0,0
163033.0,Recine Francesco,OH,Italy,23.0,186.0,2021,Serbia,Italy,2021-05-30,False,0,2,13,15,0,0,0,0,9,5,18,32,1,2,4,7,9,1,18,28,8,3,0,11
163033.0,Recine Francesco,OH,Italy,23.0,186.0,2021,Italy,Bulgaria,2021-06-03,True,1,0,4,5,0,0,1,1,0,1,1,2,0,0,0,0,3,0,4,7,1,3,0,4
163033.0,Recine Francesco,OH,Italy,23.0,186.0,2021,Iran,Italy,2021-06-04,False,0,1,9,10,0,0,1,1,8,2,4,14,1,2,0,3,11,1,8,20,4,1,0,5
163033.0,Recine Francesco,OH,Italy,23.0,186.0,2021,Canada,Italy,2021-06-05,True,0,2,12,14,0,0,2,2,16,4,12,32,3,2,3,8,15,2,21,38,5,5,4,14
163033.0,Recine Francesco,OH,Italy,23.0,186.0,2021,Argentina,Italy,2021-06-09,True,1,2,12,15,0,0,0,0,11,4,13,28,2,1,0,3,4,0,6,10,5,4,2,11
163033.0,Recine Francesco,OH,Italy,23.0,186.0,2021,Japan,Italy,2021-06-10,False,0,1,11,12,0,0,1,1,16,2,16,34,0,4,3,7,5,0,19,24,4,1,2,7
163033.0,Recine Francesco,OH,Italy,23.0,186.0,2021,Australia,Italy,2021-06-11,True,0,0,0,0,0,0,0,0,0,0,0,0,0,0,0,0,0,0,0,0,0,0,0,0
163033.0,Recine Francesco,OH,Italy,23.0,186.0,2021,Italy,USA,2021-06-15,False,0,1,4,5,0,0,2,2,1,3,6,10,0,2,0,2,1,1,7,9,1,0,0,1
163033.0,Recine Francesco,OH,Italy,23.0,186.0,2021,Netherlands,Italy,2021-06-16,True,0,3,9,12,0,0,3,3,16,4,11,31,4,1,0,5,5,2,9,16,5,2,0,7
163033.0,Recine Francesco,OH,Italy,23.0,186.0,2021,France,Italy,2021-06-17,True,1,2,7,10,0,0,0,0,11,6,12,29,0,1,0,1,14,0,9,23,2,3,0,5
163033.0,Recine Francesco,OH,Italy,23.0,186.0,2021,Brazil,Italy,2021-06-21,False,0,2,9,11,0,0,1,1,16,5,17,38,1,5,2,8,5,2,23,30,6,0,1,7
163033.0,Recine Francesco,OH,Italy,23.0,186.0,2021,Russia,Italy,2021-06-22,False,0,2,5,7,0,0,1,1,10,6,9,25,1,1,0,2,6,0,21,27,6,0,0,6
163033.0,Recine Francesco,OH,Italy,23.0,186.0,2021,Italy,Germany,2021-06-23,True,0,0,0,0,0,0,0,0,0,0,0,0,0,0,0,0,0,1,0,1,0,0,0,0
163447.0,Bottolo Mattia,OH,Italy,22.0,196.0,2021,Poland,Italy,2021-05-28,False,0,3,5,8,0,0,0,0,9,5,13,27,2,2,4,8,2,1,4,7,3,1,0,4
163447.0,Bottolo Mattia,OH,Italy,22.0,196.0,2021,Italy,Slovenia,2021-05-29,False,0,1,5,6,0,0,1,1,4,4,12,20,1,0,0,1,9,1,7,17,0,0,0,0
163447.0,Bottolo Mattia,OH,Italy,22.0,196.0,2021,Serbia,Italy,2021-05-30,False,0,0,0,0,0,0,0,0,0,0,0,0,0,0,0,0,0,0,0,0,0,0,0,0
163447.0,Bottolo Mattia,OH,Italy,22.0,196.0,2021,Italy,Bulgaria,2021-06-03,True,0,0,0,0,0,0,0,0,0,0,0,0,0,0,0,0,0,0,0,0,0,0,0,0
163447.0,Bottolo Mattia,OH,Italy,22.0,196.0,2021,Iran,Italy,2021-06-04,False,0,1,0,1,0,0,0,0,0,0,0,0,0,0,0,0,0,0,0,0,0,0,0,0
163447.0,Bottolo Mattia,OH,Italy,22.0,196.0,2021,Canada,Italy,2021-06-05,True,2,4,17,23,0,0,3,3,10,7,11,28,2,3,4,9,4,2,13,19,5,2,1,8
163447.0,Bottolo Mattia,OH,Italy,22.0,196.0,2021,Argentina,Italy,2021-06-09,True,0,0,0,0,0,0,0,0,0,0,0,0,0,0,0,0,0,0,0,0,0,0,0,0
163447.0,Bottolo Mattia,OH,Italy,22.0,196.0,2021,Japan,Italy,2021-06-10,False,2,3,10,15,0,0,0,0,9,4,10,23,4,6,3,13,2,2,23,27,3,3,3,9
163447.0,Bottolo Mattia,OH,Italy,22.0,196.0,2021,Australia,Italy,2021-06-11,True,0,0,0,0,0,0,0,0,0,0,0,0,0,0,0,0,0,0,0,0,0,0,0,0
163447.0,Bottolo Mattia,OH,Italy,22.0,196.0,2021,Italy,USA,2021-06-15,False,0,1,3,4,0,0,0,0,5,3,7,15,0,0,0,0,4,0,6,10,2,1,0,3
163447.0,Bottolo Mattia,OH,Italy,22.0,196.0,2021,Netherlands,Italy,2021-06-16,True,0,0,0,0,0,0,0,0,0,0,0,0,0,0,0,0,0,0,0,0,0,0,0,0
163447.0,Bottolo Mattia,OH,Italy,22.0,196.0,2021,France,Italy,2021-06-17,True,1,2,3,6,0,0,0,0,7,1,6,14,0,0,1,1,1,2,7,10,1,0,0,1
163447.0,Bottolo Mattia,OH,Italy,22.0,196.0,2021,Brazil,Italy,2021-06-21,False,1,2,1,4,0,0,0,0,2,0,2,4,0,0,0,0,1,0,1,2,0,0,0,0
163447.0,Bottolo Mattia,OH,Italy,22.0,196.0,2021,Russia,Italy,2021-06-22,False,4,5,23,32,0,0,3,3,10,7,12,29,0,2,0,2,5,2,10,17,6,2,0,8
163447.0,Bottolo Mattia,OH,Italy,22.0,196.0,2021,Italy,Germany,2021-06-23,True,1,4,6,11,0,0,0,0,12,5,13,30,1,1,1,3,4,1,15,20,4,1,0,5
174074.0,Mosca Leandro Ausibio,MB,Italy,21.0,208.0,2021,Poland,Italy,2021-05-28,False,0,0,1,1,0,0,0,0,0,0,0,0,0,0,1,1,0,0,0,0,0,0,0,0
174074.0,Mosca Leandro Ausibio,MB,Italy,21.0,208.0,2021,Serbia,Italy,2021-05-30,False,0,0,13,13,0,0,0,0,6,0,6,12,2,5,2,9,1,0,0,1,2,1,0,3
174074.0,Mosca Leandro Ausibio,MB,Italy,21.0,208.0,2021,Italy,Bulgaria,2021-06-03,True,0,0,0,0,0,0,0,0,0,0,0,0,0,0,0,0,0,0,0,0,0,0,0,0
174074.0,Mosca Leandro Ausibio,MB,Italy,21.0,208.0,2021,Iran,Italy,2021-06-04,False,0,0,2,2,0,0,0,0,0,0,2,2,0,0,0,0,0,0,0,0,0,0,0,0
174074.0,Mosca Leandro Ausibio,MB,Italy,21.0,208.0,2021,Canada,Italy,2021-06-05,True,0,1,12,13,0,0,3,3,3,0,1,4,5,6,4,15,0,0,0,0,0,1,0,1
174074.0,Mosca Leandro Ausibio,MB,Italy,21.0,208.0,2021,Argentina,Italy,2021-06-09,True,0,0,3,3,0,0,0,0,0,0,0,0,1,1,0,2,1,0,0,1,0,0,0,0
174074.0,Mosca Leandro Ausibio,MB,Italy,21.0,208.0,2021,Japan,Italy,2021-06-10,False,0,1,7,8,0,0,0,0,3,1,2,6,0,3,4,7,0,0,0,0,0,0,1,1
174074.0,Mosca Leandro Ausibio,MB,Italy,21.0,208.0,2021,Australia,Italy,2021-06-11,True,0,0,12,12,0,0,0,0,5,1,2,8,1,0,3,4,0,0,0,0,0,1,0,1
174074.0,Mosca Leandro Ausibio,MB,Italy,21.0,208.0,2021,Italy,USA,2021-06-15,False,0,0,5,5,0,0,0,0,4,1,1,6,0,1,1,2,0,1,0,1,1,0,0,1
174074.0,Mosca Leandro Ausibio,MB,Italy,21.0,208.0,2021,Netherlands,Italy,2021-06-16,True,0,1,10,11,0,0,2,2,3,2,4,9,3,3,8,14,0,0,0,0,1,0,0,1
174074.0,Mosca Leandro Ausibio,MB,Italy,21.0,208.0,2021,France,Italy,2021-06-17,True,1,0,8,9,0,1,0,1,2,2,3,7,1,2,1,4,1,0,2,3,3,1,0,4
174074.0,Mosca Leandro Ausibio,MB,Italy,21.0,208.0,2021,Brazil,Italy,2021-06-21,False,0,1,18,19,0,0,0,0,6,1,4,11,3,6,7,16,0,0,3,3,3,0,0,3
174074.0,Mosca Leandro Ausibio,MB,Italy,21.0,208.0,2021,Russia,Italy,2021-06-22,False,0,0,7,7,0,0,0,0,6,0,0,6,1,1,1,3,0,0,1,1,1,0,0,1
174074.0,Mosca Leandro Ausibio,MB,Italy,21.0,208.0,2021,Italy,Germany,2021-06-23,True,0,1,10,11,0,0,0,0,9,1,3,13,4,6,4,14,0,0,4,4,2,0,0,2
163025.0,Federici Filippo,L,Italy,21.0,172.0,2021,Poland,Italy,2021-05-28,False,0,0,0,0,0,0,0,0,0,0,0,0,0,0,0,0,0,1,1,2,0,0,0,0
163025.0,Federici Filippo,L,Italy,21.0,172.0,2021,Italy,Slovenia,2021-05-29,False,0,0,0,0,0,0,0,0,0,0,0,0,0,0,0,0,0,0,0,0,0,0,0,0
163025.0,Federici Filippo,L,Italy,21.0,172.0,2021,Serbia,Italy,2021-05-30,False,0,0,0,0,0,0,0,0,0,0,0,0,0,0,0,0,0,0,0,0,0,0,0,0
163025.0,Federici Filippo,L,Italy,21.0,172.0,2021,Italy,Bulgaria,2021-06-03,True,0,0,0,0,0,0,0,0,0,0,0,0,0,0,0,0,0,0,0,0,0,0,0,0
163025.0,Federici Filippo,L,Italy,21.0,172.0,2021,Iran,Italy,2021-06-04,False,0,0,0,0,0,0,0,0,0,0,0,0,0,0,0,0,0,0,0,0,0,0,0,0
163025.0,Federici Filippo,L,Italy,21.0,172.0,2021,Canada,Italy,2021-06-05,True,0,0,0,0,0,0,4,4,0,0,0,0,0,0,0,0,4,1,8,13,5,4,1,10
163025.0,Federici Filippo,L,Italy,21.0,172.0,2021,Argentina,Italy,2021-06-09,True,0,0,0,0,0,0,0,0,0,0,0,0,0,0,0,0,0,0,0,0,0,0,0,0
163025.0,Federici Filippo,L,Italy,21.0,172.0,2021,Japan,Italy,2021-06-10,False,0,0,0,0,0,0,0,0,0,0,0,0,0,0,0,0,0,0,0,0,0,0,0,0
163025.0,Federici Filippo,L,Italy,21.0,172.0,2021,Australia,Italy,2021-06-11,True,0,0,0,0,0,0,0,0,0,0,0,0,0,0,0,0,0,0,0,0,0,0,0,0
163025.0,Federici Filippo,L,Italy,21.0,172.0,2021,Italy,USA,2021-06-15,False,0,0,0,0,0,0,0,0,0,0,0,0,0,0,0,0,0,0,0,0,0,0,0,0
163025.0,Federici Filippo,L,Italy,21.0,172.0,2021,Netherlands,Italy,2021-06-16,True,0,0,0,0,0,0,0,0,0,0,0,0,0,0,0,0,0,0,0,0,0,0,0,0
163025.0,Federici Filippo,L,Italy,21.0,172.0,2021,France,Italy,2021-06-17,True,0,0,0,0,0,0,0,0,0,0,0,0,0,0,0,0,0,0,0,0,0,0,0,0
163025.0,Federici Filippo,L,Italy,21.0,172.0,2021,Brazil,Italy,2021-06-21,False,0,0,0,0,0,0,0,0,0,0,0,0,0,0,0,0,0,0,0,0,0,0,0,0
163025.0,Federici Filippo,L,Italy,21.0,172.0,2021,Russia,Italy,2021-06-22,False,0,0,0,0,0,0,0,0,0,0,0,0,0,0,0,0,0,0,0,0,0,0,0,0
163025.0,Federici Filippo,L,Italy,21.0,172.0,2021,Italy,Germany,2021-06-23,True,0,0,0,0,0,0,0,0,0,0,0,0,0,0,0,0,0,0,0,0,0,0,0,0
118511.0,Shimizu Kunihiro,O,Japan,35.0,193.0,2021,Japan,Iran,2021-05-28,True,0,0,9,9,0,0,1,1,3,1,4,8,0,0,0,0,0,0,0,0,0,0,0,0
118511.0,Shimizu Kunihiro,O,Japan,35.0,193.0,2021,Netherlands,Japan,2021-05-29,True,0,0,9,9,0,0,0,0,7,4,1,12,0,1,1,2,0,1,1,2,0,0,1,1
118511.0,Shimizu Kunihiro,O,Japan,35.0,193.0,2021,Japan,Serbia,2021-06-03,False,0,0,7,7,0,1,1,2,12,3,6,21,1,2,0,3,2,0,1,3,0,3,1,4
118511.0,Shimizu Kunihiro,O,Japan,35.0,193.0,2021,Brazil,Japan,2021-06-04,False,0,1,7,8,0,0,0,0,8,4,2,14,0,1,0,1,0,0,1,1,1,1,0,2
118511.0,Shimizu Kunihiro,O,Japan,35.0,193.0,2021,France,Japan,2021-06-05,False,1,2,12,15,1,0,0,1,16,7,13,36,1,5,3,9,0,0,0,0,2,2,1,5
118511.0,Shimizu Kunihiro,O,Japan,35.0,193.0,2021,Japan,Australia,2021-06-09,True,1,1,16,18,0,0,1,1,15,4,12,31,1,2,3,6,0,0,0,0,4,2,0,6
118511.0,Shimizu Kunihiro,O,Japan,35.0,193.0,2021,Japan,Italy,2021-06-10,True,1,0,2,3,0,0,1,1,3,2,6,11,1,1,3,5,0,0,0,0,1,0,1,2
118511.0,Shimizu Kunihiro,O,Japan,35.0,193.0,2021,Japan,Argentina,2021-06-11,False,0,0,3,3,0,0,0,0,5,0,3,8,0,0,1,1,0,0,0,0,1,1,1,3
118511.0,Shimizu Kunihiro,O,Japan,35.0,193.0,2021,Japan,Germany,2021-06-15,True,0,1,8,9,0,0,0,0,11,3,7,21,0,0,2,2,0,0,0,0,1,1,1,3
118511.0,Shimizu Kunihiro,O,Japan,35.0,193.0,2021,Japan,Canada,2021-06-17,False,0,2,4,6,0,0,0,0,10,2,12,24,1,2,2,5,0,0,1,1,5,0,0,5
118511.0,Shimizu Kunihiro,O,Japan,35.0,193.0,2021,Japan,Bulgaria,2021-06-21,True,0,1,2,3,0,0,0,0,1,0,1,2,0,0,0,0,0,0,1,1,0,0,0,0
118511.0,Shimizu Kunihiro,O,Japan,35.0,193.0,2021,Japan,Slovenia,2021-06-22,False,0,1,9,10,0,0,0,0,12,10,7,29,0,2,0,2,0,0,1,1,1,1,0,2
118511.0,Shimizu Kunihiro,O,Japan,35.0,193.0,2021,USA,Japan,2021-06-23,False,0,1,0,1,0,0,0,0,0,0,1,1,0,0,0,0,0,0,0,0,0,0,0,0
142565.0,Onodera Taishi,MB,Japan,26.0,200.0,2021,Japan,Iran,2021-05-28,True,0,1,10,11,0,0,0,0,4,0,3,7,0,0,1,1,0,0,0,0,1,0,0,1
142565.0,Onodera Taishi,MB,Japan,26.0,200.0,2021,Netherlands,Japan,2021-05-29,True,2,1,17,20,0,0,0,0,6,1,7,14,0,1,1,2,0,0,0,0,2,0,0,2
142565.0,Onodera Taishi,MB,Japan,26.0,200.0,2021,Russia,Japan,2021-05-30,True,0,1,0,1,0,0,0,0,0,0,0,0,0,0,0,0,0,0,0,0,0,0,0,0
142565.0,Onodera Taishi,MB,Japan,26.0,200.0,2021,Japan,Serbia,2021-06-03,False,0,2,12,14,0,0,1,1,4,0,3,7,3,4,0,7,0,0,0,0,1,0,0,1
142565.0,Onodera Taishi,MB,Japan,26.0,200.0,2021,France,Japan,2021-06-05,False,2,4,14,20,0,0,0,0,8,0,5,13,2,2,0,4,0,0,1,1,1,4,1,6
142565.0,Onodera Taishi,MB,Japan,26.0,200.0,2021,Japan,Australia,2021-06-09,True,0,2,8,10,0,0,0,0,7,3,6,16,2,4,4,10,0,0,2,2,1,2,0,3
142565.0,Onodera Taishi,MB,Japan,26.0,200.0,2021,Japan,Italy,2021-06-10,True,0,0,12,12,0,0,2,2,2,1,4,7,1,4,0,5,2,0,1,3,2,2,0,4
142565.0,Onodera Taishi,MB,Japan,26.0,200.0,2021,Japan,Argentina,2021-06-11,False,0,0,0,0,0,0,0,0,0,0,0,0,0,0,0,0,0,0,0,0,0,0,0,0
142565.0,Onodera Taishi,MB,Japan,26.0,200.0,2021,Japan,Germany,2021-06-15,True,0,2,7,9,0,0,0,0,6,1,3,10,2,3,0,5,2,0,0,2,1,0,0,1
142565.0,Onodera Taishi,MB,Japan,26.0,200.0,2021,Japan,Canada,2021-06-17,False,0,0,9,9,0,0,0,0,4,0,2,6,0,4,7,11,3,0,0,3,4,1,0,5
142565.0,Onodera Taishi,MB,Japan,26.0,200.0,2021,Japan,Bulgaria,2021-06-21,True,0,0,6,6,0,0,0,0,6,1,3,10,2,7,1,10,0,0,1,1,2,1,0,3
142565.0,Onodera Taishi,MB,Japan,26.0,200.0,2021,Japan,Slovenia,2021-06-22,False,0,0,0,0,0,0,0,0,0,0,0,0,0,0,0,0,0,0,0,0,0,0,0,0
142565.0,Onodera Taishi,MB,Japan,26.0,200.0,2021,USA,Japan,2021-06-23,False,0,2,6,8,0,0,0,0,2,1,6,9,1,3,1,5,1,0,0,1,1,1,0,2
162104.0,Fujii Naonobu,S,Japan,30.0,183.0,2021,Japan,Iran,2021-05-28,True,0,0,10,10,3,0,71,74,0,0,1,1,0,0,0,0,0,0,0,0,0,0,1,1
162104.0,Fujii Naonobu,S,Japan,30.0,183.0,2021,Netherlands,Japan,2021-05-29,True,0,0,3,3,8,0,51,59,0,0,0,0,0,0,2,2,0,0,0,0,1,1,0,2
162104.0,Fujii Naonobu,S,Japan,30.0,183.0,2021,Japan,Serbia,2021-06-03,False,1,0,9,10,13,0,32,45,1,0,0,1,1,0,0,1,0,0,0,0,4,2,0,6
162104.0,Fujii Naonobu,S,Japan,30.0,183.0,2021,Brazil,Japan,2021-06-04,False,0,0,4,4,16,0,25,41,0,0,0,0,0,0,0,0,0,0,0,0,4,2,1,7
162104.0,Fujii Naonobu,S,Japan,30.0,183.0,2021,France,Japan,2021-06-05,False,0,1,10,11,24,1,68,93,0,0,1,1,0,2,2,4,0,0,1,1,3,3,0,6
162104.0,Fujii Naonobu,S,Japan,30.0,183.0,2021,Japan,Australia,2021-06-09,True,0,2,18,20,36,0,58,94,0,0,0,0,1,4,0,5,0,0,0,0,7,1,1,9
162104.0,Fujii Naonobu,S,Japan,30.0,183.0,2021,Japan,Italy,2021-06-10,True,0,1,15,16,41,1,59,101,1,0,0,1,0,2,0,2,0,0,0,0,5,1,2,8
162104.0,Fujii Naonobu,S,Japan,30.0,183.0,2021,Japan,Argentina,2021-06-11,False,0,0,0,0,0,0,0,0,0,0,0,0,0,0,0,0,0,0,0,0,0,0,0,0
162104.0,Fujii Naonobu,S,Japan,30.0,183.0,2021,USA,Japan,2021-06-23,False,0,1,5,6,9,0,40,49,0,0,0,0,0,0,0,0,0,0,0,0,2,2,0,4
142575.0,Otake Issei,O,Japan,26.0,202.0,2021,Russia,Japan,2021-05-30,True,1,5,5,11,0,0,0,0,21,2,6,29,3,0,2,5,0,0,0,0,3,5,2,10
142575.0,Otake Issei,O,Japan,26.0,202.0,2021,Japan,Serbia,2021-06-03,False,1,3,3,7,0,1,0,1,8,6,5,19,0,2,2,4,0,0,0,0,1,1,1,3
142575.0,Otake Issei,O,Japan,26.0,202.0,2021,Brazil,Japan,2021-06-04,False,0,0,0,0,0,0,0,0,0,0,0,0,0,0,0,0,0,0,0,0,0,0,0,0
142575.0,Otake Issei,O,Japan,26.0,202.0,2021,Japan,Australia,2021-06-09,True,0,0,2,2,0,0,1,1,2,2,5,9,0,1,4,5,0,0,0,0,2,0,1,3
142575.0,Otake Issei,O,Japan,26.0,202.0,2021,Japan,Argentina,2021-06-11,False,0,4,5,9,0,0,2,2,15,2,15,32,0,2,3,5,0,0,0,0,8,3,2,13
142575.0,Otake Issei,O,Japan,26.0,202.0,2021,Japan,Poland,2021-06-16,False,0,2,1,3,0,0,0,0,3,2,4,9,0,0,1,1,0,0,0,0,2,0,1,3
114415.0,Fukuzawa Tatsuya,OH,Japan,35.0,189.0,2021,Japan,Iran,2021-05-28,True,0,0,0,0,0,0,0,0,0,0,0,0,0,0,0,0,0,0,0,0,0,0,0,0
114415.0,Fukuzawa Tatsuya,OH,Japan,35.0,189.0,2021,Netherlands,Japan,2021-05-29,True,0,0,0,0,0,0,0,0,0,0,0,0,0,0,0,0,0,0,0,0,0,0,0,0
114415.0,Fukuzawa Tatsuya,OH,Japan,35.0,189.0,2021,Russia,Japan,2021-05-30,True,0,2,6,8,0,0,0,0,14,5,9,28,0,2,0,2,6,1,12,19,5,0,2,7
114415.0,Fukuzawa Tatsuya,OH,Japan,35.0,189.0,2021,Japan,Serbia,2021-06-03,False,0,0,0,0,0,0,0,0,0,0,0,0,0,0,0,0,0,0,0,0,0,0,0,0
114415.0,Fukuzawa Tatsuya,OH,Japan,35.0,189.0,2021,Brazil,Japan,2021-06-04,False,0,1,2,3,0,0,0,0,2,2,3,7,0,0,2,2,2,0,6,8,3,0,0,3
114415.0,Fukuzawa Tatsuya,OH,Japan,35.0,189.0,2021,France,Japan,2021-06-05,False,0,0,0,0,0,0,0,0,0,0,0,0,0,0,0,0,0,0,0,0,0,0,0,0
114415.0,Fukuzawa Tatsuya,OH,Japan,35.0,189.0,2021,Japan,Australia,2021-06-09,True,0,0,0,0,0,0,0,0,0,0,0,0,0,0,0,0,0,0,0,0,0,0,0,0
114415.0,Fukuzawa Tatsuya,OH,Japan,35.0,189.0,2021,Japan,Italy,2021-06-10,True,0,0,0,0,0,0,0,0,0,0,0,0,0,0,0,0,0,0,0,0,0,0,0,0
114415.0,Fukuzawa Tatsuya,OH,Japan,35.0,189.0,2021,Japan,Argentina,2021-06-11,False,0,1,11,12,0,0,4,4,12,10,10,32,0,2,2,4,6,2,17,25,7,1,0,8
114415.0,Fukuzawa Tatsuya,OH,Japan,35.0,189.0,2021,Japan,Germany,2021-06-15,True,0,0,0,0,0,0,0,0,0,0,0,0,0,0,0,0,0,0,0,0,0,0,0,0
114415.0,Fukuzawa Tatsuya,OH,Japan,35.0,189.0,2021,Japan,Poland,2021-06-16,False,0,2,0,2,0,0,1,1,3,2,6,11,0,1,0,1,1,1,5,7,3,0,0,3
114415.0,Fukuzawa Tatsuya,OH,Japan,35.0,189.0,2021,Japan,Canada,2021-06-17,False,0,0,0,0,0,0,0,0,0,0,0,0,0,0,0,0,0,0,0,0,0,0,0,0
114415.0,Fukuzawa Tatsuya,OH,Japan,35.0,189.0,2021,Japan,Bulgaria,2021-06-21,True,0,0,0,0,0,0,0,0,0,0,0,0,0,0,0,0,0,0,0,0,0,0,0,0
114415.0,Fukuzawa Tatsuya,OH,Japan,35.0,189.0,2021,Japan,Slovenia,2021-06-22,False,0,1,0,1,0,0,0,0,2,1,1,4,0,1,0,1,3,0,5,8,1,0,0,1
146409.0,Yamauchi Akihiro,MB,Japan,28.0,204.0,2021,Japan,Iran,2021-05-28,True,0,0,11,11,0,1,0,1,2,1,5,8,3,2,0,5,0,0,0,0,0,0,0,0
146409.0,Yamauchi Akihiro,MB,Japan,28.0,204.0,2021,Netherlands,Japan,2021-05-29,True,0,0,2,2,0,0,0,0,0,0,1,1,0,0,0,0,0,0,0,0,0,0,0,0
146409.0,Yamauchi Akihiro,MB,Japan,28.0,204.0,2021,Russia,Japan,2021-05-30,True,0,0,0,0,0,0,0,0,0,0,0,0,0,0,0,0,0,0,0,0,0,0,0,0
146409.0,Yamauchi Akihiro,MB,Japan,28.0,204.0,2021,Japan,Serbia,2021-06-03,False,0,2,8,10,0,0,0,0,6,0,2,8,1,2,0,3,0,0,0,0,2,1,0,3
146409.0,Yamauchi Akihiro,MB,Japan,28.0,204.0,2021,Brazil,Japan,2021-06-04,False,1,0,10,11,0,0,2,2,4,0,4,8,2,3,1,6,0,0,3,3,0,0,1,1
146409.0,Yamauchi Akihiro,MB,Japan,28.0,204.0,2021,France,Japan,2021-06-05,False,0,2,9,11,0,0,1,1,2,1,1,4,0,2,1,3,0,0,0,0,0,0,0,0
146409.0,Yamauchi Akihiro,MB,Japan,28.0,204.0,2021,Japan,Australia,2021-06-09,True,0,0,0,0,0,0,0,0,0,0,0,0,0,0,0,0,0,0,0,0,0,0,0,0
146409.0,Yamauchi Akihiro,MB,Japan,28.0,204.0,2021,Japan,Italy,2021-06-10,True,0,0,8,8,0,0,1,1,3,0,3,6,1,0,2,3,2,0,1,3,2,0,1,3
146409.0,Yamauchi Akihiro,MB,Japan,28.0,204.0,2021,Japan,Argentina,2021-06-11,False,0,1,10,11,0,0,1,1,9,1,3,13,2,8,1,11,0,0,2,2,1,0,0,1
146409.0,Yamauchi Akihiro,MB,Japan,28.0,204.0,2021,Japan,Germany,2021-06-15,True,1,0,9,10,0,0,2,2,2,1,2,5,1,0,0,1,0,0,0,0,0,1,0,1
146409.0,Yamauchi Akihiro,MB,Japan,28.0,204.0,2021,Japan,Poland,2021-06-16,False,0,0,2,2,0,0,1,1,2,0,2,4,0,1,3,4,0,0,1,1,2,1,0,3
146409.0,Yamauchi Akihiro,MB,Japan,28.0,204.0,2021,Japan,Canada,2021-06-17,False,0,1,10,11,0,0,0,0,5,1,2,8,0,6,3,9,1,0,3,4,3,0,0,3
146409.0,Yamauchi Akihiro,MB,Japan,28.0,204.0,2021,Japan,Bulgaria,2021-06-21,True,1,0,15,16,0,0,0,0,5,1,2,8,0,3,1,4,0,0,0,0,3,2,0,5
146409.0,Yamauchi Akihiro,MB,Japan,28.0,204.0,2021,Japan,Slovenia,2021-06-22,False,0,0,7,7,0,0,2,2,0,1,2,3,2,2,1,5,1,0,0,1,1,1,0,2
146409.0,Yamauchi Akihiro,MB,Japan,28.0,204.0,2021,USA,Japan,2021-06-23,False,0,0,9,9,0,0,0,0,5,1,5,11,0,1,0,1,0,0,0,0,2,1,0,3
163519.0,Nishida Yuji,O,Japan,22.0,187.0,2021,Japan,Poland,2021-06-16,False,0,2,1,3,0,0,0,0,2,3,1,6,0,0,0,0,0,0,0,0,2,0,0,2
163519.0,Nishida Yuji,O,Japan,22.0,187.0,2021,Japan,Canada,2021-06-17,False,0,1,2,3,0,0,1,1,0,1,1,2,0,0,0,0,0,0,0,0,2,2,0,4
163519.0,Nishida Yuji,O,Japan,22.0,187.0,2021,Japan,Bulgaria,2021-06-21,True,0,3,5,8,0,0,0,0,20,4,5,29,3,4,2,9,0,0,0,0,4,2,0,6
163519.0,Nishida Yuji,O,Japan,22.0,187.0,2021,Japan,Slovenia,2021-06-22,False,0,1,2,3,0,0,1,1,5,0,4,9,1,1,1,3,0,0,0,0,0,1,0,1
163519.0,Nishida Yuji,O,Japan,22.0,187.0,2021,USA,Japan,2021-06-23,False,0,1,8,9,0,0,0,0,9,5,10,24,1,0,1,2,0,0,0,0,1,0,0,1
133009.0,Sekita Masahiro,S,Japan,28.0,175.0,2021,Japan,Iran,2021-05-28,True,0,1,2,3,1,0,14,15,0,0,0,0,0,0,0,0,0,0,0,0,0,0,0,0
133009.0,Sekita Masahiro,S,Japan,28.0,175.0,2021,Netherlands,Japan,2021-05-29,True,0,3,10,13,21,0,28,49,0,0,0,0,1,1,1,3,0,0,0,0,1,1,1,3
133009.0,Sekita Masahiro,S,Japan,28.0,175.0,2021,Russia,Japan,2021-05-30,True,1,0,11,12,15,0,64,79,0,0,0,0,0,1,2,3,0,0,1,1,6,2,1,9
133009.0,Sekita Masahiro,S,Japan,28.0,175.0,2021,Japan,Serbia,2021-06-03,False,0,0,5,5,9,1,41,51,0,0,2,2,0,0,0,0,0,0,0,0,1,1,0,2
133009.0,Sekita Masahiro,S,Japan,28.0,175.0,2021,France,Japan,2021-06-05,False,0,0,2,2,3,0,14,17,0,0,0,0,0,1,0,1,0,0,1,1,0,1,0,1
133009.0,Sekita Masahiro,S,Japan,28.0,175.0,2021,Japan,Australia,2021-06-09,True,0,0,1,1,5,0,8,13,0,0,0,0,0,0,0,0,0,0,0,0,2,2,0,4
133009.0,Sekita Masahiro,S,Japan,28.0,175.0,2021,Japan,Italy,2021-06-10,True,0,0,0,0,5,0,16,21,0,0,0,0,0,0,0,0,0,0,0,0,4,0,0,4
133009.0,Sekita Masahiro,S,Japan,28.0,175.0,2021,Japan,Argentina,2021-06-11,False,1,4,14,19,37,1,78,116,0,1,0,1,0,3,1,4,0,0,2,2,14,5,1,20
133009.0,Sekita Masahiro,S,Japan,28.0,175.0,2021,Japan,Germany,2021-06-15,True,0,1,15,16,19,0,47,66,0,0,3,3,1,1,0,2,0,0,0,0,6,3,0,9
133009.0,Sekita Masahiro,S,Japan,28.0,175.0,2021,Japan,Poland,2021-06-16,False,0,0,2,2,8,0,11,19,0,0,0,0,0,0,0,0,0,0,1,1,1,0,0,1
133009.0,Sekita Masahiro,S,Japan,28.0,175.0,2021,Japan,Canada,2021-06-17,False,1,2,11,14,18,1,57,76,0,0,0,0,0,3,3,6,0,0,1,1,5,1,1,7
133009.0,Sekita Masahiro,S,Japan,28.0,175.0,2021,Japan,Bulgaria,2021-06-21,True,1,0,6,7,16,0,50,66,0,0,0,0,0,3,2,5,0,0,0,0,5,1,1,7
133009.0,Sekita Masahiro,S,Japan,28.0,175.0,2021,Japan,Slovenia,2021-06-22,False,0,1,1,2,6,0,25,31,1,0,0,1,0,0,1,1,0,0,0,0,1,2,0,3
133009.0,Sekita Masahiro,S,Japan,28.0,175.0,2021,USA,Japan,2021-06-23,False,0,0,4,4,3,0,23,26,0,0,0,0,0,0,0,0,0,0,0,0,1,2,0,3
142570.0,Oya Masaki,S,Japan,26.0,178.0,2021,Russia,Japan,2021-05-30,True,0,1,11,12,17,0,37,54,0,1,0,1,0,2,1,3,0,0,0,0,2,1,1,4
142570.0,Oya Masaki,S,Japan,26.0,178.0,2021,Brazil,Japan,2021-06-04,False,0,1,1,2,8,0,14,22,0,0,0,0,0,1,0,1,0,0,0,0,2,1,0,3
142570.0,Oya Masaki,S,Japan,26.0,178.0,2021,Japan,Germany,2021-06-15,True,0,0,0,0,0,0,0,0,0,0,0,0,0,0,0,0,0,0,0,0,0,0,0,0
142570.0,Oya Masaki,S,Japan,26.0,178.0,2021,Japan,Poland,2021-06-16,False,0,2,5,7,20,1,29,50,0,0,0,0,0,1,4,5,0,0,0,0,3,2,1,6
142570.0,Oya Masaki,S,Japan,26.0,178.0,2021,Japan,Canada,2021-06-17,False,0,0,0,0,0,0,0,0,0,0,0,0,0,0,0,0,0,0,0,0,0,0,0,0
142570.0,Oya Masaki,S,Japan,26.0,178.0,2021,Japan,Bulgaria,2021-06-21,True,0,0,0,0,1,0,6,7,0,0,0,0,0,0,0,0,0,0,0,0,0,0,0,0
142570.0,Oya Masaki,S,Japan,26.0,178.0,2021,Japan,Slovenia,2021-06-22,False,0,0,3,3,14,2,32,48,0,0,0,0,0,1,0,1,0,0,0,0,3,1,0,4
142570.0,Oya Masaki,S,Japan,26.0,178.0,2021,USA,Japan,2021-06-23,False,0,0,0,0,0,0,0,0,0,0,0,0,0,0,0,0,0,0,0,0,0,0,0,0
142568.0,Ishikawa Yuki,OH,Japan,26.0,191.0,2021,Japan,Iran,2021-05-28,True,1,3,8,12,0,0,0,0,15,7,9,31,2,0,0,2,8,1,4,13,0,0,0,0
142568.0,Ishikawa Yuki,OH,Japan,26.0,191.0,2021,Netherlands,Japan,2021-05-29,True,0,4,15,19,0,0,0,0,15,2,8,25,2,4,1,7,12,0,13,25,4,1,0,5
142568.0,Ishikawa Yuki,OH,Japan,26.0,191.0,2021,Russia,Japan,2021-05-30,True,0,0,0,0,0,0,0,0,0,0,0,0,0,0,0,0,0,0,0,0,0,0,0,0
142568.0,Ishikawa Yuki,OH,Japan,26.0,191.0,2021,Brazil,Japan,2021-06-04,False,0,2,5,7,0,0,3,3,6,0,5,11,1,3,1,5,5,0,13,18,4,1,0,5
142568.0,Ishikawa Yuki,OH,Japan,26.0,191.0,2021,France,Japan,2021-06-05,False,2,4,14,20,1,0,4,5,22,1,10,33,1,2,1,4,16,3,9,28,1,2,1,4
142568.0,Ishikawa Yuki,OH,Japan,26.0,191.0,2021,Japan,Australia,2021-06-09,True,2,3,15,20,1,0,6,7,20,2,9,31,0,4,6,10,11,0,17,28,12,1,1,14
142568.0,Ishikawa Yuki,OH,Japan,26.0,191.0,2021,Japan,Italy,2021-06-10,True,0,4,12,16,0,0,3,3,19,6,16,41,2,8,4,14,12,1,20,33,12,4,2,18
142568.0,Ishikawa Yuki,OH,Japan,26.0,191.0,2021,Japan,Argentina,2021-06-11,False,0,0,0,0,0,0,0,0,0,0,0,0,0,0,0,0,0,0,0,0,0,0,0,0
142568.0,Ishikawa Yuki,OH,Japan,26.0,191.0,2021,Japan,Germany,2021-06-15,True,3,4,12,19,0,0,3,3,17,1,5,23,0,2,0,2,8,1,9,18,5,5,0,10
142568.0,Ishikawa Yuki,OH,Japan,26.0,191.0,2021,Japan,Poland,2021-06-16,False,0,0,0,0,0,0,0,0,0,0,0,0,0,0,0,0,0,0,0,0,0,0,0,0
142568.0,Ishikawa Yuki,OH,Japan,26.0,191.0,2021,Japan,Canada,2021-06-17,False,0,3,7,10,0,0,6,6,11,3,12,26,1,4,2,7,5,1,13,19,5,4,2,11
142568.0,Ishikawa Yuki,OH,Japan,26.0,191.0,2021,Japan,Bulgaria,2021-06-21,True,0,1,13,14,0,0,8,8,11,2,5,18,1,2,6,9,8,0,10,18,10,0,1,11
142568.0,Ishikawa Yuki,OH,Japan,26.0,191.0,2021,Japan,Slovenia,2021-06-22,False,0,0,3,3,0,0,0,0,1,1,3,5,0,0,0,0,4,0,1,5,1,0,0,1
142568.0,Ishikawa Yuki,OH,Japan,26.0,191.0,2021,USA,Japan,2021-06-23,False,1,4,8,13,0,0,2,2,12,3,11,26,1,1,0,2,6,0,8,14,3,3,0,6
146410.0,Ri Haku,MB,Japan,31.0,193.0,2021,Japan,Iran,2021-05-28,True,0,0,0,0,0,0,0,0,0,0,0,0,0,0,0,0,0,0,0,0,0,0,0,0
146410.0,Ri Haku,MB,Japan,31.0,193.0,2021,Netherlands,Japan,2021-05-29,True,0,0,0,0,0,0,0,0,0,0,0,0,0,0,0,0,0,0,0,0,0,0,0,0
146410.0,Ri Haku,MB,Japan,31.0,193.0,2021,Russia,Japan,2021-05-30,True,1,1,17,19,0,0,0,0,8,2,0,10,2,5,2,9,0,1,0,1,6,1,0,7
146410.0,Ri Haku,MB,Japan,31.0,193.0,2021,Japan,Serbia,2021-06-03,False,0,0,0,0,0,0,0,0,0,0,0,0,0,0,0,0,0,0,0,0,0,0,0,0
146410.0,Ri Haku,MB,Japan,31.0,193.0,2021,Brazil,Japan,2021-06-04,False,0,1,7,8,0,0,0,0,0,1,5,6,3,1,7,11,0,0,1,1,1,1,0,2
146410.0,Ri Haku,MB,Japan,31.0,193.0,2021,France,Japan,2021-06-05,False,0,0,1,1,0,0,0,0,0,0,0,0,0,0,0,0,0,0,0,0,0,1,0,1
146410.0,Ri Haku,MB,Japan,31.0,193.0,2021,Japan,Australia,2021-06-09,True,1,2,12,15,0,0,0,0,7,1,2,10,3,3,3,9,2,0,0,2,3,0,0,3
146410.0,Ri Haku,MB,Japan,31.0,193.0,2021,Japan,Italy,2021-06-10,True,1,2,16,19,0,0,0,0,9,0,2,11,0,3,16,19,1,0,1,2,7,0,1,8
146410.0,Ri Haku,MB,Japan,31.0,193.0,2021,Japan,Argentina,2021-06-11,False,0,2,15,17,0,0,0,0,2,0,3,5,0,6,3,9,1,0,0,1,4,1,1,6
146410.0,Ri Haku,MB,Japan,31.0,193.0,2021,Japan,Germany,2021-06-15,True,0,0,0,0,0,0,0,0,0,0,0,0,0,0,0,0,0,0,0,0,0,0,0,0
146410.0,Ri Haku,MB,Japan,31.0,193.0,2021,Japan,Poland,2021-06-16,False,0,1,7,8,0,0,1,1,3,0,2,5,0,1,3,4,0,1,0,1,1,2,0,3
146410.0,Ri Haku,MB,Japan,31.0,193.0,2021,Japan,Canada,2021-06-17,False,0,0,0,0,0,0,0,0,0,0,0,0,0,0,0,0,0,0,0,0,0,0,0,0
146410.0,Ri Haku,MB,Japan,31.0,193.0,2021,Japan,Bulgaria,2021-06-21,True,0,0,0,0,0,0,0,0,0,0,0,0,0,0,0,0,0,0,0,0,0,0,0,0
146410.0,Ri Haku,MB,Japan,31.0,193.0,2021,Japan,Slovenia,2021-06-22,False,1,0,11,12,0,0,0,0,1,2,4,7,0,4,1,5,0,0,0,0,3,2,0,5
146410.0,Ri Haku,MB,Japan,31.0,193.0,2021,USA,Japan,2021-06-23,False,0,0,2,2,0,0,1,1,0,0,0,0,0,0,0,0,0,0,0,0,0,0,0,0
142561.0,Takahashi Kentaro,MB,Japan,27.0,202.0,2021,Japan,Iran,2021-05-28,True,0,0,0,0,0,0,0,0,0,0,0,0,0,0,0,0,0,0,0,0,0,0,0,0
142561.0,Takahashi Kentaro,MB,Japan,27.0,202.0,2021,Netherlands,Japan,2021-05-29,True,0,5,6,11,0,0,0,0,6,0,1,7,2,1,0,3,0,0,0,0,0,0,0,0
142561.0,Takahashi Kentaro,MB,Japan,27.0,202.0,2021,Russia,Japan,2021-05-30,True,0,4,8,12,0,0,0,0,8,2,4,14,2,0,2,4,0,0,1,1,1,1,0,2
142561.0,Takahashi Kentaro,MB,Japan,27.0,202.0,2021,Japan,Serbia,2021-06-03,False,0,0,3,3,0,0,0,0,1,0,2,3,0,1,0,1,0,0,1,1,0,1,0,1
142561.0,Takahashi Kentaro,MB,Japan,27.0,202.0,2021,Brazil,Japan,2021-06-04,False,0,0,0,0,0,0,0,0,0,0,0,0,0,0,0,0,0,0,0,0,0,0,0,0
142561.0,Takahashi Kentaro,MB,Japan,27.0,202.0,2021,France,Japan,2021-06-05,False,0,2,4,6,0,0,2,2,3,1,2,6,2,3,0,5,0,0,0,0,0,1,0,1
142561.0,Takahashi Kentaro,MB,Japan,27.0,202.0,2021,Japan,Italy,2021-06-10,True,0,2,0,2,0,0,0,0,2,0,1,3,0,2,1,3,0,0,0,0,0,0,1,1
142561.0,Takahashi Kentaro,MB,Japan,27.0,202.0,2021,Japan,Argentina,2021-06-11,False,0,1,2,3,0,0,1,1,1,1,3,5,0,0,0,0,0,0,0,0,0,0,0,0
142561.0,Takahashi Kentaro,MB,Japan,27.0,202.0,2021,Japan,Germany,2021-06-15,True,0,0,0,0,0,0,0,0,0,0,0,0,0,0,0,0,0,0,0,0,0,0,0,0
142561.0,Takahashi Kentaro,MB,Japan,27.0,202.0,2021,Japan,Poland,2021-06-16,False,0,4,0,4,0,0,0,0,4,0,1,5,0,4,1,5,0,0,0,0,0,0,0,0
153365.0,Takanashi Kenta,OH,Japan,25.0,190.0,2021,Japan,Iran,2021-05-28,True,0,0,0,0,0,0,0,0,0,0,0,0,0,0,0,0,0,0,0,0,0,0,0,0
153365.0,Takanashi Kenta,OH,Japan,25.0,190.0,2021,Netherlands,Japan,2021-05-29,True,0,1,0,1,0,0,0,0,0,0,1,1,0,0,1,1,0,0,0,0,0,0,0,0
153365.0,Takanashi Kenta,OH,Japan,25.0,190.0,2021,Russia,Japan,2021-05-30,True,0,2,17,19,0,0,0,0,17,4,13,34,0,1,1,2,10,4,19,33,8,12,0,20
153365.0,Takanashi Kenta,OH,Japan,25.0,190.0,2021,Japan,Serbia,2021-06-03,False,0,1,14,15,0,0,4,4,12,6,8,26,0,1,0,1,14,0,7,21,5,4,0,9
153365.0,Takanashi Kenta,OH,Japan,25.0,190.0,2021,Brazil,Japan,2021-06-04,False,0,4,6,10,0,0,2,2,9,2,10,21,0,2,1,3,3,1,11,15,3,2,1,6
153365.0,Takanashi Kenta,OH,Japan,25.0,190.0,2021,France,Japan,2021-06-05,False,0,2,7,9,0,0,0,0,8,4,4,16,0,0,2,2,6,1,13,20,0,2,0,2
153365.0,Takanashi Kenta,OH,Japan,25.0,190.0,2021,Japan,Australia,2021-06-09,True,0,1,3,4,0,0,1,1,2,1,3,6,0,1,1,2,3,0,2,5,3,2,0,5
153365.0,Takanashi Kenta,OH,Japan,25.0,190.0,2021,Japan,Italy,2021-06-10,True,0,0,0,0,0,0,0,0,0,1,0,1,0,0,0,0,1,0,0,1,0,0,0,0
153365.0,Takanashi Kenta,OH,Japan,25.0,190.0,2021,Japan,Germany,2021-06-15,True,0,0,0,0,0,0,0,0,0,1,0,1,1,0,0,1,0,0,0,0,0,0,0,0
153365.0,Takanashi Kenta,OH,Japan,25.0,190.0,2021,Japan,Poland,2021-06-16,False,0,4,9,13,0,0,4,4,10,3,3,16,0,0,0,0,3,2,16,21,4,2,1,7
153365.0,Takanashi Kenta,OH,Japan,25.0,190.0,2021,Japan,Canada,2021-06-17,False,0,0,3,3,0,0,2,2,4,1,3,8,0,2,0,2,0,2,5,7,0,2,0,2
153365.0,Takanashi Kenta,OH,Japan,25.0,190.0,2021,Japan,Bulgaria,2021-06-21,True,0,0,0,0,0,0,0,0,0,0,0,0,0,1,0,1,0,0,1,1,0,0,0,0
153365.0,Takanashi Kenta,OH,Japan,25.0,190.0,2021,Japan,Slovenia,2021-06-22,False,1,1,7,9,0,0,3,3,11,3,2,16,1,0,0,1,8,2,13,23,2,1,0,3
153365.0,Takanashi Kenta,OH,Japan,25.0,190.0,2021,USA,Japan,2021-06-23,False,0,0,0,0,0,0,0,0,0,0,0,0,0,0,0,0,0,0,0,0,0,0,0,0
163516.0,Otsuka Tatsunori,OH,Japan,21.0,194.0,2021,Japan,Iran,2021-05-28,True,0,0,5,5,0,0,1,1,8,0,5,13,0,1,0,1,0,0,0,0,0,0,0,0
163516.0,Otsuka Tatsunori,OH,Japan,21.0,194.0,2021,Netherlands,Japan,2021-05-29,True,0,2,6,8,0,0,0,0,7,1,4,12,0,2,0,2,0,0,0,0,1,0,0,1
163516.0,Otsuka Tatsunori,OH,Japan,21.0,194.0,2021,Russia,Japan,2021-05-30,True,0,2,11,13,0,0,0,0,6,5,14,25,0,4,1,5,2,1,3,6,3,4,0,7
163516.0,Otsuka Tatsunori,OH,Japan,21.0,194.0,2021,Japan,Serbia,2021-06-03,False,0,0,4,4,0,0,0,0,4,2,7,13,1,1,0,2,5,0,11,16,1,2,0,3
163516.0,Otsuka Tatsunori,OH,Japan,21.0,194.0,2021,Brazil,Japan,2021-06-04,False,1,1,3,5,0,0,0,0,2,0,5,7,0,0,0,0,0,0,2,2,0,1,0,1
163516.0,Otsuka Tatsunori,OH,Japan,21.0,194.0,2021,France,Japan,2021-06-05,False,0,0,2,2,0,0,0,0,0,1,2,3,0,0,0,0,0,0,0,0,1,0,0,1
163516.0,Otsuka Tatsunori,OH,Japan,21.0,194.0,2021,Japan,Australia,2021-06-09,True,0,0,0,0,0,0,0,0,0,0,0,0,0,0,1,1,0,0,0,0,0,0,0,0
163516.0,Otsuka Tatsunori,OH,Japan,21.0,194.0,2021,Japan,Italy,2021-06-10,True,1,3,9,13,0,0,4,4,15,3,16,34,1,1,8,10,0,0,3,3,6,3,0,9
163516.0,Otsuka Tatsunori,OH,Japan,21.0,194.0,2021,Japan,Argentina,2021-06-11,False,0,2,12,14,0,0,5,5,10,6,24,40,4,0,0,4,8,2,12,22,7,2,2,11
163516.0,Otsuka Tatsunori,OH,Japan,21.0,194.0,2021,Japan,Germany,2021-06-15,True,0,0,0,0,0,0,0,0,0,0,0,0,0,0,0,0,0,0,0,0,0,0,0,0
163516.0,Otsuka Tatsunori,OH,Japan,21.0,194.0,2021,Japan,Poland,2021-06-16,False,0,2,6,8,0,0,0,0,7,4,12,23,0,2,1,3,1,0,7,8,1,1,0,2
163516.0,Otsuka Tatsunori,OH,Japan,21.0,194.0,2021,Japan,Canada,2021-06-17,False,0,0,1,1,0,0,0,0,2,0,0,2,0,0,0,0,0,0,0,0,1,0,0,1
163516.0,Otsuka Tatsunori,OH,Japan,21.0,194.0,2021,Japan,Bulgaria,2021-06-21,True,0,0,0,0,0,0,0,0,0,0,0,0,0,0,0,0,0,0,0,0,0,0,0,0
163516.0,Otsuka Tatsunori,OH,Japan,21.0,194.0,2021,Japan,Slovenia,2021-06-22,False,0,2,7,9,0,0,0,0,5,1,8,14,0,1,0,1,2,1,13,16,4,2,0,6
163516.0,Otsuka Tatsunori,OH,Japan,21.0,194.0,2021,USA,Japan,2021-06-23,False,0,0,0,0,0,0,0,0,0,0,0,0,0,0,0,0,0,0,0,0,0,0,0,0
172893.0,Yamamoto Tomohiro,L,Japan,27.0,171.0,2021,Japan,Iran,2021-05-28,True,0,0,0,0,0,0,2,2,0,0,0,0,0,0,0,0,9,0,9,18,8,0,0,8
172893.0,Yamamoto Tomohiro,L,Japan,27.0,171.0,2021,Netherlands,Japan,2021-05-29,True,0,0,0,0,0,0,0,0,0,0,0,0,0,0,0,0,13,3,10,26,7,3,2,12
172893.0,Yamamoto Tomohiro,L,Japan,27.0,171.0,2021,Russia,Japan,2021-05-30,True,0,0,0,0,0,0,0,0,0,0,0,0,0,0,0,0,0,0,0,0,0,0,0,0
172893.0,Yamamoto Tomohiro,L,Japan,27.0,171.0,2021,Japan,Serbia,2021-06-03,False,0,0,0,0,0,0,3,3,0,0,0,0,0,0,0,0,7,1,8,16,11,5,0,16
172893.0,Yamamoto Tomohiro,L,Japan,27.0,171.0,2021,Brazil,Japan,2021-06-04,False,0,0,0,0,0,0,1,1,0,0,0,0,0,0,0,0,3,1,2,6,1,1,0,2
172893.0,Yamamoto Tomohiro,L,Japan,27.0,171.0,2021,France,Japan,2021-06-05,False,0,0,0,0,0,0,2,2,0,0,0,0,0,0,0,0,12,2,8,22,8,3,0,11
172893.0,Yamamoto Tomohiro,L,Japan,27.0,171.0,2021,Japan,Australia,2021-06-09,True,0,0,0,0,0,0,2,2,0,0,0,0,0,0,0,0,16,0,12,28,15,5,3,23
172893.0,Yamamoto Tomohiro,L,Japan,27.0,171.0,2021,Japan,Italy,2021-06-10,True,0,0,0,0,0,0,8,8,0,0,0,0,0,0,0,0,5,1,11,17,15,6,1,22
172893.0,Yamamoto Tomohiro,L,Japan,27.0,171.0,2021,Japan,Argentina,2021-06-11,False,0,0,0,0,0,0,0,0,0,0,0,0,0,0,0,0,1,0,0,1,0,0,0,0
172893.0,Yamamoto Tomohiro,L,Japan,27.0,171.0,2021,Japan,Germany,2021-06-15,True,0,0,0,0,0,0,5,5,0,0,0,0,0,0,0,0,7,0,2,9,8,1,0,9
172893.0,Yamamoto Tomohiro,L,Japan,27.0,171.0,2021,Japan,Poland,2021-06-16,False,0,0,0,0,0,0,0,0,0,0,0,0,0,0,0,0,0,0,0,0,0,0,0,0
172893.0,Yamamoto Tomohiro,L,Japan,27.0,171.0,2021,Japan,Canada,2021-06-17,False,0,0,0,0,0,0,4,4,0,0,0,0,0,0,0,0,2,2,6,10,6,3,1,10
172893.0,Yamamoto Tomohiro,L,Japan,27.0,171.0,2021,Japan,Bulgaria,2021-06-21,True,0,0,0,0,0,0,2,2,0,0,0,0,0,0,0,0,6,0,8,14,10,2,2,14
172893.0,Yamamoto Tomohiro,L,Japan,27.0,171.0,2021,Japan,Slovenia,2021-06-22,False,0,0,0,0,0,0,2,2,0,0,0,0,0,0,0,0,0,1,2,3,0,2,0,2
172893.0,Yamamoto Tomohiro,L,Japan,27.0,171.0,2021,USA,Japan,2021-06-23,False,0,0,0,0,0,0,3,3,0,0,0,0,0,0,0,0,8,1,11,20,11,5,0,16
178762.0,Takahashi Ran,OH,Japan,20.0,188.0,2021,Japan,Iran,2021-05-28,True,1,2,11,14,0,0,0,0,13,4,9,26,2,0,1,3,8,0,11,19,1,0,0,1
178762.0,Takahashi Ran,OH,Japan,20.0,188.0,2021,Netherlands,Japan,2021-05-29,True,0,6,17,23,0,0,0,0,25,3,10,38,1,1,0,2,13,0,11,24,3,2,0,5
178762.0,Takahashi Ran,OH,Japan,20.0,188.0,2021,Russia,Japan,2021-05-30,True,0,3,4,7,0,0,0,0,1,0,1,2,0,0,0,0,0,0,5,5,2,0,0,2
178762.0,Takahashi Ran,OH,Japan,20.0,188.0,2021,Japan,Serbia,2021-06-03,False,0,3,6,9,0,0,5,5,6,3,6,15,0,0,0,0,9,0,11,20,3,4,0,7
178762.0,Takahashi Ran,OH,Japan,20.0,188.0,2021,Brazil,Japan,2021-06-04,False,0,0,0,0,0,0,0,0,0,0,0,0,0,0,0,0,0,0,0,0,0,0,0,0
178762.0,Takahashi Ran,OH,Japan,20.0,188.0,2021,France,Japan,2021-06-05,False,0,2,7,9,0,0,4,4,4,3,3,10,1,3,1,5,9,0,8,17,4,4,0,8
178762.0,Takahashi Ran,OH,Japan,20.0,188.0,2021,Japan,Australia,2021-06-09,True,1,2,6,9,1,0,5,6,11,6,6,23,1,3,0,4,6,1,7,14,4,0,1,5
178762.0,Takahashi Ran,OH,Japan,20.0,188.0,2021,Japan,Italy,2021-06-10,True,3,2,14,19,0,0,4,4,16,4,12,32,0,3,1,4,8,1,11,20,11,2,3,16
178762.0,Takahashi Ran,OH,Japan,20.0,188.0,2021,Japan,Argentina,2021-06-11,False,0,0,0,0,0,0,0,0,0,0,0,0,0,0,0,0,0,0,0,0,0,0,0,0
178762.0,Takahashi Ran,OH,Japan,20.0,188.0,2021,Japan,Germany,2021-06-15,True,0,2,9,11,0,0,1,1,10,2,8,20,0,1,1,2,8,1,6,15,8,5,0,13
178762.0,Takahashi Ran,OH,Japan,20.0,188.0,2021,Japan,Poland,2021-06-16,False,0,0,0,0,0,0,0,0,0,0,0,0,0,0,0,0,0,0,0,0,0,0,0,0
178762.0,Takahashi Ran,OH,Japan,20.0,188.0,2021,Japan,Canada,2021-06-17,False,0,1,6,7,0,0,1,1,6,4,2,12,0,3,0,3,1,2,15,18,6,0,0,6
178762.0,Takahashi Ran,OH,Japan,20.0,188.0,2021,Japan,Bulgaria,2021-06-21,True,1,2,16,19,0,0,1,1,7,4,7,18,0,0,1,1,1,2,10,13,4,2,0,6
178762.0,Takahashi Ran,OH,Japan,20.0,188.0,2021,Japan,Slovenia,2021-06-22,False,0,0,0,0,0,0,0,0,0,0,0,0,0,0,0,0,0,0,0,0,0,0,0,0
178762.0,Takahashi Ran,OH,Japan,20.0,188.0,2021,USA,Japan,2021-06-23,False,1,4,9,14,0,0,3,3,7,2,8,17,0,2,1,3,9,1,10,20,2,3,1,6
180990.0,Ogawa Tomohiro,L,Japan,25.0,176.0,2021,Japan,Iran,2021-05-28,True,0,0,0,0,0,0,0,0,0,0,0,0,0,0,0,0,0,0,0,0,0,0,0,0
180990.0,Ogawa Tomohiro,L,Japan,25.0,176.0,2021,Netherlands,Japan,2021-05-29,True,0,0,0,0,0,0,0,0,0,0,0,0,0,0,0,0,0,0,0,0,0,0,0,0
180990.0,Ogawa Tomohiro,L,Japan,25.0,176.0,2021,Russia,Japan,2021-05-30,True,0,0,0,0,0,0,4,4,0,0,0,0,0,0,0,0,9,0,22,31,16,7,1,24
180990.0,Ogawa Tomohiro,L,Japan,25.0,176.0,2021,Japan,Serbia,2021-06-03,False,0,0,0,0,0,0,0,0,0,0,0,0,0,0,0,0,0,0,0,0,0,0,0,0
180990.0,Ogawa Tomohiro,L,Japan,25.0,176.0,2021,Brazil,Japan,2021-06-04,False,0,0,0,0,0,0,1,1,0,0,0,0,0,0,0,0,1,5,4,10,3,2,1,6
180990.0,Ogawa Tomohiro,L,Japan,25.0,176.0,2021,France,Japan,2021-06-05,False,0,0,0,0,0,0,0,0,0,0,0,0,0,0,0,0,0,0,0,0,0,0,0,0
180990.0,Ogawa Tomohiro,L,Japan,25.0,176.0,2021,Japan,Australia,2021-06-09,True,0,0,0,0,0,0,0,0,0,0,0,0,0,0,0,0,0,0,0,0,0,0,0,0
180990.0,Ogawa Tomohiro,L,Japan,25.0,176.0,2021,Japan,Italy,2021-06-10,True,0,0,0,0,0,0,0,0,0,0,0,0,0,0,0,0,0,0,0,0,0,0,0,0
180990.0,Ogawa Tomohiro,L,Japan,25.0,176.0,2021,Japan,Argentina,2021-06-11,False,0,0,0,0,0,0,8,8,0,0,0,0,0,0,0,0,9,2,26,37,12,7,1,20
180990.0,Ogawa Tomohiro,L,Japan,25.0,176.0,2021,Japan,Germany,2021-06-15,True,0,0,0,0,0,0,0,0,0,0,0,0,0,0,0,0,0,0,0,0,0,0,0,0
180990.0,Ogawa Tomohiro,L,Japan,25.0,176.0,2021,Japan,Poland,2021-06-16,False,0,0,0,0,0,0,5,5,0,0,0,0,0,0,0,0,9,2,10,21,11,3,3,17
180990.0,Ogawa Tomohiro,L,Japan,25.0,176.0,2021,Japan,Canada,2021-06-17,False,0,0,0,0,0,0,0,0,0,0,0,0,0,0,0,0,0,0,0,0,0,0,0,0
180990.0,Ogawa Tomohiro,L,Japan,25.0,176.0,2021,Japan,Bulgaria,2021-06-21,True,0,0,0,0,0,0,0,0,0,0,0,0,0,0,0,0,0,0,0,0,0,0,0,0
180990.0,Ogawa Tomohiro,L,Japan,25.0,176.0,2021,Japan,Slovenia,2021-06-22,False,0,0,0,0,0,0,3,3,0,0,0,0,0,0,0,0,6,1,4,11,4,1,0,5
180990.0,Ogawa Tomohiro,L,Japan,25.0,176.0,2021,USA,Japan,2021-06-23,False,0,0,0,0,0,0,0,0,0,0,0,0,0,0,0,0,0,0,0,0,0,0,0,0
141546.0,Keemink Wessel,S,Netherlands,28.0,197.0,2021,Netherlands,Slovenia,2021-06-03,False,0,0,6,6,7,0,45,52,0,0,1,1,1,3,0,4,0,1,1,2,4,1,0,5
141546.0,Keemink Wessel,S,Netherlands,28.0,197.0,2021,Netherlands,Germany,2021-06-04,True,0,0,20,20,28,0,82,110,0,0,1,1,0,4,1,5,0,0,0,0,8,1,1,10
141546.0,Keemink Wessel,S,Netherlands,28.0,197.0,2021,Netherlands,Argentina,2021-06-05,False,0,0,9,9,13,0,59,72,1,0,0,1,0,1,1,2,0,0,0,0,1,3,0,4
141546.0,Keemink Wessel,S,Netherlands,28.0,197.0,2021,Poland,Netherlands,2021-06-10,False,0,1,1,2,1,0,14,15,0,0,2,2,0,0,0,0,0,0,0,0,1,2,0,3
141546.0,Keemink Wessel,S,Netherlands,28.0,197.0,2021,Netherlands,Bulgaria,2021-06-11,False,0,0,0,0,2,0,4,6,0,0,0,0,0,0,0,0,0,0,0,0,0,0,0,0
141546.0,Keemink Wessel,S,Netherlands,28.0,197.0,2021,Netherlands,Italy,2021-06-16,False,0,1,6,7,14,0,38,52,0,0,0,0,0,1,1,2,0,0,0,0,5,2,2,9
141546.0,Keemink Wessel,S,Netherlands,28.0,197.0,2021,Netherlands,USA,2021-06-17,False,2,0,17,19,21,0,73,94,1,0,0,1,0,2,3,5,0,0,0,0,11,1,1,13
141546.0,Keemink Wessel,S,Netherlands,28.0,197.0,2021,Canada,Netherlands,2021-06-21,False,0,0,2,2,15,0,25,40,0,0,1,1,0,1,0,1,0,0,0,0,3,0,0,3
141546.0,Keemink Wessel,S,Netherlands,28.0,197.0,2021,Serbia,Netherlands,2021-06-22,False,0,1,13,14,18,0,60,78,1,0,2,3,4,3,0,7,0,0,0,0,4,2,0,6
141546.0,Keemink Wessel,S,Netherlands,28.0,197.0,2021,Australia,Netherlands,2021-06-23,True,0,0,2,2,0,0,2,2,0,0,0,0,0,0,0,0,0,0,0,0,0,2,0,2
137345.0,Ter Horst Thijs,OH,Netherlands,30.0,204.0,2021,Netherlands,Russia,2021-05-28,False,0,1,1,2,0,0,0,0,3,0,1,4,1,0,1,2,0,0,3,3,1,0,1,2
137345.0,Ter Horst Thijs,OH,Netherlands,30.0,204.0,2021,Netherlands,Japan,2021-05-29,False,0,3,7,10,0,0,0,0,17,3,6,26,1,1,1,3,8,1,14,23,2,3,0,5
137345.0,Ter Horst Thijs,OH,Netherlands,30.0,204.0,2021,Netherlands,Germany,2021-06-04,True,1,5,8,14,0,0,2,2,24,4,8,36,1,3,0,4,5,2,12,19,5,1,0,6
137345.0,Ter Horst Thijs,OH,Netherlands,30.0,204.0,2021,Netherlands,Argentina,2021-06-05,False,0,1,3,4,0,0,0,0,4,1,4,9,0,1,0,1,4,0,5,9,0,0,0,0
137345.0,Ter Horst Thijs,OH,Netherlands,30.0,204.0,2021,Netherlands,Brazil,2021-06-09,False,0,0,0,0,0,0,0,0,0,0,0,0,0,0,0,0,0,0,0,0,0,0,0,0
137345.0,Ter Horst Thijs,OH,Netherlands,30.0,204.0,2021,Netherlands,France,2021-06-15,True,0,0,0,0,0,0,0,0,0,1,1,2,0,0,0,0,0,0,3,3,0,0,0,0
137345.0,Ter Horst Thijs,OH,Netherlands,30.0,204.0,2021,Netherlands,Italy,2021-06-16,False,0,3,3,6,0,0,4,4,11,2,11,24,1,2,3,6,1,2,10,13,0,1,0,1
137345.0,Ter Horst Thijs,OH,Netherlands,30.0,204.0,2021,Netherlands,USA,2021-06-17,False,0,4,7,11,0,0,1,1,17,7,16,40,1,4,1,6,11,4,23,38,8,5,0,13
137345.0,Ter Horst Thijs,OH,Netherlands,30.0,204.0,2021,Canada,Netherlands,2021-06-21,False,0,2,5,7,0,0,1,1,8,5,10,23,0,3,1,4,2,2,3,7,5,3,1,9
137345.0,Ter Horst Thijs,OH,Netherlands,30.0,204.0,2021,Serbia,Netherlands,2021-06-22,False,2,4,13,19,0,0,5,5,15,3,7,25,0,4,1,5,5,1,16,22,4,4,0,8
137345.0,Ter Horst Thijs,OH,Netherlands,30.0,204.0,2021,Australia,Netherlands,2021-06-23,True,0,0,0,0,0,0,0,0,0,0,0,0,0,0,0,0,0,0,0,0,0,0,0,0
169921.0,van Der Ent Cornelis Luuc,MB,Netherlands,23.0,208.0,2021,Netherlands,Russia,2021-05-28,False,0,2,11,13,0,0,0,0,1,0,3,4,2,9,6,17,0,0,0,0,3,1,0,4
169921.0,van Der Ent Cornelis Luuc,MB,Netherlands,23.0,208.0,2021,Netherlands,Japan,2021-05-29,False,0,0,0,0,0,0,0,0,0,0,0,0,0,0,0,0,0,0,0,0,0,0,0,0
169921.0,van Der Ent Cornelis Luuc,MB,Netherlands,23.0,208.0,2021,Netherlands,Slovenia,2021-06-03,False,0,2,1,3,0,0,0,0,1,0,2,3,0,3,0,3,0,0,0,0,0,0,0,0
169921.0,van Der Ent Cornelis Luuc,MB,Netherlands,23.0,208.0,2021,Netherlands,Germany,2021-06-04,True,0,0,0,0,0,0,0,0,0,0,0,0,0,0,0,0,0,0,0,0,0,0,0,0
169921.0,van Der Ent Cornelis Luuc,MB,Netherlands,23.0,208.0,2021,Netherlands,Brazil,2021-06-09,False,0,1,5,6,0,0,0,0,4,0,2,6,2,3,3,8,0,0,0,0,1,0,1,2
169921.0,van Der Ent Cornelis Luuc,MB,Netherlands,23.0,208.0,2021,Poland,Netherlands,2021-06-10,False,0,0,0,0,0,0,0,0,0,0,0,0,0,0,0,0,0,0,0,0,0,0,0,0
169921.0,van Der Ent Cornelis Luuc,MB,Netherlands,23.0,208.0,2021,Netherlands,Bulgaria,2021-06-11,False,0,1,6,7,0,0,0,0,3,0,0,3,0,3,4,7,0,0,1,1,1,2,0,3
169921.0,van Der Ent Cornelis Luuc,MB,Netherlands,23.0,208.0,2021,Netherlands,Italy,2021-06-16,False,0,0,0,0,0,0,0,0,0,0,0,0,0,0,0,0,0,0,0,0,0,0,0,0
169921.0,van Der Ent Cornelis Luuc,MB,Netherlands,23.0,208.0,2021,Netherlands,USA,2021-06-17,False,0,2,8,10,0,0,1,1,2,0,4,6,0,4,5,9,0,1,0,1,2,0,0,2
169921.0,van Der Ent Cornelis Luuc,MB,Netherlands,23.0,208.0,2021,Serbia,Netherlands,2021-06-22,False,1,1,10,12,0,0,1,1,7,0,3,10,2,4,4,10,0,0,0,0,2,2,2,6
169921.0,van Der Ent Cornelis Luuc,MB,Netherlands,23.0,208.0,2021,Australia,Netherlands,2021-06-23,True,0,0,0,0,0,0,0,0,0,0,0,0,0,0,0,0,0,0,0,0,0,0,0,0
156591.0,Dronkers Just,L,Netherlands,28.0,187.0,2021,Netherlands,Russia,2021-05-28,False,0,0,0,0,0,0,3,3,0,0,0,0,0,0,0,0,8,5,21,34,9,4,0,13
156591.0,Dronkers Just,L,Netherlands,28.0,187.0,2021,Netherlands,Japan,2021-05-29,False,0,0,0,0,0,0,3,3,0,0,0,0,0,0,0,0,10,0,19,29,6,4,0,10
156591.0,Dronkers Just,L,Netherlands,28.0,187.0,2021,Netherlands,Iran,2021-05-30,False,0,0,0,0,0,0,0,0,0,0,0,0,0,0,0,0,0,0,0,0,0,0,0,0
156591.0,Dronkers Just,L,Netherlands,28.0,187.0,2021,Netherlands,Slovenia,2021-06-03,False,0,0,0,0,0,0,10,10,0,0,0,0,0,0,0,0,7,4,11,22,5,1,0,6
156591.0,Dronkers Just,L,Netherlands,28.0,187.0,2021,Netherlands,Germany,2021-06-04,True,0,0,0,0,0,0,5,5,0,0,0,0,0,0,0,0,21,2,15,38,10,6,0,16
156591.0,Dronkers Just,L,Netherlands,28.0,187.0,2021,Netherlands,Argentina,2021-06-05,False,0,0,0,0,0,0,4,4,0,0,0,0,0,0,0,0,5,0,9,14,5,2,1,8
156591.0,Dronkers Just,L,Netherlands,28.0,187.0,2021,Netherlands,Brazil,2021-06-09,False,0,0,0,0,0,0,6,6,0,0,0,0,0,0,0,0,4,1,12,17,9,2,0,11
156591.0,Dronkers Just,L,Netherlands,28.0,187.0,2021,Poland,Netherlands,2021-06-10,False,0,0,0,0,0,0,0,0,0,0,0,0,0,0,0,0,0,0,0,0,0,0,0,0
156591.0,Dronkers Just,L,Netherlands,28.0,187.0,2021,Netherlands,Bulgaria,2021-06-11,False,0,0,0,0,0,0,4,4,0,0,0,0,0,0,0,0,11,4,16,31,12,3,1,16
156591.0,Dronkers Just,L,Netherlands,28.0,187.0,2021,Netherlands,France,2021-06-15,True,0,0,0,0,0,0,0,0,0,0,0,0,0,0,0,0,0,0,0,0,0,0,0,0
156591.0,Dronkers Just,L,Netherlands,28.0,187.0,2021,Netherlands,Italy,2021-06-16,False,0,0,0,0,0,0,10,10,0,0,0,0,0,0,0,0,9,2,12,23,13,7,3,23
156591.0,Dronkers Just,L,Netherlands,28.0,187.0,2021,Netherlands,USA,2021-06-17,False,0,0,0,0,0,0,0,0,0,0,0,0,0,0,0,0,0,0,0,0,0,0,0,0
156591.0,Dronkers Just,L,Netherlands,28.0,187.0,2021,Canada,Netherlands,2021-06-21,False,0,0,0,0,0,0,2,2,0,0,0,0,0,0,0,0,0,0,8,8,2,1,0,3
156591.0,Dronkers Just,L,Netherlands,28.0,187.0,2021,Serbia,Netherlands,2021-06-22,False,0,0,0,0,0,0,3,3,0,0,0,0,0,0,0,0,11,6,15,32,13,5,0,18
156591.0,Dronkers Just,L,Netherlands,28.0,187.0,2021,Australia,Netherlands,2021-06-23,True,0,0,0,0,0,0,5,5,0,0,0,0,0,0,0,0,8,0,5,13,6,1,0,7
131980.0,Jorna Gijs,OH,Netherlands,32.0,196.0,2021,Netherlands,Russia,2021-05-28,False,0,0,1,1,0,0,0,0,0,0,0,0,0,0,0,0,0,0,0,0,0,2,0,2
131980.0,Jorna Gijs,OH,Netherlands,32.0,196.0,2021,Netherlands,Japan,2021-05-29,False,0,1,6,7,0,0,0,0,1,0,1,2,0,0,0,0,3,0,5,8,2,1,0,3
131980.0,Jorna Gijs,OH,Netherlands,32.0,196.0,2021,Netherlands,Iran,2021-05-30,False,0,2,7,9,0,0,0,0,2,2,7,11,0,2,2,4,4,3,15,22,5,4,0,9
131980.0,Jorna Gijs,OH,Netherlands,32.0,196.0,2021,Netherlands,Slovenia,2021-06-03,False,0,0,1,1,0,0,0,0,0,1,1,2,0,0,0,0,0,0,2,2,0,0,0,0
131980.0,Jorna Gijs,OH,Netherlands,32.0,196.0,2021,Netherlands,Germany,2021-06-04,True,0,1,5,6,0,0,0,0,0,0,0,0,0,0,0,0,1,0,0,1,1,0,0,1
131980.0,Jorna Gijs,OH,Netherlands,32.0,196.0,2021,Netherlands,Argentina,2021-06-05,False,0,1,5,6,0,0,0,0,0,2,4,6,0,0,1,1,5,1,6,12,1,5,0,6
156678.0,Plak Fabian,MB,Netherlands,24.0,198.0,2021,Netherlands,Japan,2021-05-29,False,1,2,16,19,0,0,0,0,11,2,3,16,2,3,1,6,1,0,1,2,2,2,0,4
156678.0,Plak Fabian,MB,Netherlands,24.0,198.0,2021,Netherlands,Iran,2021-05-30,False,0,0,0,0,0,0,0,0,0,0,0,0,0,0,0,0,0,0,0,0,0,0,0,0
156678.0,Plak Fabian,MB,Netherlands,24.0,198.0,2021,Netherlands,Slovenia,2021-06-03,False,0,3,4,7,0,0,1,1,2,0,6,8,0,2,4,6,0,0,1,1,2,0,0,2
156678.0,Plak Fabian,MB,Netherlands,24.0,198.0,2021,Netherlands,Argentina,2021-06-05,False,0,3,6,9,0,0,0,0,5,2,5,12,2,3,0,5,0,0,0,0,2,0,0,2
156678.0,Plak Fabian,MB,Netherlands,24.0,198.0,2021,Netherlands,Brazil,2021-06-09,False,0,0,1,1,0,0,0,0,0,0,0,0,0,0,0,0,0,0,1,1,0,0,0,0
156678.0,Plak Fabian,MB,Netherlands,24.0,198.0,2021,Poland,Netherlands,2021-06-10,False,0,2,4,6,0,0,0,0,1,2,2,5,1,2,0,3,0,0,0,0,1,0,0,1
156678.0,Plak Fabian,MB,Netherlands,24.0,198.0,2021,Netherlands,Bulgaria,2021-06-11,False,0,2,11,13,0,0,0,0,12,0,1,13,1,6,1,8,0,0,1,1,3,0,0,3
156678.0,Plak Fabian,MB,Netherlands,24.0,198.0,2021,Netherlands,France,2021-06-15,True,0,0,0,0,0,0,0,0,0,0,0,0,0,1,0,1,0,0,0,0,0,0,0,0
156678.0,Plak Fabian,MB,Netherlands,24.0,198.0,2021,Netherlands,Italy,2021-06-16,False,0,0,16,16,0,0,2,2,11,2,3,16,3,5,4,12,0,0,1,1,3,2,0,5
156678.0,Plak Fabian,MB,Netherlands,24.0,198.0,2021,Netherlands,USA,2021-06-17,False,0,0,1,1,0,0,0,0,0,0,0,0,0,0,0,0,0,0,0,0,0,0,0,0
156678.0,Plak Fabian,MB,Netherlands,24.0,198.0,2021,Canada,Netherlands,2021-06-21,False,0,0,9,9,0,0,0,0,1,1,1,3,0,4,2,6,0,0,1,1,3,1,0,4
156678.0,Plak Fabian,MB,Netherlands,24.0,198.0,2021,Serbia,Netherlands,2021-06-22,False,1,0,4,5,0,0,1,1,1,0,1,2,0,1,1,2,0,0,0,0,2,1,0,3
156678.0,Plak Fabian,MB,Netherlands,24.0,198.0,2021,Australia,Netherlands,2021-06-23,True,0,0,1,1,0,0,0,0,2,1,1,4,0,1,0,1,0,0,0,0,0,0,0,0
176493.0,van Zeist Maikel,MB,Netherlands,27.0,200.0,2021,Netherlands,Russia,2021-05-28,False,0,1,0,1,0,0,0,0,0,0,0,0,0,0,0,0,0,0,0,0,0,0,0,0
176493.0,van Zeist Maikel,MB,Netherlands,27.0,200.0,2021,Netherlands,Iran,2021-05-30,False,0,3,8,11,0,0,0,0,5,1,4,10,0,2,3,5,0,0,0,0,1,0,0,1
176493.0,van Zeist Maikel,MB,Netherlands,27.0,200.0,2021,Netherlands,Slovenia,2021-06-03,False,0,0,0,0,0,0,0,0,0,0,0,0,0,0,0,0,0,0,0,0,0,0,0,0
176493.0,van Zeist Maikel,MB,Netherlands,27.0,200.0,2021,Netherlands,Germany,2021-06-04,True,0,0,0,0,0,0,0,0,0,0,0,0,0,0,0,0,0,0,0,0,0,0,0,0
176493.0,van Zeist Maikel,MB,Netherlands,27.0,200.0,2021,Netherlands,Argentina,2021-06-05,False,0,0,6,6,0,0,0,0,3,0,4,7,3,0,3,6,0,0,0,0,0,0,0,0
176493.0,van Zeist Maikel,MB,Netherlands,27.0,200.0,2021,Netherlands,Brazil,2021-06-09,False,0,0,0,0,0,0,0,0,0,0,0,0,0,0,0,0,0,0,0,0,0,0,0,0
176493.0,van Zeist Maikel,MB,Netherlands,27.0,200.0,2021,Poland,Netherlands,2021-06-10,False,1,1,1,3,0,0,1,1,0,0,1,1,1,1,1,3,0,0,0,0,1,0,0,1
176493.0,van Zeist Maikel,MB,Netherlands,27.0,200.0,2021,Netherlands,Bulgaria,2021-06-11,False,0,0,0,0,0,0,0,0,0,0,0,0,0,0,0,0,0,0,0,0,0,0,0,0
176493.0,van Zeist Maikel,MB,Netherlands,27.0,200.0,2021,Netherlands,France,2021-06-15,True,0,2,17,19,0,0,0,0,3,1,3,7,0,2,6,8,0,0,3,3,0,1,2,3
176493.0,van Zeist Maikel,MB,Netherlands,27.0,200.0,2021,Netherlands,USA,2021-06-17,False,0,0,0,0,0,0,0,0,0,0,0,0,0,0,0,0,0,0,0,0,0,0,0,0
176493.0,van Zeist Maikel,MB,Netherlands,27.0,200.0,2021,Canada,Netherlands,2021-06-21,False,0,1,2,3,0,0,0,0,0,0,0,0,0,0,0,0,1,0,1,2,1,0,0,1
176493.0,van Zeist Maikel,MB,Netherlands,27.0,200.0,2021,Serbia,Netherlands,2021-06-22,False,0,0,0,0,0,0,0,0,1,0,0,1,0,0,0,0,0,0,0,0,0,0,0,0
170436.0,Tuinstra Bennie Junior,OH,Netherlands,21.0,200.0,2021,Netherlands,Russia,2021-05-28,False,0,2,12,14,0,0,1,1,12,1,10,23,1,4,0,5,4,2,14,20,2,1,1,4
170436.0,Tuinstra Bennie Junior,OH,Netherlands,21.0,200.0,2021,Netherlands,Japan,2021-05-29,False,0,1,0,1,0,0,0,0,2,1,2,5,0,0,0,0,0,0,0,0,0,0,0,0
170436.0,Tuinstra Bennie Junior,OH,Netherlands,21.0,200.0,2021,Netherlands,Iran,2021-05-30,False,2,3,14,19,0,0,0,0,8,5,9,22,0,5,1,6,3,0,12,15,3,2,0,5
170436.0,Tuinstra Bennie Junior,OH,Netherlands,21.0,200.0,2021,Netherlands,Slovenia,2021-06-03,False,0,3,4,7,0,0,0,0,4,1,4,9,0,1,0,1,2,0,11,13,0,1,0,1
170436.0,Tuinstra Bennie Junior,OH,Netherlands,21.0,200.0,2021,Netherlands,Germany,2021-06-04,True,1,3,15,19,0,0,3,3,12,6,10,28,0,3,1,4,7,1,10,18,7,0,0,7
170436.0,Tuinstra Bennie Junior,OH,Netherlands,21.0,200.0,2021,Netherlands,Argentina,2021-06-05,False,2,2,4,8,0,0,1,1,5,2,12,19,1,0,0,1,10,1,10,21,4,2,0,6
170436.0,Tuinstra Bennie Junior,OH,Netherlands,21.0,200.0,2021,Netherlands,Brazil,2021-06-09,False,0,3,9,12,0,0,1,1,12,4,12,28,1,3,0,4,4,2,17,23,4,2,1,7
170436.0,Tuinstra Bennie Junior,OH,Netherlands,21.0,200.0,2021,Poland,Netherlands,2021-06-10,False,0,3,3,6,0,0,3,3,3,2,11,16,0,1,2,3,4,2,17,23,4,2,1,7
170436.0,Tuinstra Bennie Junior,OH,Netherlands,21.0,200.0,2021,Netherlands,Bulgaria,2021-06-11,False,1,6,10,17,0,0,5,5,12,4,9,25,0,2,1,3,4,1,25,30,4,3,1,8
170436.0,Tuinstra Bennie Junior,OH,Netherlands,21.0,200.0,2021,Netherlands,France,2021-06-15,True,0,1,16,17,0,1,5,6,13,5,17,35,1,2,6,9,3,3,30,36,7,0,2,9
170436.0,Tuinstra Bennie Junior,OH,Netherlands,21.0,200.0,2021,Netherlands,Italy,2021-06-16,False,2,3,14,19,0,0,2,2,8,4,10,22,1,1,2,4,11,3,18,32,5,4,1,10
170436.0,Tuinstra Bennie Junior,OH,Netherlands,21.0,200.0,2021,Canada,Netherlands,2021-06-21,False,0,2,8,10,0,0,3,3,7,6,14,27,0,2,0,2,8,1,12,21,2,1,1,4
170436.0,Tuinstra Bennie Junior,OH,Netherlands,21.0,200.0,2021,Serbia,Netherlands,2021-06-22,False,0,2,8,10,0,1,1,2,8,3,8,19,1,1,0,2,9,2,11,22,2,2,1,5
170436.0,Tuinstra Bennie Junior,OH,Netherlands,21.0,200.0,2021,Australia,Netherlands,2021-06-23,True,3,3,15,21,0,0,2,2,12,2,4,18,0,2,0,2,10,1,8,19,3,2,0,5
176460.0,Ottevanger Steven,L,Netherlands,27.0,183.0,2021,Netherlands,Russia,2021-05-28,False,0,0,0,0,0,0,0,0,0,0,0,0,0,0,0,0,0,0,0,0,1,0,0,1
176460.0,Ottevanger Steven,L,Netherlands,27.0,183.0,2021,Netherlands,Japan,2021-05-29,False,0,0,0,0,0,0,0,0,0,0,0,0,0,0,0,0,0,0,0,0,0,0,0,0
176460.0,Ottevanger Steven,L,Netherlands,27.0,183.0,2021,Netherlands,Iran,2021-05-30,False,0,0,0,0,0,0,1,1,0,0,0,0,0,0,0,0,5,3,10,18,14,2,0,16
176460.0,Ottevanger Steven,L,Netherlands,27.0,183.0,2021,Netherlands,Slovenia,2021-06-03,False,0,0,0,0,0,0,0,0,0,0,0,0,0,0,0,0,0,0,0,0,0,0,0,0
176460.0,Ottevanger Steven,L,Netherlands,27.0,183.0,2021,Netherlands,Germany,2021-06-04,True,0,0,0,0,0,0,0,0,0,0,0,0,0,0,0,0,0,0,0,0,0,0,0,0
176460.0,Ottevanger Steven,L,Netherlands,27.0,183.0,2021,Netherlands,Argentina,2021-06-05,False,0,0,0,0,0,0,0,0,0,0,0,0,0,0,0,0,0,0,0,0,0,0,0,0
176460.0,Ottevanger Steven,L,Netherlands,27.0,183.0,2021,Netherlands,Brazil,2021-06-09,False,0,0,0,0,0,0,0,0,0,0,0,0,0,0,0,0,0,0,0,0,0,0,0,0
176460.0,Ottevanger Steven,L,Netherlands,27.0,183.0,2021,Poland,Netherlands,2021-06-10,False,0,0,0,0,0,0,5,5,0,0,0,0,0,0,0,0,3,3,10,16,9,4,1,14
176460.0,Ottevanger Steven,L,Netherlands,27.0,183.0,2021,Netherlands,Bulgaria,2021-06-11,False,0,0,0,0,0,0,0,0,0,0,0,0,0,0,0,0,0,0,0,0,0,0,0,0
176460.0,Ottevanger Steven,L,Netherlands,27.0,183.0,2021,Netherlands,France,2021-06-15,True,0,0,0,0,0,0,4,4,0,0,0,0,0,0,0,0,3,1,14,18,11,2,2,15
176460.0,Ottevanger Steven,L,Netherlands,27.0,183.0,2021,Netherlands,Italy,2021-06-16,False,0,0,0,0,0,0,0,0,0,0,0,0,0,0,0,0,0,0,0,0,0,0,0,0
176460.0,Ottevanger Steven,L,Netherlands,27.0,183.0,2021,Netherlands,USA,2021-06-17,False,0,0,0,0,0,0,6,6,0,0,0,0,0,0,0,0,5,4,21,30,5,5,0,10
176460.0,Ottevanger Steven,L,Netherlands,27.0,183.0,2021,Canada,Netherlands,2021-06-21,False,0,0,0,0,0,0,1,1,0,0,0,0,0,0,0,0,1,2,4,7,2,5,0,7
176460.0,Ottevanger Steven,L,Netherlands,27.0,183.0,2021,Serbia,Netherlands,2021-06-22,False,0,0,0,0,0,0,0,0,0,0,0,0,0,0,0,0,0,0,0,0,0,0,0,0
176460.0,Ottevanger Steven,L,Netherlands,27.0,183.0,2021,Australia,Netherlands,2021-06-23,True,0,0,0,0,0,0,0,0,0,0,0,0,0,0,0,0,0,0,0,0,0,0,0,0
137498.0,Abdel-Aziz Nimir,O,Netherlands,30.0,201.0,2021,Netherlands,Russia,2021-05-28,False,6,5,12,23,0,0,1,1,23,8,6,37,0,1,1,2,0,1,1,2,6,0,1,7
137498.0,Abdel-Aziz Nimir,O,Netherlands,30.0,201.0,2021,Netherlands,Japan,2021-05-29,False,2,7,7,16,0,0,0,0,23,9,14,46,0,3,2,5,0,0,0,0,1,0,0,1
137498.0,Abdel-Aziz Nimir,O,Netherlands,30.0,201.0,2021,Netherlands,Iran,2021-05-30,False,1,1,4,6,0,0,0,0,9,4,4,17,1,3,0,4,0,0,0,0,3,0,0,3
137498.0,Abdel-Aziz Nimir,O,Netherlands,30.0,201.0,2021,Netherlands,Slovenia,2021-06-03,False,1,3,7,11,0,0,1,1,14,7,9,30,0,2,1,3,0,0,0,0,5,1,0,6
137498.0,Abdel-Aziz Nimir,O,Netherlands,30.0,201.0,2021,Netherlands,Germany,2021-06-04,True,5,8,10,23,0,1,3,4,18,4,20,42,1,3,4,8,0,0,0,0,14,3,0,17
137498.0,Abdel-Aziz Nimir,O,Netherlands,30.0,201.0,2021,Netherlands,Argentina,2021-06-05,False,4,3,8,15,0,0,1,1,17,6,7,30,1,3,1,5,0,0,0,0,3,4,0,7
137498.0,Abdel-Aziz Nimir,O,Netherlands,30.0,201.0,2021,Netherlands,Brazil,2021-06-09,False,3,5,7,15,0,0,2,2,15,8,8,31,2,2,0,4,1,0,0,1,3,3,0,6
137498.0,Abdel-Aziz Nimir,O,Netherlands,30.0,201.0,2021,Poland,Netherlands,2021-06-10,False,0,1,2,3,0,0,0,0,5,1,5,11,0,0,0,0,0,0,0,0,1,0,0,1
137498.0,Abdel-Aziz Nimir,O,Netherlands,30.0,201.0,2021,Netherlands,Bulgaria,2021-06-11,False,4,7,11,22,0,0,3,3,25,7,6,38,0,1,3,4,0,1,0,1,4,2,1,7
137498.0,Abdel-Aziz Nimir,O,Netherlands,30.0,201.0,2021,Netherlands,France,2021-06-15,True,4,6,12,22,0,0,1,1,37,8,12,57,2,10,4,16,0,0,0,0,8,5,1,14
137498.0,Abdel-Aziz Nimir,O,Netherlands,30.0,201.0,2021,Netherlands,Italy,2021-06-16,False,2,5,10,17,0,0,0,0,20,10,11,41,2,4,5,11,2,0,0,2,9,2,0,11
137498.0,Abdel-Aziz Nimir,O,Netherlands,30.0,201.0,2021,Australia,Netherlands,2021-06-23,True,4,4,4,12,0,0,1,1,12,5,11,28,1,1,0,2,0,0,0,0,0,1,0,1
164837.0,van Solkema Gijs,S,Netherlands,23.0,193.0,2021,Netherlands,Russia,2021-05-28,False,0,0,0,0,1,0,3,4,0,0,0,0,0,0,0,0,0,0,0,0,0,0,0,0
164837.0,van Solkema Gijs,S,Netherlands,23.0,193.0,2021,Netherlands,Japan,2021-05-29,False,0,0,0,0,2,0,2,4,0,0,0,0,0,1,0,1,0,0,0,0,0,0,0,0
164837.0,van Solkema Gijs,S,Netherlands,23.0,193.0,2021,Netherlands,Iran,2021-05-30,False,0,1,4,5,15,0,62,77,0,1,0,1,1,0,1,2,0,0,0,0,2,2,0,4
164837.0,van Solkema Gijs,S,Netherlands,23.0,193.0,2021,Netherlands,Slovenia,2021-06-03,False,0,0,1,1,0,1,7,8,0,0,0,0,0,0,0,0,0,0,0,0,1,0,0,1
164837.0,van Solkema Gijs,S,Netherlands,23.0,193.0,2021,Netherlands,Germany,2021-06-04,True,0,0,0,0,0,0,0,0,0,0,0,0,0,0,0,0,0,0,0,0,0,0,0,0
164837.0,van Solkema Gijs,S,Netherlands,23.0,193.0,2021,Netherlands,Argentina,2021-06-05,False,0,0,0,0,2,0,12,14,0,0,0,0,0,1,0,1,0,0,1,1,0,0,0,0
164837.0,van Solkema Gijs,S,Netherlands,23.0,193.0,2021,Netherlands,Brazil,2021-06-09,False,0,0,0,0,1,0,1,2,0,0,0,0,0,0,0,0,0,0,0,0,0,0,0,0
164837.0,van Solkema Gijs,S,Netherlands,23.0,193.0,2021,Poland,Netherlands,2021-06-10,False,0,0,5,5,8,1,36,45,1,0,0,1,0,2,0,2,0,0,1,1,3,1,1,5
164837.0,van Solkema Gijs,S,Netherlands,23.0,193.0,2021,Netherlands,France,2021-06-15,True,0,0,0,0,2,0,4,6,0,0,0,0,0,0,0,0,0,0,0,0,0,0,0,0
164837.0,van Solkema Gijs,S,Netherlands,23.0,193.0,2021,Netherlands,USA,2021-06-17,False,0,0,1,1,0,0,4,4,0,0,0,0,0,0,0,0,0,1,0,1,0,0,0,0
164837.0,van Solkema Gijs,S,Netherlands,23.0,193.0,2021,Canada,Netherlands,2021-06-21,False,0,0,0,0,0,0,0,0,0,0,0,0,0,0,0,0,0,0,0,0,0,0,0,0
164837.0,van Solkema Gijs,S,Netherlands,23.0,193.0,2021,Serbia,Netherlands,2021-06-22,False,0,0,0,0,0,0,0,0,0,0,0,0,0,0,0,0,0,0,0,0,0,0,0,0
137337.0,Parkinson Michael,MB,Netherlands,30.0,203.0,2021,Netherlands,Russia,2021-05-28,False,0,1,8,9,0,0,0,0,6,0,1,7,2,5,4,11,0,0,0,0,1,0,0,1
137337.0,Parkinson Michael,MB,Netherlands,30.0,203.0,2021,Netherlands,Japan,2021-05-29,False,0,1,1,2,0,0,0,0,2,0,1,3,1,0,0,1,1,0,1,2,0,0,0,0
137337.0,Parkinson Michael,MB,Netherlands,30.0,203.0,2021,Netherlands,Iran,2021-05-30,False,0,1,6,7,0,0,0,0,4,1,1,6,1,4,0,5,1,1,0,2,1,2,0,3
137337.0,Parkinson Michael,MB,Netherlands,30.0,203.0,2021,Netherlands,Germany,2021-06-04,True,1,2,9,12,0,0,0,0,11,1,1,13,4,9,8,21,1,0,5,6,1,0,0,1
137337.0,Parkinson Michael,MB,Netherlands,30.0,203.0,2021,Netherlands,Argentina,2021-06-05,False,0,0,1,1,0,0,0,0,0,0,0,0,0,0,0,0,0,0,0,0,0,0,0,0
137337.0,Parkinson Michael,MB,Netherlands,30.0,203.0,2021,Netherlands,Brazil,2021-06-09,False,0,0,11,11,0,0,0,0,4,0,2,6,2,5,2,9,0,0,1,1,2,0,0,2
137337.0,Parkinson Michael,MB,Netherlands,30.0,203.0,2021,Poland,Netherlands,2021-06-10,False,0,0,0,0,0,0,0,0,0,0,0,0,0,0,0,0,0,0,0,0,0,0,0,0
137337.0,Parkinson Michael,MB,Netherlands,30.0,203.0,2021,Netherlands,Bulgaria,2021-06-11,False,0,1,3,4,0,0,0,0,1,0,1,2,0,1,1,2,0,0,0,0,1,0,0,1
137337.0,Parkinson Michael,MB,Netherlands,30.0,203.0,2021,Netherlands,France,2021-06-15,True,0,0,9,9,0,0,1,1,5,0,4,9,0,6,4,10,0,0,0,0,1,2,2,5
137337.0,Parkinson Michael,MB,Netherlands,30.0,203.0,2021,Netherlands,Italy,2021-06-16,False,0,0,0,0,0,0,0,0,0,0,0,0,0,0,0,0,0,0,0,0,0,0,0,0
137337.0,Parkinson Michael,MB,Netherlands,30.0,203.0,2021,Netherlands,USA,2021-06-17,False,0,1,8,9,0,0,0,0,6,0,3,9,1,3,1,5,0,1,0,1,3,0,0,3
137337.0,Parkinson Michael,MB,Netherlands,30.0,203.0,2021,Canada,Netherlands,2021-06-21,False,0,0,4,4,0,0,0,0,5,2,1,8,1,1,1,3,0,0,1,1,1,0,0,1
137337.0,Parkinson Michael,MB,Netherlands,30.0,203.0,2021,Australia,Netherlands,2021-06-23,True,1,2,8,11,0,0,0,0,5,1,1,7,4,3,1,8,0,0,0,0,2,0,2,4
121992.0,Andringa Robbert,L,Netherlands,31.0,192.0,2021,Netherlands,Japan,2021-05-29,False,0,2,12,14,0,0,0,0,1,2,6,9,1,3,1,5,9,0,12,21,4,0,0,4
121992.0,Andringa Robbert,L,Netherlands,31.0,192.0,2021,Netherlands,Iran,2021-05-30,False,0,0,0,0,0,0,0,0,0,0,0,0,0,0,0,0,0,0,0,0,0,0,0,0
121992.0,Andringa Robbert,L,Netherlands,31.0,192.0,2021,Netherlands,Slovenia,2021-06-03,False,2,2,5,9,0,0,4,4,4,3,3,10,1,1,3,5,9,0,7,16,2,0,0,2
121992.0,Andringa Robbert,L,Netherlands,31.0,192.0,2021,Netherlands,Germany,2021-06-04,True,0,0,0,0,0,0,0,0,0,0,0,0,0,0,0,0,0,0,0,0,2,0,0,2
121992.0,Andringa Robbert,L,Netherlands,31.0,192.0,2021,Netherlands,Argentina,2021-06-05,False,0,1,4,5,0,0,1,1,0,3,7,10,0,0,0,0,5,0,3,8,1,0,0,1
121992.0,Andringa Robbert,L,Netherlands,31.0,192.0,2021,Netherlands,Brazil,2021-06-09,False,0,3,5,8,0,0,3,3,4,2,6,12,0,4,3,7,16,0,12,28,4,1,1,6
121992.0,Andringa Robbert,L,Netherlands,31.0,192.0,2021,Poland,Netherlands,2021-06-10,False,0,4,1,5,0,0,3,3,5,1,3,9,0,1,0,1,4,1,4,9,3,1,0,4
121992.0,Andringa Robbert,L,Netherlands,31.0,192.0,2021,Netherlands,Bulgaria,2021-06-11,False,4,5,10,19,0,0,1,1,11,4,9,24,2,2,2,6,4,1,13,18,6,1,1,8
121992.0,Andringa Robbert,L,Netherlands,31.0,192.0,2021,Netherlands,France,2021-06-15,True,1,5,10,16,0,0,4,4,6,3,7,16,2,3,3,8,13,1,16,30,13,4,1,18
121992.0,Andringa Robbert,L,Netherlands,31.0,192.0,2021,Netherlands,Italy,2021-06-16,False,0,2,3,5,0,0,2,2,2,1,5,8,0,1,3,4,3,1,8,12,4,0,0,4
121992.0,Andringa Robbert,L,Netherlands,31.0,192.0,2021,Netherlands,USA,2021-06-17,False,1,6,8,15,0,0,9,9,10,2,13,25,1,1,1,3,1,0,9,10,11,0,0,11
121992.0,Andringa Robbert,L,Netherlands,31.0,192.0,2021,Canada,Netherlands,2021-06-21,False,0,2,2,4,0,0,1,1,4,0,5,9,1,0,0,1,7,0,10,17,4,1,1,6
121992.0,Andringa Robbert,L,Netherlands,31.0,192.0,2021,Serbia,Netherlands,2021-06-22,False,1,4,3,8,0,0,2,2,3,2,2,7,1,2,0,3,2,1,7,10,0,0,0,0
121992.0,Andringa Robbert,L,Netherlands,31.0,192.0,2021,Australia,Netherlands,2021-06-23,True,0,2,6,8,0,0,2,2,8,2,2,12,1,0,0,1,10,0,7,17,2,1,0,3
162642.0,de Weijer Freek,S,Netherlands,26.0,191.0,2021,Netherlands,Russia,2021-05-28,False,0,3,10,13,26,0,53,79,0,0,0,0,0,1,2,3,0,0,0,0,2,0,2,4
162642.0,de Weijer Freek,S,Netherlands,26.0,191.0,2021,Netherlands,Japan,2021-05-29,False,0,3,12,15,28,3,76,107,0,0,2,2,0,2,0,2,0,0,0,0,7,3,1,11
162642.0,de Weijer Freek,S,Netherlands,26.0,191.0,2021,Netherlands,Iran,2021-05-30,False,0,0,2,2,6,0,0,6,0,0,0,0,0,0,0,0,0,0,0,0,0,0,0,0
162642.0,de Weijer Freek,S,Netherlands,26.0,191.0,2021,Netherlands,Brazil,2021-06-09,False,1,1,10,12,18,0,52,70,2,0,0,2,0,0,1,1,0,0,0,0,3,3,0,6
162642.0,de Weijer Freek,S,Netherlands,26.0,191.0,2021,Netherlands,Bulgaria,2021-06-11,False,0,2,10,12,27,0,62,89,0,0,1,1,1,4,2,7,0,0,2,2,4,6,0,10
162642.0,de Weijer Freek,S,Netherlands,26.0,191.0,2021,Netherlands,France,2021-06-15,True,0,1,12,13,39,1,70,110,0,0,1,1,1,2,3,6,0,1,2,3,4,1,1,6
162642.0,de Weijer Freek,S,Netherlands,26.0,191.0,2021,Netherlands,Italy,2021-06-16,False,0,2,2,4,10,0,38,48,0,0,0,0,0,1,0,1,0,0,0,0,3,2,0,5
162642.0,de Weijer Freek,S,Netherlands,26.0,191.0,2021,Netherlands,USA,2021-06-17,False,0,0,0,0,0,0,0,0,0,0,0,0,0,0,0,0,0,0,0,0,0,0,0,0
162642.0,de Weijer Freek,S,Netherlands,26.0,191.0,2021,Canada,Netherlands,2021-06-21,False,0,0,2,2,8,1,24,33,0,1,0,1,0,1,0,1,0,0,0,0,2,0,0,2
162642.0,de Weijer Freek,S,Netherlands,26.0,191.0,2021,Serbia,Netherlands,2021-06-22,False,0,0,1,1,6,0,6,12,0,0,0,0,0,0,1,1,0,0,0,0,0,0,0,0
162642.0,de Weijer Freek,S,Netherlands,26.0,191.0,2021,Australia,Netherlands,2021-06-23,True,0,1,6,7,18,0,43,61,0,0,0,0,2,3,2,7,0,0,2,2,3,1,1,5
162095.0,van Schie Stijn,OH,Netherlands,27.0,203.0,2021,Netherlands,Russia,2021-05-28,False,0,3,8,11,0,0,0,0,4,5,4,13,0,1,1,2,3,2,10,15,8,1,0,9
162095.0,van Schie Stijn,OH,Netherlands,27.0,203.0,2021,Netherlands,Iran,2021-05-30,False,0,0,0,0,0,0,0,0,0,0,0,0,0,0,0,0,0,0,0,0,0,0,0,0
162095.0,van Schie Stijn,OH,Netherlands,27.0,203.0,2021,Netherlands,Slovenia,2021-06-03,False,0,0,2,2,0,0,0,0,2,2,3,7,1,0,1,2,1,1,3,5,1,1,0,2
162095.0,van Schie Stijn,OH,Netherlands,27.0,203.0,2021,Netherlands,Brazil,2021-06-09,False,0,0,0,0,0,0,0,0,0,0,0,0,0,0,0,0,0,0,0,0,0,0,0,0
162095.0,van Schie Stijn,OH,Netherlands,27.0,203.0,2021,Poland,Netherlands,2021-06-10,False,0,1,1,2,0,0,0,0,2,4,6,12,0,0,0,0,0,2,8,10,3,0,0,3
162095.0,van Schie Stijn,OH,Netherlands,27.0,203.0,2021,Netherlands,Bulgaria,2021-06-11,False,0,0,0,0,0,0,0,0,0,0,0,0,0,0,0,0,0,0,0,0,0,0,0,0
162095.0,van Schie Stijn,OH,Netherlands,27.0,203.0,2021,Netherlands,France,2021-06-15,True,0,0,0,0,0,0,0,0,0,0,0,0,0,0,0,0,0,0,0,0,0,0,0,0
162095.0,van Schie Stijn,OH,Netherlands,27.0,203.0,2021,Netherlands,Italy,2021-06-16,False,0,0,0,0,0,0,0,0,0,0,0,0,0,0,0,0,0,0,0,0,0,0,0,0
162095.0,van Schie Stijn,OH,Netherlands,27.0,203.0,2021,Netherlands,USA,2021-06-17,False,0,0,0,0,0,0,0,0,0,0,1,1,0,2,0,2,0,0,1,1,0,0,0,0
162095.0,van Schie Stijn,OH,Netherlands,27.0,203.0,2021,Canada,Netherlands,2021-06-21,False,0,1,0,1,0,0,0,0,0,0,0,0,0,0,0,0,0,0,0,0,0,0,0,0
162095.0,van Schie Stijn,OH,Netherlands,27.0,203.0,2021,Serbia,Netherlands,2021-06-22,False,0,0,0,0,0,0,0,0,1,0,0,1,1,0,0,1,0,0,0,0,0,0,0,0
162095.0,van Schie Stijn,OH,Netherlands,27.0,203.0,2021,Australia,Netherlands,2021-06-23,True,0,0,0,0,0,0,0,0,0,0,0,0,0,0,0,0,0,0,0,0,0,0,0,0
150703.0,Wiltenburg Twan,MB,Netherlands,25.0,205.0,2021,Netherlands,Russia,2021-05-28,False,0,0,0,0,0,0,0,0,0,0,0,0,0,0,0,0,0,0,0,0,0,0,0,0
150703.0,Wiltenburg Twan,MB,Netherlands,25.0,205.0,2021,Netherlands,Japan,2021-05-29,False,1,1,10,12,0,0,0,0,2,0,1,3,1,0,0,1,1,1,0,2,0,0,0,0
150703.0,Wiltenburg Twan,MB,Netherlands,25.0,205.0,2021,Netherlands,Iran,2021-05-30,False,0,0,2,2,0,0,0,0,0,0,0,0,0,0,0,0,0,0,0,0,1,0,0,1
150703.0,Wiltenburg Twan,MB,Netherlands,25.0,205.0,2021,Netherlands,Slovenia,2021-06-03,False,0,0,3,3,0,0,0,0,1,1,1,3,1,2,1,4,0,0,2,2,1,0,0,1
150703.0,Wiltenburg Twan,MB,Netherlands,25.0,205.0,2021,Netherlands,Germany,2021-06-04,True,1,2,12,15,0,0,2,2,1,1,2,4,1,5,4,10,0,0,1,1,2,0,0,2
150703.0,Wiltenburg Twan,MB,Netherlands,25.0,205.0,2021,Netherlands,Argentina,2021-06-05,False,0,0,0,0,0,0,0,0,0,0,0,0,0,0,0,0,0,0,0,0,0,0,0,0
150703.0,Wiltenburg Twan,MB,Netherlands,25.0,205.0,2021,Poland,Netherlands,2021-06-10,False,0,1,8,9,0,0,2,2,2,1,1,4,1,1,0,2,0,0,0,0,3,0,0,3
150703.0,Wiltenburg Twan,MB,Netherlands,25.0,205.0,2021,Netherlands,Bulgaria,2021-06-11,False,1,0,8,9,0,0,0,0,0,0,2,2,1,1,3,5,0,0,0,0,0,0,0,0
150703.0,Wiltenburg Twan,MB,Netherlands,25.0,205.0,2021,Netherlands,France,2021-06-15,True,2,0,10,12,0,0,0,0,0,0,0,0,0,0,1,1,0,0,0,0,0,0,0,0
150703.0,Wiltenburg Twan,MB,Netherlands,25.0,205.0,2021,Netherlands,Italy,2021-06-16,False,1,0,11,12,0,0,0,0,3,1,3,7,0,7,3,10,0,0,0,0,1,2,2,5
150703.0,Wiltenburg Twan,MB,Netherlands,25.0,205.0,2021,Netherlands,USA,2021-06-17,False,0,2,5,7,0,0,0,0,0,0,0,0,0,0,1,1,0,0,1,1,1,2,0,3
150703.0,Wiltenburg Twan,MB,Netherlands,25.0,205.0,2021,Canada,Netherlands,2021-06-21,False,0,1,3,4,0,0,0,0,1,0,0,1,0,0,0,0,0,0,0,0,0,0,0,0
150703.0,Wiltenburg Twan,MB,Netherlands,25.0,205.0,2021,Serbia,Netherlands,2021-06-22,False,1,3,18,22,0,0,0,0,3,1,2,6,1,6,5,12,1,1,0,2,1,0,0,1
150703.0,Wiltenburg Twan,MB,Netherlands,25.0,205.0,2021,Australia,Netherlands,2021-06-23,True,0,3,7,10,0,0,0,0,3,0,1,4,0,0,2,2,0,0,2,2,1,0,1,2
169923.0,van Tilburg Stijn,O,Netherlands,25.0,203.0,2021,Netherlands,Russia,2021-05-28,False,0,0,0,0,0,0,0,0,0,0,1,1,0,0,0,0,0,0,0,0,0,0,0,0
169923.0,van Tilburg Stijn,O,Netherlands,25.0,203.0,2021,Netherlands,Japan,2021-05-29,False,0,0,2,2,0,0,0,0,1,1,2,4,0,2,0,2,0,0,0,0,0,0,0,0
169923.0,van Tilburg Stijn,O,Netherlands,25.0,203.0,2021,Netherlands,Iran,2021-05-30,False,2,2,6,10,0,0,0,0,7,1,8,16,0,2,0,2,0,0,1,1,1,0,0,1
169923.0,van Tilburg Stijn,O,Netherlands,25.0,203.0,2021,Netherlands,Slovenia,2021-06-03,False,0,0,2,2,0,0,1,1,0,1,1,2,0,1,0,1,0,0,0,0,0,0,0,0
169923.0,van Tilburg Stijn,O,Netherlands,25.0,203.0,2021,Netherlands,Germany,2021-06-04,True,0,1,0,1,0,0,0,0,0,0,0,0,0,0,0,0,0,0,0,0,0,0,0,0
169923.0,van Tilburg Stijn,O,Netherlands,25.0,203.0,2021,Netherlands,Argentina,2021-06-05,False,0,0,0,0,0,0,0,0,0,1,0,1,0,0,0,0,0,0,0,0,0,0,0,0
169923.0,van Tilburg Stijn,O,Netherlands,25.0,203.0,2021,Netherlands,Brazil,2021-06-09,False,0,1,1,2,0,0,0,0,0,0,1,1,0,0,1,1,0,0,0,0,0,0,0,0
169923.0,van Tilburg Stijn,O,Netherlands,25.0,203.0,2021,Poland,Netherlands,2021-06-10,False,1,2,5,8,0,0,1,1,3,4,7,14,0,3,1,4,0,0,0,0,1,0,0,1
169923.0,van Tilburg Stijn,O,Netherlands,25.0,203.0,2021,Netherlands,Bulgaria,2021-06-11,False,0,0,1,1,0,0,0,0,2,1,0,3,0,0,0,0,0,0,0,0,0,1,0,1
169923.0,van Tilburg Stijn,O,Netherlands,25.0,203.0,2021,Netherlands,France,2021-06-15,True,0,0,0,0,0,0,0,0,0,2,0,2,0,1,0,1,0,0,0,0,0,0,0,0
169923.0,van Tilburg Stijn,O,Netherlands,25.0,203.0,2021,Netherlands,Italy,2021-06-16,False,0,0,3,3,0,0,0,0,0,0,1,1,0,0,0,0,0,0,1,1,0,0,0,0
169923.0,van Tilburg Stijn,O,Netherlands,25.0,203.0,2021,Netherlands,USA,2021-06-17,False,4,1,17,22,0,0,2,2,15,4,17,36,0,4,2,6,1,1,2,4,4,2,0,6
169923.0,van Tilburg Stijn,O,Netherlands,25.0,203.0,2021,Canada,Netherlands,2021-06-21,False,0,0,5,5,0,0,2,2,3,2,7,12,1,0,0,1,0,0,1,1,1,0,0,1
169923.0,van Tilburg Stijn,O,Netherlands,25.0,203.0,2021,Serbia,Netherlands,2021-06-22,False,0,3,11,14,0,0,2,2,20,5,7,32,1,4,4,9,0,1,1,2,4,3,4,11
169923.0,van Tilburg Stijn,O,Netherlands,25.0,203.0,2021,Australia,Netherlands,2021-06-23,True,0,1,0,1,0,0,0,0,0,0,0,0,0,0,0,0,0,0,0,0,0,0,0,0
120245.0,Nowakowski Piotr,MB,Poland,34.0,205.0,2021,Australia,Poland,2021-06-03,True,0,2,5,7,0,0,0,0,2,0,1,3,2,1,1,4,0,0,0,0,1,0,0,1
120245.0,Nowakowski Piotr,MB,Poland,34.0,205.0,2021,Russia,Poland,2021-06-05,True,0,0,3,3,0,0,0,0,3,1,1,5,3,6,4,13,0,0,0,0,1,0,0,1
120245.0,Nowakowski Piotr,MB,Poland,34.0,205.0,2021,Poland,Bulgaria,2021-06-09,True,0,0,0,0,0,0,0,0,0,0,0,0,0,0,0,0,0,0,0,0,0,0,0,0
120245.0,Nowakowski Piotr,MB,Poland,34.0,205.0,2021,Poland,Netherlands,2021-06-10,True,0,0,0,0,0,0,0,0,0,0,0,0,0,0,0,0,0,0,0,0,0,0,0,0
120245.0,Nowakowski Piotr,MB,Poland,34.0,205.0,2021,Poland,Brazil,2021-06-11,False,0,2,1,3,0,0,0,0,1,0,2,3,3,2,0,5,0,0,0,0,0,0,0,0
120245.0,Nowakowski Piotr,MB,Poland,34.0,205.0,2021,Canada,Poland,2021-06-15,True,0,1,9,10,0,0,0,0,7,0,1,8,1,3,7,11,0,0,0,0,1,0,1,2
120245.0,Nowakowski Piotr,MB,Poland,34.0,205.0,2021,Germany,Poland,2021-06-17,True,0,2,6,8,0,0,0,0,5,0,3,8,2,5,3,10,0,0,0,0,5,0,0,5
120245.0,Nowakowski Piotr,MB,Poland,34.0,205.0,2021,Poland,Argentina,2021-06-21,True,0,0,0,0,0,0,0,0,0,0,0,0,0,0,0,0,0,0,0,0,0,0,0,0
120245.0,Nowakowski Piotr,MB,Poland,34.0,205.0,2021,Iran,Poland,2021-06-22,True,2,1,7,10,0,0,0,0,4,1,3,8,2,5,7,14,0,0,0,0,1,0,0,1
120245.0,Nowakowski Piotr,MB,Poland,34.0,205.0,2021,France,Poland,2021-06-23,False,0,2,17,19,0,0,0,0,5,1,1,7,4,5,4,13,0,0,1,1,3,0,0,3
120245.0,Nowakowski Piotr,MB,Poland,34.0,205.0,2021,Poland,Slovenia,2021-06-26,True,1,1,7,9,0,0,1,1,3,0,0,3,3,2,2,7,0,0,0,0,0,0,0,0
120245.0,Nowakowski Piotr,MB,Poland,34.0,205.0,2021,Brazil,Poland,2021-06-27,False,0,1,8,9,0,0,0,0,2,0,1,3,1,5,1,7,0,0,0,0,0,1,0,1
156531.0,Muzaj Maciej,O,Poland,27.0,208.0,2021,Poland,Italy,2021-05-28,True,3,3,14,20,0,0,0,0,11,1,13,25,0,2,3,5,0,0,0,0,5,0,1,6
156531.0,Muzaj Maciej,O,Poland,27.0,208.0,2021,Poland,Slovenia,2021-05-30,False,0,0,1,1,0,0,1,1,0,1,2,3,0,3,0,3,0,0,0,0,0,0,0,0
156531.0,Muzaj Maciej,O,Poland,27.0,208.0,2021,Poland,USA,2021-06-04,True,0,0,0,0,0,0,0,0,0,0,0,0,0,0,1,1,0,0,0,0,0,0,0,0
156531.0,Muzaj Maciej,O,Poland,27.0,208.0,2021,Russia,Poland,2021-06-05,True,1,4,8,13,0,0,4,4,9,2,8,19,2,4,5,11,0,1,0,1,3,0,0,3
156531.0,Muzaj Maciej,O,Poland,27.0,208.0,2021,Poland,Bulgaria,2021-06-09,True,0,0,0,0,0,0,0,0,0,0,0,0,0,0,0,0,0,0,0,0,0,0,0,0
156531.0,Muzaj Maciej,O,Poland,27.0,208.0,2021,Poland,Netherlands,2021-06-10,True,3,2,7,12,0,0,1,1,5,5,9,19,1,2,6,9,0,0,0,0,4,0,0,4
156531.0,Muzaj Maciej,O,Poland,27.0,208.0,2021,Poland,Brazil,2021-06-11,False,0,1,1,2,0,0,0,0,1,1,1,3,0,0,0,0,0,0,1,1,0,0,0,0
156531.0,Muzaj Maciej,O,Poland,27.0,208.0,2021,Canada,Poland,2021-06-15,True,0,0,0,0,0,0,0,0,0,0,0,0,0,0,0,0,0,0,0,0,0,0,0,0
156531.0,Muzaj Maciej,O,Poland,27.0,208.0,2021,Japan,Poland,2021-06-16,True,2,4,6,12,0,0,0,0,10,0,6,16,2,3,3,8,0,0,0,0,1,0,1,2
156531.0,Muzaj Maciej,O,Poland,27.0,208.0,2021,Iran,Poland,2021-06-22,True,0,0,3,3,0,0,1,1,1,3,2,6,2,2,2,6,0,0,0,0,2,0,0,2
156531.0,Muzaj Maciej,O,Poland,27.0,208.0,2021,France,Poland,2021-06-23,False,0,0,0,0,0,0,0,0,0,0,0,0,0,2,0,2,0,0,0,0,1,0,0,1
153389.0,Komenda Marcin,S,Poland,25.0,198.0,2021,Canada,Poland,2021-06-15,True,0,0,0,0,0,0,0,0,0,0,0,0,0,0,0,0,0,0,0,0,0,0,0,0
153389.0,Komenda Marcin,S,Poland,25.0,198.0,2021,Japan,Poland,2021-06-16,True,0,0,1,1,4,0,3,7,1,0,0,1,0,0,0,0,0,0,0,0,0,0,0,0
153389.0,Komenda Marcin,S,Poland,25.0,198.0,2021,Iran,Poland,2021-06-22,True,0,0,0,0,0,0,0,0,0,0,0,0,0,0,0,0,0,0,0,0,0,0,0,0
162105.0,Kaczmarek Lukasz,O,Poland,27.0,204.0,2021,Poland,Serbia,2021-05-29,True,0,0,1,1,0,0,0,0,0,0,0,0,0,1,0,1,0,0,0,0,0,0,0,0
162105.0,Kaczmarek Lukasz,O,Poland,27.0,204.0,2021,Poland,Slovenia,2021-05-30,False,0,4,10,14,0,0,0,0,15,8,12,35,2,5,2,9,0,0,0,0,4,1,0,5
162105.0,Kaczmarek Lukasz,O,Poland,27.0,204.0,2021,Australia,Poland,2021-06-03,True,1,0,8,9,0,0,0,0,10,2,6,18,6,3,1,10,0,0,0,0,3,1,0,4
162105.0,Kaczmarek Lukasz,O,Poland,27.0,204.0,2021,Russia,Poland,2021-06-05,True,0,0,1,1,0,0,0,0,0,0,0,0,0,1,0,1,0,0,0,0,0,0,0,0
162105.0,Kaczmarek Lukasz,O,Poland,27.0,204.0,2021,Poland,Bulgaria,2021-06-09,True,1,1,10,12,0,0,0,0,10,2,11,23,1,3,0,4,0,0,0,0,1,1,0,2
162105.0,Kaczmarek Lukasz,O,Poland,27.0,204.0,2021,Poland,Brazil,2021-06-11,False,0,3,7,10,0,0,0,0,7,1,10,18,2,0,1,3,1,0,1,2,0,1,0,1
162105.0,Kaczmarek Lukasz,O,Poland,27.0,204.0,2021,Japan,Poland,2021-06-16,True,0,0,0,0,0,0,0,0,0,0,0,0,0,0,0,0,0,0,0,0,0,0,0,0
162105.0,Kaczmarek Lukasz,O,Poland,27.0,204.0,2021,Germany,Poland,2021-06-17,True,0,0,0,0,0,0,0,0,0,0,0,0,0,0,0,0,0,0,0,0,0,0,0,0
162105.0,Kaczmarek Lukasz,O,Poland,27.0,204.0,2021,Poland,Argentina,2021-06-21,True,0,0,1,1,0,0,0,0,1,0,0,1,1,0,0,1,0,0,0,0,0,0,0,0
162105.0,Kaczmarek Lukasz,O,Poland,27.0,204.0,2021,Iran,Poland,2021-06-22,True,0,0,7,7,0,0,0,0,5,3,2,10,1,1,3,5,0,0,0,0,2,0,2,4
162105.0,Kaczmarek Lukasz,O,Poland,27.0,204.0,2021,Poland,Slovenia,2021-06-26,True,0,1,1,2,0,0,1,1,0,0,0,0,0,0,1,1,0,0,0,0,0,0,1,1
162105.0,Kaczmarek Lukasz,O,Poland,27.0,204.0,2021,Brazil,Poland,2021-06-27,False,0,0,1,1,0,0,0,0,0,0,1,1,0,0,0,0,0,0,0,0,0,0,0,0
115806.0,Kurek Bartosz,O,Poland,33.0,205.0,2021,Poland,Italy,2021-05-28,True,0,0,0,0,0,0,0,0,0,0,0,0,0,0,0,0,0,0,0,0,0,0,0,0
115806.0,Kurek Bartosz,O,Poland,33.0,205.0,2021,Poland,Serbia,2021-05-29,True,0,3,8,11,0,0,0,0,10,3,11,24,2,5,2,9,0,0,2,2,4,1,1,6
115806.0,Kurek Bartosz,O,Poland,33.0,205.0,2021,Australia,Poland,2021-06-03,True,0,0,0,0,0,0,0,0,0,0,0,0,0,0,0,0,0,0,0,0,0,0,0,0
115806.0,Kurek Bartosz,O,Poland,33.0,205.0,2021,Poland,USA,2021-06-04,True,0,3,8,11,0,0,0,0,8,5,6,19,0,2,4,6,1,0,1,2,8,1,1,10
115806.0,Kurek Bartosz,O,Poland,33.0,205.0,2021,Poland,Netherlands,2021-06-10,True,0,0,0,0,0,0,0,0,0,0,0,0,0,0,0,0,0,0,0,0,0,0,0,0
115806.0,Kurek Bartosz,O,Poland,33.0,205.0,2021,Canada,Poland,2021-06-15,True,0,4,5,9,0,0,1,1,13,2,9,24,2,1,5,8,1,0,0,1,3,1,1,5
115806.0,Kurek Bartosz,O,Poland,33.0,205.0,2021,Germany,Poland,2021-06-17,True,0,1,10,11,0,0,0,0,14,3,9,26,2,2,2,6,0,0,1,1,4,0,1,5
115806.0,Kurek Bartosz,O,Poland,33.0,205.0,2021,Poland,Argentina,2021-06-21,True,2,4,7,13,0,0,2,2,9,1,10,20,1,1,5,7,0,0,0,0,3,4,1,8
115806.0,Kurek Bartosz,O,Poland,33.0,205.0,2021,France,Poland,2021-06-23,False,0,7,7,14,0,0,5,5,14,7,8,29,1,6,3,10,0,0,0,0,6,3,1,10
115806.0,Kurek Bartosz,O,Poland,33.0,205.0,2021,Poland,Slovenia,2021-06-26,True,0,2,8,10,0,0,1,1,14,3,6,23,3,3,0,6,0,0,0,0,4,1,1,6
115806.0,Kurek Bartosz,O,Poland,33.0,205.0,2021,Brazil,Poland,2021-06-27,False,0,4,6,10,0,0,5,5,15,3,8,26,2,1,2,5,0,0,0,0,5,1,0,6
119646.0,Leon Venero Wilfredo,OH,Poland,28.0,202.0,2021,Poland,Italy,2021-05-28,True,0,0,0,0,0,0,0,0,0,0,0,0,0,0,0,0,0,0,0,0,0,0,0,0
119646.0,Leon Venero Wilfredo,OH,Poland,28.0,202.0,2021,Poland,Serbia,2021-05-29,True,13,5,12,30,0,0,0,0,13,2,2,17,0,1,0,1,10,2,21,33,7,1,0,8
119646.0,Leon Venero Wilfredo,OH,Poland,28.0,202.0,2021,Poland,USA,2021-06-04,True,0,0,1,1,0,0,0,0,0,0,0,0,0,0,0,0,0,0,0,0,0,0,0,0
119646.0,Leon Venero Wilfredo,OH,Poland,28.0,202.0,2021,Russia,Poland,2021-06-05,True,7,5,6,18,0,0,3,3,16,3,13,32,2,3,1,6,4,1,14,19,4,1,0,5
119646.0,Leon Venero Wilfredo,OH,Poland,28.0,202.0,2021,Poland,Bulgaria,2021-06-09,True,2,6,6,14,0,0,3,3,7,0,6,13,0,0,1,1,3,0,8,11,4,2,0,6
119646.0,Leon Venero Wilfredo,OH,Poland,28.0,202.0,2021,Poland,Brazil,2021-06-11,False,0,0,0,0,0,0,0,0,0,1,0,1,0,1,0,1,0,0,0,0,0,0,0,0
119646.0,Leon Venero Wilfredo,OH,Poland,28.0,202.0,2021,Canada,Poland,2021-06-15,True,3,2,9,14,0,0,1,1,11,1,10,22,1,3,0,4,2,2,10,14,5,4,2,11
119646.0,Leon Venero Wilfredo,OH,Poland,28.0,202.0,2021,Japan,Poland,2021-06-16,True,0,0,0,0,0,0,0,0,0,0,0,0,0,0,0,0,0,0,0,0,0,0,0,0
119646.0,Leon Venero Wilfredo,OH,Poland,28.0,202.0,2021,Germany,Poland,2021-06-17,True,1,6,5,12,0,0,2,2,11,1,9,21,1,2,2,5,4,1,12,17,2,1,0,3
119646.0,Leon Venero Wilfredo,OH,Poland,28.0,202.0,2021,Iran,Poland,2021-06-22,True,0,0,0,0,0,0,0,0,0,0,0,0,0,0,0,0,0,0,0,0,0,0,0,0
119646.0,Leon Venero Wilfredo,OH,Poland,28.0,202.0,2021,France,Poland,2021-06-23,False,3,7,9,19,0,0,2,2,12,3,11,26,3,2,0,5,12,1,15,28,3,2,1,6
119646.0,Leon Venero Wilfredo,OH,Poland,28.0,202.0,2021,Poland,Slovenia,2021-06-26,True,2,2,13,17,0,0,1,1,11,3,7,21,0,2,1,3,6,2,14,22,3,2,1,6
119646.0,Leon Venero Wilfredo,OH,Poland,28.0,202.0,2021,Brazil,Poland,2021-06-27,False,1,3,8,12,0,0,1,1,5,4,15,24,2,1,1,4,5,2,15,22,5,3,0,8
135322.0,Wojtaszek Damian,L,Poland,33.0,180.0,2021,Poland,Italy,2021-05-28,True,0,0,0,0,0,0,0,0,0,0,0,0,0,0,0,0,4,0,5,9,6,1,1,8
135322.0,Wojtaszek Damian,L,Poland,33.0,180.0,2021,Poland,Serbia,2021-05-29,True,0,0,0,0,0,0,0,0,0,0,0,0,0,0,0,0,1,1,2,4,2,0,0,2
135322.0,Wojtaszek Damian,L,Poland,33.0,180.0,2021,Poland,Slovenia,2021-05-30,False,0,0,0,0,0,1,3,4,0,0,0,0,0,0,0,0,11,1,11,23,9,3,1,13
135322.0,Wojtaszek Damian,L,Poland,33.0,180.0,2021,Australia,Poland,2021-06-03,True,0,0,0,0,0,0,0,0,0,0,0,0,0,0,0,0,0,0,0,0,0,0,0,0
135322.0,Wojtaszek Damian,L,Poland,33.0,180.0,2021,Poland,USA,2021-06-04,True,0,0,0,0,0,0,2,2,0,0,0,0,0,0,0,0,5,0,9,14,6,5,1,12
135322.0,Wojtaszek Damian,L,Poland,33.0,180.0,2021,Russia,Poland,2021-06-05,True,0,0,0,0,0,0,0,0,0,0,0,0,0,0,0,0,0,0,0,0,0,0,0,0
135322.0,Wojtaszek Damian,L,Poland,33.0,180.0,2021,Poland,Bulgaria,2021-06-09,True,0,0,0,0,0,0,3,3,0,0,0,0,0,0,0,0,2,1,9,12,6,1,0,7
135322.0,Wojtaszek Damian,L,Poland,33.0,180.0,2021,Poland,Netherlands,2021-06-10,True,0,0,0,0,0,0,0,0,0,0,0,0,0,0,0,0,0,0,0,0,0,0,0,0
135322.0,Wojtaszek Damian,L,Poland,33.0,180.0,2021,Poland,Brazil,2021-06-11,False,0,0,0,0,0,0,0,0,0,0,0,0,0,0,0,0,9,1,12,22,6,5,1,12
135322.0,Wojtaszek Damian,L,Poland,33.0,180.0,2021,Poland,Argentina,2021-06-21,True,0,0,0,0,0,0,0,0,0,0,0,0,0,0,0,0,0,0,0,0,0,0,0,0
135322.0,Wojtaszek Damian,L,Poland,33.0,180.0,2021,Iran,Poland,2021-06-22,True,0,0,0,0,0,0,2,2,0,0,0,0,0,0,0,0,5,0,10,15,7,1,2,10
135322.0,Wojtaszek Damian,L,Poland,33.0,180.0,2021,France,Poland,2021-06-23,False,0,0,0,0,0,0,7,7,0,0,0,0,0,0,0,0,6,2,12,20,9,4,0,13
135322.0,Wojtaszek Damian,L,Poland,33.0,180.0,2021,Poland,Slovenia,2021-06-26,True,0,0,0,0,0,0,0,0,0,0,0,0,0,0,0,0,0,0,0,0,0,0,0,0
135322.0,Wojtaszek Damian,L,Poland,33.0,180.0,2021,Brazil,Poland,2021-06-27,False,0,0,0,0,0,0,0,0,0,0,0,0,0,0,0,0,0,0,0,0,0,0,0,0
118612.0,Drzyzga Fabian,S,Poland,32.0,196.0,2021,Poland,Italy,2021-05-28,True,0,0,0,0,0,0,0,0,0,0,0,0,0,0,0,0,0,0,0,0,0,0,0,0
118612.0,Drzyzga Fabian,S,Poland,32.0,196.0,2021,Poland,Serbia,2021-05-29,True,1,4,12,17,25,0,64,89,0,0,2,2,0,0,1,1,0,0,0,0,3,2,0,5
118612.0,Drzyzga Fabian,S,Poland,32.0,196.0,2021,Poland,Slovenia,2021-05-30,False,0,0,0,0,3,0,6,9,0,0,0,0,0,0,0,0,0,0,0,0,0,0,0,0
118612.0,Drzyzga Fabian,S,Poland,32.0,196.0,2021,Australia,Poland,2021-06-03,True,3,3,12,18,10,0,36,46,0,0,0,0,2,0,0,2,0,0,0,0,4,0,0,4
118612.0,Drzyzga Fabian,S,Poland,32.0,196.0,2021,Poland,USA,2021-06-04,True,0,0,0,0,0,0,0,0,0,0,0,0,0,0,0,0,0,0,0,0,0,0,0,0
118612.0,Drzyzga Fabian,S,Poland,32.0,196.0,2021,Russia,Poland,2021-06-05,True,0,3,8,11,26,0,40,66,0,0,0,0,0,2,1,3,0,0,0,0,6,2,0,8
118612.0,Drzyzga Fabian,S,Poland,32.0,196.0,2021,Poland,Bulgaria,2021-06-09,True,1,5,9,15,18,0,40,58,0,0,0,0,0,2,1,3,0,0,1,1,3,0,0,3
118612.0,Drzyzga Fabian,S,Poland,32.0,196.0,2021,Poland,Netherlands,2021-06-10,True,0,0,0,0,0,0,0,0,0,0,0,0,0,0,0,0,0,0,0,0,0,0,0,0
118612.0,Drzyzga Fabian,S,Poland,32.0,196.0,2021,Poland,Brazil,2021-06-11,False,1,3,5,9,14,0,68,82,0,0,1,1,0,1,1,2,0,0,0,0,1,1,0,2
118612.0,Drzyzga Fabian,S,Poland,32.0,196.0,2021,Canada,Poland,2021-06-15,True,1,2,11,14,18,0,50,68,0,0,0,0,0,2,2,4,0,0,0,0,7,1,2,10
118612.0,Drzyzga Fabian,S,Poland,32.0,196.0,2021,Japan,Poland,2021-06-16,True,0,0,0,0,0,0,0,0,0,0,0,0,0,0,0,0,0,0,0,0,0,0,0,0
118612.0,Drzyzga Fabian,S,Poland,32.0,196.0,2021,Germany,Poland,2021-06-17,True,0,0,11,11,28,0,42,70,1,0,0,1,1,0,2,3,0,0,0,0,5,2,1,8
118612.0,Drzyzga Fabian,S,Poland,32.0,196.0,2021,Poland,Argentina,2021-06-21,True,2,0,9,11,25,0,39,64,1,0,0,1,0,1,2,3,0,0,0,0,5,1,0,6
118612.0,Drzyzga Fabian,S,Poland,32.0,196.0,2021,Iran,Poland,2021-06-22,True,0,0,0,0,0,0,0,0,0,0,0,0,0,0,0,0,0,0,0,0,0,0,0,0
118612.0,Drzyzga Fabian,S,Poland,32.0,196.0,2021,France,Poland,2021-06-23,False,0,3,14,17,29,1,67,97,0,1,1,2,1,2,4,7,0,0,1,1,7,0,3,10
118612.0,Drzyzga Fabian,S,Poland,32.0,196.0,2021,Poland,Slovenia,2021-06-26,True,2,1,9,12,16,0,45,61,0,0,0,0,4,3,1,8,0,0,0,0,4,1,1,6
118612.0,Drzyzga Fabian,S,Poland,32.0,196.0,2021,Brazil,Poland,2021-06-27,False,1,3,12,16,24,0,59,83,0,0,0,0,0,2,0,2,0,0,1,1,2,2,3,7
115794.0,Lomacz Grzegorz,S,Poland,34.0,187.0,2021,Poland,Italy,2021-05-28,True,0,1,6,7,30,0,0,30,1,0,0,1,0,1,0,1,0,0,0,0,4,0,1,5
115794.0,Lomacz Grzegorz,S,Poland,34.0,187.0,2021,Poland,Serbia,2021-05-29,True,0,0,0,0,0,0,0,0,0,0,0,0,0,0,0,0,0,0,0,0,0,0,0,0
115794.0,Lomacz Grzegorz,S,Poland,34.0,187.0,2021,Poland,Slovenia,2021-05-30,False,1,0,10,11,27,0,62,89,0,0,0,0,0,2,1,3,0,0,0,0,3,2,0,5
115794.0,Lomacz Grzegorz,S,Poland,34.0,187.0,2021,Australia,Poland,2021-06-03,True,0,0,0,0,0,0,0,0,0,0,0,0,0,0,0,0,0,0,0,0,0,0,0,0
115794.0,Lomacz Grzegorz,S,Poland,34.0,187.0,2021,Poland,USA,2021-06-04,True,0,0,16,16,31,1,35,67,0,0,0,0,0,2,1,3,0,0,0,0,5,1,2,8
115794.0,Lomacz Grzegorz,S,Poland,34.0,187.0,2021,Russia,Poland,2021-06-05,True,0,0,0,0,2,0,1,3,0,0,0,0,0,0,0,0,0,0,0,0,0,0,0,0
115794.0,Lomacz Grzegorz,S,Poland,34.0,187.0,2021,Poland,Bulgaria,2021-06-09,True,0,0,0,0,0,0,0,0,0,0,0,0,0,0,0,0,0,0,0,0,0,0,0,0
115794.0,Lomacz Grzegorz,S,Poland,34.0,187.0,2021,Poland,Netherlands,2021-06-10,True,0,1,14,15,15,0,35,50,1,0,0,1,2,1,2,5,0,0,0,0,4,0,2,6
115794.0,Lomacz Grzegorz,S,Poland,34.0,187.0,2021,Poland,Brazil,2021-06-11,False,0,0,0,0,0,0,1,1,0,0,0,0,0,0,0,0,0,0,0,0,0,0,0,0
115794.0,Lomacz Grzegorz,S,Poland,34.0,187.0,2021,Canada,Poland,2021-06-15,True,0,0,0,0,0,0,0,0,0,0,0,0,0,0,0,0,0,0,0,0,0,0,0,0
115794.0,Lomacz Grzegorz,S,Poland,34.0,187.0,2021,Japan,Poland,2021-06-16,True,0,0,8,8,13,0,29,42,0,0,0,0,0,1,1,2,0,0,0,0,4,0,3,7
115794.0,Lomacz Grzegorz,S,Poland,34.0,187.0,2021,Germany,Poland,2021-06-17,True,0,0,0,0,0,0,0,0,0,0,0,0,0,0,0,0,0,0,0,0,0,0,0,0
115794.0,Lomacz Grzegorz,S,Poland,34.0,187.0,2021,Poland,Argentina,2021-06-21,True,0,0,0,0,1,0,2,3,0,0,0,0,0,0,0,0,0,0,0,0,0,0,0,0
115794.0,Lomacz Grzegorz,S,Poland,34.0,187.0,2021,Iran,Poland,2021-06-22,True,0,1,10,11,18,1,41,60,0,0,0,0,1,2,5,8,0,1,0,1,4,0,1,5
115794.0,Lomacz Grzegorz,S,Poland,34.0,187.0,2021,France,Poland,2021-06-23,False,0,0,0,0,0,0,0,0,0,0,0,0,0,0,0,0,0,0,0,0,0,0,0,0
115794.0,Lomacz Grzegorz,S,Poland,34.0,187.0,2021,Poland,Slovenia,2021-06-26,True,0,0,0,0,0,0,0,0,0,0,0,0,0,0,0,0,0,0,0,0,0,0,0,0
115794.0,Lomacz Grzegorz,S,Poland,34.0,187.0,2021,Brazil,Poland,2021-06-27,False,0,0,1,1,0,0,2,2,0,0,0,0,0,0,0,0,0,0,0,0,0,0,0,0
115845.0,Kubiak Michal,OH,Poland,34.0,191.0,2021,Poland,Serbia,2021-05-29,True,0,0,0,0,0,0,0,0,0,0,0,0,0,0,0,0,0,0,0,0,0,0,0,0
115845.0,Kubiak Michal,OH,Poland,34.0,191.0,2021,Poland,Slovenia,2021-05-30,False,0,2,13,15,0,0,8,8,8,4,17,29,0,1,1,2,10,2,13,25,4,6,1,11
115845.0,Kubiak Michal,OH,Poland,34.0,191.0,2021,Poland,USA,2021-06-04,True,0,0,0,0,0,0,0,0,0,0,0,0,0,0,0,0,0,0,0,0,0,0,0,0
115845.0,Kubiak Michal,OH,Poland,34.0,191.0,2021,Russia,Poland,2021-06-05,True,1,1,9,11,0,0,3,3,8,2,9,19,2,1,0,3,1,2,11,14,5,1,2,8
115845.0,Kubiak Michal,OH,Poland,34.0,191.0,2021,Poland,Netherlands,2021-06-10,True,0,0,0,0,0,0,0,0,0,0,0,0,0,0,0,0,0,0,0,0,0,0,0,0
115845.0,Kubiak Michal,OH,Poland,34.0,191.0,2021,Poland,Brazil,2021-06-11,False,0,2,7,9,0,0,2,2,7,1,6,14,0,4,0,4,7,1,11,19,4,4,0,8
115845.0,Kubiak Michal,OH,Poland,34.0,191.0,2021,Canada,Poland,2021-06-15,True,0,1,13,14,0,0,6,6,8,4,9,21,0,1,2,3,3,2,16,21,10,1,0,11
115845.0,Kubiak Michal,OH,Poland,34.0,191.0,2021,Germany,Poland,2021-06-17,True,1,3,13,17,0,0,4,4,10,1,6,17,0,2,1,3,3,0,17,20,6,5,1,12
115845.0,Kubiak Michal,OH,Poland,34.0,191.0,2021,Poland,Argentina,2021-06-21,True,1,3,10,14,0,0,3,3,9,1,5,15,0,6,1,7,3,1,12,16,8,1,1,10
115845.0,Kubiak Michal,OH,Poland,34.0,191.0,2021,France,Poland,2021-06-23,False,0,3,17,20,0,0,4,4,10,4,11,25,2,2,4,8,16,1,13,30,2,3,0,5
115845.0,Kubiak Michal,OH,Poland,34.0,191.0,2021,Poland,Slovenia,2021-06-26,True,0,2,6,8,0,0,2,2,4,4,7,15,2,3,1,6,3,3,8,14,3,2,0,5
115845.0,Kubiak Michal,OH,Poland,34.0,191.0,2021,Brazil,Poland,2021-06-27,False,0,3,14,17,0,1,4,5,14,5,5,24,1,1,2,4,8,1,15,24,8,1,1,10
142679.0,Sliwka Aleksander,OH,Poland,26.0,196.0,2021,Poland,Serbia,2021-05-29,True,1,0,3,4,0,0,0,0,0,0,0,0,0,0,0,0,0,0,0,0,0,0,0,0
142679.0,Sliwka Aleksander,OH,Poland,26.0,196.0,2021,Poland,Slovenia,2021-05-30,False,0,1,15,16,0,0,4,4,13,4,19,36,0,2,0,2,13,2,15,30,3,2,0,5
142679.0,Sliwka Aleksander,OH,Poland,26.0,196.0,2021,Australia,Poland,2021-06-03,True,0,0,0,0,0,0,0,0,0,0,0,0,0,0,0,0,0,0,0,0,0,0,0,0
142679.0,Sliwka Aleksander,OH,Poland,26.0,196.0,2021,Poland,USA,2021-06-04,True,0,3,16,19,0,0,1,1,8,2,4,14,1,1,2,4,4,0,10,14,5,0,0,5
142679.0,Sliwka Aleksander,OH,Poland,26.0,196.0,2021,Poland,Bulgaria,2021-06-09,True,0,0,0,0,0,0,0,0,0,0,0,0,0,0,0,0,0,0,0,0,0,0,0,0
142679.0,Sliwka Aleksander,OH,Poland,26.0,196.0,2021,Poland,Netherlands,2021-06-10,True,0,3,12,15,0,0,1,1,11,0,5,16,0,1,2,3,4,2,8,14,5,0,0,5
142679.0,Sliwka Aleksander,OH,Poland,26.0,196.0,2021,Poland,Brazil,2021-06-11,False,0,0,0,0,0,0,0,0,0,0,0,0,0,0,0,0,0,0,0,0,0,0,0,0
142679.0,Sliwka Aleksander,OH,Poland,26.0,196.0,2021,Canada,Poland,2021-06-15,True,0,0,0,0,0,0,0,0,0,0,0,0,0,0,0,0,0,0,0,0,0,0,0,0
142679.0,Sliwka Aleksander,OH,Poland,26.0,196.0,2021,Japan,Poland,2021-06-16,True,0,0,0,0,0,0,0,0,0,0,0,0,0,0,0,0,0,0,0,0,0,0,0,0
142679.0,Sliwka Aleksander,OH,Poland,26.0,196.0,2021,Germany,Poland,2021-06-17,True,0,0,0,0,0,0,0,0,0,0,0,0,0,0,0,0,0,0,0,0,0,0,0,0
142679.0,Sliwka Aleksander,OH,Poland,26.0,196.0,2021,Poland,Argentina,2021-06-21,True,0,0,0,0,0,0,0,0,0,0,0,0,0,0,0,0,0,0,0,0,0,0,0,0
142679.0,Sliwka Aleksander,OH,Poland,26.0,196.0,2021,Iran,Poland,2021-06-22,True,1,2,19,22,0,0,1,1,8,1,9,18,1,1,2,4,5,1,6,12,4,2,0,6
142679.0,Sliwka Aleksander,OH,Poland,26.0,196.0,2021,France,Poland,2021-06-23,False,0,0,0,0,0,0,0,0,0,0,0,0,0,0,0,0,1,0,1,2,3,0,0,3
142679.0,Sliwka Aleksander,OH,Poland,26.0,196.0,2021,Poland,Slovenia,2021-06-26,True,0,0,1,1,0,0,1,1,1,1,1,3,0,1,0,1,0,0,1,1,0,0,0,0
142679.0,Sliwka Aleksander,OH,Poland,26.0,196.0,2021,Brazil,Poland,2021-06-27,False,0,0,0,0,0,0,0,0,0,0,0,0,0,0,0,0,1,1,2,4,0,0,0,0
152870.0,Kochanowski Jakub,MB,Poland,24.0,199.0,2021,Poland,Italy,2021-05-28,True,0,0,0,0,0,0,0,0,0,0,0,0,0,0,0,0,0,0,0,0,0,0,0,0
152870.0,Kochanowski Jakub,MB,Poland,24.0,199.0,2021,Poland,Serbia,2021-05-29,True,1,1,14,16,0,0,0,0,7,2,3,12,4,8,1,13,0,0,0,0,3,0,0,3
152870.0,Kochanowski Jakub,MB,Poland,24.0,199.0,2021,Australia,Poland,2021-06-03,True,0,0,2,2,0,0,0,0,0,0,0,0,1,0,1,2,0,0,0,0,0,1,0,1
152870.0,Kochanowski Jakub,MB,Poland,24.0,199.0,2021,Poland,USA,2021-06-04,True,0,1,6,7,0,0,0,0,9,3,1,13,1,2,3,6,0,0,0,0,3,0,2,5
152870.0,Kochanowski Jakub,MB,Poland,24.0,199.0,2021,Poland,Bulgaria,2021-06-09,True,1,2,12,15,0,0,0,0,4,0,0,4,3,2,1,6,0,0,0,0,4,1,0,5
152870.0,Kochanowski Jakub,MB,Poland,24.0,199.0,2021,Poland,Brazil,2021-06-11,False,0,0,11,11,0,0,0,0,4,1,6,11,1,3,0,4,0,0,0,0,1,3,0,4
152870.0,Kochanowski Jakub,MB,Poland,24.0,199.0,2021,Canada,Poland,2021-06-15,True,0,3,10,13,0,0,0,0,5,0,3,8,0,6,4,10,0,0,0,0,1,0,0,1
152870.0,Kochanowski Jakub,MB,Poland,24.0,199.0,2021,Japan,Poland,2021-06-16,True,0,0,0,0,0,0,0,0,0,0,0,0,0,0,0,0,0,0,0,0,0,0,0,0
152870.0,Kochanowski Jakub,MB,Poland,24.0,199.0,2021,Germany,Poland,2021-06-17,True,0,4,10,14,0,0,1,1,5,3,3,11,1,2,4,7,0,0,1,1,2,0,0,2
152870.0,Kochanowski Jakub,MB,Poland,24.0,199.0,2021,Iran,Poland,2021-06-22,True,2,2,8,12,0,0,1,1,9,0,3,12,1,5,3,9,0,0,3,3,3,0,0,3
152870.0,Kochanowski Jakub,MB,Poland,24.0,199.0,2021,France,Poland,2021-06-23,False,0,0,0,0,0,0,0,0,0,0,0,0,0,0,0,0,0,0,0,0,0,0,0,0
152870.0,Kochanowski Jakub,MB,Poland,24.0,199.0,2021,Poland,Slovenia,2021-06-26,True,0,0,3,3,0,0,0,0,2,0,0,2,0,1,2,3,0,0,0,0,1,0,0,1
153395.0,Semeniuk Kamil,OH,Poland,25.0,195.0,2021,Poland,Italy,2021-05-28,True,0,0,0,0,0,0,0,0,0,0,0,0,0,0,0,0,0,0,0,0,0,0,0,0
153395.0,Semeniuk Kamil,OH,Poland,25.0,195.0,2021,Poland,Serbia,2021-05-29,True,0,4,4,8,0,0,0,0,11,1,16,28,6,2,3,11,6,0,6,12,4,1,1,6
153395.0,Semeniuk Kamil,OH,Poland,25.0,195.0,2021,Australia,Poland,2021-06-03,True,1,2,13,16,0,0,1,1,11,1,3,15,1,1,0,2,2,0,6,8,1,3,0,4
153395.0,Semeniuk Kamil,OH,Poland,25.0,195.0,2021,Poland,USA,2021-06-04,True,0,1,3,4,0,0,0,0,5,0,1,6,1,0,1,2,3,0,3,6,5,0,1,6
153395.0,Semeniuk Kamil,OH,Poland,25.0,195.0,2021,Russia,Poland,2021-06-05,True,0,0,0,0,0,0,0,0,0,0,0,0,0,0,0,0,0,0,0,0,0,0,0,0
153395.0,Semeniuk Kamil,OH,Poland,25.0,195.0,2021,Poland,Netherlands,2021-06-10,True,0,0,0,0,0,0,0,0,0,0,0,0,0,0,0,0,0,0,0,0,0,0,0,0
153395.0,Semeniuk Kamil,OH,Poland,25.0,195.0,2021,Poland,Brazil,2021-06-11,False,0,2,9,11,0,0,1,1,15,3,12,30,1,3,0,4,12,0,9,21,4,3,0,7
153395.0,Semeniuk Kamil,OH,Poland,25.0,195.0,2021,Japan,Poland,2021-06-16,True,0,3,9,12,0,0,6,6,3,0,4,7,2,2,3,7,5,0,13,18,4,0,0,4
153395.0,Semeniuk Kamil,OH,Poland,25.0,195.0,2021,Germany,Poland,2021-06-17,True,0,0,0,0,0,0,0,0,0,0,0,0,0,0,0,0,0,0,0,0,0,0,0,0
153395.0,Semeniuk Kamil,OH,Poland,25.0,195.0,2021,Poland,Argentina,2021-06-21,True,0,4,8,12,0,0,3,3,13,3,9,25,0,2,1,3,2,0,14,16,5,1,3,9
153395.0,Semeniuk Kamil,OH,Poland,25.0,195.0,2021,France,Poland,2021-06-23,False,0,0,0,0,0,0,0,0,2,1,1,4,0,0,0,0,1,1,3,5,0,0,0,0
153395.0,Semeniuk Kamil,OH,Poland,25.0,195.0,2021,Poland,Slovenia,2021-06-26,True,0,0,0,0,0,0,0,0,0,0,0,0,0,0,0,0,0,0,0,0,0,0,0,0
153395.0,Semeniuk Kamil,OH,Poland,25.0,195.0,2021,Brazil,Poland,2021-06-27,False,0,0,1,1,0,0,1,1,1,5,1,7,0,2,1,3,1,0,1,2,0,0,0,0
118614.0,Zatorski Pawel,L,Poland,31.0,184.0,2021,Poland,Italy,2021-05-28,True,0,0,0,0,0,0,0,0,0,0,0,0,0,0,0,0,0,0,0,0,0,0,0,0
118614.0,Zatorski Pawel,L,Poland,31.0,184.0,2021,Poland,Serbia,2021-05-29,True,0,0,0,0,0,0,3,3,0,0,0,0,0,0,0,0,8,2,7,17,6,2,0,8
118614.0,Zatorski Pawel,L,Poland,31.0,184.0,2021,Poland,Slovenia,2021-05-30,False,0,0,0,0,0,0,0,0,0,0,0,0,0,0,0,0,0,0,0,0,0,0,0,0
118614.0,Zatorski Pawel,L,Poland,31.0,184.0,2021,Australia,Poland,2021-06-03,True,0,0,0,0,0,0,4,4,0,0,0,0,0,0,0,0,4,1,3,8,8,1,0,9
118614.0,Zatorski Pawel,L,Poland,31.0,184.0,2021,Poland,USA,2021-06-04,True,0,0,0,0,0,0,0,0,0,0,0,0,0,0,0,0,0,0,0,0,0,0,0,0
118614.0,Zatorski Pawel,L,Poland,31.0,184.0,2021,Russia,Poland,2021-06-05,True,0,0,0,0,0,0,3,3,0,0,0,0,0,0,0,0,7,2,15,24,8,3,3,14
118614.0,Zatorski Pawel,L,Poland,31.0,184.0,2021,Poland,Bulgaria,2021-06-09,True,0,0,0,0,0,0,0,0,0,0,0,0,0,0,0,0,0,0,0,0,0,0,0,0
118614.0,Zatorski Pawel,L,Poland,31.0,184.0,2021,Poland,Netherlands,2021-06-10,True,0,0,0,0,0,0,6,6,0,0,0,0,0,0,0,0,2,0,3,5,9,4,0,13
118614.0,Zatorski Pawel,L,Poland,31.0,184.0,2021,Poland,Brazil,2021-06-11,False,0,0,0,0,0,0,0,0,0,0,0,0,0,0,0,0,0,0,0,0,0,0,0,0
118614.0,Zatorski Pawel,L,Poland,31.0,184.0,2021,Canada,Poland,2021-06-15,True,0,0,0,0,0,0,1,1,0,0,0,0,0,0,0,0,3,1,11,15,4,3,1,8
118614.0,Zatorski Pawel,L,Poland,31.0,184.0,2021,Japan,Poland,2021-06-16,True,0,0,0,0,0,0,4,4,0,0,0,0,0,0,0,0,3,0,5,8,5,2,2,9
118614.0,Zatorski Pawel,L,Poland,31.0,184.0,2021,Germany,Poland,2021-06-17,True,0,0,0,0,0,0,5,5,0,0,0,0,0,0,0,0,4,1,7,12,12,2,1,15
118614.0,Zatorski Pawel,L,Poland,31.0,184.0,2021,Poland,Argentina,2021-06-21,True,0,0,0,0,0,0,3,3,0,0,0,0,0,0,0,0,6,0,8,14,6,1,1,8
118614.0,Zatorski Pawel,L,Poland,31.0,184.0,2021,Iran,Poland,2021-06-22,True,0,0,0,0,0,0,0,0,0,0,0,0,0,0,0,0,0,0,0,0,0,0,0,0
118614.0,Zatorski Pawel,L,Poland,31.0,184.0,2021,France,Poland,2021-06-23,False,0,0,0,0,0,0,0,0,0,0,0,0,0,0,0,0,0,0,0,0,0,0,0,0
118614.0,Zatorski Pawel,L,Poland,31.0,184.0,2021,Poland,Slovenia,2021-06-26,True,0,0,0,0,0,0,3,3,0,0,0,0,0,0,0,0,7,0,8,15,7,2,1,10
118614.0,Zatorski Pawel,L,Poland,31.0,184.0,2021,Brazil,Poland,2021-06-27,False,0,0,0,0,0,0,5,5,0,0,0,0,0,0,0,0,6,2,17,25,9,5,2,16
150734.0,Bieniek Mateusz,MB,Poland,27.0,210.0,2021,Poland,Italy,2021-05-28,True,2,2,10,14,0,0,0,0,8,1,2,11,2,2,7,11,1,0,0,1,3,1,1,5
150734.0,Bieniek Mateusz,MB,Poland,27.0,210.0,2021,Poland,Slovenia,2021-05-30,False,2,1,17,20,0,0,0,0,9,1,7,17,5,5,2,12,0,0,1,1,2,1,0,3
150734.0,Bieniek Mateusz,MB,Poland,27.0,210.0,2021,Australia,Poland,2021-06-03,True,0,0,0,0,0,0,0,0,0,0,0,0,0,0,0,0,0,0,0,0,0,0,0,0
150734.0,Bieniek Mateusz,MB,Poland,27.0,210.0,2021,Poland,USA,2021-06-04,True,0,2,8,10,0,0,3,3,7,0,3,10,5,1,1,7,0,0,0,0,1,0,0,1
150734.0,Bieniek Mateusz,MB,Poland,27.0,210.0,2021,Russia,Poland,2021-06-05,True,2,3,13,18,0,0,0,0,2,0,0,2,0,0,2,2,0,0,0,0,3,1,0,4
150734.0,Bieniek Mateusz,MB,Poland,27.0,210.0,2021,Poland,Netherlands,2021-06-10,True,3,5,5,13,0,0,0,0,11,2,2,15,2,1,6,9,0,0,0,0,0,0,0,0
150734.0,Bieniek Mateusz,MB,Poland,27.0,210.0,2021,Poland,Brazil,2021-06-11,False,1,1,6,8,0,0,0,0,2,0,3,5,0,0,0,0,0,0,0,0,1,1,0,2
150734.0,Bieniek Mateusz,MB,Poland,27.0,210.0,2021,Japan,Poland,2021-06-16,True,3,4,10,17,0,0,0,0,5,0,5,10,1,3,3,7,0,0,0,0,2,3,1,6
150734.0,Bieniek Mateusz,MB,Poland,27.0,210.0,2021,Germany,Poland,2021-06-17,True,0,0,0,0,0,0,0,0,0,0,0,0,0,0,0,0,0,0,0,0,0,0,0,0
150734.0,Bieniek Mateusz,MB,Poland,27.0,210.0,2021,Poland,Argentina,2021-06-21,True,2,4,8,14,0,0,0,0,5,0,5,10,0,6,6,12,0,0,0,0,2,0,0,2
150734.0,Bieniek Mateusz,MB,Poland,27.0,210.0,2021,France,Poland,2021-06-23,False,0,3,12,15,0,0,1,1,9,2,5,16,4,4,7,15,0,0,0,0,2,0,1,3
150734.0,Bieniek Mateusz,MB,Poland,27.0,210.0,2021,Poland,Slovenia,2021-06-26,True,1,2,9,12,0,0,1,1,2,1,3,6,2,1,5,8,1,0,0,1,2,0,0,2
150734.0,Bieniek Mateusz,MB,Poland,27.0,210.0,2021,Brazil,Poland,2021-06-27,False,1,3,8,12,0,0,0,0,7,1,8,16,1,7,7,15,0,0,1,1,2,0,0,2
152866.0,Fornal Tomasz,OH,Poland,24.0,198.0,2021,Poland,Italy,2021-05-28,True,1,2,8,11,0,0,0,0,9,2,4,15,0,2,0,2,12,0,8,20,9,2,0,11
152866.0,Fornal Tomasz,OH,Poland,24.0,198.0,2021,Poland,Slovenia,2021-05-30,False,0,1,2,3,0,0,0,0,0,0,0,0,0,0,0,0,0,0,0,0,0,1,0,1
152866.0,Fornal Tomasz,OH,Poland,24.0,198.0,2021,Australia,Poland,2021-06-03,True,4,3,6,13,0,0,1,1,6,2,5,13,0,1,1,2,5,0,7,12,2,1,0,3
152866.0,Fornal Tomasz,OH,Poland,24.0,198.0,2021,Russia,Poland,2021-06-05,True,0,0,0,0,0,0,0,0,0,0,0,0,0,0,0,0,0,0,0,0,0,0,0,0
152866.0,Fornal Tomasz,OH,Poland,24.0,198.0,2021,Poland,Bulgaria,2021-06-09,True,0,0,0,0,0,0,0,0,0,0,0,0,0,0,0,0,0,0,0,0,0,0,0,0
152866.0,Fornal Tomasz,OH,Poland,24.0,198.0,2021,Poland,Netherlands,2021-06-10,True,2,1,6,9,0,0,2,2,5,0,2,7,2,2,0,4,6,0,8,14,9,2,1,12
152866.0,Fornal Tomasz,OH,Poland,24.0,198.0,2021,Canada,Poland,2021-06-15,True,0,0,0,0,0,0,0,0,0,0,0,0,0,0,0,0,0,0,0,0,0,0,0,0
152866.0,Fornal Tomasz,OH,Poland,24.0,198.0,2021,Japan,Poland,2021-06-16,True,1,2,9,12,0,0,1,1,15,2,8,25,0,1,3,4,2,0,5,7,10,1,1,12
152866.0,Fornal Tomasz,OH,Poland,24.0,198.0,2021,Poland,Argentina,2021-06-21,True,0,0,0,0,0,0,0,0,0,0,0,0,0,0,0,0,0,0,0,0,0,0,0,0
152866.0,Fornal Tomasz,OH,Poland,24.0,198.0,2021,Iran,Poland,2021-06-22,True,0,0,0,0,0,0,0,0,0,0,0,0,0,0,0,0,0,0,0,0,0,0,0,0
152866.0,Fornal Tomasz,OH,Poland,24.0,198.0,2021,Poland,Slovenia,2021-06-26,True,0,0,0,0,0,0,0,0,0,0,0,0,0,0,0,0,0,0,0,0,0,0,0,0
152866.0,Fornal Tomasz,OH,Poland,24.0,198.0,2021,Brazil,Poland,2021-06-27,False,0,0,0,0,0,0,0,0,0,0,0,0,0,0,0,0,0,0,0,0,0,0,0,0
150742.0,Bednorz Bartosz,OH,Poland,27.0,201.0,2021,Poland,Italy,2021-05-28,True,3,4,5,12,0,0,0,0,3,5,10,18,1,2,1,4,8,0,6,14,3,1,1,5
150742.0,Bednorz Bartosz,OH,Poland,27.0,201.0,2021,Poland,Slovenia,2021-05-30,False,0,0,0,0,0,0,0,0,0,0,0,0,0,0,0,0,0,0,0,0,0,0,0,0
150742.0,Bednorz Bartosz,OH,Poland,27.0,201.0,2021,Australia,Poland,2021-06-03,True,0,0,0,0,0,0,0,0,0,0,0,0,0,0,0,0,0,0,0,0,0,0,0,0
150742.0,Bednorz Bartosz,OH,Poland,27.0,201.0,2021,Poland,USA,2021-06-04,True,2,2,5,9,0,0,2,2,3,2,7,12,2,1,0,3,2,2,3,7,3,1,0,4
150742.0,Bednorz Bartosz,OH,Poland,27.0,201.0,2021,Poland,Bulgaria,2021-06-09,True,2,1,8,11,0,0,3,3,11,1,5,17,1,2,0,3,9,0,1,10,1,1,0,2
150742.0,Bednorz Bartosz,OH,Poland,27.0,201.0,2021,Poland,Brazil,2021-06-11,False,0,0,0,0,0,0,0,0,0,0,0,0,0,0,0,0,0,0,0,0,0,0,0,0
150742.0,Bednorz Bartosz,OH,Poland,27.0,201.0,2021,Germany,Poland,2021-06-17,True,0,0,0,0,0,0,0,0,0,0,0,0,0,0,0,0,0,0,0,0,0,0,0,0
150742.0,Bednorz Bartosz,OH,Poland,27.0,201.0,2021,Poland,Argentina,2021-06-21,True,0,0,0,0,0,0,0,0,0,0,0,0,0,0,0,0,0,0,0,0,0,0,0,0
150742.0,Bednorz Bartosz,OH,Poland,27.0,201.0,2021,Iran,Poland,2021-06-22,True,1,1,6,8,0,0,3,3,4,7,3,14,3,1,1,5,3,1,8,12,6,1,0,7
118618.0,Klos Karol,MB,Poland,32.0,201.0,2021,Poland,Italy,2021-05-28,True,0,1,8,9,0,0,0,0,7,1,1,9,5,2,13,20,0,0,0,0,2,1,1,4
118618.0,Klos Karol,MB,Poland,32.0,201.0,2021,Poland,Serbia,2021-05-29,True,0,0,0,0,0,0,0,0,0,0,0,0,0,0,0,0,0,0,0,0,0,0,0,0
118618.0,Klos Karol,MB,Poland,32.0,201.0,2021,Poland,Slovenia,2021-05-30,False,0,2,8,10,0,0,2,2,6,0,2,8,1,4,2,7,0,0,2,2,0,1,0,1
118618.0,Klos Karol,MB,Poland,32.0,201.0,2021,Poland,USA,2021-06-04,True,0,0,0,0,0,0,0,0,0,0,0,0,0,0,0,0,0,0,0,0,0,0,0,0
118618.0,Klos Karol,MB,Poland,32.0,201.0,2021,Russia,Poland,2021-06-05,True,1,1,18,20,0,0,0,0,4,1,1,6,3,6,4,13,0,0,0,0,4,0,0,4
118618.0,Klos Karol,MB,Poland,32.0,201.0,2021,Poland,Bulgaria,2021-06-09,True,0,0,0,0,0,0,0,0,0,0,0,0,0,0,0,0,0,0,0,0,0,0,0,0
118618.0,Klos Karol,MB,Poland,32.0,201.0,2021,Poland,Netherlands,2021-06-10,True,0,2,7,9,0,0,0,0,2,1,1,4,2,1,1,4,0,0,0,0,0,1,0,1
118618.0,Klos Karol,MB,Poland,32.0,201.0,2021,Canada,Poland,2021-06-15,True,0,0,0,0,0,0,0,0,0,0,0,0,0,0,0,0,0,0,0,0,0,0,0,0
118618.0,Klos Karol,MB,Poland,32.0,201.0,2021,Japan,Poland,2021-06-16,True,0,1,11,12,0,0,0,0,1,1,2,4,1,4,4,9,0,0,0,0,3,1,0,4
118618.0,Klos Karol,MB,Poland,32.0,201.0,2021,Poland,Argentina,2021-06-21,True,0,0,8,8,0,0,0,0,6,1,1,8,1,4,2,7,0,0,0,0,2,0,1,3
118618.0,Klos Karol,MB,Poland,32.0,201.0,2021,France,Poland,2021-06-23,False,0,0,0,0,0,0,0,0,0,0,0,0,0,0,0,0,0,0,0,0,0,0,0,0
152869.0,Huber Norbert,MB,Poland,23.0,204.0,2021,Poland,Italy,2021-05-28,True,0,0,0,0,0,0,0,0,0,0,0,0,0,0,0,0,0,0,0,0,0,0,0,0
152869.0,Huber Norbert,MB,Poland,23.0,204.0,2021,Poland,Serbia,2021-05-29,True,1,3,5,9,0,0,0,0,5,2,2,9,1,7,2,10,0,1,0,1,0,0,0,0
152869.0,Huber Norbert,MB,Poland,23.0,204.0,2021,Poland,Slovenia,2021-05-30,False,0,0,0,0,0,0,0,0,0,0,0,0,0,0,0,0,0,0,0,0,0,0,0,0
152869.0,Huber Norbert,MB,Poland,23.0,204.0,2021,Australia,Poland,2021-06-03,True,2,2,5,9,0,0,0,0,2,0,2,4,1,3,1,5,1,0,0,1,0,0,0,0
152869.0,Huber Norbert,MB,Poland,23.0,204.0,2021,Russia,Poland,2021-06-05,True,0,0,0,0,0,0,0,0,0,0,0,0,0,0,0,0,0,0,0,0,0,0,0,0
152869.0,Huber Norbert,MB,Poland,23.0,204.0,2021,Poland,Bulgaria,2021-06-09,True,1,0,6,7,0,0,0,0,7,0,2,9,3,3,2,8,0,0,0,0,2,2,0,4
152869.0,Huber Norbert,MB,Poland,23.0,204.0,2021,Poland,Netherlands,2021-06-10,True,0,0,0,0,0,0,0,0,0,0,0,0,0,0,0,0,0,0,0,0,0,0,0,0
152869.0,Huber Norbert,MB,Poland,23.0,204.0,2021,Canada,Poland,2021-06-15,True,0,0,0,0,0,0,0,0,0,0,0,0,0,0,0,0,0,0,0,0,0,0,0,0
152869.0,Huber Norbert,MB,Poland,23.0,204.0,2021,Japan,Poland,2021-06-16,True,0,0,0,0,0,0,0,0,0,0,0,0,0,0,0,0,0,0,0,0,0,0,0,0
152869.0,Huber Norbert,MB,Poland,23.0,204.0,2021,Germany,Poland,2021-06-17,True,0,0,0,0,0,0,0,0,0,0,0,0,0,0,0,0,0,0,0,0,0,0,0,0
152869.0,Huber Norbert,MB,Poland,23.0,204.0,2021,Iran,Poland,2021-06-22,True,0,0,0,0,0,0,0,0,0,0,0,0,0,0,0,0,0,0,0,0,0,0,0,0
152869.0,Huber Norbert,MB,Poland,23.0,204.0,2021,Brazil,Poland,2021-06-27,False,0,0,0,0,0,0,0,0,0,0,0,0,0,0,0,0,0,0,0,0,0,0,0,0
168238.0,Podlesnykh Yaroslav,OH,Russia,27.0,198.0,2021,Netherlands,Russia,2021-05-28,True,0,3,7,10,0,0,1,1,5,0,7,12,0,2,4,6,5,2,13,20,4,1,1,6
168238.0,Podlesnykh Yaroslav,OH,Russia,27.0,198.0,2021,Iran,Russia,2021-05-29,True,0,0,0,0,0,0,0,0,0,0,0,0,0,0,0,0,0,0,0,0,0,0,0,0
168238.0,Podlesnykh Yaroslav,OH,Russia,27.0,198.0,2021,Russia,Japan,2021-05-30,False,0,6,17,23,0,0,0,0,16,5,7,28,1,3,3,7,14,1,21,36,5,0,2,7
168238.0,Podlesnykh Yaroslav,OH,Russia,27.0,198.0,2021,Russia,USA,2021-06-03,True,0,0,0,0,0,0,0,0,0,0,0,0,0,0,0,0,0,0,0,0,0,0,0,0
168238.0,Podlesnykh Yaroslav,OH,Russia,27.0,198.0,2021,Russia,Australia,2021-06-04,True,2,1,3,6,0,0,2,2,5,3,8,16,0,1,0,1,8,1,8,17,1,1,0,2
168238.0,Podlesnykh Yaroslav,OH,Russia,27.0,198.0,2021,France,Russia,2021-06-09,False,1,0,2,3,0,0,0,0,0,0,0,0,0,0,0,0,0,0,0,0,0,0,0,0
168238.0,Podlesnykh Yaroslav,OH,Russia,27.0,198.0,2021,Russia,Canada,2021-06-10,True,0,2,4,6,0,0,0,0,2,2,4,8,0,1,0,1,4,0,9,13,4,1,0,5
168238.0,Podlesnykh Yaroslav,OH,Russia,27.0,198.0,2021,Slovenia,Russia,2021-06-11,False,0,0,0,0,0,0,0,0,0,0,0,0,0,0,0,0,0,0,0,0,0,0,0,0
168238.0,Podlesnykh Yaroslav,OH,Russia,27.0,198.0,2021,Russia,Serbia,2021-06-15,True,0,3,6,9,0,0,1,1,9,1,4,14,1,2,2,5,3,0,9,12,3,1,0,4
168238.0,Podlesnykh Yaroslav,OH,Russia,27.0,198.0,2021,Argentina,Russia,2021-06-16,True,3,0,13,16,0,0,6,6,7,3,8,18,2,4,2,8,6,3,13,22,8,1,1,10
168238.0,Podlesnykh Yaroslav,OH,Russia,27.0,198.0,2021,Bulgaria,Russia,2021-06-17,True,0,0,3,3,0,0,0,0,0,0,0,0,0,0,0,0,0,0,0,0,0,0,0,0
168238.0,Podlesnykh Yaroslav,OH,Russia,27.0,198.0,2021,Germany,Russia,2021-06-21,True,1,2,5,8,0,0,0,0,0,0,0,0,0,0,0,0,0,0,0,0,0,0,0,0
168238.0,Podlesnykh Yaroslav,OH,Russia,27.0,198.0,2021,Russia,Italy,2021-06-22,True,0,0,5,5,0,0,0,0,0,0,0,0,0,0,0,0,0,0,0,0,0,0,0,0
168238.0,Podlesnykh Yaroslav,OH,Russia,27.0,198.0,2021,Brazil,Russia,2021-06-23,True,0,3,11,14,0,0,1,1,10,4,11,25,2,1,0,3,1,2,12,15,3,2,2,7
142651.0,Vlasov Ilia,MB,Russia,26.0,212.0,2021,Netherlands,Russia,2021-05-28,True,0,2,6,8,0,0,0,0,5,1,4,10,6,4,4,14,0,0,1,1,0,0,0,0
142651.0,Vlasov Ilia,MB,Russia,26.0,212.0,2021,Iran,Russia,2021-05-29,True,0,2,5,7,0,0,0,0,6,0,4,10,4,12,3,19,0,0,0,0,1,0,0,1
142651.0,Vlasov Ilia,MB,Russia,26.0,212.0,2021,Russia,Japan,2021-05-30,False,0,0,0,0,0,0,0,0,0,0,0,0,0,0,0,0,0,0,0,0,0,0,0,0
142651.0,Vlasov Ilia,MB,Russia,26.0,212.0,2021,Russia,USA,2021-06-03,True,0,3,6,9,0,0,0,0,11,0,5,16,1,4,3,8,0,0,2,2,0,0,0,0
142651.0,Vlasov Ilia,MB,Russia,26.0,212.0,2021,Russia,Australia,2021-06-04,True,0,0,0,0,0,0,0,0,0,0,0,0,0,0,0,0,0,0,0,0,0,0,0,0
142651.0,Vlasov Ilia,MB,Russia,26.0,212.0,2021,Russia,Poland,2021-06-05,False,0,0,0,0,0,0,0,0,0,0,0,0,0,0,0,0,0,0,0,0,0,0,0,0
142651.0,Vlasov Ilia,MB,Russia,26.0,212.0,2021,France,Russia,2021-06-09,False,0,4,4,8,0,0,0,0,6,2,3,11,2,9,8,19,0,0,2,2,2,0,1,3
142651.0,Vlasov Ilia,MB,Russia,26.0,212.0,2021,Russia,Canada,2021-06-10,True,0,2,9,11,0,0,1,1,4,0,6,10,6,4,2,12,0,0,0,0,0,1,0,1
142651.0,Vlasov Ilia,MB,Russia,26.0,212.0,2021,Slovenia,Russia,2021-06-11,False,0,1,5,6,0,0,0,0,1,1,5,7,2,5,2,9,0,0,0,0,2,0,1,3
142651.0,Vlasov Ilia,MB,Russia,26.0,212.0,2021,Russia,Serbia,2021-06-15,True,0,0,0,0,0,0,0,0,0,0,0,0,0,0,0,0,0,0,0,0,0,0,0,0
142651.0,Vlasov Ilia,MB,Russia,26.0,212.0,2021,Argentina,Russia,2021-06-16,True,0,0,0,0,0,0,0,0,0,0,0,0,0,0,0,0,0,0,0,0,0,0,0,0
142651.0,Vlasov Ilia,MB,Russia,26.0,212.0,2021,Bulgaria,Russia,2021-06-17,True,0,3,1,4,0,0,0,0,6,0,1,7,2,2,2,6,0,0,2,2,1,0,0,1
142651.0,Vlasov Ilia,MB,Russia,26.0,212.0,2021,Germany,Russia,2021-06-21,True,1,4,4,9,0,0,2,2,8,0,2,10,1,7,3,11,0,0,1,1,1,0,0,1
142651.0,Vlasov Ilia,MB,Russia,26.0,212.0,2021,Russia,Italy,2021-06-22,True,0,0,0,0,0,0,0,0,0,0,0,0,0,0,0,0,0,0,0,0,0,0,0,0
142651.0,Vlasov Ilia,MB,Russia,26.0,212.0,2021,Brazil,Russia,2021-06-23,True,1,2,4,7,0,0,0,0,3,0,0,3,3,6,3,12,0,0,0,0,1,0,0,1
119817.0,Volvich Artem,MB,Russia,32.0,208.0,2021,Netherlands,Russia,2021-05-28,True,3,0,12,15,0,0,0,0,10,1,1,12,0,9,2,11,0,0,0,0,1,1,0,2
119817.0,Volvich Artem,MB,Russia,32.0,208.0,2021,Iran,Russia,2021-05-29,True,0,2,16,18,0,0,0,0,7,0,1,8,3,4,6,13,0,0,0,0,1,0,0,1
119817.0,Volvich Artem,MB,Russia,32.0,208.0,2021,Russia,Japan,2021-05-30,False,0,0,11,11,0,0,0,0,7,1,3,11,4,7,5,16,0,0,1,1,1,0,1,2
119817.0,Volvich Artem,MB,Russia,32.0,208.0,2021,Russia,USA,2021-06-03,True,0,0,0,0,0,0,0,0,0,0,0,0,0,0,0,0,0,0,0,0,0,0,0,0
119817.0,Volvich Artem,MB,Russia,32.0,208.0,2021,Russia,Australia,2021-06-04,True,0,1,14,15,0,0,1,1,5,3,1,9,3,2,0,5,0,0,0,0,0,1,0,1
119817.0,Volvich Artem,MB,Russia,32.0,208.0,2021,Russia,Poland,2021-06-05,False,0,1,8,9,0,0,0,0,4,1,3,8,2,6,3,11,1,0,2,3,2,0,0,2
119817.0,Volvich Artem,MB,Russia,32.0,208.0,2021,France,Russia,2021-06-09,False,0,0,0,0,0,0,0,0,0,0,0,0,0,0,0,0,0,0,0,0,0,0,0,0
119817.0,Volvich Artem,MB,Russia,32.0,208.0,2021,Russia,Canada,2021-06-10,True,1,3,15,19,0,0,0,0,8,0,2,10,4,1,1,6,0,1,0,1,1,0,0,1
119817.0,Volvich Artem,MB,Russia,32.0,208.0,2021,Slovenia,Russia,2021-06-11,False,0,1,13,14,0,1,0,1,5,1,0,6,4,6,5,15,0,0,1,1,1,0,0,1
119817.0,Volvich Artem,MB,Russia,32.0,208.0,2021,Russia,Serbia,2021-06-15,True,0,0,12,12,0,0,2,2,5,1,3,9,3,2,4,9,1,1,1,3,2,0,0,2
119817.0,Volvich Artem,MB,Russia,32.0,208.0,2021,Argentina,Russia,2021-06-16,True,0,2,13,15,0,0,1,1,7,2,1,10,2,7,6,15,0,0,1,1,0,0,1,1
119817.0,Volvich Artem,MB,Russia,32.0,208.0,2021,Bulgaria,Russia,2021-06-17,True,0,2,2,4,0,0,1,1,1,0,1,2,1,1,1,3,0,0,0,0,1,0,0,1
119817.0,Volvich Artem,MB,Russia,32.0,208.0,2021,Germany,Russia,2021-06-21,True,0,0,0,0,0,0,0,0,0,0,0,0,0,0,0,0,0,0,0,0,0,0,0,0
119817.0,Volvich Artem,MB,Russia,32.0,208.0,2021,Russia,Italy,2021-06-22,True,0,0,14,14,0,0,0,0,5,1,2,8,0,1,3,4,0,0,0,0,0,0,0,0
119817.0,Volvich Artem,MB,Russia,32.0,208.0,2021,Brazil,Russia,2021-06-23,True,1,1,9,11,0,0,0,0,3,0,3,6,2,0,2,4,1,0,0,1,0,0,1,1
148521.0,Baranov Evgeny,L,Russia,26.0,180.0,2021,Netherlands,Russia,2021-05-28,True,0,0,0,0,0,0,0,0,0,0,0,0,0,0,0,0,0,0,0,0,0,0,0,0
148521.0,Baranov Evgeny,L,Russia,26.0,180.0,2021,Iran,Russia,2021-05-29,True,0,0,0,0,0,0,0,0,0,0,0,0,0,0,0,0,0,0,1,1,0,0,0,0
148521.0,Baranov Evgeny,L,Russia,26.0,180.0,2021,Russia,Japan,2021-05-30,False,0,0,0,0,0,0,8,8,0,0,0,0,0,0,0,0,9,1,9,19,9,7,0,16
148521.0,Baranov Evgeny,L,Russia,26.0,180.0,2021,Russia,USA,2021-06-03,True,0,0,0,0,0,0,0,0,0,0,0,0,0,0,0,0,0,0,0,0,0,0,0,0
148521.0,Baranov Evgeny,L,Russia,26.0,180.0,2021,Russia,Australia,2021-06-04,True,0,0,0,0,0,0,1,1,0,0,0,0,0,0,0,0,6,1,2,9,2,1,0,3
148521.0,Baranov Evgeny,L,Russia,26.0,180.0,2021,Russia,Poland,2021-06-05,False,0,0,0,0,0,0,0,0,0,0,0,0,0,0,0,0,0,0,0,0,0,0,0,0
148521.0,Baranov Evgeny,L,Russia,26.0,180.0,2021,France,Russia,2021-06-09,False,0,0,0,0,0,0,2,2,0,0,0,0,0,0,0,0,3,2,18,23,8,1,2,11
148521.0,Baranov Evgeny,L,Russia,26.0,180.0,2021,Russia,Canada,2021-06-10,True,0,0,0,0,0,0,1,1,0,0,0,0,0,0,0,0,6,1,13,20,7,6,0,13
148521.0,Baranov Evgeny,L,Russia,26.0,180.0,2021,Slovenia,Russia,2021-06-11,False,0,0,0,0,0,0,3,3,0,0,0,0,0,0,0,0,7,2,13,22,7,1,0,8
148521.0,Baranov Evgeny,L,Russia,26.0,180.0,2021,Russia,Serbia,2021-06-15,True,0,0,0,0,0,0,0,0,0,0,0,0,0,0,0,0,0,0,0,0,0,0,0,0
148521.0,Baranov Evgeny,L,Russia,26.0,180.0,2021,Argentina,Russia,2021-06-16,True,0,0,0,0,0,0,0,0,0,0,0,0,0,0,0,0,0,0,0,0,0,0,0,0
148521.0,Baranov Evgeny,L,Russia,26.0,180.0,2021,Bulgaria,Russia,2021-06-17,True,0,0,0,0,0,0,0,0,0,0,0,0,0,0,0,0,0,0,0,0,0,0,1,1
148521.0,Baranov Evgeny,L,Russia,26.0,180.0,2021,Germany,Russia,2021-06-21,True,0,0,0,0,0,0,0,0,0,0,0,0,0,0,0,0,0,0,0,0,0,0,0,0
148521.0,Baranov Evgeny,L,Russia,26.0,180.0,2021,Russia,Italy,2021-06-22,True,0,0,0,0,0,0,0,0,0,0,0,0,0,0,0,0,0,0,0,0,0,0,0,0
148521.0,Baranov Evgeny,L,Russia,26.0,180.0,2021,Brazil,Russia,2021-06-23,True,0,0,0,0,0,0,0,0,0,0,0,0,0,0,0,0,0,0,0,0,0,0,0,0
142648.0,Volkov Dmitry,OH,Russia,26.0,201.0,2021,Netherlands,Russia,2021-05-28,True,0,0,0,0,0,0,0,0,0,0,0,0,0,0,0,0,0,0,0,0,0,0,0,0
142648.0,Volkov Dmitry,OH,Russia,26.0,201.0,2021,Iran,Russia,2021-05-29,True,0,0,0,0,0,0,0,0,0,0,0,0,0,0,0,0,0,0,0,0,0,0,0,0
142648.0,Volkov Dmitry,OH,Russia,26.0,201.0,2021,Russia,Japan,2021-05-30,False,0,0,0,0,0,0,0,0,0,0,0,0,0,0,0,0,0,0,0,0,0,0,0,0
142648.0,Volkov Dmitry,OH,Russia,26.0,201.0,2021,Russia,Australia,2021-06-04,True,2,4,8,14,0,0,0,0,9,1,8,18,2,2,0,4,13,0,4,17,4,0,0,4
142648.0,Volkov Dmitry,OH,Russia,26.0,201.0,2021,Russia,Poland,2021-06-05,False,1,5,8,14,0,0,4,4,12,3,10,25,1,1,3,5,5,3,11,19,12,2,1,15
142648.0,Volkov Dmitry,OH,Russia,26.0,201.0,2021,France,Russia,2021-06-09,False,0,1,6,7,0,0,2,2,6,3,6,15,0,1,1,2,3,1,6,10,3,2,0,5
142648.0,Volkov Dmitry,OH,Russia,26.0,201.0,2021,Russia,Canada,2021-06-10,True,2,4,15,21,0,0,3,3,14,3,9,26,2,2,1,5,8,2,13,23,3,2,0,5
142648.0,Volkov Dmitry,OH,Russia,26.0,201.0,2021,Slovenia,Russia,2021-06-11,False,2,4,14,20,0,1,4,5,14,6,8,28,0,1,1,2,3,2,16,21,9,2,1,12
142648.0,Volkov Dmitry,OH,Russia,26.0,201.0,2021,Russia,Serbia,2021-06-15,True,0,1,3,4,0,0,1,1,2,2,6,10,1,0,1,2,4,0,6,10,4,0,0,4
142648.0,Volkov Dmitry,OH,Russia,26.0,201.0,2021,Argentina,Russia,2021-06-16,True,0,0,2,2,0,0,0,0,0,0,0,0,0,0,0,0,0,0,0,0,0,0,1,1
142648.0,Volkov Dmitry,OH,Russia,26.0,201.0,2021,Bulgaria,Russia,2021-06-17,True,1,3,5,9,0,0,3,3,12,1,3,16,1,1,2,4,5,1,8,14,2,1,1,4
142648.0,Volkov Dmitry,OH,Russia,26.0,201.0,2021,Germany,Russia,2021-06-21,True,2,4,13,19,0,0,1,1,11,2,4,17,1,3,3,7,6,0,17,23,6,2,0,8
142648.0,Volkov Dmitry,OH,Russia,26.0,201.0,2021,Russia,Italy,2021-06-22,True,1,2,11,14,0,0,2,2,13,7,10,30,2,4,1,7,4,1,23,28,6,4,1,11
142648.0,Volkov Dmitry,OH,Russia,26.0,201.0,2021,Brazil,Russia,2021-06-23,True,0,1,2,3,0,0,0,0,0,0,0,0,0,0,0,0,0,0,0,0,0,0,0,0
142657.0,Iakovlev Ivan,MB,Russia,26.0,207.0,2021,Germany,Russia,2021-06-21,True,0,0,0,0,0,0,0,0,0,0,0,0,0,0,0,0,0,0,0,0,0,0,0,0
142657.0,Iakovlev Ivan,MB,Russia,26.0,207.0,2021,Brazil,Russia,2021-06-23,True,0,0,0,0,0,0,0,0,0,0,0,0,0,0,0,0,0,0,0,0,0,0,0,0
153362.0,Bogdan Denis,OH,Russia,25.0,200.0,2021,Netherlands,Russia,2021-05-28,True,2,2,4,8,0,0,0,0,2,1,3,6,0,2,0,2,2,1,2,5,1,0,0,1
153362.0,Bogdan Denis,OH,Russia,25.0,200.0,2021,Iran,Russia,2021-05-29,True,1,3,13,17,0,0,1,1,10,3,8,21,2,3,3,8,7,0,6,13,6,1,1,8
153362.0,Bogdan Denis,OH,Russia,25.0,200.0,2021,Russia,Japan,2021-05-30,False,0,1,9,10,0,0,0,0,6,2,7,15,0,3,1,4,2,0,5,7,4,0,1,5
153362.0,Bogdan Denis,OH,Russia,25.0,200.0,2021,Russia,USA,2021-06-03,True,0,1,1,2,0,0,0,0,0,1,1,2,0,0,0,0,0,0,0,0,0,0,1,1
153362.0,Bogdan Denis,OH,Russia,25.0,200.0,2021,Russia,Australia,2021-06-04,True,0,0,2,2,0,0,0,0,1,0,1,2,0,1,0,1,4,0,0,4,1,1,0,2
153362.0,Bogdan Denis,OH,Russia,25.0,200.0,2021,Russia,Poland,2021-06-05,False,0,2,2,4,0,0,4,4,3,3,2,8,0,2,2,4,3,1,7,11,1,0,0,1
153362.0,Bogdan Denis,OH,Russia,25.0,200.0,2021,France,Russia,2021-06-09,False,0,3,5,8,0,0,3,3,6,1,5,12,2,3,2,7,6,1,11,18,1,1,0,2
153362.0,Bogdan Denis,OH,Russia,25.0,200.0,2021,Russia,Canada,2021-06-10,True,0,0,0,0,0,0,0,0,0,0,0,0,0,0,0,0,0,0,0,0,0,0,0,0
153362.0,Bogdan Denis,OH,Russia,25.0,200.0,2021,Slovenia,Russia,2021-06-11,False,1,1,4,6,0,0,2,2,2,0,3,5,1,0,0,1,4,1,6,11,2,0,0,2
153362.0,Bogdan Denis,OH,Russia,25.0,200.0,2021,Russia,Serbia,2021-06-15,True,1,0,2,3,0,0,0,0,0,0,0,0,0,0,0,0,0,0,0,0,0,0,0,0
153362.0,Bogdan Denis,OH,Russia,25.0,200.0,2021,Argentina,Russia,2021-06-16,True,0,0,5,5,0,0,1,1,0,0,0,0,0,0,0,0,0,0,0,0,0,0,0,0
153362.0,Bogdan Denis,OH,Russia,25.0,200.0,2021,Bulgaria,Russia,2021-06-17,True,1,3,6,10,0,0,6,6,6,1,5,12,2,4,0,6,3,3,7,13,7,1,1,9
153362.0,Bogdan Denis,OH,Russia,25.0,200.0,2021,Germany,Russia,2021-06-21,True,0,1,2,3,0,0,1,1,0,0,0,0,0,0,0,0,0,0,0,0,0,0,0,0
153362.0,Bogdan Denis,OH,Russia,25.0,200.0,2021,Russia,Italy,2021-06-22,True,0,3,6,9,0,0,0,0,0,0,0,0,0,0,0,0,0,0,0,0,1,0,0,1
153362.0,Bogdan Denis,OH,Russia,25.0,200.0,2021,Brazil,Russia,2021-06-23,True,0,2,0,2,0,0,0,0,0,0,0,0,0,0,0,0,0,0,0,0,0,0,0,0
136632.0,Pankov Pavel,S,Russia,26.0,198.0,2021,Netherlands,Russia,2021-05-28,True,2,4,4,10,17,0,20,37,0,0,0,0,0,2,0,2,0,0,1,1,1,2,0,3
136632.0,Pankov Pavel,S,Russia,26.0,198.0,2021,Iran,Russia,2021-05-29,True,1,1,9,11,14,0,1,15,0,0,0,0,0,0,0,0,0,0,0,0,2,1,1,4
136632.0,Pankov Pavel,S,Russia,26.0,198.0,2021,Russia,Japan,2021-05-30,False,1,0,8,9,22,0,46,68,0,0,1,1,4,2,3,9,0,0,0,0,3,1,2,6
136632.0,Pankov Pavel,S,Russia,26.0,198.0,2021,Russia,USA,2021-06-03,True,0,1,15,16,28,0,61,89,2,0,0,2,1,4,2,7,0,0,0,0,4,6,2,12
136632.0,Pankov Pavel,S,Russia,26.0,198.0,2021,Russia,Australia,2021-06-04,True,0,0,0,0,0,0,0,0,0,0,0,0,0,0,0,0,0,0,0,0,0,0,0,0
136632.0,Pankov Pavel,S,Russia,26.0,198.0,2021,Russia,Poland,2021-06-05,False,1,1,5,7,16,1,30,47,0,0,0,0,1,3,2,6,0,0,0,0,1,1,0,2
136632.0,Pankov Pavel,S,Russia,26.0,198.0,2021,France,Russia,2021-06-09,False,0,3,5,8,19,0,32,51,2,0,0,2,0,3,1,4,0,0,1,1,3,0,0,3
136632.0,Pankov Pavel,S,Russia,26.0,198.0,2021,Russia,Canada,2021-06-10,True,0,0,0,0,0,0,0,0,0,0,0,0,0,0,0,0,0,0,0,0,0,0,0,0
136632.0,Pankov Pavel,S,Russia,26.0,198.0,2021,Slovenia,Russia,2021-06-11,False,0,0,2,2,5,1,23,29,0,0,0,0,1,1,3,5,0,0,0,0,5,0,1,6
136632.0,Pankov Pavel,S,Russia,26.0,198.0,2021,Russia,Serbia,2021-06-15,True,0,2,3,5,10,0,22,32,0,0,0,0,0,1,1,2,0,0,0,0,3,1,0,4
136632.0,Pankov Pavel,S,Russia,26.0,198.0,2021,Argentina,Russia,2021-06-16,True,0,2,3,5,7,1,20,28,1,0,0,1,1,1,1,3,0,0,0,0,4,1,0,5
136632.0,Pankov Pavel,S,Russia,26.0,198.0,2021,Bulgaria,Russia,2021-06-17,True,0,0,2,2,0,0,0,0,0,0,0,0,0,0,0,0,0,0,0,0,0,1,0,1
136632.0,Pankov Pavel,S,Russia,26.0,198.0,2021,Germany,Russia,2021-06-21,True,0,0,0,0,0,0,0,0,0,0,0,0,0,0,0,0,0,0,0,0,0,0,0,0
136632.0,Pankov Pavel,S,Russia,26.0,198.0,2021,Russia,Italy,2021-06-22,True,1,2,3,6,16,0,43,59,0,0,0,0,1,2,4,7,0,0,0,0,2,0,1,3
136632.0,Pankov Pavel,S,Russia,26.0,198.0,2021,Brazil,Russia,2021-06-23,True,0,0,0,0,0,0,0,0,0,0,0,0,0,0,0,0,0,0,0,0,0,0,0,0
122265.0,Muserskiy Dmitriy,O,Russia,33.0,218.0,2021,Russia,USA,2021-06-03,True,0,1,2,3,0,0,0,0,1,0,1,2,1,1,0,2,0,0,0,0,1,0,0,1
122265.0,Muserskiy Dmitriy,O,Russia,33.0,218.0,2021,Russia,Australia,2021-06-04,True,0,4,6,10,0,0,1,1,12,1,7,20,2,0,4,6,0,0,0,0,2,1,0,3
122265.0,Muserskiy Dmitriy,O,Russia,33.0,218.0,2021,Russia,Poland,2021-06-05,False,2,6,6,14,0,0,2,2,6,0,3,9,0,3,3,6,0,1,0,1,1,0,1,2
122265.0,Muserskiy Dmitriy,O,Russia,33.0,218.0,2021,France,Russia,2021-06-09,False,1,1,4,6,0,0,2,2,5,2,8,15,0,2,4,6,0,0,0,0,1,0,1,2
122265.0,Muserskiy Dmitriy,O,Russia,33.0,218.0,2021,Russia,Serbia,2021-06-15,True,0,0,0,0,0,0,0,0,0,0,0,0,0,0,0,0,0,0,0,0,0,0,0,0
122265.0,Muserskiy Dmitriy,O,Russia,33.0,218.0,2021,Argentina,Russia,2021-06-16,True,0,2,1,3,0,0,3,3,8,2,3,13,2,1,2,5,0,0,0,0,4,2,1,7
122265.0,Muserskiy Dmitriy,O,Russia,33.0,218.0,2021,Bulgaria,Russia,2021-06-17,True,0,0,0,0,0,0,0,0,0,0,0,0,0,0,0,0,0,0,0,0,0,0,0,0
142635.0,Poletaev Victor,O,Russia,26.0,197.0,2021,Netherlands,Russia,2021-05-28,True,0,0,3,3,0,0,0,0,0,0,0,0,0,0,0,0,0,0,0,0,0,0,0,0
142635.0,Poletaev Victor,O,Russia,26.0,197.0,2021,Iran,Russia,2021-05-29,True,0,3,0,3,0,0,0,0,2,0,0,2,0,0,0,0,0,0,0,0,0,0,0,0
142635.0,Poletaev Victor,O,Russia,26.0,197.0,2021,Russia,Japan,2021-05-30,False,1,0,6,7,0,0,0,0,0,0,0,0,0,0,0,0,0,0,0,0,1,0,0,1
142635.0,Poletaev Victor,O,Russia,26.0,197.0,2021,Russia,USA,2021-06-03,True,0,1,4,5,0,0,0,0,0,0,0,0,0,0,0,0,0,0,0,0,0,0,0,0
142635.0,Poletaev Victor,O,Russia,26.0,197.0,2021,Russia,Australia,2021-06-04,True,0,5,8,13,0,0,0,0,14,4,6,24,0,4,2,6,0,0,0,0,2,2,0,4
142635.0,Poletaev Victor,O,Russia,26.0,197.0,2021,Russia,Poland,2021-06-05,False,0,1,0,1,0,0,0,0,0,0,0,0,0,0,0,0,0,0,0,0,0,0,0,0
142635.0,Poletaev Victor,O,Russia,26.0,197.0,2021,France,Russia,2021-06-09,False,0,3,7,10,0,0,0,0,5,1,3,9,0,1,3,4,0,0,0,0,1,0,0,1
142635.0,Poletaev Victor,O,Russia,26.0,197.0,2021,Russia,Canada,2021-06-10,True,0,0,0,0,0,0,0,0,0,0,0,0,0,0,0,0,0,0,0,0,0,0,0,0
142635.0,Poletaev Victor,O,Russia,26.0,197.0,2021,Slovenia,Russia,2021-06-11,False,0,2,8,10,0,0,0,0,6,2,5,13,0,4,2,6,0,0,0,0,2,0,0,2
142635.0,Poletaev Victor,O,Russia,26.0,197.0,2021,Russia,Serbia,2021-06-15,True,0,0,2,2,0,0,0,0,0,0,0,0,0,0,0,0,0,0,0,0,0,0,0,0
142635.0,Poletaev Victor,O,Russia,26.0,197.0,2021,Argentina,Russia,2021-06-16,True,1,1,7,9,0,0,0,0,3,1,8,12,1,0,0,1,0,0,0,0,1,0,1,2
142635.0,Poletaev Victor,O,Russia,26.0,197.0,2021,Bulgaria,Russia,2021-06-17,True,0,3,9,12,0,0,1,1,12,3,8,23,1,0,2,3,0,0,1,1,2,0,0,2
142635.0,Poletaev Victor,O,Russia,26.0,197.0,2021,Germany,Russia,2021-06-21,True,0,0,0,0,0,0,0,0,0,0,0,0,0,0,0,0,0,0,0,0,0,0,0,0
142635.0,Poletaev Victor,O,Russia,26.0,197.0,2021,Russia,Italy,2021-06-22,True,1,1,13,15,0,0,1,1,14,5,5,24,0,4,1,5,0,0,0,0,1,0,1,2
142635.0,Poletaev Victor,O,Russia,26.0,197.0,2021,Brazil,Russia,2021-06-23,True,0,0,0,0,0,0,0,0,0,0,0,0,0,0,0,0,0,0,0,0,0,0,0,0
117184.0,Mikhaylov Maxim,O,Russia,34.0,202.0,2021,Netherlands,Russia,2021-05-28,True,3,2,17,22,0,0,0,0,17,7,8,32,4,1,1,6,1,0,1,2,7,1,0,8
117184.0,Mikhaylov Maxim,O,Russia,34.0,202.0,2021,Iran,Russia,2021-05-29,True,2,4,7,13,0,0,0,0,19,3,10,32,1,2,3,6,1,0,0,1,5,1,1,7
117184.0,Mikhaylov Maxim,O,Russia,34.0,202.0,2021,Russia,Japan,2021-05-30,False,2,3,16,21,0,0,0,0,20,4,14,38,1,6,2,9,1,0,4,5,8,2,1,11
117184.0,Mikhaylov Maxim,O,Russia,34.0,202.0,2021,Russia,USA,2021-06-03,True,1,3,18,22,0,1,2,3,13,2,15,30,1,2,2,5,0,0,1,1,7,0,0,7
117184.0,Mikhaylov Maxim,O,Russia,34.0,202.0,2021,Russia,Poland,2021-06-05,False,2,2,15,19,0,0,2,2,16,8,8,32,0,1,1,2,1,0,0,1,7,1,1,9
117184.0,Mikhaylov Maxim,O,Russia,34.0,202.0,2021,France,Russia,2021-06-09,False,0,2,5,7,0,0,0,0,2,3,2,7,0,0,0,0,0,0,1,1,0,0,0,0
117184.0,Mikhaylov Maxim,O,Russia,34.0,202.0,2021,Russia,Canada,2021-06-10,True,2,3,18,23,0,1,3,4,19,3,10,32,1,1,1,3,1,0,0,1,4,2,0,6
117184.0,Mikhaylov Maxim,O,Russia,34.0,202.0,2021,Slovenia,Russia,2021-06-11,False,2,3,6,11,0,0,2,2,7,3,9,19,1,3,1,5,0,0,0,0,5,1,0,6
117184.0,Mikhaylov Maxim,O,Russia,34.0,202.0,2021,Russia,Serbia,2021-06-15,True,0,3,9,12,0,0,1,1,20,5,14,39,3,6,1,10,0,0,7,7,6,2,0,8
117184.0,Mikhaylov Maxim,O,Russia,34.0,202.0,2021,Argentina,Russia,2021-06-16,True,0,2,1,3,0,0,0,0,1,0,4,5,2,2,1,5,0,0,0,0,0,0,0,0
117184.0,Mikhaylov Maxim,O,Russia,34.0,202.0,2021,Bulgaria,Russia,2021-06-17,True,0,0,0,0,0,0,0,0,0,0,0,0,0,0,0,0,0,0,0,0,0,0,0,0
117184.0,Mikhaylov Maxim,O,Russia,34.0,202.0,2021,Germany,Russia,2021-06-21,True,1,2,9,12,0,0,2,2,17,4,11,32,0,0,5,5,0,0,1,1,7,1,1,9
117184.0,Mikhaylov Maxim,O,Russia,34.0,202.0,2021,Russia,Italy,2021-06-22,True,0,2,4,6,0,0,0,0,5,2,2,9,2,3,2,7,0,0,0,0,2,1,0,3
117184.0,Mikhaylov Maxim,O,Russia,34.0,202.0,2021,Brazil,Russia,2021-06-23,True,2,3,10,15,0,0,2,2,11,1,4,16,1,2,0,3,0,0,1,1,6,0,1,7
152885.0,Kliuka Egor,OH,Russia,26.0,209.0,2021,Netherlands,Russia,2021-05-28,True,0,4,8,12,0,0,3,3,11,1,8,20,0,4,2,6,7,2,12,21,7,3,1,11
152885.0,Kliuka Egor,OH,Russia,26.0,209.0,2021,Iran,Russia,2021-05-29,True,0,0,13,13,0,0,0,0,10,1,5,16,0,5,3,8,4,2,16,22,3,0,3,6
152885.0,Kliuka Egor,OH,Russia,26.0,209.0,2021,Russia,Japan,2021-05-30,False,3,4,5,12,0,0,0,0,9,4,9,22,2,1,2,5,10,1,14,25,1,0,0,1
152885.0,Kliuka Egor,OH,Russia,26.0,209.0,2021,Russia,USA,2021-06-03,True,0,3,10,13,0,0,3,3,17,3,8,28,0,5,0,5,6,0,12,18,12,1,2,15
152885.0,Kliuka Egor,OH,Russia,26.0,209.0,2021,Russia,Poland,2021-06-05,False,0,1,3,4,0,0,1,1,4,4,4,12,0,1,2,3,2,2,6,10,1,1,0,2
152885.0,Kliuka Egor,OH,Russia,26.0,209.0,2021,France,Russia,2021-06-09,False,1,2,15,18,0,0,4,4,14,3,10,27,0,5,0,5,8,3,16,27,9,2,0,11
152885.0,Kliuka Egor,OH,Russia,26.0,209.0,2021,Russia,Canada,2021-06-10,True,0,2,4,6,0,0,1,1,4,1,6,11,0,0,0,0,3,3,2,8,2,0,0,2
152885.0,Kliuka Egor,OH,Russia,26.0,209.0,2021,Slovenia,Russia,2021-06-11,False,0,3,7,10,0,0,4,4,7,3,14,24,4,3,2,9,4,1,20,25,2,2,0,4
152885.0,Kliuka Egor,OH,Russia,26.0,209.0,2021,Russia,Serbia,2021-06-15,True,2,3,16,21,0,0,7,7,9,3,15,27,2,1,0,3,13,2,11,26,5,1,0,6
152885.0,Kliuka Egor,OH,Russia,26.0,209.0,2021,Argentina,Russia,2021-06-16,True,0,6,10,16,0,0,6,6,14,3,14,31,1,4,1,6,10,0,16,26,4,1,0,5
152885.0,Kliuka Egor,OH,Russia,26.0,209.0,2021,Bulgaria,Russia,2021-06-17,True,0,0,0,0,0,0,0,0,0,0,0,0,0,0,0,0,0,0,0,0,0,0,0,0
152885.0,Kliuka Egor,OH,Russia,26.0,209.0,2021,Germany,Russia,2021-06-21,True,2,2,15,19,1,0,2,3,11,6,9,26,1,1,2,4,3,0,14,17,5,0,0,5
152885.0,Kliuka Egor,OH,Russia,26.0,209.0,2021,Russia,Italy,2021-06-22,True,1,4,14,19,0,0,4,4,11,2,12,25,1,4,0,5,11,6,22,39,6,0,1,7
152885.0,Kliuka Egor,OH,Russia,26.0,209.0,2021,Brazil,Russia,2021-06-23,True,1,0,8,9,0,0,2,2,11,3,5,19,1,3,0,4,4,0,14,18,2,1,0,3
143711.0,Kurkaev Ilyas,MB,Russia,28.0,207.0,2021,Netherlands,Russia,2021-05-28,True,0,0,0,0,0,0,0,0,0,0,0,0,0,0,0,0,0,0,0,0,0,0,0,0
143711.0,Kurkaev Ilyas,MB,Russia,28.0,207.0,2021,Iran,Russia,2021-05-29,True,0,0,1,1,0,0,0,0,1,0,0,1,0,1,0,1,0,0,1,1,0,0,0,0
143711.0,Kurkaev Ilyas,MB,Russia,28.0,207.0,2021,Russia,Japan,2021-05-30,False,0,2,11,13,0,0,0,0,6,2,1,9,6,6,3,15,0,0,0,0,3,2,1,6
143711.0,Kurkaev Ilyas,MB,Russia,28.0,207.0,2021,Russia,USA,2021-06-03,True,1,1,4,6,0,0,2,2,3,0,3,6,1,2,1,4,0,0,0,0,1,0,0,1
143711.0,Kurkaev Ilyas,MB,Russia,28.0,207.0,2021,Russia,Australia,2021-06-04,True,0,0,0,0,0,0,0,0,0,0,0,0,0,0,0,0,0,0,0,0,0,0,0,0
143711.0,Kurkaev Ilyas,MB,Russia,28.0,207.0,2021,Russia,Poland,2021-06-05,False,0,0,0,0,0,0,0,0,0,0,0,0,0,0,0,0,0,0,0,0,0,0,0,0
143711.0,Kurkaev Ilyas,MB,Russia,28.0,207.0,2021,France,Russia,2021-06-09,False,0,3,10,13,0,0,0,0,8,0,4,12,1,5,2,8,0,0,1,1,3,0,0,3
143711.0,Kurkaev Ilyas,MB,Russia,28.0,207.0,2021,Russia,Canada,2021-06-10,True,0,0,0,0,0,0,0,0,0,0,0,0,0,0,0,0,0,0,0,0,0,0,0,0
143711.0,Kurkaev Ilyas,MB,Russia,28.0,207.0,2021,Slovenia,Russia,2021-06-11,False,0,1,4,5,0,0,0,0,5,1,2,8,1,2,1,4,0,0,0,0,0,1,0,1
143711.0,Kurkaev Ilyas,MB,Russia,28.0,207.0,2021,Russia,Serbia,2021-06-15,True,2,4,6,12,0,0,2,2,5,2,4,11,4,6,3,13,0,0,0,0,2,1,0,3
143711.0,Kurkaev Ilyas,MB,Russia,28.0,207.0,2021,Argentina,Russia,2021-06-16,True,0,2,6,8,0,0,0,0,7,0,4,11,1,4,6,11,0,0,1,1,2,0,0,2
143711.0,Kurkaev Ilyas,MB,Russia,28.0,207.0,2021,Bulgaria,Russia,2021-06-17,True,0,3,5,8,0,0,0,0,6,0,1,7,0,3,2,5,0,0,0,0,0,1,0,1
143711.0,Kurkaev Ilyas,MB,Russia,28.0,207.0,2021,Germany,Russia,2021-06-21,True,0,3,3,6,0,0,2,2,9,0,2,11,4,3,6,13,1,0,1,2,0,0,0,0
143711.0,Kurkaev Ilyas,MB,Russia,28.0,207.0,2021,Russia,Italy,2021-06-22,True,1,1,5,7,0,0,0,0,8,1,0,9,3,2,4,9,0,0,0,0,1,1,0,2
143711.0,Kurkaev Ilyas,MB,Russia,28.0,207.0,2021,Brazil,Russia,2021-06-23,True,0,0,2,2,0,0,1,1,1,1,1,3,0,0,1,1,0,0,0,0,0,0,0,0
124794.0,Kobzar Igor,S,Russia,30.0,198.0,2021,Netherlands,Russia,2021-05-28,True,0,1,3,4,21,0,23,44,1,0,1,2,0,0,1,1,0,0,0,0,2,1,0,3
124794.0,Kobzar Igor,S,Russia,30.0,198.0,2021,Iran,Russia,2021-05-29,True,0,3,6,9,23,0,0,23,2,1,0,3,0,1,2,3,0,0,0,0,4,0,2,6
124794.0,Kobzar Igor,S,Russia,30.0,198.0,2021,Russia,Japan,2021-05-30,False,0,2,5,7,20,0,27,47,1,1,0,2,0,3,0,3,0,0,0,0,2,2,0,4
124794.0,Kobzar Igor,S,Russia,30.0,198.0,2021,Russia,USA,2021-06-03,True,0,0,0,0,0,0,0,0,0,0,0,0,0,0,0,0,0,0,0,0,0,0,0,0
124794.0,Kobzar Igor,S,Russia,30.0,198.0,2021,Russia,Australia,2021-06-04,True,0,3,12,15,18,0,62,80,0,0,1,1,0,2,3,5,0,0,0,0,1,0,0,1
124794.0,Kobzar Igor,S,Russia,30.0,198.0,2021,Russia,Poland,2021-06-05,False,0,1,4,5,8,1,23,32,0,0,0,0,0,1,2,3,0,0,1,1,3,0,1,4
124794.0,Kobzar Igor,S,Russia,30.0,198.0,2021,France,Russia,2021-06-09,False,0,1,2,3,14,0,26,40,0,0,0,0,0,3,1,4,0,0,0,0,1,1,0,2
124794.0,Kobzar Igor,S,Russia,30.0,198.0,2021,Russia,Canada,2021-06-10,True,1,3,7,11,14,2,73,89,0,0,0,0,2,3,2,7,0,0,2,2,3,1,0,4
124794.0,Kobzar Igor,S,Russia,30.0,198.0,2021,Slovenia,Russia,2021-06-11,False,2,0,16,18,20,0,44,64,0,0,0,0,0,5,3,8,0,0,0,0,3,2,4,9
124794.0,Kobzar Igor,S,Russia,30.0,198.0,2021,Russia,Serbia,2021-06-15,True,2,0,14,16,14,2,45,61,0,0,3,3,1,4,1,6,0,0,1,1,8,2,0,10
124794.0,Kobzar Igor,S,Russia,30.0,198.0,2021,Argentina,Russia,2021-06-16,True,1,3,9,13,21,0,32,53,1,0,2,3,2,1,0,3,0,0,0,0,7,0,0,7
124794.0,Kobzar Igor,S,Russia,30.0,198.0,2021,Bulgaria,Russia,2021-06-17,True,4,4,13,21,16,0,37,53,2,0,0,2,0,1,2,3,0,0,1,1,7,1,0,8
124794.0,Kobzar Igor,S,Russia,30.0,198.0,2021,Germany,Russia,2021-06-21,True,1,2,18,21,27,1,53,81,2,0,1,3,2,3,3,8,0,0,0,0,8,2,1,11
124794.0,Kobzar Igor,S,Russia,30.0,198.0,2021,Russia,Italy,2021-06-22,True,0,2,3,5,12,0,20,32,0,0,0,0,0,5,0,5,0,0,0,0,0,0,0,0
124794.0,Kobzar Igor,S,Russia,30.0,198.0,2021,Brazil,Russia,2021-06-23,True,2,3,8,13,21,2,38,61,1,0,2,3,0,2,2,4,0,0,0,0,2,1,0,3
132391.0,Golubev Valentin,L,Russia,29.0,190.0,2021,Netherlands,Russia,2021-05-28,True,0,0,0,0,0,0,3,3,0,0,0,0,0,0,0,0,5,1,13,19,8,7,0,15
132391.0,Golubev Valentin,L,Russia,29.0,190.0,2021,Iran,Russia,2021-05-29,True,0,0,0,0,0,0,0,0,0,0,0,0,0,0,0,0,8,1,12,21,17,2,0,19
132391.0,Golubev Valentin,L,Russia,29.0,190.0,2021,Russia,Japan,2021-05-30,False,0,0,0,0,0,0,0,0,0,0,0,0,0,0,0,0,0,0,0,0,0,0,0,0
132391.0,Golubev Valentin,L,Russia,29.0,190.0,2021,Russia,USA,2021-06-03,True,0,0,0,0,0,0,5,5,0,0,0,0,0,0,0,0,9,2,17,28,7,1,1,9
132391.0,Golubev Valentin,L,Russia,29.0,190.0,2021,Russia,Australia,2021-06-04,True,0,0,0,0,0,0,2,2,0,0,0,0,0,0,0,0,3,0,7,10,4,3,0,7
132391.0,Golubev Valentin,L,Russia,29.0,190.0,2021,Russia,Poland,2021-06-05,False,0,0,0,0,0,0,1,1,0,0,0,0,0,0,0,0,6,4,16,26,6,3,1,10
132391.0,Golubev Valentin,L,Russia,29.0,190.0,2021,France,Russia,2021-06-09,False,0,0,0,0,0,0,0,0,0,0,0,0,0,0,0,0,0,0,0,0,0,0,0,0
132391.0,Golubev Valentin,L,Russia,29.0,190.0,2021,Russia,Canada,2021-06-10,True,0,0,0,0,0,0,0,0,0,0,0,0,0,0,0,0,0,0,0,0,0,0,0,0
132391.0,Golubev Valentin,L,Russia,29.0,190.0,2021,Slovenia,Russia,2021-06-11,False,0,0,0,0,0,0,0,0,0,0,0,0,0,0,0,0,0,0,0,0,0,0,0,0
132391.0,Golubev Valentin,L,Russia,29.0,190.0,2021,Russia,Serbia,2021-06-15,True,0,0,0,0,0,0,7,7,0,0,0,0,0,0,0,0,6,0,12,18,9,3,0,12
132391.0,Golubev Valentin,L,Russia,29.0,190.0,2021,Argentina,Russia,2021-06-16,True,0,0,0,0,0,0,3,3,0,0,0,0,0,0,0,0,7,1,13,21,6,3,1,10
132391.0,Golubev Valentin,L,Russia,29.0,190.0,2021,Bulgaria,Russia,2021-06-17,True,0,0,0,0,0,0,5,5,0,0,0,0,0,0,0,0,5,1,10,16,10,2,0,12
132391.0,Golubev Valentin,L,Russia,29.0,190.0,2021,Germany,Russia,2021-06-21,True,0,0,0,0,0,0,6,6,0,0,0,0,0,0,0,0,6,0,11,17,10,4,0,14
132391.0,Golubev Valentin,L,Russia,29.0,190.0,2021,Russia,Italy,2021-06-22,True,0,0,0,0,0,0,6,6,0,0,0,0,0,0,0,0,6,1,11,18,11,3,1,15
132391.0,Golubev Valentin,L,Russia,29.0,190.0,2021,Brazil,Russia,2021-06-23,True,0,0,0,0,0,0,5,5,0,0,0,0,0,0,0,0,5,2,16,23,5,6,0,11
124926.0,Kovacevic Uros,OH,Serbia,28.0,197.0,2021,Serbia,Slovenia,2021-05-28,True,0,4,13,17,0,0,3,3,18,7,9,34,4,2,0,6,5,1,13,19,6,3,1,10
124926.0,Kovacevic Uros,OH,Serbia,28.0,197.0,2021,Japan,Serbia,2021-06-03,True,0,0,16,16,0,0,3,3,19,1,11,31,3,1,1,5,11,0,14,25,2,5,1,8
124926.0,Kovacevic Uros,OH,Serbia,28.0,197.0,2021,Serbia,France,2021-06-04,True,1,5,11,17,0,0,1,1,8,5,11,24,2,2,5,9,8,5,15,28,7,1,0,8
124926.0,Kovacevic Uros,OH,Serbia,28.0,197.0,2021,Brazil,Serbia,2021-06-05,False,0,4,11,15,0,0,5,5,10,5,11,26,1,5,2,8,10,2,24,36,5,3,1,9
124926.0,Kovacevic Uros,OH,Serbia,28.0,197.0,2021,Serbia,Germany,2021-06-09,True,1,2,15,18,0,0,5,5,9,1,11,21,1,5,0,6,3,1,11,15,6,2,1,9
124926.0,Kovacevic Uros,OH,Serbia,28.0,197.0,2021,Serbia,Iran,2021-06-10,True,1,6,7,14,0,0,3,3,18,4,13,35,1,4,1,6,9,1,19,29,5,2,1,8
124926.0,Kovacevic Uros,OH,Serbia,28.0,197.0,2021,USA,Serbia,2021-06-11,True,0,3,7,10,0,0,0,0,20,5,8,33,2,2,2,6,8,2,18,28,1,5,0,6
124926.0,Kovacevic Uros,OH,Serbia,28.0,197.0,2021,Russia,Serbia,2021-06-15,False,2,4,11,17,0,0,3,3,15,9,7,31,1,5,4,10,12,2,30,44,6,1,1,8
124926.0,Kovacevic Uros,OH,Serbia,28.0,197.0,2021,Serbia,Bulgaria,2021-06-16,True,2,2,8,12,0,0,2,2,6,3,2,11,1,2,3,6,2,1,10,13,0,0,0,0
124926.0,Kovacevic Uros,OH,Serbia,28.0,197.0,2021,Argentina,Serbia,2021-06-17,False,0,1,4,5,0,0,1,1,3,4,3,10,0,0,0,0,1,0,7,8,1,0,0,1
136360.0,Kapur Milorad,L,Serbia,31.0,181.0,2021,Serbia,Slovenia,2021-05-28,True,0,0,0,0,0,0,0,0,0,0,0,0,0,0,0,0,0,0,0,0,0,0,0,0
136360.0,Kapur Milorad,L,Serbia,31.0,181.0,2021,Poland,Serbia,2021-05-29,False,0,0,0,0,0,0,0,0,0,0,0,0,0,0,0,0,0,0,0,0,0,0,0,0
136360.0,Kapur Milorad,L,Serbia,31.0,181.0,2021,Serbia,Italy,2021-05-30,True,0,0,0,0,0,0,0,0,0,0,0,0,0,0,0,0,0,0,0,0,0,0,0,0
136360.0,Kapur Milorad,L,Serbia,31.0,181.0,2021,Japan,Serbia,2021-06-03,True,0,0,0,0,0,0,0,0,0,0,0,0,0,0,0,0,0,0,0,0,0,0,0,0
136360.0,Kapur Milorad,L,Serbia,31.0,181.0,2021,Serbia,France,2021-06-04,True,0,0,0,0,0,0,0,0,0,0,0,0,0,0,0,0,0,0,0,0,0,0,0,0
136360.0,Kapur Milorad,L,Serbia,31.0,181.0,2021,Brazil,Serbia,2021-06-05,False,0,0,0,0,0,0,0,0,0,0,0,0,0,0,0,0,0,0,0,0,0,0,0,0
136360.0,Kapur Milorad,L,Serbia,31.0,181.0,2021,Serbia,Germany,2021-06-09,True,0,0,0,0,0,0,0,0,0,0,0,0,0,0,0,0,0,0,0,0,4,0,1,5
136360.0,Kapur Milorad,L,Serbia,31.0,181.0,2021,Serbia,Iran,2021-06-10,True,0,0,0,0,0,0,0,0,0,0,0,0,0,0,0,0,0,0,0,0,0,0,0,0
136360.0,Kapur Milorad,L,Serbia,31.0,181.0,2021,USA,Serbia,2021-06-11,True,0,0,0,0,0,0,1,1,0,0,0,0,0,0,0,0,0,0,0,0,1,3,0,4
136360.0,Kapur Milorad,L,Serbia,31.0,181.0,2021,Russia,Serbia,2021-06-15,False,0,0,0,0,0,0,1,1,0,0,0,0,0,0,0,0,0,0,0,0,0,1,0,1
136360.0,Kapur Milorad,L,Serbia,31.0,181.0,2021,Serbia,Bulgaria,2021-06-16,True,0,0,0,0,0,0,0,0,0,0,0,0,0,0,0,0,0,0,0,0,0,0,0,0
136360.0,Kapur Milorad,L,Serbia,31.0,181.0,2021,Argentina,Serbia,2021-06-17,False,0,0,0,0,0,0,0,0,0,0,0,0,0,0,0,0,0,0,0,0,0,0,0,0
136360.0,Kapur Milorad,L,Serbia,31.0,181.0,2021,Australia,Serbia,2021-06-21,True,0,0,0,0,0,0,1,1,0,0,0,0,0,0,0,0,0,0,0,0,7,1,1,9
136360.0,Kapur Milorad,L,Serbia,31.0,181.0,2021,Serbia,Netherlands,2021-06-22,True,0,0,0,0,0,0,2,2,0,0,0,0,0,0,0,0,0,0,0,0,2,4,1,7
136360.0,Kapur Milorad,L,Serbia,31.0,181.0,2021,Canada,Serbia,2021-06-23,False,0,0,0,0,0,0,2,2,0,0,0,0,0,0,0,0,0,0,0,0,4,2,1,7
150383.0,Pekovic Nikola,L,Serbia,32.0,176.0,2021,Serbia,Slovenia,2021-05-28,True,0,0,0,0,0,0,3,3,0,0,0,0,0,0,0,0,6,2,11,19,3,0,0,3
150383.0,Pekovic Nikola,L,Serbia,32.0,176.0,2021,Poland,Serbia,2021-05-29,False,0,0,0,0,0,0,4,4,0,0,0,0,0,0,0,0,8,6,10,24,10,3,2,15
150383.0,Pekovic Nikola,L,Serbia,32.0,176.0,2021,Serbia,Italy,2021-05-30,True,0,0,0,0,0,1,10,11,0,0,0,0,0,0,0,0,9,0,6,15,11,2,0,13
150383.0,Pekovic Nikola,L,Serbia,32.0,176.0,2021,Japan,Serbia,2021-06-03,True,0,0,0,0,0,0,2,2,0,0,0,0,0,0,0,0,3,0,7,10,3,7,0,10
150383.0,Pekovic Nikola,L,Serbia,32.0,176.0,2021,Serbia,France,2021-06-04,True,0,0,0,0,0,0,6,6,0,0,0,0,0,0,0,0,15,3,13,31,4,1,0,5
150383.0,Pekovic Nikola,L,Serbia,32.0,176.0,2021,Brazil,Serbia,2021-06-05,False,0,0,0,0,0,0,5,5,0,0,0,0,0,0,0,0,3,0,14,17,11,3,0,14
150383.0,Pekovic Nikola,L,Serbia,32.0,176.0,2021,Serbia,Germany,2021-06-09,True,0,0,0,0,0,0,2,2,0,0,0,0,0,0,0,0,3,1,16,20,1,1,0,2
150383.0,Pekovic Nikola,L,Serbia,32.0,176.0,2021,Serbia,Iran,2021-06-10,True,0,0,0,0,0,0,9,9,0,0,0,0,0,0,0,0,10,1,16,27,5,8,0,13
150383.0,Pekovic Nikola,L,Serbia,32.0,176.0,2021,USA,Serbia,2021-06-11,True,0,0,0,0,0,0,4,4,0,0,0,0,0,0,0,0,2,2,19,23,2,3,1,6
150383.0,Pekovic Nikola,L,Serbia,32.0,176.0,2021,Russia,Serbia,2021-06-15,False,0,0,0,0,0,0,1,1,0,0,0,0,0,0,0,0,3,3,10,16,3,3,2,8
150383.0,Pekovic Nikola,L,Serbia,32.0,176.0,2021,Serbia,Bulgaria,2021-06-16,True,0,0,0,0,0,0,1,1,0,0,0,0,0,0,0,0,4,1,12,17,5,0,0,5
150383.0,Pekovic Nikola,L,Serbia,32.0,176.0,2021,Argentina,Serbia,2021-06-17,False,0,0,0,0,0,0,4,4,0,0,0,0,0,0,0,0,5,1,15,21,6,5,2,13
150383.0,Pekovic Nikola,L,Serbia,32.0,176.0,2021,Australia,Serbia,2021-06-21,True,0,0,0,0,0,0,1,1,0,0,0,0,0,0,0,0,8,3,5,16,0,0,0,0
150383.0,Pekovic Nikola,L,Serbia,32.0,176.0,2021,Serbia,Netherlands,2021-06-22,True,0,0,0,0,0,0,2,2,0,0,0,0,0,0,0,0,6,1,11,18,7,2,0,9
150383.0,Pekovic Nikola,L,Serbia,32.0,176.0,2021,Canada,Serbia,2021-06-23,False,0,0,0,0,0,0,10,10,0,0,0,0,0,0,0,0,8,0,18,26,8,0,1,9
146579.0,Krsmanovic Petar,MB,Serbia,31.0,205.0,2021,Serbia,Slovenia,2021-05-28,True,0,2,11,13,0,0,0,0,3,2,2,7,1,3,1,5,2,0,3,5,2,1,0,3
146579.0,Krsmanovic Petar,MB,Serbia,31.0,205.0,2021,Poland,Serbia,2021-05-29,False,0,3,13,16,0,0,0,0,4,4,0,8,1,2,0,3,1,0,0,1,4,0,0,4
146579.0,Krsmanovic Petar,MB,Serbia,31.0,205.0,2021,Serbia,Italy,2021-05-30,True,0,3,10,13,0,0,0,0,3,1,2,6,0,3,1,4,0,0,0,0,1,0,0,1
146579.0,Krsmanovic Petar,MB,Serbia,31.0,205.0,2021,Japan,Serbia,2021-06-03,True,0,2,14,16,0,0,1,1,10,2,4,16,4,5,1,10,0,0,1,1,1,0,0,1
146579.0,Krsmanovic Petar,MB,Serbia,31.0,205.0,2021,Serbia,France,2021-06-04,True,0,3,13,16,0,0,2,2,10,0,2,12,3,12,8,23,0,0,0,0,4,1,0,5
146579.0,Krsmanovic Petar,MB,Serbia,31.0,205.0,2021,Brazil,Serbia,2021-06-05,False,0,1,12,13,0,0,0,0,11,3,3,17,1,5,3,9,1,0,0,1,5,2,0,7
146579.0,Krsmanovic Petar,MB,Serbia,31.0,205.0,2021,Serbia,Germany,2021-06-09,True,1,2,13,16,0,0,1,1,6,0,2,8,2,3,8,13,0,0,1,1,1,1,2,4
146579.0,Krsmanovic Petar,MB,Serbia,31.0,205.0,2021,Serbia,Iran,2021-06-10,True,1,4,22,27,0,0,5,5,9,3,3,15,1,3,2,6,1,0,1,2,6,2,0,8
146579.0,Krsmanovic Petar,MB,Serbia,31.0,205.0,2021,USA,Serbia,2021-06-11,True,0,1,16,17,0,0,1,1,7,1,2,10,2,5,1,8,0,0,0,0,1,2,0,3
146579.0,Krsmanovic Petar,MB,Serbia,31.0,205.0,2021,Russia,Serbia,2021-06-15,False,0,0,15,15,0,0,4,4,9,0,2,11,2,5,3,10,1,0,0,1,2,0,0,2
146579.0,Krsmanovic Petar,MB,Serbia,31.0,205.0,2021,Serbia,Bulgaria,2021-06-16,True,2,1,13,16,0,0,3,3,7,0,0,7,0,3,2,5,1,0,0,1,2,0,0,2
146579.0,Krsmanovic Petar,MB,Serbia,31.0,205.0,2021,Argentina,Serbia,2021-06-17,False,0,0,9,9,0,0,2,2,4,2,1,7,3,1,4,8,0,0,0,0,0,1,0,1
146579.0,Krsmanovic Petar,MB,Serbia,31.0,205.0,2021,Australia,Serbia,2021-06-21,True,3,3,8,14,0,0,2,2,5,1,1,7,7,1,2,10,0,0,0,0,2,1,0,3
146579.0,Krsmanovic Petar,MB,Serbia,31.0,205.0,2021,Serbia,Netherlands,2021-06-22,True,3,1,16,20,0,1,1,2,8,0,4,12,1,6,7,14,0,1,0,1,3,1,1,5
146579.0,Krsmanovic Petar,MB,Serbia,31.0,205.0,2021,Canada,Serbia,2021-06-23,False,0,5,13,18,0,0,1,1,10,2,4,16,4,6,9,19,2,0,2,4,5,0,1,6
132022.0,Ivovic Marko,OH,Serbia,31.0,194.0,2021,Serbia,Slovenia,2021-05-28,True,0,2,17,19,0,0,1,1,11,3,9,23,2,4,0,6,13,1,19,33,5,1,1,7
132022.0,Ivovic Marko,OH,Serbia,31.0,194.0,2021,Poland,Serbia,2021-05-29,False,1,3,10,14,0,0,0,0,12,1,4,17,0,3,0,3,6,6,12,24,6,1,0,7
132022.0,Ivovic Marko,OH,Serbia,31.0,194.0,2021,Serbia,Italy,2021-05-30,True,0,3,9,12,0,0,0,0,17,3,17,37,0,1,5,6,6,1,14,21,7,2,0,9
132022.0,Ivovic Marko,OH,Serbia,31.0,194.0,2021,Japan,Serbia,2021-06-03,True,1,4,10,15,0,0,4,4,11,3,2,16,2,4,1,7,20,2,14,36,4,2,0,6
132022.0,Ivovic Marko,OH,Serbia,31.0,194.0,2021,Serbia,France,2021-06-04,True,0,3,13,16,0,0,5,5,15,4,7,26,0,4,3,7,14,1,11,26,6,4,0,10
132022.0,Ivovic Marko,OH,Serbia,31.0,194.0,2021,Brazil,Serbia,2021-06-05,False,2,2,9,13,0,0,1,1,12,4,8,24,0,2,1,3,14,1,9,24,7,1,3,11
132022.0,Ivovic Marko,OH,Serbia,31.0,194.0,2021,Serbia,Germany,2021-06-09,True,0,1,0,1,0,0,1,1,0,1,3,4,0,0,0,0,2,2,4,8,4,0,0,4
132022.0,Ivovic Marko,OH,Serbia,31.0,194.0,2021,Serbia,Iran,2021-06-10,True,2,0,11,13,0,0,1,1,4,1,4,9,0,1,1,2,4,2,4,10,2,5,0,7
132022.0,Ivovic Marko,OH,Serbia,31.0,194.0,2021,USA,Serbia,2021-06-11,True,3,2,15,20,0,0,2,2,9,0,7,16,2,3,1,6,9,2,3,14,6,4,1,11
132022.0,Ivovic Marko,OH,Serbia,31.0,194.0,2021,Russia,Serbia,2021-06-15,False,0,4,10,14,0,0,5,5,14,4,10,28,1,4,2,7,4,1,13,18,5,3,2,10
132022.0,Ivovic Marko,OH,Serbia,31.0,194.0,2021,Serbia,Bulgaria,2021-06-16,True,3,1,15,19,0,0,2,2,9,2,3,14,1,1,2,4,2,1,8,11,6,0,0,6
132022.0,Ivovic Marko,OH,Serbia,31.0,194.0,2021,Argentina,Serbia,2021-06-17,False,0,1,10,11,0,0,2,2,11,3,9,23,1,3,1,5,4,1,13,18,2,0,0,2
132022.0,Ivovic Marko,OH,Serbia,31.0,194.0,2021,Australia,Serbia,2021-06-21,True,2,0,8,10,0,0,0,0,9,1,7,17,1,0,0,1,4,0,1,5,2,1,0,3
132022.0,Ivovic Marko,OH,Serbia,31.0,194.0,2021,Serbia,Netherlands,2021-06-22,True,1,4,12,17,0,0,10,10,11,1,5,17,0,2,0,2,11,2,20,33,2,1,0,3
132022.0,Ivovic Marko,OH,Serbia,31.0,194.0,2021,Canada,Serbia,2021-06-23,False,5,5,19,29,1,1,7,9,13,4,16,33,2,3,5,10,10,0,16,26,11,2,1,14
124911.0,Jovovic Nikola,S,Serbia,30.0,197.0,2021,Serbia,Slovenia,2021-05-28,True,0,3,14,17,36,0,71,107,0,0,0,0,2,2,0,4,0,0,1,1,11,3,0,14
124911.0,Jovovic Nikola,S,Serbia,30.0,197.0,2021,Poland,Serbia,2021-05-29,False,0,2,9,11,27,0,58,85,1,1,1,3,0,3,0,3,0,0,0,0,4,1,0,5
124911.0,Jovovic Nikola,S,Serbia,30.0,197.0,2021,Serbia,Italy,2021-05-30,True,1,2,13,16,26,1,77,104,1,0,1,2,1,1,6,8,0,0,1,1,10,3,1,14
124911.0,Jovovic Nikola,S,Serbia,30.0,197.0,2021,Japan,Serbia,2021-06-03,True,0,0,18,18,34,0,48,82,2,0,0,2,2,2,0,4,0,0,1,1,5,2,0,7
124911.0,Jovovic Nikola,S,Serbia,30.0,197.0,2021,Serbia,France,2021-06-04,True,0,1,16,17,23,1,59,83,0,0,0,0,1,6,0,7,0,0,0,0,6,2,1,9
124911.0,Jovovic Nikola,S,Serbia,30.0,197.0,2021,Brazil,Serbia,2021-06-05,False,0,1,10,11,26,0,39,65,0,0,0,0,1,1,0,2,0,0,0,0,2,2,0,4
124911.0,Jovovic Nikola,S,Serbia,30.0,197.0,2021,Serbia,Germany,2021-06-09,True,0,0,1,1,5,1,3,9,0,0,1,1,0,0,0,0,0,0,0,0,2,0,1,3
124911.0,Jovovic Nikola,S,Serbia,30.0,197.0,2021,Serbia,Iran,2021-06-10,True,0,0,9,9,34,0,55,89,0,0,0,0,0,1,2,3,0,0,0,0,8,3,1,12
124911.0,Jovovic Nikola,S,Serbia,30.0,197.0,2021,USA,Serbia,2021-06-11,True,0,0,16,16,19,0,60,79,0,0,0,0,1,1,0,2,0,0,2,2,4,3,0,7
124911.0,Jovovic Nikola,S,Serbia,30.0,197.0,2021,Russia,Serbia,2021-06-15,False,1,1,13,15,20,0,66,86,1,0,2,3,0,2,3,5,0,1,0,1,10,3,6,19
124911.0,Jovovic Nikola,S,Serbia,30.0,197.0,2021,Serbia,Bulgaria,2021-06-16,True,0,0,7,7,21,1,29,51,0,0,1,1,0,0,1,1,0,0,0,0,4,3,1,8
124911.0,Jovovic Nikola,S,Serbia,30.0,197.0,2021,Argentina,Serbia,2021-06-17,False,0,1,6,7,20,0,43,63,0,0,0,0,0,0,1,1,0,0,0,0,4,2,1,7
124911.0,Jovovic Nikola,S,Serbia,30.0,197.0,2021,Australia,Serbia,2021-06-21,True,0,0,2,2,2,0,11,13,0,0,0,0,0,1,0,1,0,0,0,0,1,0,0,1
124911.0,Jovovic Nikola,S,Serbia,30.0,197.0,2021,Serbia,Netherlands,2021-06-22,True,0,2,8,10,22,1,44,67,0,0,0,0,0,2,2,4,0,0,0,0,2,2,1,5
124911.0,Jovovic Nikola,S,Serbia,30.0,197.0,2021,Canada,Serbia,2021-06-23,False,0,0,0,0,0,0,0,0,0,0,0,0,0,0,0,0,0,0,0,0,0,0,0,0
162122.0,Kujundžić Miran,OH,Serbia,24.0,196.0,2021,Poland,Serbia,2021-05-29,False,0,1,0,1,0,0,0,0,1,1,3,5,0,0,0,0,1,2,1,4,3,1,0,4
162122.0,Kujundžić Miran,OH,Serbia,24.0,196.0,2021,Serbia,Italy,2021-05-30,True,0,0,0,0,0,0,0,0,0,0,0,0,0,0,0,0,0,0,0,0,0,0,0,0
162122.0,Kujundžić Miran,OH,Serbia,24.0,196.0,2021,Japan,Serbia,2021-06-03,True,0,0,0,0,0,0,0,0,0,0,0,0,0,0,0,0,0,0,0,0,0,0,0,0
162122.0,Kujundžić Miran,OH,Serbia,24.0,196.0,2021,Serbia,France,2021-06-04,True,0,0,0,0,0,0,0,0,0,0,0,0,0,0,0,0,0,0,0,0,0,0,0,0
162122.0,Kujundžić Miran,OH,Serbia,24.0,196.0,2021,Brazil,Serbia,2021-06-05,False,0,0,0,0,0,0,0,0,0,0,0,0,0,0,0,0,0,0,0,0,0,0,0,0
162122.0,Kujundžić Miran,OH,Serbia,24.0,196.0,2021,Serbia,Germany,2021-06-09,True,0,0,0,0,0,0,0,0,0,0,0,0,0,0,0,0,0,0,0,0,0,0,0,0
162122.0,Kujundžić Miran,OH,Serbia,24.0,196.0,2021,Serbia,Iran,2021-06-10,True,0,0,0,0,0,0,0,0,0,0,0,0,0,0,0,0,0,0,0,0,0,0,0,0
162122.0,Kujundžić Miran,OH,Serbia,24.0,196.0,2021,USA,Serbia,2021-06-11,True,0,0,0,0,0,0,0,0,0,0,0,0,0,0,0,0,0,0,0,0,0,0,0,0
162122.0,Kujundžić Miran,OH,Serbia,24.0,196.0,2021,Russia,Serbia,2021-06-15,False,0,0,0,0,0,0,0,0,0,0,0,0,0,0,0,0,0,0,0,0,0,0,0,0
162122.0,Kujundžić Miran,OH,Serbia,24.0,196.0,2021,Serbia,Bulgaria,2021-06-16,True,0,0,0,0,0,0,0,0,0,0,0,0,0,0,0,0,0,0,0,0,0,0,0,0
162122.0,Kujundžić Miran,OH,Serbia,24.0,196.0,2021,Argentina,Serbia,2021-06-17,False,0,0,0,0,0,0,0,0,0,0,0,0,0,0,0,0,0,0,0,0,0,0,0,0
162122.0,Kujundžić Miran,OH,Serbia,24.0,196.0,2021,Australia,Serbia,2021-06-21,True,0,1,2,3,0,0,0,0,2,0,3,5,0,1,0,1,3,2,4,9,0,1,0,1
162122.0,Kujundžić Miran,OH,Serbia,24.0,196.0,2021,Serbia,Netherlands,2021-06-22,True,0,3,8,11,0,0,0,0,10,1,7,18,2,4,2,8,8,0,10,18,1,2,1,4
162122.0,Kujundžić Miran,OH,Serbia,24.0,196.0,2021,Canada,Serbia,2021-06-23,False,2,1,15,18,0,0,3,3,13,6,15,34,0,1,4,5,9,1,21,31,14,1,1,16
173249.0,Batak Aleksa,S,Serbia,22.0,198.0,2021,Serbia,Slovenia,2021-05-28,True,0,0,0,0,1,0,1,2,0,0,0,0,0,0,0,0,0,0,0,0,0,0,0,0
173249.0,Batak Aleksa,S,Serbia,22.0,198.0,2021,Poland,Serbia,2021-05-29,False,0,0,0,0,0,0,0,0,0,0,0,0,0,0,0,0,0,0,0,0,0,0,0,0
173249.0,Batak Aleksa,S,Serbia,22.0,198.0,2021,Australia,Serbia,2021-06-21,True,0,0,0,0,0,0,0,0,0,0,0,0,0,0,0,0,0,0,0,0,0,0,0,0
173249.0,Batak Aleksa,S,Serbia,22.0,198.0,2021,Serbia,Netherlands,2021-06-22,True,0,0,0,0,0,0,0,0,0,0,0,0,0,0,0,0,0,0,0,0,0,0,0,0
173249.0,Batak Aleksa,S,Serbia,22.0,198.0,2021,Canada,Serbia,2021-06-23,False,0,0,0,0,0,0,0,0,0,0,0,0,0,0,0,0,0,0,0,0,0,0,0,0
173251.0,Peric Pavle,OH,Serbia,23.0,207.0,2021,Serbia,Slovenia,2021-05-28,True,0,0,0,0,0,0,0,0,0,0,0,0,0,0,0,0,0,0,0,0,0,0,0,0
173251.0,Peric Pavle,OH,Serbia,23.0,207.0,2021,Poland,Serbia,2021-05-29,False,0,1,5,6,0,0,0,0,3,1,2,6,1,1,0,2,1,1,7,9,2,0,0,2
173251.0,Peric Pavle,OH,Serbia,23.0,207.0,2021,Serbia,Italy,2021-05-30,True,0,6,6,12,0,0,0,0,9,3,8,20,3,2,1,6,9,0,23,32,8,3,0,11
173251.0,Peric Pavle,OH,Serbia,23.0,207.0,2021,Japan,Serbia,2021-06-03,True,0,0,0,0,0,0,0,0,0,0,0,0,0,0,0,0,0,0,0,0,0,0,0,0
173251.0,Peric Pavle,OH,Serbia,23.0,207.0,2021,Serbia,France,2021-06-04,True,0,0,0,0,0,0,0,0,0,0,0,0,0,0,0,0,0,0,0,0,0,0,0,0
173251.0,Peric Pavle,OH,Serbia,23.0,207.0,2021,Brazil,Serbia,2021-06-05,False,0,0,0,0,0,0,0,0,0,0,0,0,0,0,0,0,0,0,0,0,0,0,0,0
173251.0,Peric Pavle,OH,Serbia,23.0,207.0,2021,Serbia,Germany,2021-06-09,True,2,6,5,13,0,0,2,2,12,3,4,19,1,2,3,6,3,2,7,12,7,3,2,12
173251.0,Peric Pavle,OH,Serbia,23.0,207.0,2021,Serbia,Iran,2021-06-10,True,1,4,8,13,0,0,1,1,5,4,5,14,1,1,2,4,4,2,3,9,6,1,0,7
173251.0,Peric Pavle,OH,Serbia,23.0,207.0,2021,USA,Serbia,2021-06-11,True,0,0,0,0,0,0,0,0,0,0,0,0,0,0,0,0,0,0,0,0,0,0,0,0
173251.0,Peric Pavle,OH,Serbia,23.0,207.0,2021,Russia,Serbia,2021-06-15,False,0,0,0,0,0,0,0,0,0,0,0,0,0,0,0,0,0,0,0,0,0,0,0,0
173251.0,Peric Pavle,OH,Serbia,23.0,207.0,2021,Serbia,Bulgaria,2021-06-16,True,0,0,0,0,0,0,0,0,0,0,0,0,0,0,0,0,0,0,0,0,0,0,0,0
173251.0,Peric Pavle,OH,Serbia,23.0,207.0,2021,Argentina,Serbia,2021-06-17,False,1,2,4,7,0,0,0,0,2,2,3,7,1,0,1,2,2,1,12,15,0,0,1,1
173251.0,Peric Pavle,OH,Serbia,23.0,207.0,2021,Australia,Serbia,2021-06-21,True,0,3,6,9,0,0,1,1,7,2,7,16,0,0,2,2,8,0,8,16,3,0,1,4
173251.0,Peric Pavle,OH,Serbia,23.0,207.0,2021,Serbia,Netherlands,2021-06-22,True,0,3,4,7,0,0,0,0,6,2,2,10,1,0,1,2,1,2,9,12,2,1,1,4
173251.0,Peric Pavle,OH,Serbia,23.0,207.0,2021,Canada,Serbia,2021-06-23,False,0,0,0,0,0,0,0,0,0,0,0,0,0,0,0,0,0,0,0,0,0,0,0,0
143792.0,Simic Stevan,MB,Serbia,26.0,201.0,2021,Serbia,Slovenia,2021-05-28,True,0,0,0,0,0,0,0,0,0,0,0,0,0,0,0,0,0,0,0,0,0,0,0,0
143792.0,Simic Stevan,MB,Serbia,26.0,201.0,2021,Poland,Serbia,2021-05-29,False,0,0,1,1,0,0,0,0,0,0,1,1,0,0,0,0,0,0,0,0,0,0,0,0
143792.0,Simic Stevan,MB,Serbia,26.0,201.0,2021,Serbia,Italy,2021-05-30,True,0,0,7,7,0,0,0,0,3,0,0,3,3,3,1,7,0,0,3,3,1,2,0,3
143792.0,Simic Stevan,MB,Serbia,26.0,201.0,2021,Japan,Serbia,2021-06-03,True,0,0,0,0,0,0,0,0,0,0,0,0,0,0,0,0,0,0,0,0,0,0,0,0
143792.0,Simic Stevan,MB,Serbia,26.0,201.0,2021,Serbia,France,2021-06-04,True,0,0,0,0,0,0,0,0,0,0,0,0,0,0,0,0,0,0,0,0,0,0,0,0
143792.0,Simic Stevan,MB,Serbia,26.0,201.0,2021,Brazil,Serbia,2021-06-05,False,0,1,6,7,0,0,0,0,3,0,1,4,0,3,1,4,0,0,0,0,1,0,0,1
143792.0,Simic Stevan,MB,Serbia,26.0,201.0,2021,Serbia,Germany,2021-06-09,True,0,0,0,0,0,0,0,0,0,0,0,0,0,0,0,0,0,0,0,0,0,0,0,0
143792.0,Simic Stevan,MB,Serbia,26.0,201.0,2021,Serbia,Iran,2021-06-10,True,0,0,0,0,0,0,0,0,0,0,0,0,0,0,0,0,0,0,0,0,0,0,0,0
143792.0,Simic Stevan,MB,Serbia,26.0,201.0,2021,USA,Serbia,2021-06-11,True,0,0,0,0,0,0,0,0,0,0,0,0,0,0,0,0,0,0,0,0,0,0,0,0
143792.0,Simic Stevan,MB,Serbia,26.0,201.0,2021,Russia,Serbia,2021-06-15,False,0,0,0,0,0,0,0,0,0,0,0,0,0,0,0,0,0,0,0,0,0,0,0,0
143792.0,Simic Stevan,MB,Serbia,26.0,201.0,2021,Serbia,Bulgaria,2021-06-16,True,0,0,0,0,0,0,0,0,1,0,0,1,0,0,1,1,0,0,0,0,0,0,0,0
143792.0,Simic Stevan,MB,Serbia,26.0,201.0,2021,Argentina,Serbia,2021-06-17,False,0,0,7,7,0,0,1,1,4,0,0,4,0,3,0,3,0,0,0,0,1,1,0,2
124915.0,Atanasijevic Aleksandar,O,Serbia,30.0,200.0,2021,Serbia,Slovenia,2021-05-28,True,0,0,0,0,0,0,0,0,0,0,0,0,0,0,0,0,0,0,0,0,0,0,0,0
124915.0,Atanasijevic Aleksandar,O,Serbia,30.0,200.0,2021,Poland,Serbia,2021-05-29,False,2,1,11,14,0,0,0,0,9,8,10,27,0,2,0,2,0,0,1,1,4,1,0,5
124915.0,Atanasijevic Aleksandar,O,Serbia,30.0,200.0,2021,Serbia,Italy,2021-05-30,True,0,1,1,2,0,0,0,0,0,0,3,3,0,0,1,1,0,0,0,0,1,0,0,1
124915.0,Atanasijevic Aleksandar,O,Serbia,30.0,200.0,2021,Japan,Serbia,2021-06-03,True,0,4,9,13,0,0,2,2,7,4,7,18,1,3,4,8,0,0,0,0,2,0,0,2
124915.0,Atanasijevic Aleksandar,O,Serbia,30.0,200.0,2021,Serbia,France,2021-06-04,True,2,4,11,17,0,0,2,2,20,3,7,30,2,1,4,7,0,0,0,0,3,0,0,3
124915.0,Atanasijevic Aleksandar,O,Serbia,30.0,200.0,2021,Brazil,Serbia,2021-06-05,False,1,1,10,12,0,0,1,1,10,8,6,24,1,1,2,4,0,0,0,0,1,1,1,3
124915.0,Atanasijevic Aleksandar,O,Serbia,30.0,200.0,2021,Serbia,Germany,2021-06-09,True,0,1,0,1,0,0,0,0,1,0,1,2,0,1,2,3,0,0,0,0,0,0,0,0
124915.0,Atanasijevic Aleksandar,O,Serbia,30.0,200.0,2021,Serbia,Iran,2021-06-10,True,0,0,2,2,0,0,1,1,2,1,0,3,0,0,0,0,0,0,0,0,0,0,0,0
124915.0,Atanasijevic Aleksandar,O,Serbia,30.0,200.0,2021,USA,Serbia,2021-06-11,True,2,4,9,15,0,0,1,1,15,5,7,27,0,3,2,5,0,1,0,1,4,6,0,10
124915.0,Atanasijevic Aleksandar,O,Serbia,30.0,200.0,2021,Russia,Serbia,2021-06-15,False,0,1,9,10,0,0,2,2,7,6,7,20,2,1,2,5,0,0,0,0,2,1,2,5
124915.0,Atanasijevic Aleksandar,O,Serbia,30.0,200.0,2021,Serbia,Bulgaria,2021-06-16,True,1,3,5,9,0,0,1,1,11,5,3,19,0,1,5,6,0,0,0,0,4,2,2,8
124915.0,Atanasijevic Aleksandar,O,Serbia,30.0,200.0,2021,Argentina,Serbia,2021-06-17,False,0,1,3,4,0,0,1,1,1,0,1,2,0,1,0,1,0,0,0,0,0,1,0,1
124915.0,Atanasijevic Aleksandar,O,Serbia,30.0,200.0,2021,Australia,Serbia,2021-06-21,True,0,4,11,15,0,0,3,3,19,4,6,29,0,3,0,3,0,0,0,0,3,1,0,4
124915.0,Atanasijevic Aleksandar,O,Serbia,30.0,200.0,2021,Serbia,Netherlands,2021-06-22,True,0,0,0,0,0,0,0,0,0,0,0,0,0,0,0,0,0,0,0,0,0,0,0,0
124915.0,Atanasijevic Aleksandar,O,Serbia,30.0,200.0,2021,Canada,Serbia,2021-06-23,False,0,4,3,7,0,0,2,2,12,8,9,29,0,3,5,8,0,0,0,0,8,1,1,10
143794.0,Luburic Drazen,O,Serbia,28.0,202.0,2021,Serbia,Slovenia,2021-05-28,True,1,6,8,15,0,0,1,1,27,6,11,44,1,4,1,6,0,0,0,0,3,1,0,4
143794.0,Luburic Drazen,O,Serbia,28.0,202.0,2021,Poland,Serbia,2021-05-29,False,2,0,3,5,0,0,0,0,4,0,2,6,0,0,0,0,0,0,0,0,0,0,0,0
143794.0,Luburic Drazen,O,Serbia,28.0,202.0,2021,Serbia,Italy,2021-05-30,True,2,7,10,19,0,0,0,0,18,5,17,40,1,3,3,7,0,0,0,0,4,1,0,5
143794.0,Luburic Drazen,O,Serbia,28.0,202.0,2021,Japan,Serbia,2021-06-03,True,0,2,0,2,0,0,3,3,0,0,5,5,1,2,0,3,0,0,0,0,0,0,0,0
143794.0,Luburic Drazen,O,Serbia,28.0,202.0,2021,Serbia,France,2021-06-04,True,0,2,3,5,0,0,0,0,5,0,0,5,0,0,0,0,0,0,0,0,0,0,0,0
143794.0,Luburic Drazen,O,Serbia,28.0,202.0,2021,Brazil,Serbia,2021-06-05,False,1,2,1,4,0,0,0,0,0,5,3,8,0,1,0,1,0,0,0,0,0,2,0,2
143794.0,Luburic Drazen,O,Serbia,28.0,202.0,2021,Serbia,Germany,2021-06-09,True,2,5,6,13,0,0,1,1,13,4,11,28,0,1,2,3,0,0,0,0,3,3,0,6
143794.0,Luburic Drazen,O,Serbia,28.0,202.0,2021,Serbia,Iran,2021-06-10,True,1,5,7,13,0,0,2,2,21,3,8,32,1,2,3,6,0,0,0,0,7,1,0,8
143794.0,Luburic Drazen,O,Serbia,28.0,202.0,2021,USA,Serbia,2021-06-11,True,0,0,0,0,0,0,0,0,0,0,0,0,0,0,0,0,0,0,0,0,0,0,0,0
143794.0,Luburic Drazen,O,Serbia,28.0,202.0,2021,Russia,Serbia,2021-06-15,False,0,2,2,4,0,0,0,0,4,4,2,10,0,0,0,0,0,0,0,0,1,1,0,2
143794.0,Luburic Drazen,O,Serbia,28.0,202.0,2021,Serbia,Bulgaria,2021-06-16,True,0,0,0,0,0,0,0,0,0,0,0,0,0,0,0,0,0,0,0,0,0,0,0,0
143794.0,Luburic Drazen,O,Serbia,28.0,202.0,2021,Argentina,Serbia,2021-06-17,False,1,5,6,12,0,0,2,2,10,5,6,21,1,2,4,7,0,0,0,0,5,0,1,6
143794.0,Luburic Drazen,O,Serbia,28.0,202.0,2021,Australia,Serbia,2021-06-21,True,0,0,0,0,0,0,0,0,0,0,0,0,0,0,0,0,0,0,0,0,0,0,0,0
143794.0,Luburic Drazen,O,Serbia,28.0,202.0,2021,Serbia,Netherlands,2021-06-22,True,8,4,15,27,0,0,2,2,24,8,10,42,1,6,1,8,0,0,0,0,3,2,0,5
143794.0,Luburic Drazen,O,Serbia,28.0,202.0,2021,Canada,Serbia,2021-06-23,False,1,4,1,6,0,0,2,2,7,6,6,19,1,0,2,3,0,0,0,0,1,0,0,1
116525.0,Podrascanin Marko,MB,Serbia,34.0,204.0,2021,Serbia,Slovenia,2021-05-28,True,2,2,20,24,0,0,1,1,4,1,1,6,4,6,2,12,0,0,1,1,4,0,0,4
116525.0,Podrascanin Marko,MB,Serbia,34.0,204.0,2021,Poland,Serbia,2021-05-29,False,1,2,11,14,0,0,0,0,11,0,4,15,1,6,4,11,0,0,0,0,3,1,0,4
116525.0,Podrascanin Marko,MB,Serbia,34.0,204.0,2021,Serbia,Italy,2021-05-30,True,1,0,14,15,0,0,0,0,10,2,2,14,3,4,6,13,0,0,1,1,0,0,1,1
116525.0,Podrascanin Marko,MB,Serbia,34.0,204.0,2021,Japan,Serbia,2021-06-03,True,0,3,9,12,0,0,1,1,9,1,1,11,4,3,1,8,0,0,0,0,1,1,0,2
116525.0,Podrascanin Marko,MB,Serbia,34.0,204.0,2021,Serbia,France,2021-06-04,True,0,4,18,22,0,0,1,1,4,2,2,8,3,6,5,14,0,0,0,0,2,0,0,2
116525.0,Podrascanin Marko,MB,Serbia,34.0,204.0,2021,Brazil,Serbia,2021-06-05,False,0,0,7,7,0,0,0,0,3,0,1,4,1,2,2,5,0,0,0,0,1,1,0,2
116525.0,Podrascanin Marko,MB,Serbia,34.0,204.0,2021,Serbia,Germany,2021-06-09,True,1,3,10,14,0,0,2,2,3,0,3,6,4,3,4,11,0,0,0,0,3,0,1,4
116525.0,Podrascanin Marko,MB,Serbia,34.0,204.0,2021,Serbia,Iran,2021-06-10,True,3,2,16,21,0,0,2,2,6,0,2,8,8,4,4,16,0,0,1,1,3,3,2,8
116525.0,Podrascanin Marko,MB,Serbia,34.0,204.0,2021,USA,Serbia,2021-06-11,True,0,3,14,17,0,0,0,0,4,1,2,7,4,3,1,8,0,0,1,1,1,1,0,2
116525.0,Podrascanin Marko,MB,Serbia,34.0,204.0,2021,Russia,Serbia,2021-06-15,False,0,3,14,17,0,0,2,2,5,0,2,7,1,8,5,14,0,0,0,0,1,1,0,2
116525.0,Podrascanin Marko,MB,Serbia,34.0,204.0,2021,Serbia,Bulgaria,2021-06-16,True,1,1,9,11,0,0,4,4,7,0,1,8,5,4,3,12,0,0,0,0,1,1,0,2
116525.0,Podrascanin Marko,MB,Serbia,34.0,204.0,2021,Argentina,Serbia,2021-06-17,False,0,2,6,8,0,0,1,1,3,1,2,6,1,5,0,6,0,0,0,0,1,1,0,2
116525.0,Podrascanin Marko,MB,Serbia,34.0,204.0,2021,Australia,Serbia,2021-06-21,True,0,2,18,20,0,0,2,2,7,1,1,9,3,5,1,9,1,0,0,1,3,0,0,3
116525.0,Podrascanin Marko,MB,Serbia,34.0,204.0,2021,Serbia,Netherlands,2021-06-22,True,0,1,11,12,0,0,1,1,5,4,2,11,0,5,6,11,1,0,1,2,5,1,0,6
116525.0,Podrascanin Marko,MB,Serbia,34.0,204.0,2021,Canada,Serbia,2021-06-23,False,0,6,6,12,0,0,3,3,6,2,1,9,2,2,7,11,1,0,1,2,1,1,0,2
173250.0,Todorovic Vuk,S,Serbia,23.0,190.0,2021,Serbia,Italy,2021-05-30,True,0,0,0,0,0,0,7,7,0,0,0,0,0,0,0,0,0,0,0,0,1,1,0,2
173250.0,Todorovic Vuk,S,Serbia,23.0,190.0,2021,Japan,Serbia,2021-06-03,True,0,0,0,0,1,0,2,3,0,0,0,0,0,1,0,1,0,0,0,0,0,0,0,0
173250.0,Todorovic Vuk,S,Serbia,23.0,190.0,2021,Serbia,France,2021-06-04,True,0,0,0,0,2,0,4,6,0,0,0,0,0,0,0,0,0,0,0,0,1,0,0,1
173250.0,Todorovic Vuk,S,Serbia,23.0,190.0,2021,Brazil,Serbia,2021-06-05,False,0,0,4,4,12,0,20,32,0,0,1,1,1,1,1,3,0,0,0,0,2,1,0,3
173250.0,Todorovic Vuk,S,Serbia,23.0,190.0,2021,Serbia,Germany,2021-06-09,True,0,2,13,15,25,0,39,64,1,0,0,1,0,1,3,4,0,0,0,0,4,1,0,5
173250.0,Todorovic Vuk,S,Serbia,23.0,190.0,2021,Serbia,Iran,2021-06-10,True,0,0,0,0,3,0,0,3,0,0,0,0,0,0,0,0,0,0,1,1,0,0,0,0
173250.0,Todorovic Vuk,S,Serbia,23.0,190.0,2021,USA,Serbia,2021-06-11,True,0,0,0,0,0,0,0,0,0,0,0,0,0,0,0,0,0,0,0,0,0,0,0,0
173250.0,Todorovic Vuk,S,Serbia,23.0,190.0,2021,Russia,Serbia,2021-06-15,False,0,0,0,0,2,0,2,4,0,0,0,0,0,0,0,0,0,0,0,0,0,0,0,0
173250.0,Todorovic Vuk,S,Serbia,23.0,190.0,2021,Serbia,Bulgaria,2021-06-16,True,0,0,0,0,0,0,0,0,0,0,0,0,0,0,0,0,0,0,0,0,0,0,0,0
173250.0,Todorovic Vuk,S,Serbia,23.0,190.0,2021,Argentina,Serbia,2021-06-17,False,0,0,0,0,0,0,4,4,0,0,0,0,0,0,0,0,0,0,0,0,1,1,0,2
173250.0,Todorovic Vuk,S,Serbia,23.0,190.0,2021,Australia,Serbia,2021-06-21,True,1,2,15,18,19,2,42,63,0,0,0,0,0,2,3,5,0,0,0,0,1,0,0,1
173250.0,Todorovic Vuk,S,Serbia,23.0,190.0,2021,Serbia,Netherlands,2021-06-22,True,0,0,4,4,6,0,18,24,0,0,0,0,0,1,0,1,0,0,0,0,1,0,0,1
173250.0,Todorovic Vuk,S,Serbia,23.0,190.0,2021,Canada,Serbia,2021-06-23,False,0,2,11,13,28,1,84,113,1,0,0,1,0,1,3,4,0,0,1,1,7,2,0,9
168276.0,Vucicevic Bozidar,O,Serbia,23.0,205.0,2021,Poland,Serbia,2021-05-29,False,0,0,0,0,0,0,0,0,0,0,0,0,0,0,0,0,0,0,0,0,0,0,0,0
168276.0,Vucicevic Bozidar,O,Serbia,23.0,205.0,2021,Serbia,Italy,2021-05-30,True,0,0,0,0,0,0,0,0,0,0,0,0,0,0,0,0,0,0,0,0,0,0,0,0
168276.0,Vucicevic Bozidar,O,Serbia,23.0,205.0,2021,Australia,Serbia,2021-06-21,True,0,0,0,0,0,0,0,0,0,1,0,1,0,0,0,0,0,0,0,0,0,0,0,0
168276.0,Vucicevic Bozidar,O,Serbia,23.0,205.0,2021,Serbia,Netherlands,2021-06-22,True,0,0,0,0,0,0,0,0,0,0,0,0,0,0,0,0,0,0,0,0,0,0,0,0
168276.0,Vucicevic Bozidar,O,Serbia,23.0,205.0,2021,Canada,Serbia,2021-06-23,False,0,0,0,0,0,0,0,0,0,0,0,0,0,0,0,0,0,0,0,0,0,0,0,0
146751.0,Kovac Davide,OH,Serbia,22.0,192.0,2021,Serbia,Slovenia,2021-05-28,True,0,0,0,0,0,0,0,0,0,0,0,0,0,0,0,0,0,0,0,0,0,0,0,0
146751.0,Kovac Davide,OH,Serbia,22.0,192.0,2021,Poland,Serbia,2021-05-29,False,0,2,0,2,0,0,0,0,0,2,3,5,0,1,1,2,5,2,6,13,2,0,0,2
146751.0,Kovac Davide,OH,Serbia,22.0,192.0,2021,Serbia,Italy,2021-05-30,True,0,0,0,0,0,0,0,0,0,0,0,0,0,0,0,0,0,0,0,0,0,0,0,0
146751.0,Kovac Davide,OH,Serbia,22.0,192.0,2021,Japan,Serbia,2021-06-03,True,0,0,0,0,0,0,0,0,0,0,0,0,0,0,0,0,0,0,0,0,0,0,0,0
146751.0,Kovac Davide,OH,Serbia,22.0,192.0,2021,Serbia,France,2021-06-04,True,0,0,0,0,0,0,0,0,0,0,0,0,0,0,0,0,0,0,0,0,0,0,0,0
146751.0,Kovac Davide,OH,Serbia,22.0,192.0,2021,Brazil,Serbia,2021-06-05,False,0,0,0,0,0,0,0,0,0,0,0,0,0,0,0,0,0,0,0,0,0,0,0,0
146751.0,Kovac Davide,OH,Serbia,22.0,192.0,2021,Serbia,Germany,2021-06-09,True,0,1,0,1,0,0,1,1,0,0,1,1,1,0,1,2,1,0,3,4,1,0,0,1
146751.0,Kovac Davide,OH,Serbia,22.0,192.0,2021,Serbia,Iran,2021-06-10,True,0,0,0,0,0,0,0,0,0,0,0,0,0,0,0,0,1,1,1,3,0,0,0,0
146751.0,Kovac Davide,OH,Serbia,22.0,192.0,2021,USA,Serbia,2021-06-11,True,0,0,0,0,0,0,0,0,0,0,0,0,0,0,0,0,0,0,1,1,0,0,0,0
146751.0,Kovac Davide,OH,Serbia,22.0,192.0,2021,Russia,Serbia,2021-06-15,False,0,0,0,0,0,0,0,0,0,0,0,0,0,0,0,0,0,0,0,0,0,0,0,0
146751.0,Kovac Davide,OH,Serbia,22.0,192.0,2021,Serbia,Bulgaria,2021-06-16,True,0,0,0,0,0,0,1,1,1,0,3,4,0,0,0,0,1,0,2,3,3,0,0,3
146751.0,Kovac Davide,OH,Serbia,22.0,192.0,2021,Argentina,Serbia,2021-06-17,False,0,0,0,0,0,0,0,0,0,0,0,0,0,0,0,0,0,0,1,1,0,0,0,0
146751.0,Kovac Davide,OH,Serbia,22.0,192.0,2021,Australia,Serbia,2021-06-21,True,0,0,2,2,0,0,1,1,3,1,1,5,0,1,0,1,3,1,8,12,0,2,0,2
146751.0,Kovac Davide,OH,Serbia,22.0,192.0,2021,Serbia,Netherlands,2021-06-22,True,0,0,0,0,0,0,0,0,0,0,0,0,0,0,0,0,0,0,3,3,0,0,0,0
146751.0,Kovac Davide,OH,Serbia,22.0,192.0,2021,Canada,Serbia,2021-06-23,False,0,0,0,0,0,0,0,0,0,0,0,0,0,0,0,0,0,0,0,0,0,0,0,0
151390.0,Štern Tonček,O,Slovenia,26.0,200.0,2021,Serbia,Slovenia,2021-05-28,False,0,5,9,14,0,0,0,0,13,9,5,27,1,3,1,5,0,0,0,0,5,4,0,9
151390.0,Štern Tonček,O,Slovenia,26.0,200.0,2021,Italy,Slovenia,2021-05-29,True,0,0,0,0,0,0,0,0,0,0,0,0,0,0,0,0,0,0,0,0,0,0,0,0
151390.0,Štern Tonček,O,Slovenia,26.0,200.0,2021,Poland,Slovenia,2021-05-30,True,1,3,10,14,0,0,2,2,15,3,19,37,2,4,0,6,0,0,0,0,0,1,0,1
151390.0,Štern Tonček,O,Slovenia,26.0,200.0,2021,Netherlands,Slovenia,2021-06-03,True,1,2,12,15,0,0,1,1,10,3,4,17,1,2,3,6,0,0,0,0,5,1,1,7
151390.0,Štern Tonček,O,Slovenia,26.0,200.0,2021,Argentina,Slovenia,2021-06-04,True,1,3,8,12,0,0,2,2,6,3,7,16,0,1,0,1,0,0,0,0,2,0,0,2
151390.0,Štern Tonček,O,Slovenia,26.0,200.0,2021,Slovenia,Germany,2021-06-05,False,0,2,3,5,0,0,1,1,12,2,5,19,1,6,2,9,0,0,0,0,3,0,0,3
151390.0,Štern Tonček,O,Slovenia,26.0,200.0,2021,Slovenia,Canada,2021-06-09,True,2,3,12,17,0,0,3,3,14,4,5,23,1,1,0,2,0,0,0,0,6,1,1,8
151390.0,Štern Tonček,O,Slovenia,26.0,200.0,2021,Slovenia,Russia,2021-06-11,True,1,5,6,12,0,0,4,4,5,8,4,17,0,3,2,5,0,0,0,0,7,2,0,9
151390.0,Štern Tonček,O,Slovenia,26.0,200.0,2021,Brazil,Slovenia,2021-06-15,False,0,4,10,14,0,0,2,2,15,4,7,26,0,2,2,4,0,0,0,0,2,1,0,3
151390.0,Štern Tonček,O,Slovenia,26.0,200.0,2021,Iran,Slovenia,2021-06-17,True,2,4,12,18,0,0,1,1,8,7,9,24,1,5,1,7,0,0,0,0,3,1,0,4
151390.0,Štern Tonček,O,Slovenia,26.0,200.0,2021,Slovenia,USA,2021-06-21,True,1,6,12,19,0,0,2,2,15,8,5,28,2,2,0,4,0,0,0,0,7,2,2,11
151390.0,Štern Tonček,O,Slovenia,26.0,200.0,2021,Japan,Slovenia,2021-06-22,True,1,3,6,10,0,0,0,0,11,2,7,20,2,3,1,6,0,0,1,1,5,0,0,5
151390.0,Štern Tonček,O,Slovenia,26.0,200.0,2021,Slovenia,Bulgaria,2021-06-23,True,0,1,11,12,0,0,0,0,12,3,4,19,1,3,1,5,0,0,0,0,1,0,0,1
151390.0,Štern Tonček,O,Slovenia,26.0,200.0,2021,Poland,Slovenia,2021-06-26,False,3,3,8,14,0,0,2,2,7,4,10,21,2,5,2,9,0,0,0,0,2,0,0,2
151390.0,Štern Tonček,O,Slovenia,26.0,200.0,2021,France,Slovenia,2021-06-27,False,0,2,7,9,0,0,0,0,11,1,6,18,1,8,1,10,0,0,0,0,3,1,0,4
114962.0,Pajenk Alen,MB,Slovenia,35.0,203.0,2021,Serbia,Slovenia,2021-05-28,False,1,2,13,16,0,0,0,0,6,2,0,8,3,2,0,5,0,0,0,0,1,1,0,2
114962.0,Pajenk Alen,MB,Slovenia,35.0,203.0,2021,Italy,Slovenia,2021-05-29,True,1,0,17,18,0,0,0,0,6,1,4,11,1,0,0,1,1,1,0,2,0,0,0,0
114962.0,Pajenk Alen,MB,Slovenia,35.0,203.0,2021,Poland,Slovenia,2021-05-30,True,3,2,12,17,0,0,3,3,6,1,7,14,1,1,0,2,0,0,2,2,1,0,0,1
114962.0,Pajenk Alen,MB,Slovenia,35.0,203.0,2021,Netherlands,Slovenia,2021-06-03,True,0,2,10,12,0,0,2,2,3,0,1,4,2,1,2,5,0,0,0,0,2,1,0,3
114962.0,Pajenk Alen,MB,Slovenia,35.0,203.0,2021,Argentina,Slovenia,2021-06-04,True,0,2,10,12,0,0,0,0,6,0,2,8,1,6,7,14,0,0,1,1,3,1,0,4
114962.0,Pajenk Alen,MB,Slovenia,35.0,203.0,2021,Slovenia,Germany,2021-06-05,False,0,2,8,10,0,0,1,1,5,2,3,10,0,1,9,10,1,0,2,3,2,0,0,2
114962.0,Pajenk Alen,MB,Slovenia,35.0,203.0,2021,Slovenia,Canada,2021-06-09,True,1,3,10,14,0,0,0,0,4,0,1,5,0,3,5,8,1,0,0,1,0,0,0,0
114962.0,Pajenk Alen,MB,Slovenia,35.0,203.0,2021,France,Slovenia,2021-06-10,True,1,7,6,14,0,0,0,0,11,1,3,15,1,4,5,10,0,0,0,0,2,0,0,2
114962.0,Pajenk Alen,MB,Slovenia,35.0,203.0,2021,Slovenia,Russia,2021-06-11,True,1,5,10,16,0,0,1,1,6,1,4,11,1,2,6,9,0,0,0,0,3,0,1,4
114962.0,Pajenk Alen,MB,Slovenia,35.0,203.0,2021,Brazil,Slovenia,2021-06-15,False,1,3,14,18,0,0,1,1,8,1,4,13,4,6,4,14,0,0,0,0,1,2,0,3
114962.0,Pajenk Alen,MB,Slovenia,35.0,203.0,2021,Slovenia,Australia,2021-06-16,True,3,4,21,28,0,0,1,1,7,1,0,8,0,1,4,5,1,0,2,3,4,1,0,5
114962.0,Pajenk Alen,MB,Slovenia,35.0,203.0,2021,Iran,Slovenia,2021-06-17,True,0,4,12,16,0,0,4,4,8,1,3,12,1,2,1,4,2,0,0,2,4,0,0,4
114962.0,Pajenk Alen,MB,Slovenia,35.0,203.0,2021,Slovenia,USA,2021-06-21,True,1,6,11,18,0,0,0,0,8,0,4,12,4,4,3,11,0,0,3,3,2,0,0,2
114962.0,Pajenk Alen,MB,Slovenia,35.0,203.0,2021,Japan,Slovenia,2021-06-22,True,1,0,9,10,0,0,0,0,3,0,0,3,0,1,0,1,0,0,0,0,0,0,0,0
114962.0,Pajenk Alen,MB,Slovenia,35.0,203.0,2021,Slovenia,Bulgaria,2021-06-23,True,1,0,11,12,0,0,0,0,5,2,0,7,0,1,1,2,0,0,0,0,2,0,0,2
114962.0,Pajenk Alen,MB,Slovenia,35.0,203.0,2021,Poland,Slovenia,2021-06-26,False,2,3,8,13,0,0,0,0,7,1,2,10,0,2,3,5,0,0,1,1,2,0,0,2
114962.0,Pajenk Alen,MB,Slovenia,35.0,203.0,2021,France,Slovenia,2021-06-27,False,1,3,9,13,0,0,0,0,3,1,3,7,1,3,4,8,1,0,1,2,1,0,0,1
181130.0,Pernuš Gregor,S,Slovenia,22.0,195.0,2021,Netherlands,Slovenia,2021-06-03,True,0,1,0,1,0,0,8,8,0,0,0,0,1,0,0,1,0,0,0,0,0,1,0,1
181130.0,Pernuš Gregor,S,Slovenia,22.0,195.0,2021,Argentina,Slovenia,2021-06-04,True,0,0,0,0,0,0,0,0,0,0,0,0,0,0,0,0,0,0,0,0,0,0,0,0
181130.0,Pernuš Gregor,S,Slovenia,22.0,195.0,2021,Slovenia,Germany,2021-06-05,False,0,0,0,0,3,1,2,6,0,0,0,0,0,0,0,0,0,0,0,0,0,0,0,0
181130.0,Pernuš Gregor,S,Slovenia,22.0,195.0,2021,France,Slovenia,2021-06-10,True,0,0,0,0,0,0,0,0,0,0,0,0,0,0,0,0,0,0,0,0,0,0,0,0
151391.0,Kozamernik Jan,MB,Slovenia,26.0,204.0,2021,Serbia,Slovenia,2021-05-28,False,0,1,15,16,0,0,0,0,8,0,3,11,4,5,1,10,0,0,4,4,3,1,0,4
151391.0,Kozamernik Jan,MB,Slovenia,26.0,204.0,2021,Italy,Slovenia,2021-05-29,True,2,1,7,10,0,0,2,2,6,0,0,6,2,0,0,2,0,0,1,1,0,0,0,0
151391.0,Kozamernik Jan,MB,Slovenia,26.0,204.0,2021,Poland,Slovenia,2021-05-30,True,0,2,12,14,0,0,3,3,7,2,4,13,2,5,2,9,0,0,1,1,0,1,0,1
151391.0,Kozamernik Jan,MB,Slovenia,26.0,204.0,2021,Netherlands,Slovenia,2021-06-03,True,0,0,9,9,0,0,1,1,3,0,2,5,1,3,4,8,0,0,0,0,0,0,0,0
151391.0,Kozamernik Jan,MB,Slovenia,26.0,204.0,2021,Argentina,Slovenia,2021-06-04,True,1,4,11,16,0,0,1,1,2,1,4,7,2,2,8,12,0,0,2,2,3,0,0,3
151391.0,Kozamernik Jan,MB,Slovenia,26.0,204.0,2021,Slovenia,Germany,2021-06-05,False,0,1,9,10,0,0,0,0,1,3,1,5,0,4,4,8,1,0,0,1,2,0,0,2
151391.0,Kozamernik Jan,MB,Slovenia,26.0,204.0,2021,Slovenia,Canada,2021-06-09,True,0,2,9,11,0,0,1,1,3,0,2,5,1,2,2,5,0,0,1,1,0,0,0,0
151391.0,Kozamernik Jan,MB,Slovenia,26.0,204.0,2021,Slovenia,Russia,2021-06-11,True,0,0,12,12,0,1,3,4,2,1,3,6,2,7,8,17,0,0,0,0,4,2,1,7
151391.0,Kozamernik Jan,MB,Slovenia,26.0,204.0,2021,Brazil,Slovenia,2021-06-15,False,3,1,16,20,0,0,0,0,7,3,2,12,2,6,2,10,1,0,0,1,5,3,0,8
151391.0,Kozamernik Jan,MB,Slovenia,26.0,204.0,2021,Slovenia,Australia,2021-06-16,True,0,2,8,10,0,0,0,0,7,1,2,10,1,3,6,10,0,0,0,0,2,2,0,4
151391.0,Kozamernik Jan,MB,Slovenia,26.0,204.0,2021,Iran,Slovenia,2021-06-17,True,0,1,12,13,0,0,1,1,5,1,2,8,2,4,3,9,3,0,1,4,2,4,0,6
151391.0,Kozamernik Jan,MB,Slovenia,26.0,204.0,2021,Slovenia,USA,2021-06-21,True,1,2,16,19,0,0,1,1,4,2,3,9,2,6,6,14,1,0,0,1,2,1,1,4
151391.0,Kozamernik Jan,MB,Slovenia,26.0,204.0,2021,Japan,Slovenia,2021-06-22,True,0,1,11,12,1,0,1,2,6,0,0,6,3,2,1,6,0,0,0,0,0,1,0,1
151391.0,Kozamernik Jan,MB,Slovenia,26.0,204.0,2021,Slovenia,Bulgaria,2021-06-23,True,0,3,9,12,0,0,2,2,2,0,0,2,1,1,4,6,0,0,0,0,5,1,0,6
151391.0,Kozamernik Jan,MB,Slovenia,26.0,204.0,2021,Poland,Slovenia,2021-06-26,False,0,1,5,6,0,0,1,1,2,1,1,4,1,1,0,2,0,0,1,1,0,0,0,0
151391.0,Kozamernik Jan,MB,Slovenia,26.0,204.0,2021,France,Slovenia,2021-06-27,False,0,1,6,7,0,0,3,3,0,1,1,2,1,5,2,8,0,0,0,0,3,0,0,3
119022.0,Šket Alen,O,Slovenia,33.0,205.0,2021,Italy,Slovenia,2021-05-29,True,0,1,1,2,0,0,0,0,0,0,0,0,0,1,0,1,0,0,0,0,0,0,0,0
119022.0,Šket Alen,O,Slovenia,33.0,205.0,2021,Poland,Slovenia,2021-05-30,True,1,0,1,2,0,0,0,0,2,0,1,3,0,0,0,0,0,0,0,0,0,0,0,0
119022.0,Šket Alen,O,Slovenia,33.0,205.0,2021,Netherlands,Slovenia,2021-06-03,True,0,0,0,0,0,0,0,0,0,0,0,0,0,0,0,0,0,0,0,0,0,0,0,0
119022.0,Šket Alen,O,Slovenia,33.0,205.0,2021,Argentina,Slovenia,2021-06-04,True,0,1,2,3,0,0,0,0,4,0,3,7,0,2,0,2,0,0,0,0,0,1,0,1
119022.0,Šket Alen,O,Slovenia,33.0,205.0,2021,Slovenia,Germany,2021-06-05,False,0,0,0,0,0,0,0,0,0,0,3,3,0,0,1,1,0,0,0,0,0,0,0,0
119022.0,Šket Alen,O,Slovenia,33.0,205.0,2021,Slovenia,Canada,2021-06-09,True,0,0,0,0,0,0,0,0,0,0,0,0,0,0,0,0,0,0,0,0,0,0,0,0
119022.0,Šket Alen,O,Slovenia,33.0,205.0,2021,France,Slovenia,2021-06-10,True,1,4,7,12,0,0,1,1,9,0,10,19,0,4,6,10,0,0,0,0,7,2,2,11
119022.0,Šket Alen,O,Slovenia,33.0,205.0,2021,Slovenia,Russia,2021-06-11,True,1,1,14,16,0,0,0,0,4,1,2,7,1,0,3,4,0,0,0,0,1,1,0,2
119022.0,Šket Alen,O,Slovenia,33.0,205.0,2021,Brazil,Slovenia,2021-06-15,False,0,1,1,2,0,0,2,2,0,0,3,3,0,0,0,0,0,0,0,0,1,0,0,1
119022.0,Šket Alen,O,Slovenia,33.0,205.0,2021,Slovenia,Australia,2021-06-16,True,0,3,7,10,0,0,3,3,8,3,12,23,1,1,4,6,0,0,0,0,3,3,0,6
119022.0,Šket Alen,O,Slovenia,33.0,205.0,2021,Iran,Slovenia,2021-06-17,True,0,0,0,0,0,0,0,0,0,0,0,0,0,0,0,0,0,0,0,0,0,0,0,0
119022.0,Šket Alen,O,Slovenia,33.0,205.0,2021,Slovenia,USA,2021-06-21,True,0,0,2,2,0,0,0,0,0,0,1,1,0,0,0,0,0,0,0,0,0,0,1,1
119022.0,Šket Alen,O,Slovenia,33.0,205.0,2021,Japan,Slovenia,2021-06-22,True,0,0,0,0,0,0,0,0,0,0,0,0,0,0,0,0,0,0,0,0,0,0,0,0
119022.0,Šket Alen,O,Slovenia,33.0,205.0,2021,Slovenia,Bulgaria,2021-06-23,True,0,0,0,0,0,0,0,0,0,0,0,0,0,0,0,0,0,0,0,0,0,0,0,0
119022.0,Šket Alen,O,Slovenia,33.0,205.0,2021,Poland,Slovenia,2021-06-26,False,0,0,0,0,0,0,0,0,0,0,0,0,0,0,0,0,0,0,0,0,0,0,0,0
119022.0,Šket Alen,O,Slovenia,33.0,205.0,2021,France,Slovenia,2021-06-27,False,0,0,0,0,0,0,0,0,0,0,0,0,0,0,0,0,0,0,0,0,0,0,0,0
114952.0,Gasparini Mitja,O,Slovenia,37.0,202.0,2021,Serbia,Slovenia,2021-05-28,False,0,0,2,2,0,0,0,0,1,0,0,1,0,0,0,0,0,0,0,0,0,0,0,0
114952.0,Gasparini Mitja,O,Slovenia,37.0,202.0,2021,Italy,Slovenia,2021-05-29,True,0,4,6,10,0,0,2,2,6,2,9,17,0,0,0,0,0,0,0,0,1,0,0,1
114952.0,Gasparini Mitja,O,Slovenia,37.0,202.0,2021,Netherlands,Slovenia,2021-06-03,True,0,0,0,0,0,0,0,0,0,0,0,0,0,0,0,0,0,0,0,0,0,0,0,0
114952.0,Gasparini Mitja,O,Slovenia,37.0,202.0,2021,Argentina,Slovenia,2021-06-04,True,0,0,0,0,0,0,0,0,0,0,0,0,0,0,0,0,0,0,0,0,0,0,0,0
114952.0,Gasparini Mitja,O,Slovenia,37.0,202.0,2021,Slovenia,Germany,2021-06-05,False,1,2,3,6,0,0,1,1,4,0,7,11,2,0,1,3,0,0,0,0,7,1,1,9
114952.0,Gasparini Mitja,O,Slovenia,37.0,202.0,2021,Slovenia,Canada,2021-06-09,True,0,0,0,0,0,0,0,0,0,0,0,0,0,0,0,0,0,0,0,0,0,0,0,0
114952.0,Gasparini Mitja,O,Slovenia,37.0,202.0,2021,France,Slovenia,2021-06-10,True,0,3,1,4,0,0,0,0,4,3,1,8,0,0,0,0,0,0,0,0,0,0,0,0
114952.0,Gasparini Mitja,O,Slovenia,37.0,202.0,2021,Slovenia,Russia,2021-06-11,True,0,0,0,0,0,0,0,0,0,0,0,0,0,0,0,0,0,0,0,0,0,0,0,0
114952.0,Gasparini Mitja,O,Slovenia,37.0,202.0,2021,Brazil,Slovenia,2021-06-15,False,0,0,0,0,0,0,0,0,0,0,0,0,0,0,0,0,0,0,0,0,0,0,0,0
114952.0,Gasparini Mitja,O,Slovenia,37.0,202.0,2021,Slovenia,Australia,2021-06-16,True,0,0,1,1,0,0,0,0,2,2,0,4,0,0,0,0,0,0,0,0,0,0,0,0
114952.0,Gasparini Mitja,O,Slovenia,37.0,202.0,2021,Iran,Slovenia,2021-06-17,True,0,0,2,2,0,0,0,0,2,0,1,3,0,1,0,1,0,0,0,0,0,1,0,1
114952.0,Gasparini Mitja,O,Slovenia,37.0,202.0,2021,Slovenia,USA,2021-06-21,True,0,0,0,0,0,0,0,0,0,0,0,0,0,0,0,0,0,0,0,0,0,0,0,0
114952.0,Gasparini Mitja,O,Slovenia,37.0,202.0,2021,Japan,Slovenia,2021-06-22,True,0,0,0,0,0,0,0,0,0,0,0,0,0,0,0,0,0,0,0,0,0,0,0,0
114952.0,Gasparini Mitja,O,Slovenia,37.0,202.0,2021,Slovenia,Bulgaria,2021-06-23,True,0,0,0,0,0,0,0,0,0,0,0,0,0,0,0,0,0,0,0,0,0,0,0,0
114952.0,Gasparini Mitja,O,Slovenia,37.0,202.0,2021,Poland,Slovenia,2021-06-26,False,0,1,2,3,0,0,0,0,0,1,1,2,0,0,0,0,0,0,0,0,1,0,0,1
114952.0,Gasparini Mitja,O,Slovenia,37.0,202.0,2021,France,Slovenia,2021-06-27,False,0,0,0,0,0,0,0,0,0,0,0,0,0,0,0,0,0,0,0,0,0,0,0,0
114956.0,Vincic Dejan,S,Slovenia,35.0,200.0,2021,Serbia,Slovenia,2021-05-28,False,1,0,11,12,36,0,51,87,0,2,0,2,0,1,1,2,0,0,0,0,5,5,0,10
114956.0,Vincic Dejan,S,Slovenia,35.0,200.0,2021,Italy,Slovenia,2021-05-29,True,0,0,0,0,1,0,4,5,0,0,0,0,0,0,0,0,0,0,0,0,0,0,0,0
114956.0,Vincic Dejan,S,Slovenia,35.0,200.0,2021,Poland,Slovenia,2021-05-30,True,0,0,0,0,1,1,2,4,0,0,0,0,0,0,0,0,0,0,0,0,0,0,0,0
114956.0,Vincic Dejan,S,Slovenia,35.0,200.0,2021,Slovenia,Canada,2021-06-09,True,0,0,0,0,0,0,0,0,0,0,0,0,0,0,0,0,0,0,0,0,0,0,0,0
114956.0,Vincic Dejan,S,Slovenia,35.0,200.0,2021,France,Slovenia,2021-06-10,True,1,1,1,3,16,2,7,25,0,0,0,0,0,0,0,0,0,0,0,0,0,3,0,3
114956.0,Vincic Dejan,S,Slovenia,35.0,200.0,2021,Slovenia,Russia,2021-06-11,True,0,0,0,0,0,0,0,0,0,0,0,0,0,0,0,0,0,0,0,0,0,0,0,0
114956.0,Vincic Dejan,S,Slovenia,35.0,200.0,2021,Brazil,Slovenia,2021-06-15,False,0,0,0,0,3,0,1,4,0,0,0,0,0,0,0,0,0,1,0,1,0,1,0,1
114956.0,Vincic Dejan,S,Slovenia,35.0,200.0,2021,Slovenia,Australia,2021-06-16,True,0,0,0,0,3,0,6,9,0,0,0,0,0,1,0,1,0,0,0,0,0,0,0,0
114956.0,Vincic Dejan,S,Slovenia,35.0,200.0,2021,Iran,Slovenia,2021-06-17,True,0,0,0,0,2,0,7,9,0,0,0,0,0,0,0,0,0,0,0,0,0,0,0,0
114956.0,Vincic Dejan,S,Slovenia,35.0,200.0,2021,Slovenia,USA,2021-06-21,True,0,0,0,0,0,0,0,0,0,0,0,0,0,0,0,0,0,0,0,0,0,0,0,0
114956.0,Vincic Dejan,S,Slovenia,35.0,200.0,2021,Japan,Slovenia,2021-06-22,True,0,0,0,0,0,0,0,0,0,0,0,0,0,0,0,0,0,0,0,0,0,0,0,0
114956.0,Vincic Dejan,S,Slovenia,35.0,200.0,2021,Slovenia,Bulgaria,2021-06-23,True,0,0,0,0,0,0,0,0,0,0,0,0,0,0,0,0,0,0,0,0,0,0,0,0
114956.0,Vincic Dejan,S,Slovenia,35.0,200.0,2021,Poland,Slovenia,2021-06-26,False,0,0,2,2,4,0,6,10,0,0,0,0,2,1,1,4,0,0,0,0,0,0,0,0
114956.0,Vincic Dejan,S,Slovenia,35.0,200.0,2021,France,Slovenia,2021-06-27,False,0,0,0,0,0,0,0,0,0,0,0,0,0,0,0,0,0,0,0,0,0,0,0,0
151404.0,Štalekar Sašo,MB,Slovenia,25.0,214.0,2021,Serbia,Slovenia,2021-05-28,False,0,0,0,0,0,0,0,0,0,0,0,0,0,0,0,0,0,0,0,0,0,0,0,0
151404.0,Štalekar Sašo,MB,Slovenia,25.0,214.0,2021,Poland,Slovenia,2021-05-30,True,0,0,0,0,0,0,0,0,0,0,0,0,0,0,0,0,0,0,0,0,0,0,0,0
151404.0,Štalekar Sašo,MB,Slovenia,25.0,214.0,2021,Argentina,Slovenia,2021-06-04,True,0,0,0,0,0,0,0,0,0,0,0,0,0,0,0,0,0,0,0,0,0,0,0,0
151404.0,Štalekar Sašo,MB,Slovenia,25.0,214.0,2021,Slovenia,Germany,2021-06-05,False,0,0,4,4,0,0,0,0,1,0,2,3,1,1,4,6,0,0,1,1,0,1,0,1
151404.0,Štalekar Sašo,MB,Slovenia,25.0,214.0,2021,Slovenia,Canada,2021-06-09,True,0,0,0,0,0,0,0,0,0,0,0,0,0,0,0,0,0,0,0,0,0,0,0,0
151404.0,Štalekar Sašo,MB,Slovenia,25.0,214.0,2021,France,Slovenia,2021-06-10,True,0,1,3,4,0,1,1,2,1,3,0,4,2,1,2,5,0,0,0,0,0,1,0,1
151404.0,Štalekar Sašo,MB,Slovenia,25.0,214.0,2021,Brazil,Slovenia,2021-06-15,False,0,0,0,0,0,0,0,0,0,0,0,0,0,0,0,0,0,0,0,0,0,0,0,0
151404.0,Štalekar Sašo,MB,Slovenia,25.0,214.0,2021,Slovenia,Australia,2021-06-16,True,0,0,0,0,0,0,0,0,0,0,0,0,0,0,0,0,0,0,0,0,0,0,0,0
151404.0,Štalekar Sašo,MB,Slovenia,25.0,214.0,2021,Slovenia,USA,2021-06-21,True,0,0,0,0,0,0,0,0,0,0,0,0,0,0,0,0,0,0,0,0,0,0,0,0
151404.0,Štalekar Sašo,MB,Slovenia,25.0,214.0,2021,Slovenia,Bulgaria,2021-06-23,True,0,1,1,2,0,0,0,0,0,0,1,1,0,0,0,0,0,0,1,1,0,0,0,0
151404.0,Štalekar Sašo,MB,Slovenia,25.0,214.0,2021,France,Slovenia,2021-06-27,False,0,0,0,0,0,0,0,0,0,0,0,0,0,0,0,0,0,0,0,0,1,0,0,1
155920.0,Štern Žiga,OH,Slovenia,28.0,193.0,2021,Serbia,Slovenia,2021-05-28,False,0,0,2,2,0,0,0,0,2,0,0,2,0,0,0,0,0,0,2,2,0,2,0,2
155920.0,Štern Žiga,OH,Slovenia,28.0,193.0,2021,Italy,Slovenia,2021-05-29,True,0,2,5,7,0,0,3,3,12,1,12,25,0,0,0,0,7,0,6,13,1,0,0,1
155920.0,Štern Žiga,OH,Slovenia,28.0,193.0,2021,Poland,Slovenia,2021-05-30,True,0,0,0,0,0,0,0,0,0,0,0,0,0,0,0,0,0,0,0,0,0,0,0,0
155920.0,Štern Žiga,OH,Slovenia,28.0,193.0,2021,Netherlands,Slovenia,2021-06-03,True,0,0,0,0,0,0,0,0,0,0,0,0,0,0,0,0,0,0,0,0,0,0,0,0
155920.0,Štern Žiga,OH,Slovenia,28.0,193.0,2021,Argentina,Slovenia,2021-06-04,True,2,4,8,14,0,0,3,3,11,2,5,18,1,1,1,3,1,0,15,16,7,3,1,11
155920.0,Štern Žiga,OH,Slovenia,28.0,193.0,2021,Slovenia,Germany,2021-06-05,False,0,0,2,2,0,0,1,1,2,1,3,6,0,0,1,1,1,0,3,4,1,0,1,2
155920.0,Štern Žiga,OH,Slovenia,28.0,193.0,2021,Slovenia,Canada,2021-06-09,True,0,0,0,0,0,0,0,0,0,0,0,0,0,0,0,0,0,0,0,0,0,0,0,0
155920.0,Štern Žiga,OH,Slovenia,28.0,193.0,2021,France,Slovenia,2021-06-10,True,0,2,2,4,0,0,0,0,0,0,2,2,0,1,0,1,1,2,5,8,1,0,0,1
155920.0,Štern Žiga,OH,Slovenia,28.0,193.0,2021,Slovenia,Russia,2021-06-11,True,0,0,0,0,0,0,0,0,0,0,0,0,0,0,0,0,0,0,0,0,0,0,0,0
155920.0,Štern Žiga,OH,Slovenia,28.0,193.0,2021,Brazil,Slovenia,2021-06-15,False,0,0,0,0,0,0,0,0,0,0,0,0,0,0,0,0,0,0,0,0,0,0,0,0
155920.0,Štern Žiga,OH,Slovenia,28.0,193.0,2021,Slovenia,Australia,2021-06-16,True,0,0,2,2,0,0,0,0,5,1,4,10,0,1,0,1,3,2,5,10,1,0,0,1
155920.0,Štern Žiga,OH,Slovenia,28.0,193.0,2021,Iran,Slovenia,2021-06-17,True,0,0,0,0,0,0,0,0,0,0,0,0,0,0,0,0,0,0,0,0,0,0,0,0
155920.0,Štern Žiga,OH,Slovenia,28.0,193.0,2021,Slovenia,USA,2021-06-21,True,0,0,0,0,0,0,0,0,0,0,0,0,0,0,0,0,0,0,0,0,0,0,0,0
155920.0,Štern Žiga,OH,Slovenia,28.0,193.0,2021,Japan,Slovenia,2021-06-22,True,0,0,1,1,0,0,3,3,5,4,4,13,1,1,0,2,1,2,5,8,2,0,0,2
155920.0,Štern Žiga,OH,Slovenia,28.0,193.0,2021,Slovenia,Bulgaria,2021-06-23,True,0,0,0,0,0,0,0,0,0,0,0,0,0,0,0,0,0,0,0,0,0,0,0,0
155920.0,Štern Žiga,OH,Slovenia,28.0,193.0,2021,Poland,Slovenia,2021-06-26,False,0,0,0,0,0,0,0,0,0,0,0,0,0,0,0,0,0,0,0,0,0,0,0,0
155920.0,Štern Žiga,OH,Slovenia,28.0,193.0,2021,France,Slovenia,2021-06-27,False,0,0,0,0,0,0,0,0,0,0,0,0,0,0,0,0,0,0,0,0,0,0,0,0
154546.0,Klobucar Jan,L,Slovenia,29.0,196.0,2021,Serbia,Slovenia,2021-05-28,False,0,0,0,0,0,0,0,0,0,0,0,0,0,0,0,0,0,0,1,1,1,0,0,1
154546.0,Klobucar Jan,L,Slovenia,29.0,196.0,2021,Italy,Slovenia,2021-05-29,True,0,0,0,0,0,0,0,0,0,0,0,0,0,0,0,0,0,0,0,0,0,0,0,0
154546.0,Klobucar Jan,L,Slovenia,29.0,196.0,2021,Poland,Slovenia,2021-05-30,True,0,0,0,0,2,0,1,3,0,0,0,0,0,0,0,0,0,0,0,0,0,0,0,0
154546.0,Klobucar Jan,L,Slovenia,29.0,196.0,2021,Netherlands,Slovenia,2021-06-03,True,0,0,0,0,0,0,0,0,0,0,0,0,0,0,0,0,0,0,0,0,0,0,0,0
154546.0,Klobucar Jan,L,Slovenia,29.0,196.0,2021,Slovenia,Germany,2021-06-05,False,0,0,0,0,0,0,0,0,0,0,0,0,0,0,0,0,0,0,0,0,0,0,0,0
154546.0,Klobucar Jan,L,Slovenia,29.0,196.0,2021,France,Slovenia,2021-06-10,True,0,0,0,0,0,0,0,0,0,0,0,0,0,0,0,0,0,0,0,0,0,0,0,0
154546.0,Klobucar Jan,L,Slovenia,29.0,196.0,2021,Slovenia,Russia,2021-06-11,True,0,0,0,0,0,0,0,0,0,0,0,0,0,0,0,0,1,0,0,1,0,0,0,0
154546.0,Klobucar Jan,L,Slovenia,29.0,196.0,2021,Slovenia,Australia,2021-06-16,True,0,0,0,0,0,0,0,0,0,0,0,0,0,0,0,0,0,0,0,0,0,0,0,0
154546.0,Klobucar Jan,L,Slovenia,29.0,196.0,2021,Iran,Slovenia,2021-06-17,True,0,0,0,0,0,0,0,0,0,0,0,0,0,0,0,0,0,0,0,0,0,0,0,0
154546.0,Klobucar Jan,L,Slovenia,29.0,196.0,2021,Japan,Slovenia,2021-06-22,True,0,0,1,1,0,0,0,0,0,0,1,1,0,0,0,0,0,0,0,0,0,0,0,0
154546.0,Klobucar Jan,L,Slovenia,29.0,196.0,2021,Slovenia,Bulgaria,2021-06-23,True,0,0,0,0,0,0,1,1,0,0,0,0,0,0,0,0,0,1,2,3,1,0,0,1
154546.0,Klobucar Jan,L,Slovenia,29.0,196.0,2021,Poland,Slovenia,2021-06-26,False,0,0,0,0,0,0,0,0,0,0,0,0,0,0,0,0,0,0,0,0,0,0,0,0
154546.0,Klobucar Jan,L,Slovenia,29.0,196.0,2021,France,Slovenia,2021-06-27,False,0,0,0,0,0,0,0,0,0,0,0,0,0,0,0,0,0,0,0,0,0,0,0,0
144415.0,Kovačič Jani,L,Slovenia,29.0,186.0,2021,Serbia,Slovenia,2021-05-28,False,0,0,0,0,0,0,6,6,0,0,0,0,0,0,0,0,7,0,13,20,5,5,1,11
144415.0,Kovačič Jani,L,Slovenia,29.0,186.0,2021,Italy,Slovenia,2021-05-29,True,0,0,0,0,0,0,2,2,0,0,0,0,0,0,0,0,4,0,3,7,2,0,0,2
144415.0,Kovačič Jani,L,Slovenia,29.0,186.0,2021,Poland,Slovenia,2021-05-30,True,0,0,0,0,0,0,4,4,0,0,0,0,0,0,0,0,8,1,10,19,17,5,1,23
144415.0,Kovačič Jani,L,Slovenia,29.0,186.0,2021,Netherlands,Slovenia,2021-06-03,True,0,0,0,0,0,0,2,2,0,0,0,0,0,0,0,0,9,0,2,11,7,1,0,8
144415.0,Kovačič Jani,L,Slovenia,29.0,186.0,2021,Argentina,Slovenia,2021-06-04,True,0,0,0,0,0,0,3,3,0,0,0,0,0,0,0,0,3,0,8,11,12,1,0,13
144415.0,Kovačič Jani,L,Slovenia,29.0,186.0,2021,Slovenia,Germany,2021-06-05,False,0,0,0,0,0,0,5,5,0,0,0,0,0,0,0,0,8,2,9,19,18,3,0,21
144415.0,Kovačič Jani,L,Slovenia,29.0,186.0,2021,Slovenia,Canada,2021-06-09,True,0,0,0,0,0,0,7,7,0,0,0,0,0,0,0,0,6,0,9,15,6,2,0,8
144415.0,Kovačič Jani,L,Slovenia,29.0,186.0,2021,France,Slovenia,2021-06-10,True,0,0,0,0,0,0,3,3,0,0,0,0,0,0,0,0,6,0,17,23,11,8,1,20
144415.0,Kovačič Jani,L,Slovenia,29.0,186.0,2021,Slovenia,Russia,2021-06-11,True,0,0,0,0,0,0,9,9,0,0,0,0,0,0,0,0,5,4,14,23,8,1,0,9
144415.0,Kovačič Jani,L,Slovenia,29.0,186.0,2021,Brazil,Slovenia,2021-06-15,False,0,0,0,0,0,0,4,4,0,0,0,0,0,0,0,0,6,1,11,18,8,5,1,14
144415.0,Kovačič Jani,L,Slovenia,29.0,186.0,2021,Slovenia,Australia,2021-06-16,True,0,0,0,0,0,0,3,3,0,0,0,0,0,0,0,0,7,1,7,15,9,6,0,15
144415.0,Kovačič Jani,L,Slovenia,29.0,186.0,2021,Iran,Slovenia,2021-06-17,True,0,0,0,0,0,1,3,4,0,0,0,0,0,0,0,0,11,3,7,21,8,7,0,15
144415.0,Kovačič Jani,L,Slovenia,29.0,186.0,2021,Slovenia,USA,2021-06-21,True,0,0,0,0,1,0,5,6,0,0,0,0,0,0,0,0,6,1,8,15,13,3,1,17
144415.0,Kovačič Jani,L,Slovenia,29.0,186.0,2021,Japan,Slovenia,2021-06-22,True,0,0,0,0,0,0,2,2,0,0,0,0,0,0,0,0,6,0,10,16,2,4,0,6
144415.0,Kovačič Jani,L,Slovenia,29.0,186.0,2021,Slovenia,Bulgaria,2021-06-23,True,0,0,0,0,0,0,2,2,0,0,0,0,0,0,0,0,7,0,7,14,6,5,0,11
144415.0,Kovačič Jani,L,Slovenia,29.0,186.0,2021,Poland,Slovenia,2021-06-26,False,0,0,0,0,0,0,3,3,0,0,0,0,0,0,0,0,6,4,18,28,13,4,2,19
144415.0,Kovačič Jani,L,Slovenia,29.0,186.0,2021,France,Slovenia,2021-06-27,False,0,0,0,0,0,0,5,5,0,0,0,0,0,0,0,0,4,1,10,15,5,0,0,5
161754.0,Videčnik Matic,MB,Slovenia,28.0,203.0,2021,Serbia,Slovenia,2021-05-28,False,0,0,0,0,0,0,0,0,0,0,0,0,0,0,0,0,0,0,0,0,0,0,0,0
161754.0,Videčnik Matic,MB,Slovenia,28.0,203.0,2021,Italy,Slovenia,2021-05-29,True,0,0,1,1,0,0,0,0,0,0,0,0,0,0,0,0,0,0,1,1,0,0,0,0
161754.0,Videčnik Matic,MB,Slovenia,28.0,203.0,2021,Poland,Slovenia,2021-05-30,True,0,0,0,0,0,0,0,0,0,0,0,0,0,0,0,0,0,0,0,0,0,0,0,0
161754.0,Videčnik Matic,MB,Slovenia,28.0,203.0,2021,Netherlands,Slovenia,2021-06-03,True,0,0,4,4,0,0,0,0,1,0,1,2,0,0,2,2,0,0,0,0,1,0,0,1
161754.0,Videčnik Matic,MB,Slovenia,28.0,203.0,2021,Argentina,Slovenia,2021-06-04,True,0,0,0,0,0,0,0,0,0,0,0,0,0,0,0,0,0,0,0,0,1,0,0,1
161754.0,Videčnik Matic,MB,Slovenia,28.0,203.0,2021,Slovenia,Canada,2021-06-09,True,0,0,0,0,0,0,1,1,0,0,0,0,0,0,0,0,0,0,0,0,0,0,0,0
161754.0,Videčnik Matic,MB,Slovenia,28.0,203.0,2021,France,Slovenia,2021-06-10,True,0,2,11,13,0,0,0,0,1,0,1,2,0,1,1,2,0,0,0,0,1,0,0,1
161754.0,Videčnik Matic,MB,Slovenia,28.0,203.0,2021,Slovenia,Russia,2021-06-11,True,0,0,0,0,1,0,3,4,0,0,0,0,0,0,2,2,0,0,0,0,0,0,0,0
161754.0,Videčnik Matic,MB,Slovenia,28.0,203.0,2021,Brazil,Slovenia,2021-06-15,False,0,0,0,0,0,0,0,0,0,0,0,0,0,0,0,0,0,0,0,0,0,0,0,0
161754.0,Videčnik Matic,MB,Slovenia,28.0,203.0,2021,Slovenia,Australia,2021-06-16,True,0,0,0,0,0,0,0,0,0,0,0,0,0,0,0,0,0,0,0,0,0,0,0,0
161754.0,Videčnik Matic,MB,Slovenia,28.0,203.0,2021,Iran,Slovenia,2021-06-17,True,0,0,0,0,0,0,0,0,0,0,0,0,0,0,0,0,0,0,0,0,0,0,0,0
161754.0,Videčnik Matic,MB,Slovenia,28.0,203.0,2021,Slovenia,USA,2021-06-21,True,0,0,0,0,0,0,0,0,0,0,0,0,0,0,0,0,0,0,0,0,0,0,0,0
161754.0,Videčnik Matic,MB,Slovenia,28.0,203.0,2021,Japan,Slovenia,2021-06-22,True,1,0,4,5,0,0,0,0,2,0,0,2,0,1,1,2,0,0,0,0,0,0,0,0
161754.0,Videčnik Matic,MB,Slovenia,28.0,203.0,2021,Poland,Slovenia,2021-06-26,False,0,0,0,0,0,0,0,0,0,0,0,0,0,0,0,0,0,0,0,0,0,0,0,0
119018.0,Ropret Gregor,S,Slovenia,33.0,192.0,2021,Serbia,Slovenia,2021-05-28,False,1,0,3,4,7,0,7,14,0,0,1,1,0,1,2,3,0,0,0,0,0,0,1,1
119018.0,Ropret Gregor,S,Slovenia,33.0,192.0,2021,Italy,Slovenia,2021-05-29,True,1,4,2,7,18,0,38,56,0,0,0,0,0,0,0,0,0,0,0,0,0,0,0,0
119018.0,Ropret Gregor,S,Slovenia,33.0,192.0,2021,Poland,Slovenia,2021-05-30,True,0,2,19,21,37,0,59,96,2,1,0,3,1,1,0,2,0,0,0,0,4,3,0,7
119018.0,Ropret Gregor,S,Slovenia,33.0,192.0,2021,Netherlands,Slovenia,2021-06-03,True,3,1,6,10,11,1,37,49,0,0,0,0,1,2,0,3,0,0,1,1,9,2,2,13
119018.0,Ropret Gregor,S,Slovenia,33.0,192.0,2021,Argentina,Slovenia,2021-06-04,True,0,0,9,9,35,1,39,75,1,0,0,1,0,1,3,4,0,0,0,0,5,0,1,6
119018.0,Ropret Gregor,S,Slovenia,33.0,192.0,2021,Slovenia,Germany,2021-06-05,False,2,2,18,22,35,0,61,96,1,0,0,1,0,4,2,6,0,0,0,0,8,4,1,13
119018.0,Ropret Gregor,S,Slovenia,33.0,192.0,2021,Slovenia,Canada,2021-06-09,True,0,3,5,8,14,0,44,58,1,0,0,1,0,1,2,3,0,0,0,0,7,2,1,10
119018.0,Ropret Gregor,S,Slovenia,33.0,192.0,2021,France,Slovenia,2021-06-10,True,0,1,13,14,38,1,28,67,0,0,0,0,3,3,3,9,0,0,0,0,5,0,2,7
119018.0,Ropret Gregor,S,Slovenia,33.0,192.0,2021,Slovenia,Russia,2021-06-11,True,1,4,11,16,26,0,67,93,0,0,1,1,2,1,5,8,0,0,0,0,10,2,0,12
119018.0,Ropret Gregor,S,Slovenia,33.0,192.0,2021,Brazil,Slovenia,2021-06-15,False,0,1,15,16,33,1,58,92,3,0,0,3,0,4,1,5,0,0,0,0,4,4,5,13
119018.0,Ropret Gregor,S,Slovenia,33.0,192.0,2021,Slovenia,Australia,2021-06-16,True,0,1,17,18,36,0,43,79,2,0,0,2,0,0,1,1,0,0,0,0,6,2,2,10
119018.0,Ropret Gregor,S,Slovenia,33.0,192.0,2021,Iran,Slovenia,2021-06-17,True,1,2,10,13,26,0,57,83,1,0,1,2,0,2,0,2,0,0,0,0,7,3,0,10
119018.0,Ropret Gregor,S,Slovenia,33.0,192.0,2021,Slovenia,USA,2021-06-21,True,1,2,15,18,20,1,93,114,1,0,0,1,1,5,2,8,0,0,2,2,4,3,2,9
119018.0,Ropret Gregor,S,Slovenia,33.0,192.0,2021,Japan,Slovenia,2021-06-22,True,1,1,12,14,21,1,42,64,0,0,1,1,2,0,0,2,0,0,0,0,7,1,0,8
119018.0,Ropret Gregor,S,Slovenia,33.0,192.0,2021,Slovenia,Bulgaria,2021-06-23,True,1,2,10,13,18,0,36,54,0,0,1,1,0,0,3,3,0,0,0,0,3,2,1,6
119018.0,Ropret Gregor,S,Slovenia,33.0,192.0,2021,Poland,Slovenia,2021-06-26,False,0,0,7,7,15,0,46,61,0,0,0,0,0,2,1,3,0,0,0,0,4,0,1,5
119018.0,Ropret Gregor,S,Slovenia,33.0,192.0,2021,France,Slovenia,2021-06-27,False,1,2,7,10,17,0,48,65,0,0,1,1,1,3,1,5,0,0,0,0,4,0,1,5
114957.0,Urnaut Tine,OH,Slovenia,33.0,200.0,2021,Serbia,Slovenia,2021-05-28,False,0,4,7,11,0,0,0,0,14,4,14,32,0,0,1,1,4,3,19,26,3,4,1,8
114957.0,Urnaut Tine,OH,Slovenia,33.0,200.0,2021,Italy,Slovenia,2021-05-29,True,0,0,0,0,0,0,0,0,0,0,0,0,0,0,0,0,0,0,0,0,0,0,0,0
114957.0,Urnaut Tine,OH,Slovenia,33.0,200.0,2021,Poland,Slovenia,2021-05-30,True,0,3,11,14,0,1,9,10,12,2,17,31,1,2,0,3,18,1,14,33,5,1,0,6
114957.0,Urnaut Tine,OH,Slovenia,33.0,200.0,2021,Netherlands,Slovenia,2021-06-03,True,1,3,9,13,0,0,7,7,8,0,6,14,0,3,0,3,7,2,12,21,3,0,1,4
114957.0,Urnaut Tine,OH,Slovenia,33.0,200.0,2021,Argentina,Slovenia,2021-06-04,True,0,0,0,0,0,0,0,0,0,0,0,0,0,0,0,0,0,0,0,0,0,0,0,0
114957.0,Urnaut Tine,OH,Slovenia,33.0,200.0,2021,Slovenia,Germany,2021-06-05,False,1,3,10,14,1,0,2,3,11,6,14,31,0,2,1,3,3,0,12,15,8,2,0,10
114957.0,Urnaut Tine,OH,Slovenia,33.0,200.0,2021,Slovenia,Canada,2021-06-09,True,0,1,9,10,0,0,1,1,9,2,6,17,1,1,0,2,7,2,11,20,5,4,0,9
114957.0,Urnaut Tine,OH,Slovenia,33.0,200.0,2021,France,Slovenia,2021-06-10,True,0,0,0,0,0,0,0,0,0,0,0,0,0,0,0,0,0,0,0,0,0,0,0,0
114957.0,Urnaut Tine,OH,Slovenia,33.0,200.0,2021,Slovenia,Russia,2021-06-11,True,0,4,8,12,0,0,5,5,18,5,14,37,0,5,2,7,6,1,19,26,6,3,1,10
114957.0,Urnaut Tine,OH,Slovenia,33.0,200.0,2021,Brazil,Slovenia,2021-06-15,False,0,3,10,13,0,0,1,1,9,2,12,23,0,3,2,5,4,2,12,18,7,2,0,9
114957.0,Urnaut Tine,OH,Slovenia,33.0,200.0,2021,Slovenia,Australia,2021-06-16,True,0,1,2,3,0,0,0,0,1,3,3,7,0,0,0,0,2,0,1,3,5,0,0,5
114957.0,Urnaut Tine,OH,Slovenia,33.0,200.0,2021,Iran,Slovenia,2021-06-17,True,0,3,17,20,0,0,3,3,16,3,8,27,1,2,0,3,14,0,14,28,3,6,0,9
114957.0,Urnaut Tine,OH,Slovenia,33.0,200.0,2021,Slovenia,USA,2021-06-21,True,0,6,18,24,0,0,3,3,16,2,17,35,0,5,3,8,7,2,30,39,9,0,2,11
114957.0,Urnaut Tine,OH,Slovenia,33.0,200.0,2021,Japan,Slovenia,2021-06-22,True,0,2,13,15,0,0,5,5,12,1,6,19,2,2,1,5,3,0,13,16,3,0,0,3
114957.0,Urnaut Tine,OH,Slovenia,33.0,200.0,2021,Slovenia,Bulgaria,2021-06-23,True,1,0,6,7,0,0,4,4,3,2,1,6,0,2,0,2,0,0,2,2,1,1,0,2
114957.0,Urnaut Tine,OH,Slovenia,33.0,200.0,2021,Poland,Slovenia,2021-06-26,False,0,3,11,14,0,0,1,1,13,3,4,20,0,1,1,2,1,2,13,16,3,3,2,8
114957.0,Urnaut Tine,OH,Slovenia,33.0,200.0,2021,France,Slovenia,2021-06-27,False,0,2,7,9,0,0,5,5,8,4,6,18,2,3,2,7,3,2,12,17,1,1,0,2
136918.0,Čebulj Klemen,OH,Slovenia,30.0,202.0,2021,Serbia,Slovenia,2021-05-28,False,1,5,13,19,0,1,2,3,9,4,14,27,1,2,1,4,15,0,20,35,4,5,2,11
136918.0,Čebulj Klemen,OH,Slovenia,30.0,202.0,2021,Italy,Slovenia,2021-05-29,True,4,2,13,19,0,0,4,4,8,0,8,16,1,0,0,1,5,3,8,16,1,0,0,1
136918.0,Čebulj Klemen,OH,Slovenia,30.0,202.0,2021,Poland,Slovenia,2021-05-30,True,0,4,11,15,0,0,6,6,16,7,17,40,1,3,0,4,10,1,13,24,3,4,1,8
136918.0,Čebulj Klemen,OH,Slovenia,30.0,202.0,2021,Netherlands,Slovenia,2021-06-03,True,0,0,0,0,0,0,0,0,0,0,0,0,0,0,0,0,0,0,0,0,0,0,0,0
136918.0,Čebulj Klemen,OH,Slovenia,30.0,202.0,2021,Argentina,Slovenia,2021-06-04,True,0,2,6,8,0,0,3,3,11,3,14,28,1,2,6,9,6,0,13,19,7,1,2,10
136918.0,Čebulj Klemen,OH,Slovenia,30.0,202.0,2021,Slovenia,Germany,2021-06-05,False,0,6,4,10,0,0,0,0,7,1,10,18,1,1,1,3,9,4,6,19,4,2,0,6
136918.0,Čebulj Klemen,OH,Slovenia,30.0,202.0,2021,Slovenia,Canada,2021-06-09,True,2,1,6,9,0,0,1,1,10,4,4,18,0,1,1,2,5,0,6,11,1,1,0,2
136918.0,Čebulj Klemen,OH,Slovenia,30.0,202.0,2021,France,Slovenia,2021-06-10,True,2,4,12,18,0,0,5,5,10,0,14,24,4,3,0,7,9,2,19,30,5,0,2,7
136918.0,Čebulj Klemen,OH,Slovenia,30.0,202.0,2021,Slovenia,Russia,2021-06-11,True,2,6,11,19,0,0,3,3,27,2,11,40,3,3,3,9,5,2,26,33,8,0,0,8
136918.0,Čebulj Klemen,OH,Slovenia,30.0,202.0,2021,Brazil,Slovenia,2021-06-15,False,1,4,9,14,0,0,3,3,14,4,11,29,1,3,3,7,12,2,28,42,12,1,0,13
136918.0,Čebulj Klemen,OH,Slovenia,30.0,202.0,2021,Slovenia,Australia,2021-06-16,True,1,3,6,10,0,0,4,4,14,2,5,21,1,1,1,3,6,0,4,10,7,3,0,10
136918.0,Čebulj Klemen,OH,Slovenia,30.0,202.0,2021,Iran,Slovenia,2021-06-17,True,0,6,7,13,0,0,4,4,20,5,9,34,1,0,0,1,8,1,15,24,2,3,0,5
136918.0,Čebulj Klemen,OH,Slovenia,30.0,202.0,2021,Slovenia,USA,2021-06-21,True,0,3,14,17,0,0,5,5,25,5,13,43,2,3,0,5,6,3,22,31,4,5,2,11
136918.0,Čebulj Klemen,OH,Slovenia,30.0,202.0,2021,Japan,Slovenia,2021-06-22,True,1,2,6,9,0,0,1,1,6,1,8,15,0,3,0,3,5,0,6,11,2,2,0,4
136918.0,Čebulj Klemen,OH,Slovenia,30.0,202.0,2021,Slovenia,Bulgaria,2021-06-23,True,0,1,8,9,0,0,2,2,6,4,9,19,1,5,4,10,5,1,10,16,9,2,1,12
136918.0,Čebulj Klemen,OH,Slovenia,30.0,202.0,2021,Poland,Slovenia,2021-06-26,False,0,3,5,8,0,0,5,5,9,8,9,26,1,0,3,4,9,0,8,17,2,1,1,4
136918.0,Čebulj Klemen,OH,Slovenia,30.0,202.0,2021,France,Slovenia,2021-06-27,False,1,0,9,10,0,0,0,0,8,6,12,26,0,2,2,4,8,2,14,24,8,1,2,11
168747.0,Možič Rok,OH,Slovenia,20.0,200.0,2021,Serbia,Slovenia,2021-05-28,False,0,0,0,0,0,0,0,0,0,0,0,0,0,0,0,0,0,0,0,0,0,0,0,0
168747.0,Možič Rok,OH,Slovenia,20.0,200.0,2021,Italy,Slovenia,2021-05-29,True,0,0,0,0,0,0,0,0,2,1,4,7,0,0,0,0,2,1,2,5,0,0,0,0
168747.0,Možič Rok,OH,Slovenia,20.0,200.0,2021,Poland,Slovenia,2021-05-30,True,0,0,0,0,0,0,0,0,1,0,0,1,0,0,0,0,0,0,0,0,0,0,0,0
168747.0,Možič Rok,OH,Slovenia,20.0,200.0,2021,Netherlands,Slovenia,2021-06-03,True,1,2,7,10,0,1,0,1,14,4,9,27,1,0,2,3,2,1,3,6,2,2,0,4
168747.0,Možič Rok,OH,Slovenia,20.0,200.0,2021,Argentina,Slovenia,2021-06-04,True,0,0,0,0,0,0,0,0,0,0,0,0,0,0,0,0,0,0,0,0,0,0,0,0
168747.0,Možič Rok,OH,Slovenia,20.0,200.0,2021,Slovenia,Germany,2021-06-05,False,1,2,1,4,0,0,0,0,3,1,1,5,0,0,1,1,2,1,6,9,2,1,0,3
168747.0,Možič Rok,OH,Slovenia,20.0,200.0,2021,Slovenia,Canada,2021-06-09,True,0,2,3,5,0,0,1,1,3,0,0,3,0,0,0,0,0,0,2,2,1,1,0,2
168747.0,Možič Rok,OH,Slovenia,20.0,200.0,2021,France,Slovenia,2021-06-10,True,0,7,8,15,0,0,3,3,19,2,10,31,1,8,0,9,3,2,13,18,6,0,1,7
168747.0,Možič Rok,OH,Slovenia,20.0,200.0,2021,Slovenia,Russia,2021-06-11,True,0,0,2,2,0,0,0,0,2,1,0,3,0,0,1,1,0,0,3,3,2,1,0,3
168747.0,Možič Rok,OH,Slovenia,20.0,200.0,2021,Brazil,Slovenia,2021-06-15,False,0,1,0,1,0,0,1,1,2,0,1,3,0,0,0,0,0,1,2,3,0,0,0,0
168747.0,Možič Rok,OH,Slovenia,20.0,200.0,2021,Slovenia,Australia,2021-06-16,True,0,2,8,10,0,0,2,2,11,4,4,19,3,3,4,10,8,0,17,25,3,1,0,4
168747.0,Možič Rok,OH,Slovenia,20.0,200.0,2021,Iran,Slovenia,2021-06-17,True,0,0,0,0,0,0,0,0,0,0,2,2,0,1,0,1,0,0,3,3,0,0,0,0
168747.0,Možič Rok,OH,Slovenia,20.0,200.0,2021,Slovenia,USA,2021-06-21,True,0,0,0,0,0,0,0,0,0,0,0,0,0,0,0,0,0,0,0,0,0,0,0,0
168747.0,Možič Rok,OH,Slovenia,20.0,200.0,2021,Japan,Slovenia,2021-06-22,True,0,0,0,0,0,0,1,1,0,0,0,0,0,0,0,0,0,0,0,0,0,1,0,1
168747.0,Možič Rok,OH,Slovenia,20.0,200.0,2021,Slovenia,Bulgaria,2021-06-23,True,0,1,6,7,0,0,1,1,8,1,1,10,2,3,0,5,0,0,5,5,1,0,1,2
168747.0,Možič Rok,OH,Slovenia,20.0,200.0,2021,Poland,Slovenia,2021-06-26,False,0,0,0,0,0,0,0,0,0,0,0,0,0,0,0,0,0,0,0,0,0,0,0,0
168747.0,Možič Rok,OH,Slovenia,20.0,200.0,2021,France,Slovenia,2021-06-27,False,0,1,0,1,0,0,1,1,1,2,2,5,0,0,0,0,0,0,3,3,0,0,0,0
118893.0,Anderson Matthew,O,USA,34.0,202.0,2021,Poland,USA,2021-06-04,False,0,4,1,5,0,0,0,0,9,2,5,16,0,0,1,1,9,1,6,16,5,1,2,8
118893.0,Anderson Matthew,O,USA,34.0,202.0,2021,USA,Australia,2021-06-05,False,1,3,8,12,0,0,2,2,12,2,4,18,1,0,0,1,2,0,6,8,4,2,2,8
118893.0,Anderson Matthew,O,USA,34.0,202.0,2021,USA,Serbia,2021-06-11,False,0,1,5,6,0,0,1,1,7,3,5,15,2,1,1,4,0,0,1,1,3,2,0,5
118893.0,Anderson Matthew,O,USA,34.0,202.0,2021,Italy,USA,2021-06-15,False,3,3,9,15,0,0,0,0,13,3,5,21,1,1,3,5,2,0,0,2,4,1,1,6
118893.0,Anderson Matthew,O,USA,34.0,202.0,2021,USA,France,2021-06-16,False,0,0,0,0,0,0,0,0,0,0,0,0,0,0,0,0,0,0,0,0,0,0,0,0
118893.0,Anderson Matthew,O,USA,34.0,202.0,2021,Netherlands,USA,2021-06-17,False,0,6,9,15,0,1,2,3,17,4,7,28,2,7,7,16,1,0,3,4,5,4,1,10
118893.0,Anderson Matthew,O,USA,34.0,202.0,2021,Slovenia,USA,2021-06-21,False,0,1,9,10,0,0,3,3,8,5,11,24,1,4,1,6,2,0,3,5,4,3,0,7
118893.0,Anderson Matthew,O,USA,34.0,202.0,2021,Bulgaria,USA,2021-06-22,False,0,0,0,0,0,0,0,0,0,0,0,0,0,0,0,0,0,0,0,0,0,0,0,0
118893.0,Anderson Matthew,O,USA,34.0,202.0,2021,USA,Japan,2021-06-23,False,1,5,5,11,0,0,1,1,11,1,7,19,0,0,0,0,0,0,0,0,5,3,0,8
124941.0,Sander Taylor,OH,USA,30.0,196.0,2021,Iran,USA,2021-06-09,False,0,0,0,0,0,0,0,0,0,0,0,0,0,0,0,0,0,0,0,0,0,0,0,0
124941.0,Sander Taylor,OH,USA,30.0,196.0,2021,Germany,USA,2021-06-10,False,0,0,0,0,0,0,0,0,0,0,0,0,0,0,0,0,0,0,0,0,0,0,0,0
124941.0,Sander Taylor,OH,USA,30.0,196.0,2021,USA,Serbia,2021-06-11,False,0,0,0,0,0,0,0,0,0,0,0,0,0,0,0,0,0,0,0,0,0,0,0,0
124941.0,Sander Taylor,OH,USA,30.0,196.0,2021,Italy,USA,2021-06-15,False,0,2,7,9,0,0,2,2,12,0,7,19,2,0,0,2,6,1,10,17,4,0,0,4
124941.0,Sander Taylor,OH,USA,30.0,196.0,2021,Netherlands,USA,2021-06-17,False,4,2,11,17,0,0,8,8,15,5,8,28,2,5,3,10,8,2,16,26,4,3,0,7
124941.0,Sander Taylor,OH,USA,30.0,196.0,2021,Slovenia,USA,2021-06-21,False,1,7,11,19,1,0,2,3,16,4,13,33,4,3,2,9,17,2,17,36,7,1,1,9
147721.0,Jendryk II Jeffrey,MB,USA,26.0,208.0,2021,USA,Brazil,2021-05-29,False,0,2,7,9,0,0,0,0,5,0,3,8,2,0,0,2,0,0,0,0,0,0,0,0
147721.0,Jendryk II Jeffrey,MB,USA,26.0,208.0,2021,USA,Argentina,2021-05-30,False,0,0,0,0,0,0,0,0,0,0,0,0,0,0,0,0,0,0,0,0,0,0,0,0
147721.0,Jendryk II Jeffrey,MB,USA,26.0,208.0,2021,Russia,USA,2021-06-03,False,1,1,5,7,0,0,0,0,4,1,0,5,0,2,1,3,0,0,0,0,2,0,0,2
147721.0,Jendryk II Jeffrey,MB,USA,26.0,208.0,2021,Poland,USA,2021-06-04,False,0,0,0,0,0,0,0,0,0,0,0,0,0,0,0,0,0,0,0,0,0,0,0,0
147721.0,Jendryk II Jeffrey,MB,USA,26.0,208.0,2021,USA,Australia,2021-06-05,False,0,4,4,8,0,0,0,0,6,0,6,12,1,3,5,9,1,0,2,3,4,0,1,5
147721.0,Jendryk II Jeffrey,MB,USA,26.0,208.0,2021,Iran,USA,2021-06-09,False,0,0,10,10,0,0,0,0,2,0,6,8,3,5,3,11,1,0,0,1,3,0,0,3
147721.0,Jendryk II Jeffrey,MB,USA,26.0,208.0,2021,Germany,USA,2021-06-10,False,0,0,0,0,0,0,0,0,0,0,0,0,0,0,0,0,0,0,0,0,0,0,0,0
147721.0,Jendryk II Jeffrey,MB,USA,26.0,208.0,2021,Italy,USA,2021-06-15,False,0,0,0,0,0,0,0,0,0,0,0,0,0,0,0,0,0,0,0,0,0,0,0,0
147721.0,Jendryk II Jeffrey,MB,USA,26.0,208.0,2021,USA,France,2021-06-16,False,0,0,0,0,0,0,0,0,0,0,0,0,0,0,0,0,0,0,0,0,0,0,0,0
147721.0,Jendryk II Jeffrey,MB,USA,26.0,208.0,2021,Netherlands,USA,2021-06-17,False,0,0,0,0,0,0,0,0,0,0,0,0,0,0,0,0,0,0,0,0,0,0,0,0
147721.0,Jendryk II Jeffrey,MB,USA,26.0,208.0,2021,Slovenia,USA,2021-06-21,False,0,0,0,0,0,0,0,0,0,0,0,0,0,0,0,0,0,0,0,0,0,0,0,0
147721.0,Jendryk II Jeffrey,MB,USA,26.0,208.0,2021,Bulgaria,USA,2021-06-22,False,0,0,9,9,0,0,0,0,6,1,3,10,4,1,3,8,0,0,3,3,2,0,0,2
147721.0,Jendryk II Jeffrey,MB,USA,26.0,208.0,2021,USA,Japan,2021-06-23,False,0,0,0,0,0,0,0,0,0,0,0,0,0,0,0,0,0,0,0,0,0,0,0,0
147417.0,Ensing Kyle,O,USA,25.0,201.0,2021,USA,Canada,2021-05-28,False,1,5,5,11,0,0,0,0,11,4,18,33,1,2,2,5,1,0,0,1,6,2,0,8
147417.0,Ensing Kyle,O,USA,25.0,201.0,2021,USA,Brazil,2021-05-29,False,0,0,0,0,0,0,0,0,0,0,0,0,0,0,0,0,0,0,0,0,0,0,0,0
147417.0,Ensing Kyle,O,USA,25.0,201.0,2021,USA,Argentina,2021-05-30,False,0,2,6,8,0,0,0,0,13,0,5,18,3,1,1,5,0,0,0,0,4,0,0,4
147417.0,Ensing Kyle,O,USA,25.0,201.0,2021,Russia,USA,2021-06-03,False,0,2,7,9,0,0,2,2,6,2,4,12,0,1,4,5,0,0,0,0,3,1,0,4
147417.0,Ensing Kyle,O,USA,25.0,201.0,2021,Poland,USA,2021-06-04,False,0,2,1,3,0,0,0,0,2,2,3,7,1,0,2,3,0,0,0,0,2,0,0,2
147417.0,Ensing Kyle,O,USA,25.0,201.0,2021,USA,Australia,2021-06-05,False,0,1,9,10,0,0,1,1,9,3,8,20,2,2,3,7,0,0,0,0,4,1,0,5
147417.0,Ensing Kyle,O,USA,25.0,201.0,2021,Iran,USA,2021-06-09,False,0,0,1,1,0,0,0,0,2,1,1,4,1,1,1,3,0,0,0,0,1,0,0,1
147417.0,Ensing Kyle,O,USA,25.0,201.0,2021,Germany,USA,2021-06-10,False,1,3,9,13,0,0,1,1,7,1,6,14,1,3,4,8,0,0,0,0,6,1,2,9
147417.0,Ensing Kyle,O,USA,25.0,201.0,2021,Italy,USA,2021-06-15,False,0,0,0,0,0,0,0,0,0,0,0,0,0,0,0,0,0,0,0,0,0,0,0,0
147417.0,Ensing Kyle,O,USA,25.0,201.0,2021,USA,France,2021-06-16,False,2,5,9,16,0,0,1,1,7,5,13,25,5,4,4,13,0,0,1,1,6,3,0,9
147417.0,Ensing Kyle,O,USA,25.0,201.0,2021,Netherlands,USA,2021-06-17,False,0,0,0,0,0,0,0,0,0,0,0,0,0,0,0,0,0,0,0,0,0,0,0,0
147417.0,Ensing Kyle,O,USA,25.0,201.0,2021,Slovenia,USA,2021-06-21,False,0,1,3,4,0,0,1,1,5,3,2,10,0,2,0,2,0,0,0,0,0,0,1,1
147417.0,Ensing Kyle,O,USA,25.0,201.0,2021,Bulgaria,USA,2021-06-22,False,0,1,10,11,0,0,1,1,8,4,3,15,0,4,2,6,0,0,0,0,6,2,0,8
147417.0,Ensing Kyle,O,USA,25.0,201.0,2021,USA,Japan,2021-06-23,False,0,0,0,0,0,0,0,0,0,0,0,0,0,0,0,0,0,0,0,0,0,0,0,0
140185.0,Stahl Mitchell,MB,USA,27.0,203.0,2021,USA,Brazil,2021-05-29,False,1,5,5,11,0,0,1,1,5,1,5,11,2,0,0,2,2,0,1,3,0,0,0,0
140185.0,Stahl Mitchell,MB,USA,27.0,203.0,2021,Russia,USA,2021-06-03,False,0,2,2,4,0,0,0,0,4,0,2,6,1,2,1,4,1,0,2,3,0,0,1,1
140185.0,Stahl Mitchell,MB,USA,27.0,203.0,2021,Poland,USA,2021-06-04,False,1,3,9,13,0,0,1,1,4,1,5,10,3,0,0,3,1,0,0,1,0,1,0,1
140185.0,Stahl Mitchell,MB,USA,27.0,203.0,2021,USA,Australia,2021-06-05,False,0,0,0,0,0,0,0,0,0,0,0,0,0,0,0,0,0,0,0,0,0,0,0,0
140185.0,Stahl Mitchell,MB,USA,27.0,203.0,2021,Iran,USA,2021-06-09,False,0,0,0,0,0,0,0,0,0,0,0,0,0,0,0,0,0,0,0,0,0,0,0,0
140185.0,Stahl Mitchell,MB,USA,27.0,203.0,2021,Germany,USA,2021-06-10,False,0,5,6,11,0,0,1,1,5,0,2,7,1,0,5,6,0,0,0,0,3,0,0,3
140185.0,Stahl Mitchell,MB,USA,27.0,203.0,2021,USA,Serbia,2021-06-11,False,0,0,0,0,0,0,0,0,0,0,0,0,0,0,0,0,0,0,0,0,0,0,0,0
140185.0,Stahl Mitchell,MB,USA,27.0,203.0,2021,Italy,USA,2021-06-15,False,2,1,3,6,0,0,1,1,1,1,1,3,1,1,1,3,0,0,0,0,1,0,0,1
140185.0,Stahl Mitchell,MB,USA,27.0,203.0,2021,USA,France,2021-06-16,False,1,7,13,21,0,0,1,1,6,2,5,13,3,9,9,21,1,0,0,1,4,0,2,6
140185.0,Stahl Mitchell,MB,USA,27.0,203.0,2021,Netherlands,USA,2021-06-17,False,1,4,11,16,0,0,1,1,7,1,3,11,3,4,7,14,1,0,0,1,4,0,0,4
140185.0,Stahl Mitchell,MB,USA,27.0,203.0,2021,Slovenia,USA,2021-06-21,False,1,3,0,4,0,0,0,0,4,0,0,4,0,2,0,2,0,0,0,0,0,0,0,0
140185.0,Stahl Mitchell,MB,USA,27.0,203.0,2021,Bulgaria,USA,2021-06-22,False,3,2,9,14,0,0,0,0,3,1,2,6,1,3,8,12,0,0,0,0,1,0,0,1
140185.0,Stahl Mitchell,MB,USA,27.0,203.0,2021,USA,Japan,2021-06-23,False,0,0,0,0,0,0,0,0,0,0,0,0,0,0,0,0,0,0,0,0,0,0,0,0
118913.0,Shoji Kawika,S,USA,34.0,190.0,2021,USA,Canada,2021-05-28,False,0,0,0,0,0,0,0,0,0,0,0,0,0,0,0,0,0,0,0,0,0,0,0,0
118913.0,Shoji Kawika,S,USA,34.0,190.0,2021,USA,Brazil,2021-05-29,False,0,0,0,0,0,0,0,0,0,0,0,0,0,0,0,0,0,0,0,0,0,0,0,0
118913.0,Shoji Kawika,S,USA,34.0,190.0,2021,Russia,USA,2021-06-03,False,0,0,0,0,0,0,0,0,0,0,0,0,0,0,0,0,0,0,0,0,0,0,0,0
118913.0,Shoji Kawika,S,USA,34.0,190.0,2021,USA,Australia,2021-06-05,False,0,0,1,1,2,0,7,9,0,0,0,0,0,0,0,0,0,0,0,0,0,1,0,1
118913.0,Shoji Kawika,S,USA,34.0,190.0,2021,Iran,USA,2021-06-09,False,0,0,7,7,20,1,59,80,1,0,0,1,0,1,3,4,0,0,0,0,4,1,2,7
118913.0,Shoji Kawika,S,USA,34.0,190.0,2021,Germany,USA,2021-06-10,False,1,2,8,11,20,0,33,53,1,0,0,1,4,1,2,7,0,0,0,0,7,0,0,7
118913.0,Shoji Kawika,S,USA,34.0,190.0,2021,USA,Serbia,2021-06-11,False,0,0,0,0,1,0,4,5,0,0,0,0,0,0,0,0,0,0,0,0,0,0,0,0
118913.0,Shoji Kawika,S,USA,34.0,190.0,2021,Italy,USA,2021-06-15,False,0,0,0,0,0,0,0,0,0,0,0,0,0,0,0,0,0,0,0,0,0,0,0,0
118913.0,Shoji Kawika,S,USA,34.0,190.0,2021,USA,France,2021-06-16,False,0,3,12,15,33,0,76,109,3,0,1,4,1,4,3,8,0,0,0,0,9,0,1,10
118913.0,Shoji Kawika,S,USA,34.0,190.0,2021,Netherlands,USA,2021-06-17,False,0,0,0,0,0,0,0,0,0,0,0,0,0,0,0,0,0,0,0,0,0,0,0,0
118913.0,Shoji Kawika,S,USA,34.0,190.0,2021,Slovenia,USA,2021-06-21,False,0,0,0,0,0,0,0,0,0,0,0,0,0,0,0,0,0,0,0,0,0,0,0,0
118913.0,Shoji Kawika,S,USA,34.0,190.0,2021,Bulgaria,USA,2021-06-22,False,1,1,11,13,22,0,45,67,2,0,0,2,0,3,1,4,0,0,0,0,3,0,1,4
118913.0,Shoji Kawika,S,USA,34.0,190.0,2021,USA,Japan,2021-06-23,False,0,0,0,0,0,0,0,0,0,0,0,0,0,0,0,0,0,0,0,0,0,0,0,0
139254.0,Defalco Torey,OH,USA,24.0,198.0,2021,USA,Canada,2021-05-28,False,1,3,8,12,0,0,0,0,13,6,5,24,1,0,2,3,5,1,12,18,8,3,0,11
139254.0,Defalco Torey,OH,USA,24.0,198.0,2021,USA,Brazil,2021-05-29,False,2,1,9,12,0,0,2,2,7,2,10,19,1,0,1,2,12,3,17,32,1,0,0,1
139254.0,Defalco Torey,OH,USA,24.0,198.0,2021,USA,Argentina,2021-05-30,False,0,6,6,12,0,0,6,6,15,3,9,27,5,5,0,10,14,0,22,36,4,0,2,6
139254.0,Defalco Torey,OH,USA,24.0,198.0,2021,Russia,USA,2021-06-03,False,0,4,12,16,0,0,2,2,10,7,9,26,2,3,2,7,3,1,18,22,6,2,1,9
139254.0,Defalco Torey,OH,USA,24.0,198.0,2021,Poland,USA,2021-06-04,False,0,1,1,2,0,0,1,1,3,3,3,9,0,1,0,1,4,0,10,14,0,1,0,1
139254.0,Defalco Torey,OH,USA,24.0,198.0,2021,USA,Australia,2021-06-05,False,0,0,0,0,0,0,0,0,0,0,0,0,0,0,0,0,0,0,0,0,0,0,0,0
139254.0,Defalco Torey,OH,USA,24.0,198.0,2021,Iran,USA,2021-06-09,False,0,1,8,9,0,0,1,1,5,5,12,22,0,0,3,3,6,1,6,13,2,1,0,3
139254.0,Defalco Torey,OH,USA,24.0,198.0,2021,Germany,USA,2021-06-10,False,0,0,2,2,0,0,0,0,0,0,0,0,0,0,0,0,0,0,0,0,0,0,0,0
139254.0,Defalco Torey,OH,USA,24.0,198.0,2021,USA,Serbia,2021-06-11,False,0,4,8,12,0,0,5,5,20,1,9,30,2,2,0,4,7,1,12,20,4,3,0,7
139254.0,Defalco Torey,OH,USA,24.0,198.0,2021,Italy,USA,2021-06-15,False,0,3,8,11,0,0,1,1,8,1,10,19,0,1,0,1,1,0,13,14,10,2,1,13
139254.0,Defalco Torey,OH,USA,24.0,198.0,2021,USA,France,2021-06-16,False,0,4,13,17,0,0,5,5,19,5,21,45,2,4,3,9,14,0,21,35,9,3,2,14
139254.0,Defalco Torey,OH,USA,24.0,198.0,2021,Netherlands,USA,2021-06-17,False,0,0,0,0,0,0,0,0,0,0,0,0,0,0,0,0,0,0,0,0,0,0,0,0
139254.0,Defalco Torey,OH,USA,24.0,198.0,2021,Slovenia,USA,2021-06-21,False,1,2,17,20,0,0,3,3,15,2,12,29,1,7,2,10,8,1,25,34,12,3,2,17
139254.0,Defalco Torey,OH,USA,24.0,198.0,2021,Bulgaria,USA,2021-06-22,False,0,0,0,0,0,0,0,0,0,0,0,0,0,0,0,0,0,0,0,0,0,0,0,0
139254.0,Defalco Torey,OH,USA,24.0,198.0,2021,USA,Japan,2021-06-23,False,0,4,5,9,0,0,5,5,11,3,6,20,4,3,0,7,5,0,7,12,0,3,0,3
170104.0,Hanes Jake,O,USA,23.0,210.0,2021,USA,Canada,2021-05-28,False,0,0,0,0,0,0,0,0,0,0,0,0,0,0,0,0,0,0,0,0,0,0,0,0
170104.0,Hanes Jake,O,USA,23.0,210.0,2021,Iran,USA,2021-06-09,False,0,0,0,0,0,0,0,0,0,0,0,0,0,0,0,0,0,0,0,0,0,0,0,0
170104.0,Hanes Jake,O,USA,23.0,210.0,2021,Bulgaria,USA,2021-06-22,False,0,1,6,7,0,0,1,1,2,0,1,3,0,1,0,1,0,0,0,0,0,0,1,1
170104.0,Hanes Jake,O,USA,23.0,210.0,2021,USA,Japan,2021-06-23,False,0,0,0,0,0,0,0,0,0,0,0,0,0,0,0,0,0,0,0,0,0,0,0,0
124879.0,Christenson Micah,S,USA,28.0,198.0,2021,USA,Canada,2021-05-28,False,1,0,12,13,29,0,59,88,3,0,3,6,1,2,1,4,0,0,0,0,2,0,0,2
124879.0,Christenson Micah,S,USA,28.0,198.0,2021,USA,Brazil,2021-05-29,False,1,1,14,16,19,0,58,77,0,1,1,2,0,0,0,0,0,0,0,0,0,0,0,0
124879.0,Christenson Micah,S,USA,28.0,198.0,2021,USA,Argentina,2021-05-30,False,3,2,16,21,37,0,45,82,1,0,0,1,1,3,2,6,0,0,0,0,2,2,0,4
124879.0,Christenson Micah,S,USA,28.0,198.0,2021,Russia,USA,2021-06-03,False,1,3,13,17,35,0,50,85,4,0,2,6,0,4,2,6,0,0,1,1,4,6,2,12
124879.0,Christenson Micah,S,USA,28.0,198.0,2021,Poland,USA,2021-06-04,False,0,2,5,7,21,1,29,51,0,0,2,2,0,1,0,1,0,0,0,0,1,3,0,4
124879.0,Christenson Micah,S,USA,28.0,198.0,2021,USA,Australia,2021-06-05,False,1,2,10,13,21,0,34,55,2,0,2,4,1,4,4,9,0,0,0,0,6,3,1,10
124879.0,Christenson Micah,S,USA,28.0,198.0,2021,Italy,USA,2021-06-15,False,2,2,9,13,17,1,51,69,0,0,1,1,0,2,1,3,0,0,0,0,5,1,0,6
124879.0,Christenson Micah,S,USA,28.0,198.0,2021,USA,France,2021-06-16,False,0,0,0,0,0,0,0,0,0,0,0,0,0,0,0,0,0,0,0,0,0,0,0,0
124879.0,Christenson Micah,S,USA,28.0,198.0,2021,Netherlands,USA,2021-06-17,False,3,2,16,21,28,0,63,91,3,0,1,4,0,0,3,3,0,0,0,0,6,1,2,9
124879.0,Christenson Micah,S,USA,28.0,198.0,2021,Slovenia,USA,2021-06-21,False,0,3,18,21,42,0,66,108,0,0,4,4,1,10,5,16,0,0,1,1,7,2,2,11
124879.0,Christenson Micah,S,USA,28.0,198.0,2021,Bulgaria,USA,2021-06-22,False,0,0,0,0,0,0,0,0,0,0,0,0,0,0,0,0,0,0,0,0,0,0,0,0
124879.0,Christenson Micah,S,USA,28.0,198.0,2021,USA,Japan,2021-06-23,False,1,1,16,18,22,0,33,55,3,1,2,6,1,0,1,2,0,0,0,0,9,2,1,12
118901.0,Holt Maxwell,MB,USA,35.0,205.0,2021,USA,Canada,2021-05-28,False,1,5,5,11,1,0,0,1,3,0,4,7,1,1,3,5,0,0,1,1,2,0,0,2
118901.0,Holt Maxwell,MB,USA,35.0,205.0,2021,USA,Brazil,2021-05-29,False,0,0,0,0,0,0,0,0,0,0,0,0,0,0,0,0,0,0,0,0,0,0,0,0
118901.0,Holt Maxwell,MB,USA,35.0,205.0,2021,USA,Argentina,2021-05-30,False,1,5,18,24,0,0,2,2,6,0,3,9,0,2,0,2,0,0,1,1,2,0,0,2
118901.0,Holt Maxwell,MB,USA,35.0,205.0,2021,Poland,USA,2021-06-04,False,0,3,3,6,0,0,0,0,1,2,5,8,3,0,0,3,0,0,0,0,1,1,0,2
118901.0,Holt Maxwell,MB,USA,35.0,205.0,2021,Germany,USA,2021-06-10,False,0,0,0,0,0,0,0,0,0,0,0,0,0,0,0,0,0,0,0,0,0,0,0,0
118901.0,Holt Maxwell,MB,USA,35.0,205.0,2021,USA,Serbia,2021-06-11,False,2,2,11,15,0,0,2,2,3,2,4,9,2,4,1,7,2,0,0,2,1,0,0,1
118901.0,Holt Maxwell,MB,USA,35.0,205.0,2021,Italy,USA,2021-06-15,False,1,2,1,4,0,0,0,0,2,0,3,5,1,1,4,6,0,0,1,1,2,0,0,2
118901.0,Holt Maxwell,MB,USA,35.0,205.0,2021,USA,France,2021-06-16,False,0,5,9,14,0,0,3,3,10,0,5,15,2,4,5,11,0,0,0,0,4,0,0,4
118901.0,Holt Maxwell,MB,USA,35.0,205.0,2021,Netherlands,USA,2021-06-17,False,0,0,0,0,0,0,0,0,0,0,0,0,0,0,0,0,0,0,0,0,0,0,0,0
118901.0,Holt Maxwell,MB,USA,35.0,205.0,2021,Slovenia,USA,2021-06-21,False,1,3,12,16,0,0,2,2,9,2,4,15,2,4,2,8,0,0,0,0,5,1,0,6
118901.0,Holt Maxwell,MB,USA,35.0,205.0,2021,Bulgaria,USA,2021-06-22,False,0,0,0,0,0,0,0,0,0,0,0,0,0,0,0,0,0,0,0,0,0,0,0,0
118901.0,Holt Maxwell,MB,USA,35.0,205.0,2021,USA,Japan,2021-06-23,False,0,2,12,14,0,0,1,1,6,1,0,7,4,4,1,9,0,0,0,0,1,0,0,1
136074.0,Patch Benjamin,O,USA,27.0,203.0,2021,USA,Canada,2021-05-28,False,0,0,0,0,0,0,0,0,0,0,0,0,0,0,0,0,0,0,0,0,0,0,0,0
136074.0,Patch Benjamin,O,USA,27.0,203.0,2021,USA,Brazil,2021-05-29,False,0,5,6,11,0,0,1,1,15,6,9,30,3,0,0,3,0,0,0,0,0,0,0,0
136074.0,Patch Benjamin,O,USA,27.0,203.0,2021,USA,Argentina,2021-05-30,False,1,3,2,6,0,0,1,1,6,6,3,15,3,1,0,4,0,0,0,0,2,0,2,4
136074.0,Patch Benjamin,O,USA,27.0,203.0,2021,Russia,USA,2021-06-03,False,0,2,2,4,0,0,1,1,4,3,7,14,0,0,1,1,0,0,0,0,2,1,0,3
136074.0,Patch Benjamin,O,USA,27.0,203.0,2021,Poland,USA,2021-06-04,False,0,0,7,7,0,0,0,0,5,3,6,14,0,0,1,1,0,0,1,1,3,2,0,5
136074.0,Patch Benjamin,O,USA,27.0,203.0,2021,USA,Australia,2021-06-05,False,0,0,0,0,0,0,0,0,0,0,0,0,0,0,0,0,0,0,0,0,0,0,0,0
136074.0,Patch Benjamin,O,USA,27.0,203.0,2021,Iran,USA,2021-06-09,False,0,5,5,10,0,0,1,1,14,3,9,26,0,2,1,3,0,0,0,0,4,2,2,8
136074.0,Patch Benjamin,O,USA,27.0,203.0,2021,Germany,USA,2021-06-10,False,0,1,0,1,0,0,0,0,1,0,1,2,1,1,0,2,0,0,0,0,1,0,0,1
136074.0,Patch Benjamin,O,USA,27.0,203.0,2021,USA,Serbia,2021-06-11,False,1,3,4,8,0,0,1,1,10,2,2,14,0,3,0,3,0,0,0,0,2,2,0,4
147725.0,Sander Brenden,OH,USA,26.0,193.0,2021,USA,Canada,2021-05-28,False,0,0,0,0,0,0,0,0,0,0,0,0,0,0,0,0,0,0,0,0,0,0,0,0
147725.0,Sander Brenden,OH,USA,26.0,193.0,2021,USA,Brazil,2021-05-29,False,0,0,0,0,0,0,0,0,0,0,0,0,0,0,0,0,0,0,0,0,0,0,0,0
147725.0,Sander Brenden,OH,USA,26.0,193.0,2021,USA,Argentina,2021-05-30,False,0,0,0,0,0,0,0,0,0,0,0,0,0,0,0,0,0,0,0,0,0,0,0,0
147725.0,Sander Brenden,OH,USA,26.0,193.0,2021,Russia,USA,2021-06-03,False,0,0,0,0,0,0,0,0,0,0,0,0,0,0,0,0,0,0,0,0,0,0,0,0
147725.0,Sander Brenden,OH,USA,26.0,193.0,2021,Iran,USA,2021-06-09,False,1,1,5,7,0,0,1,1,0,2,1,3,0,1,0,1,3,0,3,6,0,0,0,0
147725.0,Sander Brenden,OH,USA,26.0,193.0,2021,Germany,USA,2021-06-10,False,1,5,4,10,0,0,2,2,9,4,10,23,2,2,2,6,3,3,9,15,3,0,1,4
147725.0,Sander Brenden,OH,USA,26.0,193.0,2021,USA,Serbia,2021-06-11,False,0,3,4,7,0,0,1,1,5,4,6,15,0,1,0,1,5,3,7,15,0,3,0,3
147725.0,Sander Brenden,OH,USA,26.0,193.0,2021,USA,France,2021-06-16,False,0,0,0,0,0,0,0,0,0,0,0,0,0,0,0,0,0,0,0,0,0,0,0,0
147725.0,Sander Brenden,OH,USA,26.0,193.0,2021,Slovenia,USA,2021-06-21,False,0,0,0,0,0,0,0,0,0,0,0,0,0,0,0,0,0,0,0,0,0,0,0,0
147725.0,Sander Brenden,OH,USA,26.0,193.0,2021,Bulgaria,USA,2021-06-22,False,0,0,0,0,0,0,0,0,0,0,0,0,0,0,0,0,0,0,0,0,0,0,0,0
147725.0,Sander Brenden,OH,USA,26.0,193.0,2021,USA,Japan,2021-06-23,False,0,0,0,0,0,0,0,0,0,0,0,0,0,0,0,0,0,0,0,0,0,0,0,0
147543.0,Tuaniga Joshua,S,USA,25.0,191.0,2021,USA,Argentina,2021-05-30,False,0,0,0,0,0,0,0,0,0,0,0,0,0,0,0,0,0,0,0,0,0,0,0,0
147543.0,Tuaniga Joshua,S,USA,25.0,191.0,2021,Poland,USA,2021-06-04,False,0,0,4,4,12,0,17,29,1,0,0,1,0,0,1,1,0,0,0,0,3,2,0,5
147543.0,Tuaniga Joshua,S,USA,25.0,191.0,2021,Iran,USA,2021-06-09,False,0,0,0,0,0,0,1,1,0,0,0,0,0,0,0,0,0,0,1,1,0,0,0,0
147543.0,Tuaniga Joshua,S,USA,25.0,191.0,2021,Germany,USA,2021-06-10,False,0,0,0,0,2,0,2,4,1,0,0,1,0,0,0,0,0,0,0,0,0,0,0,0
147543.0,Tuaniga Joshua,S,USA,25.0,191.0,2021,USA,Serbia,2021-06-11,False,0,4,13,17,25,0,63,88,2,1,1,4,0,3,1,4,0,0,0,0,4,1,0,5
143682.0,Jaeschke Thomas,OH,USA,28.0,198.0,2021,USA,Canada,2021-05-28,False,0,0,0,0,0,0,0,0,0,0,0,0,0,0,0,0,0,0,0,0,0,0,0,0
143682.0,Jaeschke Thomas,OH,USA,28.0,198.0,2021,USA,Brazil,2021-05-29,False,0,1,4,5,0,0,0,0,4,3,6,13,1,1,0,2,8,1,8,17,0,0,0,0
143682.0,Jaeschke Thomas,OH,USA,28.0,198.0,2021,USA,Argentina,2021-05-30,False,0,0,0,0,0,0,0,0,0,0,0,0,0,0,0,0,0,0,0,0,0,0,0,0
143682.0,Jaeschke Thomas,OH,USA,28.0,198.0,2021,Russia,USA,2021-06-03,False,1,2,12,15,0,0,2,2,14,2,5,21,1,2,2,5,5,1,15,21,6,7,2,15
143682.0,Jaeschke Thomas,OH,USA,28.0,198.0,2021,Poland,USA,2021-06-04,False,0,2,1,3,0,0,0,0,2,0,3,5,0,1,0,1,2,0,2,4,0,3,0,3
143682.0,Jaeschke Thomas,OH,USA,28.0,198.0,2021,USA,Australia,2021-06-05,False,3,1,11,15,0,0,1,1,4,3,8,15,1,1,0,2,11,0,17,28,1,1,1,3
143682.0,Jaeschke Thomas,OH,USA,28.0,198.0,2021,Italy,USA,2021-06-15,False,0,0,0,0,0,0,0,0,0,0,0,0,0,0,0,0,0,0,0,0,0,0,0,0
143682.0,Jaeschke Thomas,OH,USA,28.0,198.0,2021,USA,France,2021-06-16,False,0,0,15,15,0,0,2,2,12,5,13,30,1,5,5,11,13,2,14,29,6,2,1,9
143682.0,Jaeschke Thomas,OH,USA,28.0,198.0,2021,Netherlands,USA,2021-06-17,False,0,0,0,0,0,0,0,0,0,0,0,0,0,0,0,0,0,0,0,0,0,0,0,0
143682.0,Jaeschke Thomas,OH,USA,28.0,198.0,2021,Slovenia,USA,2021-06-21,False,0,0,0,0,0,0,0,0,0,0,0,0,0,0,0,0,0,1,0,1,0,0,0,0
143682.0,Jaeschke Thomas,OH,USA,28.0,198.0,2021,Bulgaria,USA,2021-06-22,False,1,3,7,11,0,0,2,2,7,1,10,18,2,2,3,7,6,0,11,17,9,5,0,14
143682.0,Jaeschke Thomas,OH,USA,28.0,198.0,2021,USA,Japan,2021-06-23,False,0,0,0,0,0,0,0,0,0,0,0,0,0,0,0,0,0,0,0,0,0,0,0,0
133463.0,Muagututia Garrett,OH,USA,34.0,205.0,2021,USA,Canada,2021-05-28,False,0,2,10,12,0,0,0,0,5,2,8,15,0,0,0,0,10,2,12,24,4,2,0,6
133463.0,Muagututia Garrett,OH,USA,34.0,205.0,2021,USA,Brazil,2021-05-29,False,0,0,2,2,0,0,0,0,0,1,3,4,0,0,0,0,0,1,2,3,0,0,0,0
133463.0,Muagututia Garrett,OH,USA,34.0,205.0,2021,USA,Argentina,2021-05-30,False,1,2,12,15,0,0,5,5,5,5,11,21,0,2,1,3,7,0,7,14,9,4,2,15
133463.0,Muagututia Garrett,OH,USA,34.0,205.0,2021,Russia,USA,2021-06-03,False,0,0,0,0,0,0,0,0,0,0,0,0,0,0,0,0,0,0,0,0,0,0,0,0
133463.0,Muagututia Garrett,OH,USA,34.0,205.0,2021,Poland,USA,2021-06-04,False,1,1,6,8,0,0,1,1,2,2,8,12,0,1,2,3,5,1,8,14,5,1,0,6
133463.0,Muagututia Garrett,OH,USA,34.0,205.0,2021,USA,Australia,2021-06-05,False,0,1,1,2,0,0,0,0,0,0,0,0,0,0,0,0,0,0,0,0,0,0,0,0
133463.0,Muagututia Garrett,OH,USA,34.0,205.0,2021,Iran,USA,2021-06-09,False,0,0,12,12,0,0,1,1,11,2,6,19,1,4,1,6,8,4,14,26,9,1,1,11
133463.0,Muagututia Garrett,OH,USA,34.0,205.0,2021,Germany,USA,2021-06-10,False,2,2,14,18,0,0,1,1,9,0,6,15,1,2,2,5,2,1,9,12,3,2,0,5
133463.0,Muagututia Garrett,OH,USA,34.0,205.0,2021,USA,Serbia,2021-06-11,False,0,2,7,9,0,0,0,0,4,1,7,12,1,1,0,2,12,1,5,18,2,2,0,4
133463.0,Muagututia Garrett,OH,USA,34.0,205.0,2021,Italy,USA,2021-06-15,False,0,1,0,1,0,0,0,0,0,0,0,0,0,0,0,0,0,0,0,0,0,0,0,0
133463.0,Muagututia Garrett,OH,USA,34.0,205.0,2021,USA,France,2021-06-16,False,0,0,2,2,0,0,0,0,0,0,0,0,0,0,0,0,0,0,0,0,0,0,0,0
133463.0,Muagututia Garrett,OH,USA,34.0,205.0,2021,Netherlands,USA,2021-06-17,False,3,4,15,22,0,0,0,0,17,3,10,30,1,2,3,6,13,3,12,28,7,1,0,8
133463.0,Muagututia Garrett,OH,USA,34.0,205.0,2021,Slovenia,USA,2021-06-21,False,1,1,3,5,0,0,0,0,0,0,1,1,0,1,0,1,0,0,1,1,1,0,0,1
133463.0,Muagututia Garrett,OH,USA,34.0,205.0,2021,Bulgaria,USA,2021-06-22,False,0,3,6,9,0,0,1,1,13,2,8,23,0,0,3,3,7,0,7,14,6,1,1,8
133463.0,Muagututia Garrett,OH,USA,34.0,205.0,2021,USA,Japan,2021-06-23,False,0,2,7,9,0,0,3,3,12,1,3,16,0,2,0,2,13,1,12,26,4,6,0,10
148120.0,Averill Taylor,MB,USA,30.0,201.0,2021,USA,Canada,2021-05-28,False,0,1,14,15,0,0,0,0,8,0,4,12,1,3,0,4,0,0,0,0,2,1,0,3
148120.0,Averill Taylor,MB,USA,30.0,201.0,2021,USA,Argentina,2021-05-30,False,0,0,0,0,0,0,0,0,0,0,0,0,0,0,0,0,0,0,0,0,0,0,0,0
148120.0,Averill Taylor,MB,USA,30.0,201.0,2021,Russia,USA,2021-06-03,False,0,0,8,8,0,0,1,1,4,0,2,6,1,1,0,2,0,0,0,0,1,0,1,2
148120.0,Averill Taylor,MB,USA,30.0,201.0,2021,Poland,USA,2021-06-04,False,0,0,3,3,0,0,1,1,3,1,0,4,1,0,1,2,0,0,0,0,0,0,1,1
148120.0,Averill Taylor,MB,USA,30.0,201.0,2021,USA,Australia,2021-06-05,False,0,0,0,0,0,0,0,0,0,0,0,0,0,0,0,0,0,0,0,0,0,0,0,0
148120.0,Averill Taylor,MB,USA,30.0,201.0,2021,Iran,USA,2021-06-09,False,0,3,8,11,0,0,0,0,2,2,1,5,1,3,2,6,0,0,1,1,2,0,1,3
148120.0,Averill Taylor,MB,USA,30.0,201.0,2021,USA,Serbia,2021-06-11,False,0,0,0,0,0,0,0,0,0,0,0,0,0,0,0,0,0,0,0,0,0,0,0,0
116069.0,Smith David,MB,USA,36.0,201.0,2021,USA,Canada,2021-05-28,False,0,0,0,0,0,0,0,0,0,0,0,0,0,0,0,0,0,0,0,0,0,0,0,0
116069.0,Smith David,MB,USA,36.0,201.0,2021,USA,Brazil,2021-05-29,False,0,0,0,0,0,0,0,0,0,0,0,0,0,0,0,0,0,0,0,0,0,0,0,0
116069.0,Smith David,MB,USA,36.0,201.0,2021,USA,Argentina,2021-05-30,False,0,5,6,11,0,0,1,1,8,2,4,14,0,0,1,1,0,0,0,0,1,0,0,1
116069.0,Smith David,MB,USA,36.0,201.0,2021,Russia,USA,2021-06-03,False,0,1,5,6,0,0,0,0,2,1,2,5,0,2,1,3,0,0,0,0,2,1,0,3
116069.0,Smith David,MB,USA,36.0,201.0,2021,USA,Australia,2021-06-05,False,1,2,9,12,0,0,0,0,5,0,0,5,3,2,3,8,0,0,0,0,3,0,1,4
116069.0,Smith David,MB,USA,36.0,201.0,2021,Iran,USA,2021-06-09,False,0,0,0,0,0,0,0,0,0,0,0,0,0,0,0,0,0,0,0,0,0,0,0,0
116069.0,Smith David,MB,USA,36.0,201.0,2021,Germany,USA,2021-06-10,False,1,3,7,11,0,0,2,2,3,1,4,8,1,2,4,7,1,0,0,1,4,0,0,4
116069.0,Smith David,MB,USA,36.0,201.0,2021,USA,Serbia,2021-06-11,False,4,2,11,17,0,0,0,0,4,1,4,9,1,3,1,5,1,0,3,4,1,1,0,2
116069.0,Smith David,MB,USA,36.0,201.0,2021,Italy,USA,2021-06-15,False,1,1,13,15,0,0,0,0,3,0,2,5,2,1,3,6,1,0,0,1,5,2,0,7
116069.0,Smith David,MB,USA,36.0,201.0,2021,USA,France,2021-06-16,False,0,0,0,0,0,0,0,0,0,0,0,0,0,0,0,0,0,0,0,0,0,0,0,0
116069.0,Smith David,MB,USA,36.0,201.0,2021,Netherlands,USA,2021-06-17,False,1,4,13,18,0,0,3,3,8,1,1,10,0,6,6,12,1,0,1,2,4,0,1,5
116069.0,Smith David,MB,USA,36.0,201.0,2021,Slovenia,USA,2021-06-21,False,1,1,12,14,0,0,2,2,4,4,3,11,1,6,4,11,0,0,0,0,5,0,1,6
116069.0,Smith David,MB,USA,36.0,201.0,2021,Bulgaria,USA,2021-06-22,False,0,0,0,0,0,0,0,0,0,0,0,0,0,0,0,0,0,0,0,0,0,0,0,0
116069.0,Smith David,MB,USA,36.0,201.0,2021,USA,Japan,2021-06-23,False,0,4,8,12,0,0,4,4,5,0,6,11,1,4,2,7,0,0,0,0,3,0,0,3
133895.0,Watten Dustin,L,USA,35.0,182.0,2021,USA,Canada,2021-05-28,False,0,0,0,0,0,0,0,0,0,0,0,0,0,0,0,0,0,0,0,0,0,0,0,0
133895.0,Watten Dustin,L,USA,35.0,182.0,2021,USA,Brazil,2021-05-29,False,0,0,0,0,0,0,0,0,0,0,0,0,0,0,0,0,0,0,0,0,0,0,0,0
133895.0,Watten Dustin,L,USA,35.0,182.0,2021,USA,Argentina,2021-05-30,False,0,0,0,0,0,0,0,0,0,0,0,0,0,0,0,0,0,0,0,0,0,0,0,0
133895.0,Watten Dustin,L,USA,35.0,182.0,2021,Russia,USA,2021-06-03,False,0,0,0,0,0,0,0,0,0,0,0,0,0,0,0,0,0,0,0,0,0,0,0,0
133895.0,Watten Dustin,L,USA,35.0,182.0,2021,Poland,USA,2021-06-04,False,0,0,0,0,0,0,0,0,0,0,0,0,0,0,0,0,0,0,0,0,0,0,0,0
133895.0,Watten Dustin,L,USA,35.0,182.0,2021,USA,Australia,2021-06-05,False,0,0,0,0,0,0,8,8,0,0,0,0,0,0,0,0,3,1,10,14,7,2,0,9
133895.0,Watten Dustin,L,USA,35.0,182.0,2021,Germany,USA,2021-06-10,False,0,0,0,0,0,0,0,0,0,0,0,0,0,0,0,0,0,0,0,0,0,0,0,0
133895.0,Watten Dustin,L,USA,35.0,182.0,2021,USA,Serbia,2021-06-11,False,0,0,0,0,0,0,0,0,0,0,0,0,0,0,0,0,0,0,0,0,0,0,0,0
133895.0,Watten Dustin,L,USA,35.0,182.0,2021,Italy,USA,2021-06-15,False,0,0,0,0,0,0,0,0,0,0,0,0,0,0,0,0,0,0,0,0,0,0,0,0
133895.0,Watten Dustin,L,USA,35.0,182.0,2021,USA,France,2021-06-16,False,0,0,0,0,0,0,0,0,0,0,0,0,0,0,0,0,0,0,0,0,0,0,0,0
133895.0,Watten Dustin,L,USA,35.0,182.0,2021,Netherlands,USA,2021-06-17,False,0,0,0,0,0,0,2,2,0,0,0,0,0,0,0,0,3,1,5,9,7,3,1,11
119732.0,Shoji Erik,L,USA,32.0,184.0,2021,USA,Canada,2021-05-28,False,0,0,0,0,0,0,2,2,0,0,0,0,0,0,0,0,3,0,7,10,16,3,0,19
119732.0,Shoji Erik,L,USA,32.0,184.0,2021,USA,Brazil,2021-05-29,False,0,0,0,0,0,0,1,1,0,0,0,0,0,0,0,0,4,1,2,7,2,0,0,2
119732.0,Shoji Erik,L,USA,32.0,184.0,2021,USA,Argentina,2021-05-30,False,0,0,0,0,0,0,3,3,0,0,0,0,0,0,0,0,9,1,5,15,6,5,0,11
119732.0,Shoji Erik,L,USA,32.0,184.0,2021,Russia,USA,2021-06-03,False,0,0,0,0,0,0,5,5,0,0,0,0,0,0,0,0,10,0,17,27,8,2,1,11
119732.0,Shoji Erik,L,USA,32.0,184.0,2021,Poland,USA,2021-06-04,False,0,0,0,0,0,0,1,1,0,0,0,0,0,0,0,0,4,0,11,15,8,7,0,15
119732.0,Shoji Erik,L,USA,32.0,184.0,2021,USA,Australia,2021-06-05,False,0,0,0,0,0,0,0,0,0,0,0,0,0,0,0,0,0,0,0,0,0,0,0,0
119732.0,Shoji Erik,L,USA,32.0,184.0,2021,Iran,USA,2021-06-09,False,0,0,0,0,0,0,8,8,0,0,0,0,0,0,0,0,4,0,11,15,9,3,0,12
119732.0,Shoji Erik,L,USA,32.0,184.0,2021,Germany,USA,2021-06-10,False,0,0,0,0,0,0,5,5,0,0,0,0,0,0,0,0,5,0,7,12,6,1,0,7
119732.0,Shoji Erik,L,USA,32.0,184.0,2021,USA,Serbia,2021-06-11,False,0,0,0,0,0,0,3,3,0,0,0,0,0,0,0,0,12,0,10,22,1,5,0,6
119732.0,Shoji Erik,L,USA,32.0,184.0,2021,Italy,USA,2021-06-15,False,0,0,0,0,0,0,3,3,0,0,0,0,0,0,0,0,5,2,2,9,6,5,0,11
119732.0,Shoji Erik,L,USA,32.0,184.0,2021,USA,France,2021-06-16,False,0,0,0,0,0,0,8,8,0,0,0,0,0,0,0,0,8,1,12,21,14,3,0,17
119732.0,Shoji Erik,L,USA,32.0,184.0,2021,Netherlands,USA,2021-06-17,False,0,0,0,0,0,0,3,3,0,0,0,0,0,0,0,0,5,1,3,9,7,0,0,7
119732.0,Shoji Erik,L,USA,32.0,184.0,2021,Slovenia,USA,2021-06-21,False,0,0,0,0,0,0,7,7,0,0,0,0,0,0,0,0,2,0,12,14,9,0,0,9
119732.0,Shoji Erik,L,USA,32.0,184.0,2021,Bulgaria,USA,2021-06-22,False,0,0,0,0,0,0,6,6,0,0,0,0,0,0,0,0,3,0,7,10,8,3,0,11
119732.0,Shoji Erik,L,USA,32.0,184.0,2021,USA,Japan,2021-06-23,False,0,0,0,0,0,0,4,4,0,0,0,0,0,0,0,0,6,1,8,15,1,0,2,3
142412.0,Sanchez Matias,S,Argentina,26.0,175.0,2022,Poland,Argentina,2022-06-08,False,1,1,8,10,31,0,31,62,1,0,0,1,0,0,0,0,0,0,0,0,4,3,3,10
142412.0,Sanchez Matias,S,Argentina,26.0,175.0,2022,Germany,Argentina,2022-06-09,True,0,0,10,10,23,0,44,67,0,0,2,2,0,1,0,1,0,0,1,1,6,0,2,8
142412.0,Sanchez Matias,S,Argentina,26.0,175.0,2022,Serbia,Argentina,2022-06-10,False,0,0,4,4,27,0,19,46,0,1,0,1,1,0,0,1,0,0,0,0,3,0,0,3
142412.0,Sanchez Matias,S,Argentina,26.0,175.0,2022,Argentina,Italy,2022-06-12,False,0,1,9,10,47,0,30,77,0,0,1,1,0,4,0,4,0,0,0,0,7,0,4,11
142412.0,Sanchez Matias,S,Argentina,26.0,175.0,2022,Argentina,Japan,2022-06-21,False,0,2,13,15,25,0,44,69,1,0,0,1,0,1,0,1,0,0,1,1,4,0,1,5
142412.0,Sanchez Matias,S,Argentina,26.0,175.0,2022,Argentina,Slovenia,2022-06-23,False,0,2,6,8,25,0,42,67,1,1,0,2,1,1,1,3,0,0,0,0,7,2,0,9
142412.0,Sanchez Matias,S,Argentina,26.0,175.0,2022,Argentina,China,2022-06-24,True,0,0,17,17,36,0,41,77,1,0,0,1,0,1,1,2,0,0,0,0,6,1,1,8
142412.0,Sanchez Matias,S,Argentina,26.0,175.0,2022,Argentina,Netherlands,2022-06-25,False,0,1,14,15,35,0,59,94,1,0,1,2,0,3,7,10,0,1,1,2,4,7,4,15
142412.0,Sanchez Matias,S,Argentina,26.0,175.0,2022,Canada,Argentina,2022-07-05,True,0,0,0,0,0,0,7,7,0,0,0,0,0,0,0,0,0,0,0,0,0,0,0,0
142412.0,Sanchez Matias,S,Argentina,26.0,175.0,2022,Argentina,Australia,2022-07-08,True,0,0,0,0,0,0,0,0,0,0,0,0,0,0,0,0,0,0,0,0,0,0,0,0
142412.0,Sanchez Matias,S,Argentina,26.0,175.0,2022,France,Argentina,2022-07-09,True,0,0,3,3,1,0,1,2,0,0,0,0,0,0,0,0,0,0,0,0,0,0,0,0
142412.0,Sanchez Matias,S,Argentina,26.0,175.0,2022,USA,Argentina,2022-07-10,False,0,1,3,4,2,0,1,3,0,0,0,0,0,0,0,0,0,0,0,0,0,0,0,0
142411.0,Gallego Joaquin,MB,Argentina,26.0,204.0,2022,Poland,Argentina,2022-06-08,False,0,0,0,0,0,0,0,0,0,0,0,0,0,0,0,0,0,0,0,0,0,0,0,0
142411.0,Gallego Joaquin,MB,Argentina,26.0,204.0,2022,Germany,Argentina,2022-06-09,True,0,0,0,0,0,0,0,0,0,0,0,0,0,0,0,0,0,0,0,0,0,0,0,0
142411.0,Gallego Joaquin,MB,Argentina,26.0,204.0,2022,Serbia,Argentina,2022-06-10,False,0,0,0,0,0,0,0,0,0,0,0,0,0,0,0,0,0,0,0,0,0,0,0,0
142411.0,Gallego Joaquin,MB,Argentina,26.0,204.0,2022,Argentina,Italy,2022-06-12,False,0,3,10,13,0,0,0,0,3,0,2,5,5,3,1,9,1,0,1,2,1,0,2,3
142411.0,Gallego Joaquin,MB,Argentina,26.0,204.0,2022,Argentina,Japan,2022-06-21,False,0,0,4,4,0,0,0,0,0,2,2,4,1,3,3,7,0,0,0,0,1,0,0,1
142411.0,Gallego Joaquin,MB,Argentina,26.0,204.0,2022,Argentina,Slovenia,2022-06-23,False,0,0,0,0,0,0,0,0,0,0,0,0,0,0,0,0,0,0,0,0,0,0,0,0
142411.0,Gallego Joaquin,MB,Argentina,26.0,204.0,2022,Argentina,China,2022-06-24,True,0,0,0,0,0,0,0,0,0,0,0,0,0,0,0,0,0,0,0,0,0,0,0,0
142411.0,Gallego Joaquin,MB,Argentina,26.0,204.0,2022,Argentina,Netherlands,2022-06-25,False,0,0,0,0,0,0,0,0,0,0,0,0,0,0,0,0,0,0,0,0,0,0,0,0
142411.0,Gallego Joaquin,MB,Argentina,26.0,204.0,2022,Canada,Argentina,2022-07-05,True,0,0,0,0,0,0,0,0,0,0,0,0,0,0,0,0,0,0,0,0,0,0,0,0
142411.0,Gallego Joaquin,MB,Argentina,26.0,204.0,2022,Argentina,Australia,2022-07-08,True,0,1,16,17,0,0,0,0,10,0,7,17,5,3,5,13,0,0,0,0,1,2,0,3
142411.0,Gallego Joaquin,MB,Argentina,26.0,204.0,2022,France,Argentina,2022-07-09,True,0,2,5,7,0,0,1,1,5,1,4,10,1,2,4,7,0,0,1,1,2,0,1,3
142411.0,Gallego Joaquin,MB,Argentina,26.0,204.0,2022,USA,Argentina,2022-07-10,False,0,1,12,13,0,0,2,2,8,0,4,12,3,7,4,14,1,1,2,4,1,2,2,5
152692.0,Loser Agustin,MB,Argentina,25.0,198.0,2022,Poland,Argentina,2022-06-08,False,1,3,9,13,0,0,0,0,4,1,5,10,1,3,5,9,0,0,0,0,0,0,0,0
152692.0,Loser Agustin,MB,Argentina,25.0,198.0,2022,Germany,Argentina,2022-06-09,True,3,2,18,23,0,0,1,1,8,2,3,13,2,14,5,21,0,0,0,0,1,0,1,2
152692.0,Loser Agustin,MB,Argentina,25.0,198.0,2022,Serbia,Argentina,2022-06-10,False,0,0,0,0,0,0,0,0,0,0,0,0,0,0,0,0,0,0,0,0,0,0,0,0
152692.0,Loser Agustin,MB,Argentina,25.0,198.0,2022,Argentina,Italy,2022-06-12,False,2,6,14,22,0,0,2,2,12,2,7,21,2,7,9,18,1,0,3,4,4,0,4,8
152692.0,Loser Agustin,MB,Argentina,25.0,198.0,2022,Argentina,Japan,2022-06-21,False,0,3,11,14,0,0,1,1,8,1,3,12,3,7,10,20,1,0,2,3,3,2,2,7
152692.0,Loser Agustin,MB,Argentina,25.0,198.0,2022,Argentina,Slovenia,2022-06-23,False,1,4,9,14,0,0,1,1,6,2,7,15,5,5,4,14,2,0,0,2,3,0,1,4
152692.0,Loser Agustin,MB,Argentina,25.0,198.0,2022,Argentina,China,2022-06-24,True,0,4,13,17,0,0,2,2,12,1,5,18,1,8,3,12,1,0,0,1,2,0,1,3
152692.0,Loser Agustin,MB,Argentina,25.0,198.0,2022,Argentina,Netherlands,2022-06-25,False,0,4,10,14,0,0,1,1,10,1,4,15,6,7,6,19,1,0,5,6,1,1,0,2
152692.0,Loser Agustin,MB,Argentina,25.0,198.0,2022,Canada,Argentina,2022-07-05,True,0,4,14,18,0,1,0,1,11,2,6,19,1,4,1,6,1,0,1,2,0,0,1,1
152692.0,Loser Agustin,MB,Argentina,25.0,198.0,2022,Argentina,Australia,2022-07-08,True,0,2,4,6,0,0,0,0,5,2,1,8,2,2,2,6,0,0,0,0,2,0,0,2
152692.0,Loser Agustin,MB,Argentina,25.0,198.0,2022,France,Argentina,2022-07-09,True,1,5,10,16,0,0,4,4,10,0,3,13,1,6,5,12,1,0,1,2,1,1,0,2
152692.0,Loser Agustin,MB,Argentina,25.0,198.0,2022,USA,Argentina,2022-07-10,False,0,3,16,19,0,0,0,0,9,3,7,19,2,7,3,12,0,0,1,1,4,1,3,8
153053.0,Danani Santiago,L,Argentina,27.0,176.0,2022,Poland,Argentina,2022-06-08,False,0,0,0,0,0,0,9,9,0,0,0,0,0,0,0,0,6,1,10,17,4,3,2,9
153053.0,Danani Santiago,L,Argentina,27.0,176.0,2022,Germany,Argentina,2022-06-09,True,0,0,0,0,0,0,7,7,0,0,0,0,0,0,0,0,7,2,8,17,14,2,2,18
153053.0,Danani Santiago,L,Argentina,27.0,176.0,2022,Serbia,Argentina,2022-06-10,False,0,0,0,0,0,0,4,4,0,0,0,0,0,0,0,0,3,0,19,22,6,1,4,11
153053.0,Danani Santiago,L,Argentina,27.0,176.0,2022,Argentina,Italy,2022-06-12,False,0,0,0,0,0,0,5,5,0,0,0,0,0,0,0,0,6,1,13,20,11,5,6,22
153053.0,Danani Santiago,L,Argentina,27.0,176.0,2022,Argentina,Japan,2022-06-21,False,0,0,0,0,0,0,2,2,0,0,0,0,0,0,0,0,4,2,10,16,12,3,0,15
153053.0,Danani Santiago,L,Argentina,27.0,176.0,2022,Argentina,Slovenia,2022-06-23,False,0,0,0,0,1,1,7,9,0,0,0,0,0,0,0,0,7,1,8,16,12,10,1,23
153053.0,Danani Santiago,L,Argentina,27.0,176.0,2022,Argentina,China,2022-06-24,True,0,0,0,0,1,0,9,10,0,0,0,0,0,0,0,0,12,0,12,24,11,3,1,15
153053.0,Danani Santiago,L,Argentina,27.0,176.0,2022,Argentina,Netherlands,2022-06-25,False,0,0,0,0,0,0,3,3,0,0,0,0,0,0,0,0,8,2,6,16,12,7,0,19
153053.0,Danani Santiago,L,Argentina,27.0,176.0,2022,Canada,Argentina,2022-07-05,True,0,0,0,0,0,0,3,3,0,0,0,0,0,0,0,0,7,0,6,13,5,7,2,14
153053.0,Danani Santiago,L,Argentina,27.0,176.0,2022,Argentina,Australia,2022-07-08,True,0,0,0,0,0,0,6,6,0,0,0,0,0,0,0,0,13,0,2,15,10,1,1,12
153053.0,Danani Santiago,L,Argentina,27.0,176.0,2022,France,Argentina,2022-07-09,True,0,0,0,0,0,0,8,8,0,0,0,0,0,0,0,0,3,0,13,16,8,6,3,17
153053.0,Danani Santiago,L,Argentina,27.0,176.0,2022,USA,Argentina,2022-07-10,False,0,0,0,0,0,0,6,6,0,0,0,0,0,0,0,0,11,1,9,21,12,4,2,18
136737.0,Lazo Nicolás,OH,Argentina,27.0,192.0,2022,Poland,Argentina,2022-06-08,False,1,1,7,9,0,0,1,1,9,3,13,25,0,0,4,4,1,0,13,14,7,3,0,10
136737.0,Lazo Nicolás,OH,Argentina,27.0,192.0,2022,Germany,Argentina,2022-06-09,True,0,1,16,17,0,0,4,4,10,2,6,18,0,3,2,5,3,5,12,20,5,0,1,6
136737.0,Lazo Nicolás,OH,Argentina,27.0,192.0,2022,Serbia,Argentina,2022-06-10,False,0,0,2,2,0,0,1,1,1,0,0,1,0,0,0,0,1,3,3,7,0,0,0,0
136737.0,Lazo Nicolás,OH,Argentina,27.0,192.0,2022,Argentina,Italy,2022-06-12,False,0,1,5,6,0,0,2,2,3,0,4,7,0,0,2,2,0,0,4,4,2,1,2,5
136737.0,Lazo Nicolás,OH,Argentina,27.0,192.0,2022,Argentina,Japan,2022-06-21,False,1,3,14,18,0,0,5,5,7,2,6,15,0,2,1,3,7,0,11,18,1,3,0,4
136737.0,Lazo Nicolás,OH,Argentina,27.0,192.0,2022,Argentina,Slovenia,2022-06-23,False,0,0,1,1,0,0,0,0,0,0,0,0,0,0,0,0,0,0,0,0,0,0,0,0
136737.0,Lazo Nicolás,OH,Argentina,27.0,192.0,2022,Argentina,China,2022-06-24,True,0,0,0,0,0,0,0,0,0,0,0,0,0,0,0,0,0,0,0,0,0,0,0,0
136737.0,Lazo Nicolás,OH,Argentina,27.0,192.0,2022,Argentina,Netherlands,2022-06-25,False,0,0,2,2,0,0,0,0,0,0,0,0,0,0,0,0,0,0,0,0,1,0,0,1
136737.0,Lazo Nicolás,OH,Argentina,27.0,192.0,2022,Canada,Argentina,2022-07-05,True,0,1,1,2,0,0,0,0,0,0,0,0,0,0,0,0,0,0,0,0,0,0,0,0
136737.0,Lazo Nicolás,OH,Argentina,27.0,192.0,2022,Argentina,Australia,2022-07-08,True,0,0,0,0,0,0,0,0,0,0,0,0,0,0,0,0,0,0,0,0,0,0,0,0
136737.0,Lazo Nicolás,OH,Argentina,27.0,192.0,2022,France,Argentina,2022-07-09,True,0,0,0,0,0,0,0,0,0,0,0,0,0,0,0,0,0,0,0,0,0,0,0,0
136737.0,Lazo Nicolás,OH,Argentina,27.0,192.0,2022,USA,Argentina,2022-07-10,False,0,0,0,0,0,0,0,0,0,0,0,0,0,0,0,0,0,0,0,0,0,0,0,0
174853.0,Armoa Manuel,OH,Argentina,20.0,195.0,2022,Poland,Argentina,2022-06-08,False,0,0,4,4,0,0,0,0,3,0,2,5,0,3,0,3,2,1,7,10,1,3,0,4
174853.0,Armoa Manuel,OH,Argentina,20.0,195.0,2022,Germany,Argentina,2022-06-09,True,0,1,2,3,0,0,0,0,1,3,5,9,2,1,1,4,1,0,4,5,0,1,1,2
174853.0,Armoa Manuel,OH,Argentina,20.0,195.0,2022,Serbia,Argentina,2022-06-10,False,2,2,9,13,1,0,3,4,8,5,8,21,3,3,1,7,5,0,15,20,1,1,2,4
174853.0,Armoa Manuel,OH,Argentina,20.0,195.0,2022,Argentina,Italy,2022-06-12,False,0,0,2,2,0,0,1,1,1,4,3,8,1,0,0,1,3,1,3,7,0,2,0,2
174853.0,Armoa Manuel,OH,Argentina,20.0,195.0,2022,Argentina,Japan,2022-06-21,False,0,0,0,0,0,0,0,0,0,0,0,0,0,0,0,0,0,0,0,0,0,0,0,0
174853.0,Armoa Manuel,OH,Argentina,20.0,195.0,2022,Argentina,Slovenia,2022-06-23,False,0,0,4,4,0,0,0,0,2,3,3,8,1,0,1,2,1,1,4,6,2,1,0,3
174853.0,Armoa Manuel,OH,Argentina,20.0,195.0,2022,Argentina,China,2022-06-24,True,0,0,0,0,0,0,0,0,0,0,0,0,0,0,0,0,0,0,0,0,0,0,0,0
174853.0,Armoa Manuel,OH,Argentina,20.0,195.0,2022,Argentina,Netherlands,2022-06-25,False,0,0,0,0,0,0,0,0,0,0,0,0,0,0,0,0,0,0,0,0,0,0,0,0
174853.0,Armoa Manuel,OH,Argentina,20.0,195.0,2022,Canada,Argentina,2022-07-05,True,0,0,0,0,0,0,0,0,1,1,1,3,0,0,0,0,0,0,0,0,0,0,0,0
174853.0,Armoa Manuel,OH,Argentina,20.0,195.0,2022,Argentina,Australia,2022-07-08,True,0,0,3,3,0,0,0,0,2,3,4,9,0,0,0,0,3,0,5,8,1,0,1,2
174853.0,Armoa Manuel,OH,Argentina,20.0,195.0,2022,France,Argentina,2022-07-09,True,0,0,0,0,0,0,2,2,0,0,1,1,0,0,0,0,0,0,0,0,0,0,0,0
174853.0,Armoa Manuel,OH,Argentina,20.0,195.0,2022,USA,Argentina,2022-07-10,False,0,1,2,3,0,0,2,2,4,2,4,10,0,1,0,1,4,0,5,9,1,1,1,3
142415.0,Lima Bruno,O,Argentina,27.0,198.0,2022,Poland,Argentina,2022-06-08,False,0,5,8,13,0,0,1,1,7,3,12,22,1,3,5,9,0,0,1,1,2,2,0,4
142415.0,Lima Bruno,O,Argentina,27.0,198.0,2022,Germany,Argentina,2022-06-09,True,1,4,11,16,0,0,1,1,16,5,10,31,2,4,0,6,0,0,1,1,2,5,2,9
142415.0,Lima Bruno,O,Argentina,27.0,198.0,2022,Serbia,Argentina,2022-06-10,False,2,4,6,12,0,0,1,1,11,7,12,30,2,2,2,6,1,0,0,1,3,4,1,8
142415.0,Lima Bruno,O,Argentina,27.0,198.0,2022,Argentina,Italy,2022-06-12,False,0,5,9,14,0,0,2,2,17,6,11,34,1,7,4,12,0,2,2,4,2,1,6,9
142415.0,Lima Bruno,O,Argentina,27.0,198.0,2022,Argentina,Japan,2022-06-21,False,0,7,6,13,0,0,0,0,17,4,9,30,1,2,0,3,0,1,1,2,3,1,0,4
142415.0,Lima Bruno,O,Argentina,27.0,198.0,2022,Argentina,Slovenia,2022-06-23,False,1,5,7,13,0,0,0,0,11,5,13,29,0,2,2,4,2,0,3,5,6,0,1,7
142415.0,Lima Bruno,O,Argentina,27.0,198.0,2022,Argentina,China,2022-06-24,True,2,4,15,21,0,1,0,1,20,1,8,29,3,3,2,8,0,0,0,0,5,5,0,10
142415.0,Lima Bruno,O,Argentina,27.0,198.0,2022,Argentina,Netherlands,2022-06-25,False,1,6,12,19,0,0,0,0,19,3,9,31,1,7,2,10,0,1,0,1,6,2,1,9
142415.0,Lima Bruno,O,Argentina,27.0,198.0,2022,Canada,Argentina,2022-07-05,True,0,3,4,7,0,0,0,0,2,5,2,9,1,1,0,2,0,0,0,0,2,0,0,2
142415.0,Lima Bruno,O,Argentina,27.0,198.0,2022,Argentina,Australia,2022-07-08,True,3,3,10,16,1,0,0,1,16,5,3,24,0,6,3,9,0,0,0,0,6,5,1,12
142415.0,Lima Bruno,O,Argentina,27.0,198.0,2022,France,Argentina,2022-07-09,True,0,0,1,1,0,0,0,0,0,0,0,0,0,0,0,0,0,0,0,0,0,0,0,0
142415.0,Lima Bruno,O,Argentina,27.0,198.0,2022,USA,Argentina,2022-07-10,False,0,0,0,0,0,0,0,0,0,0,0,0,0,0,0,0,0,0,0,0,0,0,0,0
125048.0,Palacios Ezequiel,OH,Argentina,30.0,198.0,2022,Poland,Argentina,2022-06-08,False,0,1,4,5,0,0,3,3,4,2,7,13,1,2,0,3,0,1,12,13,2,3,1,6
125048.0,Palacios Ezequiel,OH,Argentina,30.0,198.0,2022,Germany,Argentina,2022-06-09,True,2,0,10,12,0,0,2,2,10,1,13,24,2,3,1,6,5,2,15,22,1,1,2,4
125048.0,Palacios Ezequiel,OH,Argentina,30.0,198.0,2022,Serbia,Argentina,2022-06-10,False,0,2,1,3,0,0,0,0,2,2,2,6,0,2,2,4,3,1,9,13,1,0,3,4
125048.0,Palacios Ezequiel,OH,Argentina,30.0,198.0,2022,Argentina,Italy,2022-06-12,False,0,3,11,14,1,0,3,4,7,0,7,14,0,5,4,9,0,0,10,10,7,1,3,11
125048.0,Palacios Ezequiel,OH,Argentina,30.0,198.0,2022,Argentina,Japan,2022-06-21,False,0,0,12,12,0,0,1,1,13,2,8,23,0,4,7,11,9,6,14,29,4,2,2,8
125048.0,Palacios Ezequiel,OH,Argentina,30.0,198.0,2022,Argentina,Slovenia,2022-06-23,False,0,4,10,14,0,0,3,3,11,3,10,24,1,4,4,9,9,3,16,28,6,3,1,10
125048.0,Palacios Ezequiel,OH,Argentina,30.0,198.0,2022,Argentina,China,2022-06-24,True,1,5,8,14,0,0,2,2,12,2,8,22,0,5,1,6,8,1,28,37,6,1,2,9
125048.0,Palacios Ezequiel,OH,Argentina,30.0,198.0,2022,Argentina,Netherlands,2022-06-25,False,3,5,11,19,0,0,3,3,15,2,10,27,1,2,5,8,11,2,13,26,2,4,0,6
125048.0,Palacios Ezequiel,OH,Argentina,30.0,198.0,2022,Canada,Argentina,2022-07-05,True,1,5,7,13,0,0,2,2,15,1,15,31,2,3,8,13,5,1,26,32,7,2,0,9
125048.0,Palacios Ezequiel,OH,Argentina,30.0,198.0,2022,Argentina,Australia,2022-07-08,True,1,3,8,12,0,0,1,1,10,3,3,16,1,2,0,3,7,2,15,24,6,2,4,12
125048.0,Palacios Ezequiel,OH,Argentina,30.0,198.0,2022,France,Argentina,2022-07-09,True,1,6,8,15,0,0,2,2,15,3,11,29,1,3,9,13,3,2,15,20,10,2,4,16
125048.0,Palacios Ezequiel,OH,Argentina,30.0,198.0,2022,USA,Argentina,2022-07-10,False,0,5,11,16,1,0,2,3,16,6,14,36,0,6,2,8,3,0,16,19,4,4,2,10
117457.0,De Cecco Luciano,S,Argentina,34.0,191.0,2022,Canada,Argentina,2022-07-05,True,1,4,14,19,28,0,63,91,0,0,0,0,1,2,3,6,0,0,0,0,5,0,0,5
117457.0,De Cecco Luciano,S,Argentina,34.0,191.0,2022,Argentina,Australia,2022-07-08,True,3,1,12,16,46,0,42,88,0,0,1,1,0,3,2,5,0,0,1,1,3,5,3,11
117457.0,De Cecco Luciano,S,Argentina,34.0,191.0,2022,France,Argentina,2022-07-09,True,0,3,9,12,28,0,60,88,2,1,1,4,0,2,2,4,0,0,0,0,4,3,2,9
117457.0,De Cecco Luciano,S,Argentina,34.0,191.0,2022,USA,Argentina,2022-07-10,False,1,3,19,23,55,1,53,109,0,1,2,3,2,5,5,12,0,0,0,0,3,0,2,5
162546.0,Palonsky Luciano,OH,Argentina,23.0,198.0,2022,Poland,Argentina,2022-06-08,False,0,1,0,1,0,0,0,0,0,0,0,0,0,0,0,0,0,0,0,0,0,0,0,0
162546.0,Palonsky Luciano,OH,Argentina,23.0,198.0,2022,Germany,Argentina,2022-06-09,True,0,0,0,0,0,0,0,0,0,0,0,0,0,0,0,0,0,0,0,0,0,0,0,0
162546.0,Palonsky Luciano,OH,Argentina,23.0,198.0,2022,Serbia,Argentina,2022-06-10,False,0,6,9,15,0,0,4,4,18,3,11,32,0,5,2,7,4,2,13,19,2,3,2,7
162546.0,Palonsky Luciano,OH,Argentina,23.0,198.0,2022,Argentina,Italy,2022-06-12,False,0,1,7,8,0,0,4,4,8,6,11,25,0,2,3,5,1,3,16,20,2,1,2,5
162546.0,Palonsky Luciano,OH,Argentina,23.0,198.0,2022,Argentina,Japan,2022-06-21,False,0,1,0,1,0,0,0,0,0,0,0,0,0,0,0,0,0,0,0,0,0,0,0,0
162546.0,Palonsky Luciano,OH,Argentina,23.0,198.0,2022,Argentina,Slovenia,2022-06-23,False,0,1,0,1,0,0,0,0,0,1,2,3,0,0,0,0,0,0,0,0,1,0,0,1
162546.0,Palonsky Luciano,OH,Argentina,23.0,198.0,2022,Argentina,China,2022-06-24,True,0,0,0,0,0,0,0,0,0,0,0,0,0,0,0,0,0,0,0,0,0,0,0,0
162546.0,Palonsky Luciano,OH,Argentina,23.0,198.0,2022,Argentina,Netherlands,2022-06-25,False,0,0,0,0,0,0,0,0,0,0,0,0,0,0,0,0,0,0,0,0,0,0,0,0
162546.0,Palonsky Luciano,OH,Argentina,23.0,198.0,2022,Canada,Argentina,2022-07-05,True,0,1,12,13,0,0,2,2,13,2,11,26,0,2,2,4,3,1,7,11,6,1,2,9
162546.0,Palonsky Luciano,OH,Argentina,23.0,198.0,2022,Argentina,Australia,2022-07-08,True,0,1,2,3,0,0,0,0,1,2,2,5,0,0,0,0,2,1,4,7,0,1,0,1
162546.0,Palonsky Luciano,OH,Argentina,23.0,198.0,2022,France,Argentina,2022-07-09,True,1,3,10,14,0,0,1,1,12,2,11,25,1,1,1,3,0,0,1,1,10,2,0,12
162546.0,Palonsky Luciano,OH,Argentina,23.0,198.0,2022,USA,Argentina,2022-07-10,False,0,5,9,14,0,0,1,1,24,3,10,37,0,4,2,6,2,0,7,9,6,3,1,10
163555.0,Vicentin Luciano,OH,Argentina,22.0,197.0,2022,Poland,Argentina,2022-06-08,False,0,0,0,0,0,0,0,0,0,0,0,0,0,0,0,0,0,0,0,0,0,0,0,0
163555.0,Vicentin Luciano,OH,Argentina,22.0,197.0,2022,Germany,Argentina,2022-06-09,True,0,0,0,0,0,0,0,0,0,0,0,0,0,0,0,0,0,0,0,0,0,0,0,0
163555.0,Vicentin Luciano,OH,Argentina,22.0,197.0,2022,Serbia,Argentina,2022-06-10,False,0,0,1,1,0,0,0,0,0,1,0,1,0,0,0,0,0,0,0,0,0,0,0,0
163555.0,Vicentin Luciano,OH,Argentina,22.0,197.0,2022,Argentina,Italy,2022-06-12,False,0,0,0,0,0,0,0,0,0,0,0,0,0,0,0,0,0,0,0,0,0,0,0,0
163555.0,Vicentin Luciano,OH,Argentina,22.0,197.0,2022,Argentina,Japan,2022-06-21,False,0,0,1,1,0,0,0,0,3,0,2,5,0,0,0,0,0,0,3,3,1,0,0,1
163555.0,Vicentin Luciano,OH,Argentina,22.0,197.0,2022,Argentina,Slovenia,2022-06-23,False,2,2,11,15,0,0,2,2,10,7,14,31,1,1,3,5,7,1,20,28,4,1,0,5
163555.0,Vicentin Luciano,OH,Argentina,22.0,197.0,2022,Argentina,China,2022-06-24,True,0,5,10,15,0,0,2,2,10,6,5,21,1,3,2,6,3,1,8,12,4,4,1,9
163555.0,Vicentin Luciano,OH,Argentina,22.0,197.0,2022,Argentina,Netherlands,2022-06-25,False,0,2,15,17,0,0,1,1,11,7,7,25,3,7,3,13,8,2,24,34,5,2,2,9
163555.0,Vicentin Luciano,OH,Argentina,22.0,197.0,2022,Canada,Argentina,2022-07-05,True,0,1,7,8,0,0,2,2,2,1,4,7,0,0,1,1,4,1,7,12,5,1,0,6
163555.0,Vicentin Luciano,OH,Argentina,22.0,197.0,2022,Argentina,Australia,2022-07-08,True,0,2,11,13,0,0,2,2,7,4,4,15,1,0,0,1,8,0,5,13,5,0,1,6
163555.0,Vicentin Luciano,OH,Argentina,22.0,197.0,2022,France,Argentina,2022-07-09,True,2,6,12,20,0,1,5,6,15,5,11,31,0,4,5,9,6,1,21,28,8,1,2,11
163555.0,Vicentin Luciano,OH,Argentina,22.0,197.0,2022,USA,Argentina,2022-07-10,False,1,5,7,13,0,0,4,4,5,3,8,16,0,1,0,1,8,1,20,29,4,2,0,6
125047.0,Ramos Martin,MB,Argentina,31.0,197.0,2022,Poland,Argentina,2022-06-08,False,0,1,7,8,0,0,0,0,2,0,2,4,1,1,2,4,0,0,0,0,3,0,2,5
125047.0,Ramos Martin,MB,Argentina,31.0,197.0,2022,Germany,Argentina,2022-06-09,True,0,0,0,0,0,0,0,0,0,0,0,0,0,0,0,0,0,0,0,0,0,0,0,0
125047.0,Ramos Martin,MB,Argentina,31.0,197.0,2022,Serbia,Argentina,2022-06-10,False,0,1,11,12,0,0,3,3,7,2,6,15,1,3,6,10,0,0,3,3,3,1,2,6
125047.0,Ramos Martin,MB,Argentina,31.0,197.0,2022,Argentina,Italy,2022-06-12,False,0,0,0,0,0,0,0,0,0,0,0,0,0,0,0,0,0,0,0,0,0,0,0,0
125047.0,Ramos Martin,MB,Argentina,31.0,197.0,2022,Argentina,Japan,2022-06-21,False,0,0,0,0,0,0,0,0,0,0,0,0,0,0,0,0,0,0,0,0,0,0,0,0
125047.0,Ramos Martin,MB,Argentina,31.0,197.0,2022,Argentina,Slovenia,2022-06-23,False,0,0,6,6,0,0,0,0,1,0,1,2,0,0,2,2,0,0,0,0,0,1,0,1
125047.0,Ramos Martin,MB,Argentina,31.0,197.0,2022,Argentina,China,2022-06-24,True,0,3,6,9,0,0,0,0,4,2,1,7,1,5,7,13,0,0,0,0,0,1,2,3
125047.0,Ramos Martin,MB,Argentina,31.0,197.0,2022,Argentina,Netherlands,2022-06-25,False,0,0,0,0,0,0,0,0,0,0,0,0,0,0,0,0,0,0,0,0,0,0,0,0
125047.0,Ramos Martin,MB,Argentina,31.0,197.0,2022,Canada,Argentina,2022-07-05,True,0,0,0,0,0,0,0,0,0,0,0,0,0,0,0,0,0,0,0,0,0,0,0,0
125047.0,Ramos Martin,MB,Argentina,31.0,197.0,2022,Argentina,Australia,2022-07-08,True,1,1,7,9,1,0,1,2,3,0,4,7,3,1,3,7,0,0,0,0,0,1,0,1
125047.0,Ramos Martin,MB,Argentina,31.0,197.0,2022,France,Argentina,2022-07-09,True,0,0,9,9,0,0,1,1,3,0,1,4,0,1,0,1,0,0,0,0,1,0,1,2
125047.0,Ramos Martin,MB,Argentina,31.0,197.0,2022,USA,Argentina,2022-07-10,False,0,0,0,0,0,0,0,0,0,0,0,0,0,0,0,0,0,0,0,0,1,0,0,1
135349.0,Massimino Franco,L,Argentina,34.0,177.0,2022,Poland,Argentina,2022-06-08,False,0,0,0,0,0,0,0,0,0,0,0,0,0,0,0,0,0,0,0,0,0,0,0,0
135349.0,Massimino Franco,L,Argentina,34.0,177.0,2022,Germany,Argentina,2022-06-09,True,0,0,0,0,0,0,0,0,0,0,0,0,0,0,0,0,0,0,0,0,0,0,0,0
135349.0,Massimino Franco,L,Argentina,34.0,177.0,2022,Serbia,Argentina,2022-06-10,False,0,0,0,0,0,0,0,0,0,0,0,0,0,0,0,0,0,0,0,0,0,0,0,0
135349.0,Massimino Franco,L,Argentina,34.0,177.0,2022,Argentina,Italy,2022-06-12,False,0,0,0,0,0,0,0,0,0,0,0,0,0,0,0,0,0,0,0,0,0,0,0,0
135349.0,Massimino Franco,L,Argentina,34.0,177.0,2022,Argentina,Japan,2022-06-21,False,0,0,0,0,0,0,0,0,0,0,0,0,0,0,0,0,0,0,0,0,0,0,0,0
135349.0,Massimino Franco,L,Argentina,34.0,177.0,2022,Argentina,Slovenia,2022-06-23,False,0,0,0,0,0,0,0,0,0,0,0,0,0,0,0,0,0,0,0,0,0,0,0,0
135349.0,Massimino Franco,L,Argentina,34.0,177.0,2022,Argentina,China,2022-06-24,True,0,0,0,0,0,0,0,0,0,0,0,0,0,0,0,0,0,0,0,0,0,0,0,0
135349.0,Massimino Franco,L,Argentina,34.0,177.0,2022,Argentina,Netherlands,2022-06-25,False,0,0,0,0,0,0,0,0,0,0,0,0,0,0,0,0,0,0,0,0,0,0,0,0
135349.0,Massimino Franco,L,Argentina,34.0,177.0,2022,Canada,Argentina,2022-07-05,True,0,0,0,0,0,0,0,0,0,0,0,0,0,0,0,0,0,0,0,0,0,0,0,0
135349.0,Massimino Franco,L,Argentina,34.0,177.0,2022,Argentina,Australia,2022-07-08,True,0,0,0,0,0,0,0,0,0,0,0,0,0,0,0,0,0,0,0,0,0,0,0,0
135349.0,Massimino Franco,L,Argentina,34.0,177.0,2022,France,Argentina,2022-07-09,True,0,0,0,0,0,0,0,0,0,0,0,0,0,0,0,0,0,0,0,0,1,0,0,1
135349.0,Massimino Franco,L,Argentina,34.0,177.0,2022,USA,Argentina,2022-07-10,False,0,0,0,0,0,0,0,0,0,0,0,0,0,0,0,0,0,0,0,0,0,0,0,0
162543.0,Zerba Nicolas,MB,Argentina,23.0,203.0,2022,Poland,Argentina,2022-06-08,False,0,1,2,3,0,0,1,1,1,1,2,4,2,4,2,8,0,0,2,2,0,1,2,3
162543.0,Zerba Nicolas,MB,Argentina,23.0,203.0,2022,Germany,Argentina,2022-06-09,True,0,1,7,8,0,0,0,0,2,1,0,3,1,3,11,15,1,0,0,1,0,1,4,5
162543.0,Zerba Nicolas,MB,Argentina,23.0,203.0,2022,Serbia,Argentina,2022-06-10,False,1,1,14,16,0,0,0,0,6,0,1,7,2,4,10,16,0,0,0,0,2,2,0,4
162543.0,Zerba Nicolas,MB,Argentina,23.0,203.0,2022,Argentina,Italy,2022-06-12,False,0,0,2,2,0,0,0,0,0,2,1,3,0,0,1,1,0,0,2,2,0,0,0,0
162543.0,Zerba Nicolas,MB,Argentina,23.0,203.0,2022,Argentina,Japan,2022-06-21,False,0,1,5,6,0,0,0,0,0,0,2,2,0,2,6,8,0,0,1,1,1,0,0,1
162543.0,Zerba Nicolas,MB,Argentina,23.0,203.0,2022,Argentina,Slovenia,2022-06-23,False,0,1,3,4,0,0,0,0,4,2,2,8,1,6,4,11,0,0,1,1,0,0,0,0
162543.0,Zerba Nicolas,MB,Argentina,23.0,203.0,2022,Argentina,China,2022-06-24,True,0,0,3,3,0,0,0,0,1,1,2,4,0,0,2,2,0,0,0,0,1,0,0,1
162543.0,Zerba Nicolas,MB,Argentina,23.0,203.0,2022,Argentina,Netherlands,2022-06-25,False,0,0,19,19,1,0,0,1,6,1,3,10,0,3,6,9,0,0,0,0,2,1,1,4
162543.0,Zerba Nicolas,MB,Argentina,23.0,203.0,2022,Canada,Argentina,2022-07-05,True,2,1,14,17,0,0,1,1,6,1,5,12,2,9,8,19,0,0,0,0,1,0,2,3
162543.0,Zerba Nicolas,MB,Argentina,23.0,203.0,2022,Argentina,Australia,2022-07-08,True,0,0,0,0,0,0,0,0,0,0,0,0,0,0,0,0,0,0,0,0,0,0,0,0
162543.0,Zerba Nicolas,MB,Argentina,23.0,203.0,2022,France,Argentina,2022-07-09,True,0,0,0,0,0,0,0,0,0,0,0,0,0,0,0,0,0,0,0,0,0,0,0,0
162543.0,Zerba Nicolas,MB,Argentina,23.0,203.0,2022,USA,Argentina,2022-07-10,False,0,0,0,0,0,0,0,0,0,0,0,0,0,0,0,0,0,0,0,0,0,0,0,0
142420.0,Giraudo Matias,S,Argentina,25.0,196.0,2022,Poland,Argentina,2022-06-08,False,0,1,0,1,0,0,6,6,0,0,0,0,0,0,2,2,0,0,0,0,0,0,0,0
142420.0,Giraudo Matias,S,Argentina,25.0,196.0,2022,Germany,Argentina,2022-06-09,True,0,3,0,3,3,0,9,12,0,0,1,1,1,0,0,1,0,0,0,0,1,2,1,4
142420.0,Giraudo Matias,S,Argentina,25.0,196.0,2022,Serbia,Argentina,2022-06-10,False,3,3,7,13,29,0,17,46,2,0,0,2,1,1,1,3,0,0,0,0,5,1,2,8
142420.0,Giraudo Matias,S,Argentina,25.0,196.0,2022,Argentina,Italy,2022-06-12,False,0,1,3,4,11,0,5,16,0,0,0,0,0,1,0,1,0,0,0,0,1,2,2,5
142420.0,Giraudo Matias,S,Argentina,25.0,196.0,2022,Argentina,Japan,2022-06-21,False,0,1,0,1,3,0,8,11,0,0,0,0,0,0,0,0,0,0,0,0,0,0,0,0
142420.0,Giraudo Matias,S,Argentina,25.0,196.0,2022,Argentina,Slovenia,2022-06-23,False,0,0,4,4,6,0,31,37,1,0,0,1,0,0,1,1,0,0,0,0,3,0,0,3
142420.0,Giraudo Matias,S,Argentina,25.0,196.0,2022,Argentina,China,2022-06-24,True,0,0,0,0,0,0,7,7,1,0,0,1,0,0,0,0,0,0,0,0,0,0,0,0
142420.0,Giraudo Matias,S,Argentina,25.0,196.0,2022,Argentina,Netherlands,2022-06-25,False,0,0,1,1,0,0,4,4,0,1,0,1,0,0,0,0,0,0,0,0,0,0,0,0
144457.0,Graham Beau,MB,Australia,28.0,203.0,2022,Netherlands,Australia,2022-06-12,False,0,1,9,10,2,0,0,2,0,0,1,1,0,2,3,5,0,1,0,1,0,1,0,1
144457.0,Graham Beau,MB,Australia,28.0,203.0,2022,Australia,Canada,2022-06-21,False,1,1,13,15,0,0,0,0,9,1,1,11,1,2,4,7,2,0,0,2,0,1,1,2
144457.0,Graham Beau,MB,Australia,28.0,203.0,2022,Australia,Bulgaria,2022-06-24,True,1,0,10,11,1,0,0,1,11,0,4,15,1,3,1,5,0,0,0,0,1,1,0,2
144457.0,Graham Beau,MB,Australia,28.0,203.0,2022,Poland,Australia,2022-06-25,False,0,0,5,5,0,0,0,0,1,3,3,7,2,2,0,4,0,0,0,0,0,0,0,0
144457.0,Graham Beau,MB,Australia,28.0,203.0,2022,Serbia,Australia,2022-06-26,False,0,1,6,7,0,0,0,0,2,0,1,3,0,2,0,2,0,0,0,0,1,2,0,3
144457.0,Graham Beau,MB,Australia,28.0,203.0,2022,Japan,Australia,2022-07-06,False,0,3,11,14,0,0,2,2,4,1,4,9,1,3,2,6,1,0,0,1,0,1,0,1
144457.0,Graham Beau,MB,Australia,28.0,203.0,2022,Germany,Australia,2022-07-07,False,2,3,11,16,0,0,2,2,4,2,0,6,1,2,4,7,1,0,3,4,2,4,1,7
144457.0,Graham Beau,MB,Australia,28.0,203.0,2022,Argentina,Australia,2022-07-08,False,0,1,12,13,0,0,1,1,7,1,4,12,2,4,4,10,0,0,0,0,1,0,2,3
144457.0,Graham Beau,MB,Australia,28.0,203.0,2022,Australia,France,2022-07-10,False,0,3,4,7,0,0,0,0,4,0,0,4,2,1,4,7,1,0,0,1,0,0,0,0
144456.0,Dosanjh Arshdeep,S,Australia,26.0,205.0,2022,Netherlands,Australia,2022-06-12,False,0,0,8,8,12,1,15,28,1,1,0,2,0,1,1,2,0,0,0,0,3,0,1,4
144456.0,Dosanjh Arshdeep,S,Australia,26.0,205.0,2022,Australia,Canada,2022-06-21,False,1,3,8,12,18,2,78,98,5,0,1,6,1,4,1,6,0,0,0,0,1,3,0,4
144456.0,Dosanjh Arshdeep,S,Australia,26.0,205.0,2022,Australia,Bulgaria,2022-06-24,True,2,2,20,24,19,2,91,112,2,1,1,4,3,2,2,7,0,0,0,0,1,4,1,6
144456.0,Dosanjh Arshdeep,S,Australia,26.0,205.0,2022,Poland,Australia,2022-06-25,False,0,0,0,0,0,0,0,0,0,0,0,0,0,0,0,0,0,0,0,0,0,0,0,0
144456.0,Dosanjh Arshdeep,S,Australia,26.0,205.0,2022,Serbia,Australia,2022-06-26,False,0,2,5,7,14,0,45,59,1,1,1,3,1,6,1,8,0,0,0,0,1,0,0,1
144456.0,Dosanjh Arshdeep,S,Australia,26.0,205.0,2022,Japan,Australia,2022-07-06,False,0,1,10,11,21,1,45,67,2,0,3,5,1,2,3,6,0,1,0,1,3,2,0,5
144456.0,Dosanjh Arshdeep,S,Australia,26.0,205.0,2022,Germany,Australia,2022-07-07,False,0,1,13,14,25,1,40,66,2,0,2,4,0,2,4,6,0,0,2,2,7,1,2,10
144456.0,Dosanjh Arshdeep,S,Australia,26.0,205.0,2022,Argentina,Australia,2022-07-08,False,0,0,0,0,0,0,0,0,0,0,0,0,0,0,0,0,0,0,0,0,0,0,0,0
144456.0,Dosanjh Arshdeep,S,Australia,26.0,205.0,2022,Australia,France,2022-07-10,False,1,0,4,5,9,1,20,30,0,0,2,2,0,1,0,1,0,0,0,0,1,2,0,3
174192.0,Pope Lorenzo,OH,Australia,21.0,205.0,2022,Netherlands,Australia,2022-06-12,False,1,4,6,11,1,0,2,3,16,2,5,23,1,6,0,7,1,5,8,14,3,0,0,3
174192.0,Pope Lorenzo,OH,Australia,21.0,205.0,2022,Australia,Canada,2022-06-21,False,0,3,11,14,0,0,1,1,13,5,17,35,2,1,2,5,6,2,12,20,4,4,1,9
174192.0,Pope Lorenzo,OH,Australia,21.0,205.0,2022,Australia,Bulgaria,2022-06-24,True,1,2,14,17,0,1,1,2,20,7,8,35,0,2,1,3,8,3,20,31,8,4,0,12
174192.0,Pope Lorenzo,OH,Australia,21.0,205.0,2022,Poland,Australia,2022-06-25,False,0,0,0,0,0,0,0,0,0,0,0,0,0,0,0,0,0,0,0,0,0,0,0,0
174192.0,Pope Lorenzo,OH,Australia,21.0,205.0,2022,Serbia,Australia,2022-06-26,False,0,3,6,9,0,0,0,0,11,4,4,19,2,0,2,4,10,1,16,27,0,2,0,2
174192.0,Pope Lorenzo,OH,Australia,21.0,205.0,2022,Japan,Australia,2022-07-06,False,0,4,8,12,0,0,2,2,21,5,6,32,1,2,2,5,13,4,19,36,5,2,0,7
174192.0,Pope Lorenzo,OH,Australia,21.0,205.0,2022,Germany,Australia,2022-07-07,False,0,5,11,16,1,0,4,5,16,3,7,26,1,3,3,7,10,3,23,36,3,0,3,6
174192.0,Pope Lorenzo,OH,Australia,21.0,205.0,2022,Argentina,Australia,2022-07-08,False,1,2,15,18,0,0,0,0,11,4,5,20,0,4,1,5,12,4,15,31,6,3,3,12
174192.0,Pope Lorenzo,OH,Australia,21.0,205.0,2022,Australia,France,2022-07-10,False,0,0,0,0,0,0,0,0,0,0,0,0,0,0,0,0,0,0,0,0,0,0,0,0
160879.0,Holland Jackson,L,Australia,24.0,186.0,2022,Netherlands,Australia,2022-06-12,False,0,0,0,0,0,0,0,0,0,0,0,0,0,0,0,0,0,0,0,0,0,0,0,0
160879.0,Holland Jackson,L,Australia,24.0,186.0,2022,Australia,Canada,2022-06-21,False,0,0,0,0,0,0,0,0,0,0,0,0,0,0,0,0,0,0,0,0,0,0,0,0
160879.0,Holland Jackson,L,Australia,24.0,186.0,2022,Australia,Bulgaria,2022-06-24,True,0,0,0,0,0,0,0,0,0,0,0,0,0,0,0,0,0,0,0,0,0,0,0,0
160879.0,Holland Jackson,L,Australia,24.0,186.0,2022,Poland,Australia,2022-06-25,False,0,0,0,0,0,0,0,0,0,0,0,0,0,0,0,0,0,2,3,5,0,0,0,0
160879.0,Holland Jackson,L,Australia,24.0,186.0,2022,Serbia,Australia,2022-06-26,False,0,0,0,0,0,0,0,0,0,0,0,0,0,0,0,0,0,0,0,0,0,0,0,0
160879.0,Holland Jackson,L,Australia,24.0,186.0,2022,Japan,Australia,2022-07-06,False,0,0,0,0,0,0,3,3,0,0,0,0,0,0,0,0,8,4,9,21,6,3,1,10
160879.0,Holland Jackson,L,Australia,24.0,186.0,2022,Germany,Australia,2022-07-07,False,0,0,0,0,0,0,7,7,0,0,0,0,0,0,0,0,7,1,8,16,4,5,3,12
160879.0,Holland Jackson,L,Australia,24.0,186.0,2022,Argentina,Australia,2022-07-08,False,0,0,0,0,0,0,1,1,0,0,0,0,0,0,0,0,13,1,17,31,7,2,1,10
160879.0,Holland Jackson,L,Australia,24.0,186.0,2022,Australia,France,2022-07-10,False,0,0,0,0,0,0,7,7,0,0,0,0,0,0,0,0,2,1,13,16,4,5,0,9
139052.0,Murch Malachi,OH,Australia,28.0,197.0,2022,Japan,Australia,2022-07-06,False,0,2,11,13,0,0,2,2,8,2,5,15,1,2,1,4,3,1,11,15,4,0,1,5
139052.0,Murch Malachi,OH,Australia,28.0,197.0,2022,Germany,Australia,2022-07-07,False,0,2,6,8,0,0,1,1,5,1,4,10,0,0,1,1,3,0,7,10,1,2,0,3
139052.0,Murch Malachi,OH,Australia,28.0,197.0,2022,Argentina,Australia,2022-07-08,False,0,3,8,11,1,0,0,1,13,4,13,30,3,3,2,8,4,3,11,18,4,2,4,10
139052.0,Murch Malachi,OH,Australia,28.0,197.0,2022,Australia,France,2022-07-10,False,0,1,1,2,0,0,3,3,0,1,2,3,0,0,0,0,0,1,3,4,1,0,1,2
162077.0,Weir James,MB,Australia,27.0,204.0,2022,Netherlands,Australia,2022-06-12,False,0,3,6,9,0,0,0,0,5,1,2,8,2,5,3,10,0,0,0,0,0,0,0,0
162077.0,Weir James,MB,Australia,27.0,204.0,2022,Australia,Canada,2022-06-21,False,2,1,10,13,0,0,2,2,10,1,6,17,2,3,4,9,0,0,1,1,0,1,0,1
162077.0,Weir James,MB,Australia,27.0,204.0,2022,Australia,Bulgaria,2022-06-24,True,1,2,16,19,0,0,0,0,11,0,5,16,3,2,7,12,0,1,3,4,2,0,1,3
162077.0,Weir James,MB,Australia,27.0,204.0,2022,Poland,Australia,2022-06-25,False,0,1,1,2,0,0,0,0,0,1,3,4,1,1,1,3,0,0,0,0,0,1,0,1
162077.0,Weir James,MB,Australia,27.0,204.0,2022,Serbia,Australia,2022-06-26,False,0,2,9,11,0,0,0,0,8,0,4,12,1,5,4,10,0,0,0,0,0,1,0,1
144464.0,O'Dea Trent,MB,Australia,28.0,201.0,2022,Netherlands,Australia,2022-06-12,False,0,0,0,0,0,0,0,0,0,0,0,0,0,0,0,0,0,0,0,0,0,0,0,0
144464.0,O'Dea Trent,MB,Australia,28.0,201.0,2022,Australia,Canada,2022-06-21,False,0,0,0,0,0,0,0,0,0,0,0,0,0,0,0,0,0,0,0,0,0,0,0,0
144464.0,O'Dea Trent,MB,Australia,28.0,201.0,2022,Australia,Bulgaria,2022-06-24,True,0,0,0,0,0,0,0,0,0,0,0,0,0,0,0,0,0,0,0,0,0,0,0,0
144464.0,O'Dea Trent,MB,Australia,28.0,201.0,2022,Poland,Australia,2022-06-25,False,0,0,9,9,0,0,1,1,5,2,3,10,1,1,1,3,2,0,2,4,0,0,0,0
144464.0,O'Dea Trent,MB,Australia,28.0,201.0,2022,Serbia,Australia,2022-06-26,False,0,1,3,4,0,0,1,1,2,0,1,3,0,3,1,4,0,0,1,1,0,0,0,0
144464.0,O'Dea Trent,MB,Australia,28.0,201.0,2022,Japan,Australia,2022-07-06,False,0,0,11,11,2,0,1,3,6,0,6,12,0,6,2,8,0,0,1,1,0,3,0,3
144464.0,O'Dea Trent,MB,Australia,28.0,201.0,2022,Germany,Australia,2022-07-07,False,1,2,12,15,0,0,5,5,7,3,1,11,3,1,4,8,0,0,2,2,2,2,0,4
144464.0,O'Dea Trent,MB,Australia,28.0,201.0,2022,Argentina,Australia,2022-07-08,False,0,0,13,13,0,0,4,4,4,1,4,9,1,3,3,7,1,0,0,1,1,0,2,3
144464.0,O'Dea Trent,MB,Australia,28.0,201.0,2022,Australia,France,2022-07-10,False,1,1,8,10,0,0,3,3,3,0,2,5,1,3,1,5,0,0,2,2,0,1,2,3
135532.0,Staples Max,OH,Australia,28.0,194.0,2022,Australia,Canada,2022-06-21,False,0,5,12,17,0,0,1,1,9,2,8,19,1,2,0,3,9,3,11,23,5,0,1,6
135532.0,Staples Max,OH,Australia,28.0,194.0,2022,Australia,Bulgaria,2022-06-24,True,1,4,14,19,0,0,2,2,10,9,14,33,1,3,0,4,5,2,17,24,0,2,1,3
135532.0,Staples Max,OH,Australia,28.0,194.0,2022,Poland,Australia,2022-06-25,False,0,0,0,0,0,0,0,0,0,0,0,0,0,0,0,0,0,0,0,0,0,0,0,0
135532.0,Staples Max,OH,Australia,28.0,194.0,2022,Serbia,Australia,2022-06-26,False,1,3,4,8,0,0,0,0,3,1,8,12,2,3,1,6,4,1,9,14,0,2,0,2
144578.0,Perry Luke,L,Australia,27.0,180.0,2022,Netherlands,Australia,2022-06-12,False,0,0,0,0,5,0,1,6,0,0,0,0,0,0,0,0,2,0,12,14,6,3,1,10
144578.0,Perry Luke,L,Australia,27.0,180.0,2022,Australia,Canada,2022-06-21,False,0,0,0,0,0,0,6,6,0,0,0,0,0,0,0,0,12,2,11,25,11,4,4,19
144578.0,Perry Luke,L,Australia,27.0,180.0,2022,Australia,Bulgaria,2022-06-24,True,0,0,0,0,1,0,3,4,0,0,0,0,0,0,0,0,6,1,16,23,5,4,1,10
144578.0,Perry Luke,L,Australia,27.0,180.0,2022,Poland,Australia,2022-06-25,False,0,0,0,0,0,0,4,4,0,0,0,0,0,0,0,0,6,0,2,8,6,3,3,12
144578.0,Perry Luke,L,Australia,27.0,180.0,2022,Serbia,Australia,2022-06-26,False,0,0,0,0,0,0,2,2,0,0,0,0,0,0,0,0,6,0,10,16,0,2,0,2
168641.0,Heptinstall Thomas,O,Australia,24.0,206.0,2022,Netherlands,Australia,2022-06-12,False,0,1,1,2,1,0,0,1,1,0,2,3,0,0,2,2,0,0,0,0,4,0,0,4
168641.0,Heptinstall Thomas,O,Australia,24.0,206.0,2022,Australia,Canada,2022-06-21,False,4,2,14,20,0,0,0,0,6,6,5,17,0,0,1,1,2,0,3,5,1,1,0,2
168641.0,Heptinstall Thomas,O,Australia,24.0,206.0,2022,Australia,Bulgaria,2022-06-24,True,1,4,12,17,0,0,1,1,7,5,11,23,0,2,0,2,0,0,4,4,3,1,2,6
168641.0,Heptinstall Thomas,O,Australia,24.0,206.0,2022,Poland,Australia,2022-06-25,False,0,1,6,7,0,0,0,0,8,3,13,24,0,0,0,0,0,0,3,3,2,1,0,3
168641.0,Heptinstall Thomas,O,Australia,24.0,206.0,2022,Serbia,Australia,2022-06-26,False,0,1,13,14,0,0,0,0,9,3,1,13,0,1,1,2,0,0,3,3,0,1,0,1
168641.0,Heptinstall Thomas,O,Australia,24.0,206.0,2022,Japan,Australia,2022-07-06,False,1,1,13,15,1,0,1,2,9,3,3,15,0,1,1,2,1,2,0,3,2,3,3,8
168641.0,Heptinstall Thomas,O,Australia,24.0,206.0,2022,Germany,Australia,2022-07-07,False,0,3,2,5,0,0,0,0,3,1,3,7,0,1,0,1,0,0,0,0,0,1,0,1
168641.0,Heptinstall Thomas,O,Australia,24.0,206.0,2022,Argentina,Australia,2022-07-08,False,0,1,0,1,0,0,0,0,0,1,0,1,0,0,0,0,0,0,0,0,0,1,0,1
168641.0,Heptinstall Thomas,O,Australia,24.0,206.0,2022,Australia,France,2022-07-10,False,0,2,7,9,0,1,3,4,5,2,5,12,0,0,1,1,0,0,4,4,4,1,0,5
162264.0,Hazelden Hamish,O,Australia,26.0,204.0,2022,Netherlands,Australia,2022-06-12,False,0,4,3,7,0,0,0,0,6,3,3,12,1,3,2,6,0,0,0,0,0,0,0,0
162264.0,Hazelden Hamish,O,Australia,26.0,204.0,2022,Australia,Canada,2022-06-21,False,0,0,0,0,0,0,0,0,0,0,0,0,0,0,0,0,0,0,0,0,0,0,0,0
162264.0,Hazelden Hamish,O,Australia,26.0,204.0,2022,Australia,Bulgaria,2022-06-24,True,0,0,0,0,0,0,0,0,0,0,0,0,0,0,0,0,0,0,0,0,0,0,0,0
162264.0,Hazelden Hamish,O,Australia,26.0,204.0,2022,Poland,Australia,2022-06-25,False,0,0,0,0,0,0,0,0,0,0,0,0,0,0,0,0,0,0,0,0,0,0,0,0
162264.0,Hazelden Hamish,O,Australia,26.0,204.0,2022,Serbia,Australia,2022-06-26,False,0,0,0,0,0,0,0,0,0,0,0,0,0,0,0,0,0,0,0,0,0,0,0,0
172376.0,McAinsh Conal Tain,MB,Australia,25.0,202.0,2022,Netherlands,Australia,2022-06-12,False,0,0,0,0,0,0,0,0,0,0,0,0,0,0,0,0,0,0,0,0,0,0,0,0
172376.0,McAinsh Conal Tain,MB,Australia,25.0,202.0,2022,Japan,Australia,2022-07-06,False,0,0,0,0,0,0,0,0,0,0,0,0,0,0,0,0,0,0,0,0,0,0,0,0
172376.0,McAinsh Conal Tain,MB,Australia,25.0,202.0,2022,Germany,Australia,2022-07-07,False,0,0,0,0,0,0,0,0,0,0,0,0,0,0,0,0,0,0,0,0,0,0,0,0
172376.0,McAinsh Conal Tain,MB,Australia,25.0,202.0,2022,Argentina,Australia,2022-07-08,False,0,0,0,0,0,0,0,0,0,0,0,0,0,0,0,0,0,0,0,0,0,0,0,0
172376.0,McAinsh Conal Tain,MB,Australia,25.0,202.0,2022,Australia,France,2022-07-10,False,0,0,0,0,0,0,0,0,0,0,0,0,0,0,0,0,0,0,0,0,0,0,0,0
181281.0,Phillips Korben,MB,Australia,21.0,197.0,2022,Japan,Australia,2022-07-06,False,0,0,0,0,,,,,0,0,0,0,0,0,0,0,0,0,0,0,0,0,0,0
181281.0,Phillips Korben,MB,Australia,21.0,197.0,2022,Germany,Australia,2022-07-07,False,0,0,0,0,,,,,0,0,0,0,0,0,0,0,0,0,0,0,0,0,0,0
181281.0,Phillips Korben,MB,Australia,21.0,197.0,2022,Argentina,Australia,2022-07-08,False,0,0,0,0,,,,,0,0,0,0,0,0,0,0,0,0,0,0,0,0,0,0
181281.0,Phillips Korben,MB,Australia,21.0,197.0,2022,Australia,France,2022-07-10,False,0,0,0,0,,,,,0,0,0,0,0,0,0,0,0,0,0,0,0,0,0,0
158841.0,Butler Nicholas,S,Australia,25.0,198.0,2022,Netherlands,Australia,2022-06-12,False,0,2,3,5,8,1,13,22,0,0,0,0,0,1,1,2,0,1,0,1,1,1,0,2
158841.0,Butler Nicholas,S,Australia,25.0,198.0,2022,Australia,Canada,2022-06-21,False,0,0,0,0,0,0,0,0,0,0,0,0,0,0,0,0,0,0,0,0,0,0,0,0
158841.0,Butler Nicholas,S,Australia,25.0,198.0,2022,Australia,Bulgaria,2022-06-24,True,0,0,0,0,0,0,0,0,0,0,0,0,0,0,0,0,0,0,0,0,0,0,0,0
158841.0,Butler Nicholas,S,Australia,25.0,198.0,2022,Poland,Australia,2022-06-25,False,1,2,4,7,20,0,55,75,0,0,2,2,0,1,0,1,0,0,0,0,1,2,0,3
158841.0,Butler Nicholas,S,Australia,25.0,198.0,2022,Serbia,Australia,2022-06-26,False,0,0,0,0,0,0,0,0,0,0,0,0,0,0,0,0,0,0,0,0,0,0,0,0
158841.0,Butler Nicholas,S,Australia,25.0,198.0,2022,Japan,Australia,2022-07-06,False,0,0,0,0,1,0,1,2,0,0,0,0,0,0,0,0,0,0,0,0,0,0,1,1
158841.0,Butler Nicholas,S,Australia,25.0,198.0,2022,Germany,Australia,2022-07-07,False,0,0,0,0,0,0,0,0,0,0,0,0,0,0,0,0,0,0,0,0,0,0,0,0
158841.0,Butler Nicholas,S,Australia,25.0,198.0,2022,Argentina,Australia,2022-07-08,False,2,4,9,15,32,1,51,84,0,0,1,1,0,2,2,4,0,0,0,0,0,3,1,4
158841.0,Butler Nicholas,S,Australia,25.0,198.0,2022,Australia,France,2022-07-10,False,0,2,4,6,4,0,9,13,1,0,0,1,0,1,0,1,0,0,1,1,2,0,0,2
178207.0,Flowerday Sam,OH,Australia,20.0,191.0,2022,Netherlands,Australia,2022-06-12,False,0,0,0,0,0,0,0,0,0,0,0,0,0,0,0,0,0,0,0,0,0,0,0,0
178207.0,Flowerday Sam,OH,Australia,20.0,191.0,2022,Australia,Canada,2022-06-21,False,0,1,0,1,0,0,0,0,0,0,0,0,0,0,0,0,0,0,0,0,0,0,0,0
178207.0,Flowerday Sam,OH,Australia,20.0,191.0,2022,Australia,Bulgaria,2022-06-24,True,0,0,1,1,0,0,0,0,0,0,0,0,0,0,0,0,0,0,0,0,0,0,0,0
178207.0,Flowerday Sam,OH,Australia,20.0,191.0,2022,Poland,Australia,2022-06-25,False,0,0,1,1,0,0,0,0,0,2,0,2,0,0,0,0,0,0,0,0,0,0,0,0
178207.0,Flowerday Sam,OH,Australia,20.0,191.0,2022,Serbia,Australia,2022-06-26,False,0,0,0,0,0,0,0,0,0,0,0,0,0,0,0,0,0,0,0,0,0,0,0,0
178207.0,Flowerday Sam,OH,Australia,20.0,191.0,2022,Japan,Australia,2022-07-06,False,0,0,0,0,0,0,0,0,0,0,0,0,0,0,0,0,0,0,0,0,0,0,0,0
178207.0,Flowerday Sam,OH,Australia,20.0,191.0,2022,Germany,Australia,2022-07-07,False,0,0,0,0,0,0,0,0,0,0,0,0,0,0,0,0,0,0,0,0,0,0,0,0
178207.0,Flowerday Sam,OH,Australia,20.0,191.0,2022,Argentina,Australia,2022-07-08,False,0,0,0,0,0,0,0,0,0,0,0,0,0,0,0,0,0,0,0,0,0,0,0,0
178207.0,Flowerday Sam,OH,Australia,20.0,191.0,2022,Australia,France,2022-07-10,False,0,3,5,8,0,0,4,4,4,7,3,14,0,1,0,1,0,1,9,10,3,3,1,7
162870.0,Senica Max,OH,Australia,23.0,191.0,2022,Netherlands,Australia,2022-06-12,False,0,0,6,6,0,0,0,0,4,0,4,8,0,1,0,1,5,1,10,16,2,1,0,3
162870.0,Senica Max,OH,Australia,23.0,191.0,2022,Australia,Canada,2022-06-21,False,0,0,1,1,0,0,0,0,2,2,0,4,0,0,0,0,0,0,2,2,1,0,0,1
162870.0,Senica Max,OH,Australia,23.0,191.0,2022,Australia,Bulgaria,2022-06-24,True,0,0,0,0,0,0,0,0,0,0,0,0,0,0,0,0,0,0,0,0,0,0,0,0
162870.0,Senica Max,OH,Australia,23.0,191.0,2022,Poland,Australia,2022-06-25,False,0,0,10,10,0,1,0,1,6,4,9,19,0,0,0,0,4,1,14,19,0,1,0,1
162870.0,Senica Max,OH,Australia,23.0,191.0,2022,Serbia,Australia,2022-06-26,False,0,0,1,1,0,0,0,0,1,0,0,1,0,0,1,1,0,0,2,2,0,0,0,0
162870.0,Senica Max,OH,Australia,23.0,191.0,2022,Japan,Australia,2022-07-06,False,0,0,1,1,0,0,0,0,1,0,0,1,0,0,1,1,2,1,0,3,0,1,0,1
162870.0,Senica Max,OH,Australia,23.0,191.0,2022,Germany,Australia,2022-07-07,False,0,1,4,5,0,0,0,0,3,2,1,6,0,0,1,1,2,1,4,7,1,1,0,2
162870.0,Senica Max,OH,Australia,23.0,191.0,2022,Argentina,Australia,2022-07-08,False,0,0,1,1,0,0,0,0,0,1,0,1,0,0,0,0,0,0,0,0,0,0,0,0
162870.0,Senica Max,OH,Australia,23.0,191.0,2022,Australia,France,2022-07-10,False,0,0,2,2,0,0,0,0,2,1,1,4,0,2,1,3,1,3,4,8,1,0,2,3
169335.0,Garrett Ethan,OH,Australia,22.0,196.0,2022,Netherlands,Australia,2022-06-12,False,0,0,2,2,0,0,0,0,1,1,1,3,0,0,0,0,2,1,8,11,2,0,1,3
169335.0,Garrett Ethan,OH,Australia,22.0,196.0,2022,Australia,Canada,2022-06-21,False,0,0,0,0,0,0,0,0,0,0,0,0,0,0,0,0,0,0,0,0,0,0,0,0
169335.0,Garrett Ethan,OH,Australia,22.0,196.0,2022,Australia,Bulgaria,2022-06-24,True,0,0,0,0,0,0,0,0,0,0,0,0,0,0,0,0,0,0,0,0,0,0,0,0
169335.0,Garrett Ethan,OH,Australia,22.0,196.0,2022,Poland,Australia,2022-06-25,False,0,3,7,10,0,0,0,0,7,3,5,15,0,1,2,3,5,1,20,26,0,0,1,1
169335.0,Garrett Ethan,OH,Australia,22.0,196.0,2022,Serbia,Australia,2022-06-26,False,0,0,0,0,0,0,0,0,0,0,0,0,0,0,0,0,0,0,0,0,0,0,0,0
169335.0,Garrett Ethan,OH,Australia,22.0,196.0,2022,Japan,Australia,2022-07-06,False,0,0,0,0,0,0,0,0,0,0,0,0,0,0,0,0,0,0,0,0,0,0,0,0
169335.0,Garrett Ethan,OH,Australia,22.0,196.0,2022,Germany,Australia,2022-07-07,False,0,0,0,0,0,0,0,0,0,0,0,0,0,0,0,0,0,0,0,0,0,0,0,0
169335.0,Garrett Ethan,OH,Australia,22.0,196.0,2022,Argentina,Australia,2022-07-08,False,0,0,0,0,0,0,0,0,0,0,0,0,0,0,0,0,0,0,0,0,0,0,0,0
169335.0,Garrett Ethan,OH,Australia,22.0,196.0,2022,Australia,France,2022-07-10,False,0,0,3,3,0,0,3,3,2,1,2,5,0,2,2,4,0,0,9,9,1,1,0,2
162265.0,Aubrey Matthew,O,Australia,25.0,209.0,2022,Japan,Australia,2022-07-06,False,0,0,1,1,1,0,0,1,0,0,0,0,0,0,0,0,0,0,0,0,0,0,0,0
162265.0,Aubrey Matthew,O,Australia,25.0,209.0,2022,Germany,Australia,2022-07-07,False,1,4,3,8,0,0,2,2,8,3,9,20,0,2,5,7,0,0,0,0,2,2,1,5
162265.0,Aubrey Matthew,O,Australia,25.0,209.0,2022,Argentina,Australia,2022-07-08,False,0,4,7,11,0,0,0,0,11,6,3,20,1,1,4,6,0,0,0,0,2,0,1,3
162265.0,Aubrey Matthew,O,Australia,25.0,209.0,2022,Australia,France,2022-07-10,False,0,0,3,3,0,0,1,1,2,3,3,8,0,2,1,3,0,0,0,0,1,2,0,3
116099.0,Rezende Bruno Mossa,S,Brazil,36.0,190.0,2022,USA,Brazil,2022-06-11,False,0,2,9,11,28,1,38,67,1,0,0,1,0,2,4,6,0,0,1,1,4,4,1,9
116099.0,Rezende Bruno Mossa,S,Brazil,36.0,190.0,2022,Brazil,China,2022-06-12,False,1,2,8,11,33,1,38,72,0,0,0,0,0,2,2,4,0,0,0,0,3,2,0,5
116099.0,Rezende Bruno Mossa,S,Brazil,36.0,190.0,2022,Brazil,Poland,2022-06-22,False,0,0,8,8,21,0,52,73,0,0,1,1,0,2,1,3,0,0,1,1,4,1,3,8
116099.0,Rezende Bruno Mossa,S,Brazil,36.0,190.0,2022,Serbia,Brazil,2022-06-23,True,2,1,10,13,21,1,47,69,0,0,0,0,0,0,0,0,0,0,0,0,2,2,0,4
116099.0,Rezende Bruno Mossa,S,Brazil,36.0,190.0,2022,Iran,Brazil,2022-06-24,True,3,1,13,17,23,0,38,61,1,0,0,1,0,3,1,4,0,0,1,1,0,3,0,3
116099.0,Rezende Bruno Mossa,S,Brazil,36.0,190.0,2022,Bulgaria,Brazil,2022-06-26,True,1,0,11,12,20,0,40,60,1,0,0,1,1,4,1,6,0,0,0,0,0,1,0,1
116099.0,Rezende Bruno Mossa,S,Brazil,36.0,190.0,2022,Brazil,Germany,2022-07-06,True,0,2,16,18,37,1,44,82,1,0,0,1,1,1,2,4,0,0,0,0,8,0,4,12
116099.0,Rezende Bruno Mossa,S,Brazil,36.0,190.0,2022,Canada,Brazil,2022-07-07,True,0,1,9,10,11,0,50,61,1,0,0,1,0,1,2,3,0,0,0,0,6,2,1,9
116099.0,Rezende Bruno Mossa,S,Brazil,36.0,190.0,2022,France,Brazil,2022-07-08,False,0,0,4,4,2,0,9,11,0,0,1,1,0,0,0,0,0,0,1,1,1,0,0,1
116099.0,Rezende Bruno Mossa,S,Brazil,36.0,190.0,2022,Brazil,Japan,2022-07-10,True,1,2,12,15,30,0,35,65,0,0,1,1,1,2,2,5,0,0,0,0,2,0,2,4
116099.0,Rezende Bruno Mossa,S,Brazil,36.0,190.0,2022,USA,Brazil,2022-07-20,False,0,3,8,11,29,0,63,92,0,0,0,0,0,3,1,4,0,0,0,0,3,1,1,5
174334.0,Andrade Leonardo Henrique,MB,Brazil,20.0,203.0,2022,Brazil,Germany,2022-07-06,True,0,0,0,0,0,0,0,0,0,0,0,0,0,0,0,0,0,0,0,0,0,0,0,0
174334.0,Andrade Leonardo Henrique,MB,Brazil,20.0,203.0,2022,Canada,Brazil,2022-07-07,True,0,0,0,0,0,0,0,0,0,0,0,0,0,0,0,0,0,0,0,0,0,0,0,0
174334.0,Andrade Leonardo Henrique,MB,Brazil,20.0,203.0,2022,France,Brazil,2022-07-08,False,0,0,0,0,0,0,0,0,0,0,0,0,0,0,0,0,0,0,0,0,0,0,0,0
174334.0,Andrade Leonardo Henrique,MB,Brazil,20.0,203.0,2022,Brazil,Japan,2022-07-10,True,0,0,0,0,0,0,0,0,0,0,0,0,0,0,0,0,0,0,0,0,0,0,0,0
124456.0,Cargnin Paese Franco Willian,O,Brazil,33.0,202.0,2022,USA,Brazil,2022-06-11,False,0,0,0,0,0,0,0,0,3,1,1,5,0,0,2,2,0,0,0,0,0,0,0,0
124456.0,Cargnin Paese Franco Willian,O,Brazil,33.0,202.0,2022,Brazil,China,2022-06-12,False,0,0,0,0,1,0,1,2,0,0,2,2,0,1,0,1,0,0,0,0,0,0,0,0
174908.0,Fernandes P.X.Cavalcante Adriano,OH,Brazil,21.0,201.0,2022,USA,Brazil,2022-06-11,False,0,3,9,12,1,0,0,1,2,2,6,10,0,1,0,1,6,2,10,18,2,1,1,4
174908.0,Fernandes P.X.Cavalcante Adriano,OH,Brazil,21.0,201.0,2022,Brazil,China,2022-06-12,False,0,2,7,9,3,0,1,4,8,2,3,13,0,1,2,3,13,1,17,31,3,1,0,4
174908.0,Fernandes P.X.Cavalcante Adriano,OH,Brazil,21.0,201.0,2022,Brazil,Poland,2022-06-22,False,0,0,0,0,0,0,0,0,0,1,0,1,0,0,0,0,0,0,1,1,0,0,0,0
174908.0,Fernandes P.X.Cavalcante Adriano,OH,Brazil,21.0,201.0,2022,Serbia,Brazil,2022-06-23,True,0,0,0,0,0,0,0,0,1,0,0,1,0,0,0,0,2,0,3,5,0,0,0,0
174908.0,Fernandes P.X.Cavalcante Adriano,OH,Brazil,21.0,201.0,2022,Iran,Brazil,2022-06-24,True,0,0,0,0,0,0,0,0,0,1,0,1,0,0,0,0,1,0,0,1,1,0,0,1
174908.0,Fernandes P.X.Cavalcante Adriano,OH,Brazil,21.0,201.0,2022,Bulgaria,Brazil,2022-06-26,True,0,0,0,0,0,0,0,0,0,0,0,0,0,0,0,0,0,1,1,2,0,0,0,0
174908.0,Fernandes P.X.Cavalcante Adriano,OH,Brazil,21.0,201.0,2022,Brazil,Germany,2022-07-06,True,0,0,0,0,0,0,1,1,0,0,0,0,0,0,1,1,0,0,0,0,0,0,0,0
174908.0,Fernandes P.X.Cavalcante Adriano,OH,Brazil,21.0,201.0,2022,Canada,Brazil,2022-07-07,True,0,0,0,0,0,0,0,0,0,0,0,0,0,0,0,0,0,0,2,2,0,0,0,0
174908.0,Fernandes P.X.Cavalcante Adriano,OH,Brazil,21.0,201.0,2022,France,Brazil,2022-07-08,False,1,1,8,10,0,0,4,4,6,0,4,10,0,3,1,4,3,6,4,13,4,2,1,7
174908.0,Fernandes P.X.Cavalcante Adriano,OH,Brazil,21.0,201.0,2022,Brazil,Japan,2022-07-10,True,0,0,1,1,0,0,0,0,3,0,2,5,0,1,0,1,3,0,4,7,0,0,0,0
174908.0,Fernandes P.X.Cavalcante Adriano,OH,Brazil,21.0,201.0,2022,USA,Brazil,2022-07-20,False,0,0,5,5,0,0,0,0,1,1,3,5,0,1,0,1,0,0,0,0,2,0,0,2
118928.0,Leal Hidalgo Yoandy,OH,Brazil,34.0,202.0,2022,Brazil,Poland,2022-06-22,False,1,2,15,18,0,0,2,2,8,5,9,22,1,3,1,5,3,5,23,31,4,2,2,8
118928.0,Leal Hidalgo Yoandy,OH,Brazil,34.0,202.0,2022,Serbia,Brazil,2022-06-23,True,1,2,9,12,0,0,1,1,8,0,7,15,2,4,1,7,1,1,13,15,0,2,1,3
118928.0,Leal Hidalgo Yoandy,OH,Brazil,34.0,202.0,2022,Iran,Brazil,2022-06-24,True,1,1,13,15,0,0,0,0,11,3,5,19,1,3,0,4,1,2,10,13,4,1,0,5
118928.0,Leal Hidalgo Yoandy,OH,Brazil,34.0,202.0,2022,Bulgaria,Brazil,2022-06-26,True,1,2,7,10,0,0,1,1,11,2,4,17,0,3,0,3,3,2,16,21,1,2,0,3
118928.0,Leal Hidalgo Yoandy,OH,Brazil,34.0,202.0,2022,Brazil,Germany,2022-07-06,True,1,3,12,16,0,0,6,6,19,2,8,29,1,6,4,11,2,0,17,19,3,4,0,7
118928.0,Leal Hidalgo Yoandy,OH,Brazil,34.0,202.0,2022,Canada,Brazil,2022-07-07,True,1,3,11,15,0,0,1,1,13,0,6,19,1,2,1,4,2,5,6,13,0,0,1,1
118928.0,Leal Hidalgo Yoandy,OH,Brazil,34.0,202.0,2022,France,Brazil,2022-07-08,False,0,1,10,11,0,0,5,5,5,3,11,19,0,4,2,6,3,3,12,18,1,1,2,4
118928.0,Leal Hidalgo Yoandy,OH,Brazil,34.0,202.0,2022,Brazil,Japan,2022-07-10,True,0,3,5,8,0,0,1,1,7,2,4,13,0,4,0,4,3,1,8,12,2,2,0,4
118928.0,Leal Hidalgo Yoandy,OH,Brazil,34.0,202.0,2022,USA,Brazil,2022-07-20,False,0,4,7,11,0,0,1,1,18,7,12,37,0,1,0,1,10,1,19,30,6,2,1,9
142721.0,Leao Rodrigo,OH,Brazil,26.0,197.0,2022,USA,Brazil,2022-06-11,False,2,3,9,14,2,0,1,3,10,2,7,19,1,2,4,7,17,1,13,31,4,1,3,8
142721.0,Leao Rodrigo,OH,Brazil,26.0,197.0,2022,Brazil,China,2022-06-12,False,0,4,7,11,0,0,0,0,4,4,4,12,0,4,2,6,8,1,8,17,1,2,3,6
142721.0,Leao Rodrigo,OH,Brazil,26.0,197.0,2022,Brazil,Poland,2022-06-22,False,0,1,5,6,0,0,1,1,6,2,7,15,0,0,0,0,1,2,2,5,1,0,0,1
142721.0,Leao Rodrigo,OH,Brazil,26.0,197.0,2022,Serbia,Brazil,2022-06-23,True,0,0,0,0,0,0,0,0,0,0,0,0,0,0,0,0,0,0,0,0,0,0,0,0
142721.0,Leao Rodrigo,OH,Brazil,26.0,197.0,2022,Iran,Brazil,2022-06-24,True,0,0,0,0,0,0,0,0,0,0,0,0,0,0,0,0,0,0,2,2,0,0,0,0
142721.0,Leao Rodrigo,OH,Brazil,26.0,197.0,2022,Bulgaria,Brazil,2022-06-26,True,0,0,0,0,0,0,0,0,0,0,0,0,0,0,0,0,0,0,0,0,0,0,0,0
142721.0,Leao Rodrigo,OH,Brazil,26.0,197.0,2022,Brazil,Germany,2022-07-06,True,1,0,0,1,0,0,0,0,0,0,0,0,0,0,0,0,0,0,0,0,0,0,0,0
142721.0,Leao Rodrigo,OH,Brazil,26.0,197.0,2022,Canada,Brazil,2022-07-07,True,0,0,0,0,0,0,0,0,0,0,0,0,0,0,0,0,0,0,0,0,0,0,0,0
142721.0,Leao Rodrigo,OH,Brazil,26.0,197.0,2022,France,Brazil,2022-07-08,False,0,1,2,3,0,0,1,1,3,1,1,5,0,0,1,1,1,0,2,3,4,1,1,6
142721.0,Leao Rodrigo,OH,Brazil,26.0,197.0,2022,Brazil,Japan,2022-07-10,True,0,0,0,0,0,0,1,1,0,0,0,0,0,0,0,0,0,0,1,1,1,0,0,1
142721.0,Leao Rodrigo,OH,Brazil,26.0,197.0,2022,USA,Brazil,2022-07-20,False,0,0,0,0,0,0,0,0,0,0,0,0,0,0,0,0,1,0,1,2,0,0,0,0
119872.0,Santos Isac,MB,Brazil,32.0,208.0,2022,USA,Brazil,2022-06-11,False,0,2,3,5,0,0,0,0,4,1,1,6,0,1,1,2,0,0,0,0,0,0,0,0
119872.0,Santos Isac,MB,Brazil,32.0,208.0,2022,Brazil,China,2022-06-12,False,0,0,0,0,0,0,0,0,0,0,0,0,0,0,0,0,0,0,0,0,0,0,0,0
119872.0,Santos Isac,MB,Brazil,32.0,208.0,2022,Brazil,Poland,2022-06-22,False,0,2,1,3,0,0,0,0,3,1,2,6,0,1,1,2,0,0,0,0,0,0,0,0
119872.0,Santos Isac,MB,Brazil,32.0,208.0,2022,Serbia,Brazil,2022-06-23,True,0,0,0,0,0,0,0,0,0,0,0,0,0,0,0,0,0,0,0,0,0,0,0,0
119872.0,Santos Isac,MB,Brazil,32.0,208.0,2022,Iran,Brazil,2022-06-24,True,1,3,8,12,0,0,1,1,9,0,2,11,4,3,5,12,0,0,0,0,0,0,0,0
119872.0,Santos Isac,MB,Brazil,32.0,208.0,2022,Bulgaria,Brazil,2022-06-26,True,1,4,9,14,0,0,0,0,8,1,1,10,2,1,2,5,0,0,2,2,0,1,2,3
119872.0,Santos Isac,MB,Brazil,32.0,208.0,2022,Brazil,Germany,2022-07-06,True,1,1,16,18,0,0,1,1,10,0,3,13,1,10,5,16,1,0,0,1,2,0,0,2
119872.0,Santos Isac,MB,Brazil,32.0,208.0,2022,Canada,Brazil,2022-07-07,True,3,0,17,20,0,0,1,1,7,0,2,9,0,3,6,9,1,0,0,1,4,1,1,6
119872.0,Santos Isac,MB,Brazil,32.0,208.0,2022,France,Brazil,2022-07-08,False,2,0,10,12,0,0,0,0,1,0,2,3,1,4,5,10,0,0,0,0,2,1,1,4
119872.0,Santos Isac,MB,Brazil,32.0,208.0,2022,Brazil,Japan,2022-07-10,True,2,3,12,17,0,0,0,0,4,1,5,10,2,7,7,16,0,0,1,1,2,0,0,2
119872.0,Santos Isac,MB,Brazil,32.0,208.0,2022,USA,Brazil,2022-07-20,False,0,2,5,7,0,0,0,0,1,0,6,7,0,1,1,2,0,0,0,0,3,1,0,4
151789.0,Kavalkievicz Gabriel,OH,Brazil,26.0,191.0,2022,USA,Brazil,2022-06-11,False,0,1,4,5,0,0,0,0,7,2,5,14,0,0,1,1,1,0,9,10,0,1,0,1
151789.0,Kavalkievicz Gabriel,OH,Brazil,26.0,191.0,2022,Brazil,China,2022-06-12,False,0,0,0,0,0,0,0,0,0,0,0,0,0,0,0,0,0,0,0,0,0,0,0,0
142744.0,Gil Kreling Fernando,S,Brazil,27.0,186.0,2022,USA,Brazil,2022-06-11,False,0,1,4,5,11,0,15,26,0,0,0,0,0,0,2,2,0,0,0,0,1,1,0,2
142744.0,Gil Kreling Fernando,S,Brazil,27.0,186.0,2022,Brazil,China,2022-06-12,False,0,0,1,1,1,1,1,3,0,0,0,0,0,0,0,0,0,0,0,0,1,1,0,2
142744.0,Gil Kreling Fernando,S,Brazil,27.0,186.0,2022,Brazil,Poland,2022-06-22,False,0,0,4,4,8,0,17,25,0,0,0,0,0,1,2,3,0,0,0,0,1,0,0,1
142744.0,Gil Kreling Fernando,S,Brazil,27.0,186.0,2022,Serbia,Brazil,2022-06-23,True,0,0,0,0,0,0,0,0,0,0,0,0,0,0,0,0,0,0,0,0,0,0,0,0
142744.0,Gil Kreling Fernando,S,Brazil,27.0,186.0,2022,Iran,Brazil,2022-06-24,True,0,1,1,2,5,0,9,14,0,0,0,0,0,0,0,0,0,0,0,0,0,0,0,0
142744.0,Gil Kreling Fernando,S,Brazil,27.0,186.0,2022,Bulgaria,Brazil,2022-06-26,True,0,0,2,2,2,0,1,3,0,0,0,0,0,0,0,0,0,0,0,0,0,0,0,0
142744.0,Gil Kreling Fernando,S,Brazil,27.0,186.0,2022,Brazil,Germany,2022-07-06,True,1,0,2,3,2,0,3,5,0,0,0,0,0,0,0,0,0,0,0,0,1,1,0,2
142744.0,Gil Kreling Fernando,S,Brazil,27.0,186.0,2022,Canada,Brazil,2022-07-07,True,0,0,0,0,0,0,1,1,0,0,0,0,0,0,0,0,0,0,0,0,0,0,0,0
142744.0,Gil Kreling Fernando,S,Brazil,27.0,186.0,2022,France,Brazil,2022-07-08,False,0,1,5,6,10,0,33,43,1,1,0,2,0,0,0,0,0,0,0,0,4,0,0,4
142744.0,Gil Kreling Fernando,S,Brazil,27.0,186.0,2022,Brazil,Japan,2022-07-10,True,0,0,1,1,0,0,0,0,0,0,0,0,0,0,0,0,0,0,0,0,0,1,0,1
142744.0,Gil Kreling Fernando,S,Brazil,27.0,186.0,2022,USA,Brazil,2022-07-20,False,0,0,4,4,3,0,18,21,0,0,0,0,0,2,1,3,0,0,0,0,0,0,0,0
161939.0,Nascimento Maique Reis,L,Brazil,25.0,187.0,2022,USA,Brazil,2022-06-11,False,0,0,0,0,2,0,1,3,0,0,0,0,0,0,0,0,1,0,5,6,7,1,2,10
161939.0,Nascimento Maique Reis,L,Brazil,25.0,187.0,2022,Brazil,China,2022-06-12,False,0,0,0,0,1,0,0,1,0,0,0,0,0,0,0,0,0,0,0,0,3,3,0,6
161939.0,Nascimento Maique Reis,L,Brazil,25.0,187.0,2022,Brazil,Poland,2022-06-22,False,0,0,0,0,1,1,1,3,0,0,0,0,0,0,0,0,1,3,11,15,4,5,1,10
161939.0,Nascimento Maique Reis,L,Brazil,25.0,187.0,2022,Serbia,Brazil,2022-06-23,True,0,0,0,0,0,0,0,0,0,0,0,0,0,0,0,0,0,0,0,0,0,0,0,0
161939.0,Nascimento Maique Reis,L,Brazil,25.0,187.0,2022,Iran,Brazil,2022-06-24,True,0,0,0,0,0,0,0,0,0,0,0,0,0,0,0,0,0,0,0,0,0,0,0,0
161939.0,Nascimento Maique Reis,L,Brazil,25.0,187.0,2022,Bulgaria,Brazil,2022-06-26,True,0,0,0,0,0,0,0,0,0,0,0,0,0,0,0,0,0,0,1,1,0,0,1,1
161939.0,Nascimento Maique Reis,L,Brazil,25.0,187.0,2022,Brazil,Germany,2022-07-06,True,0,0,0,0,0,0,0,0,0,0,0,0,0,0,0,0,0,0,0,0,0,0,0,0
161939.0,Nascimento Maique Reis,L,Brazil,25.0,187.0,2022,Canada,Brazil,2022-07-07,True,0,0,0,0,0,0,0,0,0,0,0,0,0,0,0,0,0,0,0,0,0,0,0,0
161939.0,Nascimento Maique Reis,L,Brazil,25.0,187.0,2022,France,Brazil,2022-07-08,False,0,0,0,0,0,0,0,0,0,0,0,0,0,0,0,0,0,0,0,0,1,0,0,1
161939.0,Nascimento Maique Reis,L,Brazil,25.0,187.0,2022,Brazil,Japan,2022-07-10,True,0,0,0,0,0,0,0,0,0,0,0,0,0,0,0,0,0,0,0,0,3,1,0,4
161939.0,Nascimento Maique Reis,L,Brazil,25.0,187.0,2022,USA,Brazil,2022-07-20,False,0,0,0,0,0,0,2,2,0,0,0,0,0,0,0,0,0,0,0,0,1,3,0,4
116081.0,Saatkamp Lucas,MB,Brazil,37.0,209.0,2022,USA,Brazil,2022-06-11,False,0,5,9,14,0,0,0,0,5,2,2,9,4,4,4,12,0,0,0,0,1,0,0,1
116081.0,Saatkamp Lucas,MB,Brazil,37.0,209.0,2022,Brazil,China,2022-06-12,False,3,2,18,23,0,0,1,1,8,2,0,10,1,3,1,5,0,0,0,0,1,1,1,3
116081.0,Saatkamp Lucas,MB,Brazil,37.0,209.0,2022,Brazil,Poland,2022-06-22,False,0,3,9,12,0,0,0,0,3,0,1,4,2,3,3,8,0,0,0,0,1,0,1,2
116081.0,Saatkamp Lucas,MB,Brazil,37.0,209.0,2022,Serbia,Brazil,2022-06-23,True,0,4,3,7,0,0,0,0,2,0,6,8,1,5,3,9,0,0,0,0,0,1,0,1
116081.0,Saatkamp Lucas,MB,Brazil,37.0,209.0,2022,Iran,Brazil,2022-06-24,True,0,0,0,0,0,0,0,0,0,0,0,0,0,0,0,0,0,0,0,0,0,0,0,0
116081.0,Saatkamp Lucas,MB,Brazil,37.0,209.0,2022,USA,Brazil,2022-07-20,False,0,2,6,8,0,0,0,0,8,0,2,10,0,4,2,6,0,0,1,1,0,2,0,2
118916.0,Hoss Thales,L,Brazil,33.0,190.0,2022,USA,Brazil,2022-06-11,False,0,0,0,0,2,0,0,2,0,0,0,0,0,0,0,0,4,2,9,15,4,0,0,4
118916.0,Hoss Thales,L,Brazil,33.0,190.0,2022,Brazil,China,2022-06-12,False,0,0,0,0,1,0,0,1,0,0,0,0,0,0,0,0,5,1,11,17,3,1,0,4
118916.0,Hoss Thales,L,Brazil,33.0,190.0,2022,Brazil,Poland,2022-06-22,False,0,0,0,0,0,0,4,4,0,0,0,0,0,0,0,0,3,1,2,6,1,1,1,3
118916.0,Hoss Thales,L,Brazil,33.0,190.0,2022,Serbia,Brazil,2022-06-23,True,0,0,0,0,1,0,3,4,0,0,0,0,0,0,0,0,5,0,4,9,5,2,1,8
118916.0,Hoss Thales,L,Brazil,33.0,190.0,2022,Iran,Brazil,2022-06-24,True,0,0,0,0,1,0,3,4,0,0,0,0,0,0,0,0,4,2,9,15,3,0,0,3
118916.0,Hoss Thales,L,Brazil,33.0,190.0,2022,Bulgaria,Brazil,2022-06-26,True,0,0,0,0,0,0,1,1,0,0,0,0,0,0,0,0,4,0,6,10,5,4,0,9
118916.0,Hoss Thales,L,Brazil,33.0,190.0,2022,Brazil,Germany,2022-07-06,True,0,0,0,0,0,0,5,5,0,0,0,0,0,0,0,0,5,2,8,15,13,3,1,17
118916.0,Hoss Thales,L,Brazil,33.0,190.0,2022,Canada,Brazil,2022-07-07,True,0,0,0,0,0,0,1,1,0,0,0,0,0,0,0,0,3,0,10,13,11,2,1,14
118916.0,Hoss Thales,L,Brazil,33.0,190.0,2022,France,Brazil,2022-07-08,False,0,0,0,0,0,0,7,7,0,0,0,0,0,0,0,0,3,1,10,14,5,2,0,7
118916.0,Hoss Thales,L,Brazil,33.0,190.0,2022,Brazil,Japan,2022-07-10,True,0,0,0,0,1,0,0,1,0,0,0,0,0,0,0,0,4,0,6,10,2,2,2,6
118916.0,Hoss Thales,L,Brazil,33.0,190.0,2022,USA,Brazil,2022-07-20,False,0,0,0,0,1,0,1,2,0,0,0,0,0,0,0,0,16,0,7,23,6,2,1,9
136468.0,Souza Ricardo Lucarelli,OH,Brazil,31.0,196.0,2022,Brazil,Poland,2022-06-22,False,0,2,7,9,0,0,2,2,3,2,8,13,1,0,0,1,3,1,16,20,1,1,0,2
136468.0,Souza Ricardo Lucarelli,OH,Brazil,31.0,196.0,2022,Serbia,Brazil,2022-06-23,True,2,1,10,13,1,0,0,1,10,2,7,19,2,2,0,4,4,2,10,16,2,3,1,6
136468.0,Souza Ricardo Lucarelli,OH,Brazil,31.0,196.0,2022,Iran,Brazil,2022-06-24,True,0,3,6,9,0,0,2,2,15,2,5,22,0,2,2,4,11,0,15,26,1,1,1,3
136468.0,Souza Ricardo Lucarelli,OH,Brazil,31.0,196.0,2022,Bulgaria,Brazil,2022-06-26,True,1,3,10,14,0,0,1,1,8,3,1,12,2,0,2,4,1,0,11,12,3,4,1,8
136468.0,Souza Ricardo Lucarelli,OH,Brazil,31.0,196.0,2022,Brazil,Germany,2022-07-06,True,2,3,14,19,0,0,4,4,13,5,6,24,0,3,5,8,11,1,17,29,4,4,0,8
136468.0,Souza Ricardo Lucarelli,OH,Brazil,31.0,196.0,2022,Canada,Brazil,2022-07-07,True,0,1,8,9,0,0,6,6,4,1,10,15,0,1,2,3,3,0,12,15,4,2,2,8
136468.0,Souza Ricardo Lucarelli,OH,Brazil,31.0,196.0,2022,France,Brazil,2022-07-08,False,0,0,0,0,0,0,0,0,0,0,0,0,0,0,0,0,0,0,0,0,0,0,0,0
136468.0,Souza Ricardo Lucarelli,OH,Brazil,31.0,196.0,2022,Brazil,Japan,2022-07-10,True,1,4,9,14,0,0,6,6,7,4,3,14,1,1,2,4,9,2,13,24,10,1,3,14
136468.0,Souza Ricardo Lucarelli,OH,Brazil,31.0,196.0,2022,USA,Brazil,2022-07-20,False,1,1,16,18,0,0,0,0,15,4,8,27,0,3,1,4,12,3,9,24,8,4,2,14
136954.0,Santos Leandro,MB,Brazil,30.0,197.0,2022,USA,Brazil,2022-06-11,False,0,0,0,0,0,0,0,0,0,0,0,0,0,0,0,0,0,0,0,0,0,0,0,0
136954.0,Santos Leandro,MB,Brazil,30.0,197.0,2022,Brazil,China,2022-06-12,False,0,0,0,0,0,0,0,0,0,0,0,0,0,0,0,0,0,0,0,0,0,0,0,0
136954.0,Santos Leandro,MB,Brazil,30.0,197.0,2022,Brazil,Poland,2022-06-22,False,0,0,0,0,0,0,0,0,0,0,0,0,0,0,0,0,0,0,0,0,0,0,0,0
136954.0,Santos Leandro,MB,Brazil,30.0,197.0,2022,Serbia,Brazil,2022-06-23,True,0,0,2,2,0,0,0,0,0,0,0,0,1,1,0,2,0,0,0,0,0,0,0,0
136954.0,Santos Leandro,MB,Brazil,30.0,197.0,2022,Iran,Brazil,2022-06-24,True,0,0,0,0,0,0,0,0,0,0,0,0,0,0,0,0,0,0,0,0,0,0,0,0
136954.0,Santos Leandro,MB,Brazil,30.0,197.0,2022,Bulgaria,Brazil,2022-06-26,True,0,0,0,0,0,0,0,0,0,0,0,0,0,0,0,0,0,0,0,0,0,0,0,0
136954.0,Santos Leandro,MB,Brazil,30.0,197.0,2022,Brazil,Germany,2022-07-06,True,0,0,0,0,0,0,0,0,0,0,0,0,0,0,0,0,0,0,0,0,0,0,0,0
136954.0,Santos Leandro,MB,Brazil,30.0,197.0,2022,Canada,Brazil,2022-07-07,True,0,0,0,0,0,0,0,0,0,0,0,0,0,0,0,0,0,0,0,0,0,0,0,0
136954.0,Santos Leandro,MB,Brazil,30.0,197.0,2022,France,Brazil,2022-07-08,False,0,0,4,4,0,0,0,0,1,0,0,1,0,1,0,1,0,0,0,0,0,0,0,0
136954.0,Santos Leandro,MB,Brazil,30.0,197.0,2022,Brazil,Japan,2022-07-10,True,0,0,0,0,0,0,0,0,0,0,0,0,0,0,0,0,0,0,0,0,0,0,0,0
136954.0,Santos Leandro,MB,Brazil,30.0,197.0,2022,USA,Brazil,2022-07-20,False,0,0,0,0,0,0,0,0,0,0,0,0,0,0,0,0,0,0,0,0,0,0,0,0
161930.0,Honorato Henrique Dantas Nóbrega,OH,Brazil,26.0,190.0,2022,Brazil,Germany,2022-07-06,True,0,0,0,0,0,0,1,1,0,0,0,0,0,0,0,0,0,0,2,2,0,0,0,0
161930.0,Honorato Henrique Dantas Nóbrega,OH,Brazil,26.0,190.0,2022,Canada,Brazil,2022-07-07,True,0,0,3,3,0,0,0,0,0,0,0,0,0,0,0,0,0,0,0,0,0,0,0,0
161930.0,Honorato Henrique Dantas Nóbrega,OH,Brazil,26.0,190.0,2022,France,Brazil,2022-07-08,False,0,0,2,2,0,0,1,1,0,0,0,0,0,0,0,0,0,0,0,0,0,0,0,0
161930.0,Honorato Henrique Dantas Nóbrega,OH,Brazil,26.0,190.0,2022,Brazil,Japan,2022-07-10,True,0,0,0,0,0,0,0,0,0,0,0,0,0,0,0,0,0,0,0,0,0,0,0,0
161930.0,Honorato Henrique Dantas Nóbrega,OH,Brazil,26.0,190.0,2022,USA,Brazil,2022-07-20,False,0,0,0,0,0,0,0,0,0,0,0,0,0,0,0,0,0,0,0,0,0,0,0,0
136947.0,Souza Alan,O,Brazil,29.0,202.0,2022,USA,Brazil,2022-06-11,False,1,4,11,16,2,0,0,2,21,4,9,34,1,5,2,8,0,0,0,0,5,2,2,9
136947.0,Souza Alan,O,Brazil,29.0,202.0,2022,Brazil,China,2022-06-12,False,0,3,9,12,0,0,1,1,16,5,8,29,3,1,4,8,0,0,0,0,4,2,0,6
136947.0,Souza Alan,O,Brazil,29.0,202.0,2022,Brazil,Poland,2022-06-22,False,0,6,5,11,0,0,1,1,19,4,11,34,0,3,2,5,0,1,0,1,1,2,2,5
136947.0,Souza Alan,O,Brazil,29.0,202.0,2022,Serbia,Brazil,2022-06-23,True,3,3,11,17,0,0,0,0,10,3,9,22,0,0,1,1,0,0,0,0,2,1,0,3
136947.0,Souza Alan,O,Brazil,29.0,202.0,2022,Iran,Brazil,2022-06-24,True,0,2,1,3,0,0,1,1,3,1,2,6,0,2,0,2,0,0,0,0,1,1,0,2
136956.0,Resende Gualberto Flavio,MB,Brazil,29.0,199.0,2022,USA,Brazil,2022-06-11,False,0,1,8,9,0,0,0,0,3,0,2,5,2,3,3,8,0,0,0,0,2,0,0,2
136956.0,Resende Gualberto Flavio,MB,Brazil,29.0,199.0,2022,Brazil,China,2022-06-12,False,0,0,9,9,1,1,0,2,11,3,2,16,2,0,2,4,0,0,0,0,1,0,0,1
136956.0,Resende Gualberto Flavio,MB,Brazil,29.0,199.0,2022,Brazil,Poland,2022-06-22,False,0,1,8,9,0,0,0,0,6,0,7,13,1,6,5,12,0,0,0,0,1,1,0,2
136956.0,Resende Gualberto Flavio,MB,Brazil,29.0,199.0,2022,Serbia,Brazil,2022-06-23,True,0,2,9,11,0,0,0,0,5,1,0,6,1,3,4,8,0,0,1,1,0,0,0,0
136956.0,Resende Gualberto Flavio,MB,Brazil,29.0,199.0,2022,Iran,Brazil,2022-06-24,True,0,3,10,13,0,0,0,0,6,1,0,7,2,2,1,5,1,0,0,1,1,2,1,4
136956.0,Resende Gualberto Flavio,MB,Brazil,29.0,199.0,2022,Bulgaria,Brazil,2022-06-26,True,0,0,11,11,0,0,0,0,6,0,3,9,4,0,2,6,1,0,2,3,0,0,0,0
136956.0,Resende Gualberto Flavio,MB,Brazil,29.0,199.0,2022,Brazil,Germany,2022-07-06,True,0,3,10,13,0,0,1,1,7,1,4,12,3,2,8,13,1,0,1,2,3,1,1,5
136956.0,Resende Gualberto Flavio,MB,Brazil,29.0,199.0,2022,Canada,Brazil,2022-07-07,True,0,0,7,7,0,0,1,1,7,0,1,8,3,4,6,13,0,0,1,1,3,2,0,5
136956.0,Resende Gualberto Flavio,MB,Brazil,29.0,199.0,2022,France,Brazil,2022-07-08,False,1,0,6,7,0,0,1,1,6,2,4,12,1,6,3,10,0,1,2,3,2,1,2,5
136956.0,Resende Gualberto Flavio,MB,Brazil,29.0,199.0,2022,Brazil,Japan,2022-07-10,True,0,0,9,9,0,0,0,0,4,1,3,8,1,5,6,12,0,0,1,1,0,0,1,1
136956.0,Resende Gualberto Flavio,MB,Brazil,29.0,199.0,2022,USA,Brazil,2022-07-20,False,0,3,9,12,0,0,1,1,7,1,2,10,2,3,3,8,1,0,0,1,1,2,1,4
161946.0,Almeida Cardoso Victor Alexsander,OH,Brazil,24.0,199.0,2022,USA,Brazil,2022-06-11,False,0,0,0,0,0,0,0,0,0,0,0,0,0,0,0,0,0,0,0,0,0,0,0,0
161946.0,Almeida Cardoso Victor Alexsander,OH,Brazil,24.0,199.0,2022,Brazil,China,2022-06-12,False,0,0,1,1,0,0,0,0,0,1,0,1,0,0,0,0,1,1,1,3,0,0,1,1
174902.0,Ferreira Souza Darlan,O,Brazil,20.0,192.0,2022,Brazil,Poland,2022-06-22,False,0,0,0,0,0,0,0,0,0,1,0,1,0,0,0,0,0,0,0,0,0,0,0,0
174902.0,Ferreira Souza Darlan,O,Brazil,20.0,192.0,2022,Serbia,Brazil,2022-06-23,True,0,0,0,0,0,0,0,0,0,0,0,0,0,0,0,0,0,0,0,0,0,0,0,0
174902.0,Ferreira Souza Darlan,O,Brazil,20.0,192.0,2022,Iran,Brazil,2022-06-24,True,0,5,3,8,0,0,0,0,5,2,5,12,0,1,1,2,0,0,0,0,1,0,0,1
174902.0,Ferreira Souza Darlan,O,Brazil,20.0,192.0,2022,Bulgaria,Brazil,2022-06-26,True,0,2,8,10,0,0,0,0,10,4,5,19,0,1,3,4,0,0,1,1,0,1,0,1
174902.0,Ferreira Souza Darlan,O,Brazil,20.0,192.0,2022,Brazil,Germany,2022-07-06,True,0,2,9,11,0,0,0,0,13,5,5,23,0,3,5,8,0,0,1,1,4,2,1,7
174902.0,Ferreira Souza Darlan,O,Brazil,20.0,192.0,2022,Canada,Brazil,2022-07-07,True,0,1,8,9,0,0,1,1,11,3,8,22,1,3,3,7,0,0,0,0,3,2,1,6
174902.0,Ferreira Souza Darlan,O,Brazil,20.0,192.0,2022,France,Brazil,2022-07-08,False,1,2,4,7,0,0,0,0,8,2,7,17,0,4,5,9,0,0,0,0,1,1,0,2
174902.0,Ferreira Souza Darlan,O,Brazil,20.0,192.0,2022,Brazil,Japan,2022-07-10,True,0,1,7,8,0,0,2,2,17,4,5,26,2,1,2,5,0,0,0,0,0,0,2,2
174902.0,Ferreira Souza Darlan,O,Brazil,20.0,192.0,2022,USA,Brazil,2022-07-20,False,1,4,7,12,0,0,0,0,11,3,7,21,1,2,5,8,0,0,0,0,5,3,0,8
174445.0,Karyagin Denis,OH,Bulgaria,20.0,206.0,2022,Bulgaria,Serbia,2022-06-07,False,0,0,0,0,0,0,0,0,1,0,0,1,0,0,0,0,0,0,0,0,0,0,0,0
174445.0,Karyagin Denis,OH,Bulgaria,20.0,206.0,2022,Bulgaria,Germany,2022-06-10,False,0,1,2,3,0,0,2,2,5,4,8,17,0,2,1,3,0,0,0,0,1,0,0,1
174445.0,Karyagin Denis,OH,Bulgaria,20.0,206.0,2022,Bulgaria,Poland,2022-06-11,False,0,2,1,3,0,0,0,0,2,4,5,11,1,1,2,4,1,0,0,1,2,2,0,4
174445.0,Karyagin Denis,OH,Bulgaria,20.0,206.0,2022,Bulgaria,Canada,2022-06-12,False,0,0,0,0,0,0,0,0,0,0,0,0,0,0,0,0,0,0,0,0,0,0,0,0
174445.0,Karyagin Denis,OH,Bulgaria,20.0,206.0,2022,Iran,Bulgaria,2022-06-21,True,0,0,0,0,0,0,0,0,0,0,0,0,0,0,0,0,0,0,0,0,0,0,0,0
174445.0,Karyagin Denis,OH,Bulgaria,20.0,206.0,2022,Australia,Bulgaria,2022-06-24,False,0,0,1,1,0,0,0,0,1,2,2,5,0,0,0,0,0,0,0,0,0,0,0,0
174445.0,Karyagin Denis,OH,Bulgaria,20.0,206.0,2022,USA,Bulgaria,2022-06-25,False,0,0,0,0,0,0,0,0,0,0,0,0,0,0,0,0,0,0,0,0,0,0,0,0
174445.0,Karyagin Denis,OH,Bulgaria,20.0,206.0,2022,Bulgaria,Brazil,2022-06-26,False,0,0,2,2,0,0,0,0,1,0,1,2,0,0,1,1,0,0,0,0,0,0,0,0
174445.0,Karyagin Denis,OH,Bulgaria,20.0,206.0,2022,Bulgaria,Italy,2022-07-05,False,0,2,0,2,0,0,0,0,2,2,2,6,0,0,0,0,0,0,0,0,0,0,0,0
174445.0,Karyagin Denis,OH,Bulgaria,20.0,206.0,2022,Bulgaria,Slovenia,2022-07-07,False,0,0,0,0,0,0,0,0,0,0,0,0,0,0,0,0,0,0,0,0,0,0,0,0
174445.0,Karyagin Denis,OH,Bulgaria,20.0,206.0,2022,Bulgaria,Netherlands,2022-07-08,True,2,3,8,13,0,0,2,2,10,4,4,18,0,1,0,1,0,0,0,0,4,0,0,4
174445.0,Karyagin Denis,OH,Bulgaria,20.0,206.0,2022,China,Bulgaria,2022-07-09,False,0,4,13,17,0,0,0,0,15,6,1,22,0,0,0,0,0,0,0,0,0,0,1,1
180588.0,Chavdarov Stefan,MB,Bulgaria,27.0,202.0,2022,Bulgaria,Serbia,2022-06-07,False,0,0,0,0,0,0,0,0,0,0,0,0,0,0,0,0,0,0,0,0,0,0,0,0
180588.0,Chavdarov Stefan,MB,Bulgaria,27.0,202.0,2022,Bulgaria,Germany,2022-06-10,False,0,0,0,0,0,0,0,0,0,0,0,0,0,0,0,0,0,0,0,0,0,0,0,0
180588.0,Chavdarov Stefan,MB,Bulgaria,27.0,202.0,2022,Bulgaria,Poland,2022-06-11,False,0,2,6,8,0,0,0,0,3,0,1,4,0,1,2,3,0,0,1,1,1,1,2,4
180588.0,Chavdarov Stefan,MB,Bulgaria,27.0,202.0,2022,Bulgaria,Canada,2022-06-12,False,0,0,0,0,0,0,0,0,0,0,0,0,0,0,0,0,0,0,0,0,0,0,0,0
180588.0,Chavdarov Stefan,MB,Bulgaria,27.0,202.0,2022,Iran,Bulgaria,2022-06-21,True,0,0,0,0,0,0,0,0,0,0,0,0,0,0,0,0,0,0,0,0,0,0,0,0
180588.0,Chavdarov Stefan,MB,Bulgaria,27.0,202.0,2022,Australia,Bulgaria,2022-06-24,False,1,1,7,9,0,0,0,0,2,1,1,4,1,1,0,2,0,0,0,0,0,0,0,0
180588.0,Chavdarov Stefan,MB,Bulgaria,27.0,202.0,2022,USA,Bulgaria,2022-06-25,False,1,4,9,14,0,0,0,0,3,0,2,5,1,2,3,6,0,0,1,1,1,0,0,1
180588.0,Chavdarov Stefan,MB,Bulgaria,27.0,202.0,2022,Bulgaria,Brazil,2022-06-26,False,0,2,5,7,0,0,0,0,6,0,1,7,1,1,3,5,0,0,0,0,0,2,1,3
180588.0,Chavdarov Stefan,MB,Bulgaria,27.0,202.0,2022,Bulgaria,Italy,2022-07-05,False,0,0,4,4,0,0,0,0,3,2,3,8,0,0,1,1,0,0,1,1,1,0,0,1
180588.0,Chavdarov Stefan,MB,Bulgaria,27.0,202.0,2022,Bulgaria,Slovenia,2022-07-07,False,0,2,0,2,0,0,0,0,0,1,0,1,0,0,0,0,0,0,0,0,0,0,0,0
180588.0,Chavdarov Stefan,MB,Bulgaria,27.0,202.0,2022,Bulgaria,Netherlands,2022-07-08,True,0,0,0,0,0,0,0,0,0,0,0,0,0,0,0,0,0,0,0,0,0,0,0,0
180588.0,Chavdarov Stefan,MB,Bulgaria,27.0,202.0,2022,China,Bulgaria,2022-07-09,False,1,1,8,10,0,0,0,0,4,0,3,7,0,3,0,3,0,0,1,1,0,1,0,1
173067.0,Kolev Nikolay,MB,Bulgaria,25.0,204.0,2022,Bulgaria,Serbia,2022-06-07,False,0,0,1,1,0,0,0,0,1,0,0,1,0,2,0,2,0,0,0,0,0,0,0,0
173067.0,Kolev Nikolay,MB,Bulgaria,25.0,204.0,2022,Bulgaria,Germany,2022-06-10,False,0,0,13,13,0,0,0,0,5,1,2,8,0,6,4,10,0,0,0,0,0,0,0,0
173067.0,Kolev Nikolay,MB,Bulgaria,25.0,204.0,2022,Bulgaria,Poland,2022-06-11,False,0,0,9,9,1,0,2,3,9,0,2,11,4,4,7,15,0,0,1,1,3,2,0,5
173067.0,Kolev Nikolay,MB,Bulgaria,25.0,204.0,2022,Bulgaria,Canada,2022-06-12,False,1,1,14,16,0,0,2,2,9,0,1,10,1,1,4,6,1,0,2,3,1,0,0,1
173067.0,Kolev Nikolay,MB,Bulgaria,25.0,204.0,2022,Iran,Bulgaria,2022-06-21,True,1,0,13,14,0,0,0,0,5,3,2,10,1,5,3,9,0,0,2,2,1,0,0,1
173067.0,Kolev Nikolay,MB,Bulgaria,25.0,204.0,2022,Australia,Bulgaria,2022-06-24,False,0,0,6,6,0,0,1,1,5,3,5,13,2,2,0,4,0,0,0,0,0,0,0,0
173067.0,Kolev Nikolay,MB,Bulgaria,25.0,204.0,2022,USA,Bulgaria,2022-06-25,False,0,1,4,5,0,0,0,0,4,0,1,5,0,1,1,2,0,0,2,2,0,0,0,0
173067.0,Kolev Nikolay,MB,Bulgaria,25.0,204.0,2022,Bulgaria,Brazil,2022-06-26,False,1,0,11,12,0,0,0,0,1,1,3,5,3,2,2,7,1,0,3,4,2,0,0,2
173067.0,Kolev Nikolay,MB,Bulgaria,25.0,204.0,2022,Bulgaria,Italy,2022-07-05,False,0,1,6,7,0,0,0,0,2,1,0,3,0,0,0,0,0,0,0,0,1,1,0,2
173067.0,Kolev Nikolay,MB,Bulgaria,25.0,204.0,2022,Bulgaria,Slovenia,2022-07-07,False,0,0,12,12,0,0,0,0,7,0,1,8,1,4,0,5,0,0,1,1,0,1,1,2
173067.0,Kolev Nikolay,MB,Bulgaria,25.0,204.0,2022,Bulgaria,Netherlands,2022-07-08,True,0,0,17,17,1,0,0,1,5,2,1,8,2,3,0,5,0,0,0,0,0,0,0,0
173067.0,Kolev Nikolay,MB,Bulgaria,25.0,204.0,2022,China,Bulgaria,2022-07-09,False,0,0,9,9,0,0,0,0,5,0,1,6,2,2,0,4,0,0,1,1,0,0,0,0
156676.0,Atanasov Martin,OH,Bulgaria,26.0,197.0,2022,Bulgaria,Serbia,2022-06-07,False,0,4,4,8,0,0,0,0,5,5,8,18,1,3,0,4,3,0,11,14,1,1,0,2
156676.0,Atanasov Martin,OH,Bulgaria,26.0,197.0,2022,Bulgaria,Germany,2022-06-10,False,1,5,13,19,0,0,3,3,13,4,9,26,4,2,2,8,3,1,20,24,7,2,1,10
156676.0,Atanasov Martin,OH,Bulgaria,26.0,197.0,2022,Bulgaria,Poland,2022-06-11,False,0,2,1,3,0,0,0,0,1,0,4,5,0,1,0,1,3,1,5,9,1,0,0,1
156676.0,Atanasov Martin,OH,Bulgaria,26.0,197.0,2022,Bulgaria,Canada,2022-06-12,False,0,1,6,7,0,0,0,0,4,4,5,13,0,1,0,1,3,1,10,14,0,1,0,1
156676.0,Atanasov Martin,OH,Bulgaria,26.0,197.0,2022,Iran,Bulgaria,2022-06-21,True,4,2,11,17,0,0,2,2,10,2,5,17,0,3,2,5,8,0,8,16,0,0,1,1
156676.0,Atanasov Martin,OH,Bulgaria,26.0,197.0,2022,Australia,Bulgaria,2022-06-24,False,3,5,13,21,0,0,0,0,11,6,11,28,0,3,0,3,13,1,15,29,3,2,0,5
156676.0,Atanasov Martin,OH,Bulgaria,26.0,197.0,2022,USA,Bulgaria,2022-06-25,False,2,4,11,17,1,0,1,2,9,5,13,27,0,2,1,3,9,2,16,27,2,0,0,2
156676.0,Atanasov Martin,OH,Bulgaria,26.0,197.0,2022,Bulgaria,Brazil,2022-06-26,False,0,1,7,8,0,0,1,1,12,3,7,22,0,1,0,1,11,0,11,22,3,0,0,3
156676.0,Atanasov Martin,OH,Bulgaria,26.0,197.0,2022,Bulgaria,Italy,2022-07-05,False,1,3,8,12,0,0,0,0,13,5,6,24,0,1,1,2,2,0,10,12,0,1,0,1
156676.0,Atanasov Martin,OH,Bulgaria,26.0,197.0,2022,Bulgaria,Slovenia,2022-07-07,False,2,3,9,14,0,1,0,1,12,2,11,25,1,3,0,4,6,2,21,29,1,2,0,3
156676.0,Atanasov Martin,OH,Bulgaria,26.0,197.0,2022,Bulgaria,Netherlands,2022-07-08,True,2,1,7,10,0,0,0,0,17,1,15,33,1,3,0,4,1,1,17,19,0,0,0,0
156676.0,Atanasov Martin,OH,Bulgaria,26.0,197.0,2022,China,Bulgaria,2022-07-09,False,0,3,8,11,0,1,2,3,10,3,4,17,0,2,0,2,2,1,21,24,0,2,0,2
132035.0,Gotsev Svetoslav,MB,Bulgaria,32.0,205.0,2022,Bulgaria,Serbia,2022-06-07,False,2,1,18,21,0,0,2,2,6,1,2,9,5,4,3,12,0,0,3,3,2,2,2,6
132035.0,Gotsev Svetoslav,MB,Bulgaria,32.0,205.0,2022,Bulgaria,Germany,2022-06-10,False,0,1,9,10,0,0,0,0,1,1,0,2,0,5,0,5,0,0,0,0,0,0,0,0
132035.0,Gotsev Svetoslav,MB,Bulgaria,32.0,205.0,2022,Bulgaria,Poland,2022-06-11,False,0,0,0,0,0,0,0,0,0,0,0,0,0,0,0,0,0,0,0,0,0,0,0,0
132035.0,Gotsev Svetoslav,MB,Bulgaria,32.0,205.0,2022,Bulgaria,Canada,2022-06-12,False,0,0,0,0,0,0,0,0,0,0,0,0,0,0,0,0,0,0,0,0,0,0,0,0
132035.0,Gotsev Svetoslav,MB,Bulgaria,32.0,205.0,2022,Iran,Bulgaria,2022-06-21,True,0,0,11,11,0,0,0,0,4,1,1,6,6,8,2,16,1,1,0,2,3,0,0,3
132035.0,Gotsev Svetoslav,MB,Bulgaria,32.0,205.0,2022,Australia,Bulgaria,2022-06-24,False,0,1,10,11,0,0,1,1,10,0,5,15,7,2,10,19,0,0,1,1,1,0,0,1
132035.0,Gotsev Svetoslav,MB,Bulgaria,32.0,205.0,2022,USA,Bulgaria,2022-06-25,False,0,1,7,8,1,0,0,1,4,0,3,7,2,4,3,9,0,0,1,1,1,0,0,1
132035.0,Gotsev Svetoslav,MB,Bulgaria,32.0,205.0,2022,Bulgaria,Brazil,2022-06-26,False,0,0,0,0,0,0,0,0,0,0,0,0,0,0,0,0,0,0,0,0,0,0,0,0
132035.0,Gotsev Svetoslav,MB,Bulgaria,32.0,205.0,2022,Bulgaria,Italy,2022-07-05,False,0,0,9,9,0,0,0,0,2,0,2,4,2,1,0,3,0,0,1,1,2,1,0,3
132035.0,Gotsev Svetoslav,MB,Bulgaria,32.0,205.0,2022,Bulgaria,Slovenia,2022-07-07,False,1,2,8,11,0,0,1,1,4,3,2,9,3,4,0,7,0,0,0,0,0,1,0,1
132035.0,Gotsev Svetoslav,MB,Bulgaria,32.0,205.0,2022,Bulgaria,Netherlands,2022-07-08,True,0,2,8,10,0,0,0,0,6,0,4,10,6,5,0,11,0,0,0,0,2,1,0,3
132035.0,Gotsev Svetoslav,MB,Bulgaria,32.0,205.0,2022,China,Bulgaria,2022-07-09,False,0,1,11,12,0,0,0,0,7,0,3,10,4,5,1,10,0,1,0,1,0,1,1,2
136489.0,Dimitrov Dobromir,S,Bulgaria,31.0,198.0,2022,Bulgaria,Serbia,2022-06-07,False,0,0,1,1,7,0,3,10,0,0,1,1,0,0,0,0,0,0,0,0,0,0,1,1
136489.0,Dimitrov Dobromir,S,Bulgaria,31.0,198.0,2022,Bulgaria,Germany,2022-06-10,False,0,0,1,1,0,0,0,0,0,0,0,0,0,0,0,0,0,0,0,0,0,0,0,0
136489.0,Dimitrov Dobromir,S,Bulgaria,31.0,198.0,2022,Bulgaria,Poland,2022-06-11,False,0,0,5,5,13,0,6,19,0,0,0,0,0,0,0,0,0,0,0,0,0,2,0,2
136489.0,Dimitrov Dobromir,S,Bulgaria,31.0,198.0,2022,Bulgaria,Canada,2022-06-12,False,0,0,1,1,1,0,0,1,0,0,0,0,0,1,1,2,0,0,0,0,0,0,0,0
136489.0,Dimitrov Dobromir,S,Bulgaria,31.0,198.0,2022,Iran,Bulgaria,2022-06-21,True,0,0,0,0,0,0,0,0,0,0,0,0,0,0,0,0,0,0,0,0,0,0,0,0
136489.0,Dimitrov Dobromir,S,Bulgaria,31.0,198.0,2022,Australia,Bulgaria,2022-06-24,False,1,1,5,7,1,0,4,5,0,0,0,0,0,0,1,1,0,0,0,0,0,0,0,0
136489.0,Dimitrov Dobromir,S,Bulgaria,31.0,198.0,2022,USA,Bulgaria,2022-06-25,False,0,0,2,2,1,0,9,10,0,0,0,0,0,0,0,0,0,0,0,0,0,0,0,0
136489.0,Dimitrov Dobromir,S,Bulgaria,31.0,198.0,2022,Bulgaria,Brazil,2022-06-26,False,0,2,10,12,19,2,51,72,2,1,0,3,0,3,0,3,0,0,0,0,1,1,0,2
136489.0,Dimitrov Dobromir,S,Bulgaria,31.0,198.0,2022,Bulgaria,Italy,2022-07-05,False,0,0,0,0,0,0,0,0,0,0,0,0,0,0,0,0,0,0,0,0,0,0,0,0
136489.0,Dimitrov Dobromir,S,Bulgaria,31.0,198.0,2022,Bulgaria,Slovenia,2022-07-07,False,0,0,4,4,6,0,8,14,0,0,1,1,0,1,0,1,0,0,0,0,0,1,0,1
136489.0,Dimitrov Dobromir,S,Bulgaria,31.0,198.0,2022,Bulgaria,Netherlands,2022-07-08,True,0,0,3,3,0,0,0,0,0,0,0,0,0,0,0,0,0,0,0,0,0,0,0,0
136489.0,Dimitrov Dobromir,S,Bulgaria,31.0,198.0,2022,China,Bulgaria,2022-07-09,False,1,1,5,7,6,0,15,21,0,1,0,1,0,0,0,0,0,0,0,0,1,1,0,2
137012.0,Seganov Georgi,S,Bulgaria,29.0,197.0,2022,Bulgaria,Serbia,2022-06-07,False,0,1,11,12,46,1,31,78,1,0,0,1,1,0,1,2,0,0,1,1,2,5,4,11
137012.0,Seganov Georgi,S,Bulgaria,29.0,197.0,2022,Bulgaria,Germany,2022-06-10,False,0,1,15,16,37,2,59,98,3,0,1,4,1,3,1,5,0,0,0,0,6,4,3,13
137012.0,Seganov Georgi,S,Bulgaria,29.0,197.0,2022,Bulgaria,Poland,2022-06-11,False,0,2,7,9,24,0,26,50,0,0,1,1,0,0,2,2,0,0,1,1,4,3,1,8
137012.0,Seganov Georgi,S,Bulgaria,29.0,197.0,2022,Bulgaria,Canada,2022-06-12,False,0,2,10,12,54,0,36,90,1,0,2,3,1,7,3,11,0,0,1,1,8,4,4,16
137012.0,Seganov Georgi,S,Bulgaria,29.0,197.0,2022,Iran,Bulgaria,2022-06-21,True,0,3,10,13,19,0,50,69,1,0,0,1,0,0,5,5,0,0,0,0,5,1,0,6
137012.0,Seganov Georgi,S,Bulgaria,29.0,197.0,2022,Australia,Bulgaria,2022-06-24,False,0,1,14,15,40,1,61,102,2,1,1,4,2,4,3,9,0,0,0,0,1,1,1,3
137012.0,Seganov Georgi,S,Bulgaria,29.0,197.0,2022,USA,Bulgaria,2022-06-25,False,0,1,11,12,22,1,63,86,0,0,1,1,0,1,1,2,0,0,1,1,1,1,1,3
137012.0,Seganov Georgi,S,Bulgaria,29.0,197.0,2022,Bulgaria,Brazil,2022-06-26,False,0,0,0,0,0,0,0,0,0,0,0,0,0,0,0,0,0,0,0,0,0,0,0,0
137012.0,Seganov Georgi,S,Bulgaria,29.0,197.0,2022,Bulgaria,Italy,2022-07-05,False,0,1,8,9,11,1,71,83,0,0,0,0,0,0,0,0,0,0,0,0,0,0,0,0
137012.0,Seganov Georgi,S,Bulgaria,29.0,197.0,2022,Bulgaria,Slovenia,2022-07-07,False,0,1,10,11,16,0,64,80,1,0,0,1,1,1,0,2,0,0,0,0,0,1,0,1
137012.0,Seganov Georgi,S,Bulgaria,29.0,197.0,2022,Bulgaria,Netherlands,2022-07-08,True,1,0,15,16,19,2,77,98,0,0,1,1,2,2,0,4,0,0,0,0,0,1,1,2
137012.0,Seganov Georgi,S,Bulgaria,29.0,197.0,2022,China,Bulgaria,2022-07-09,False,0,1,8,9,13,0,49,62,0,2,0,2,0,2,0,2,0,0,0,0,1,0,0,1
152619.0,Grozdanov Aleks,MB,Bulgaria,24.0,208.0,2022,Bulgaria,Serbia,2022-06-07,False,1,2,7,10,0,0,1,1,5,1,5,11,5,8,11,24,0,0,0,0,1,1,1,3
152619.0,Grozdanov Aleks,MB,Bulgaria,24.0,208.0,2022,Bulgaria,Germany,2022-06-10,False,0,2,7,9,0,0,2,2,5,1,3,9,1,4,8,13,1,0,0,1,2,0,1,3
152619.0,Grozdanov Aleks,MB,Bulgaria,24.0,208.0,2022,Bulgaria,Poland,2022-06-11,False,1,0,3,4,0,0,0,0,1,0,2,3,0,2,3,5,0,1,0,1,0,0,1,1
152619.0,Grozdanov Aleks,MB,Bulgaria,24.0,208.0,2022,Bulgaria,Canada,2022-06-12,False,0,1,14,15,0,0,1,1,4,1,6,11,2,6,6,14,2,0,0,2,3,3,1,7
168269.0,Asparuhov Asparuh,OH,Bulgaria,22.0,201.0,2022,Bulgaria,Serbia,2022-06-07,False,0,1,5,6,0,0,0,0,8,0,2,10,0,0,0,0,0,2,13,15,0,0,1,1
168269.0,Asparuhov Asparuh,OH,Bulgaria,22.0,201.0,2022,Bulgaria,Germany,2022-06-10,False,0,0,0,0,0,0,0,0,0,0,0,0,0,0,0,0,0,0,0,0,0,0,0,0
168269.0,Asparuhov Asparuh,OH,Bulgaria,22.0,201.0,2022,Bulgaria,Poland,2022-06-11,False,1,1,3,5,1,0,0,1,2,2,6,10,1,0,1,2,1,2,4,7,1,0,1,2
168269.0,Asparuhov Asparuh,OH,Bulgaria,22.0,201.0,2022,Bulgaria,Canada,2022-06-12,False,3,1,6,10,1,0,1,2,12,3,7,22,0,5,2,7,1,0,12,13,0,0,1,1
168269.0,Asparuhov Asparuh,OH,Bulgaria,22.0,201.0,2022,Iran,Bulgaria,2022-06-21,True,0,0,0,0,0,0,0,0,0,0,0,0,0,0,0,0,0,0,0,0,0,0,0,0
168269.0,Asparuhov Asparuh,OH,Bulgaria,22.0,201.0,2022,Australia,Bulgaria,2022-06-24,False,0,2,7,9,0,0,0,0,4,0,4,8,2,3,1,6,0,0,0,0,2,0,0,2
168269.0,Asparuhov Asparuh,OH,Bulgaria,22.0,201.0,2022,USA,Bulgaria,2022-06-25,False,0,0,0,0,0,0,0,0,0,0,0,0,0,0,0,0,0,0,0,0,0,0,0,0
168269.0,Asparuhov Asparuh,OH,Bulgaria,22.0,201.0,2022,Bulgaria,Brazil,2022-06-26,False,1,3,1,5,0,0,0,0,6,3,5,14,2,2,1,5,5,0,10,15,0,1,0,1
168269.0,Asparuhov Asparuh,OH,Bulgaria,22.0,201.0,2022,Bulgaria,Italy,2022-07-05,False,0,0,0,0,0,0,0,0,0,2,1,3,0,0,0,0,0,0,1,1,0,0,0,0
168269.0,Asparuhov Asparuh,OH,Bulgaria,22.0,201.0,2022,Bulgaria,Slovenia,2022-07-07,False,0,2,5,7,0,0,1,1,4,6,5,15,0,1,0,1,0,0,1,1,0,0,0,0
168269.0,Asparuhov Asparuh,OH,Bulgaria,22.0,201.0,2022,Bulgaria,Netherlands,2022-07-08,True,0,0,0,0,0,0,0,0,0,0,0,0,0,0,0,0,0,0,0,0,0,0,0,0
168269.0,Asparuhov Asparuh,OH,Bulgaria,22.0,201.0,2022,China,Bulgaria,2022-07-09,False,0,1,1,2,0,0,2,2,1,1,2,4,1,1,0,2,1,0,5,6,1,0,0,1
150277.0,Parapunov Radoslav,O,Bulgaria,25.0,205.0,2022,Bulgaria,Serbia,2022-06-07,False,0,3,8,11,0,0,2,2,13,2,7,22,2,6,2,10,0,0,1,1,2,9,1,12
150277.0,Parapunov Radoslav,O,Bulgaria,25.0,205.0,2022,Bulgaria,Germany,2022-06-10,False,0,2,6,8,0,0,0,0,5,5,3,13,1,3,3,7,0,0,2,2,1,2,0,3
150277.0,Parapunov Radoslav,O,Bulgaria,25.0,205.0,2022,Bulgaria,Poland,2022-06-11,False,0,2,2,4,0,0,2,2,6,2,2,10,0,2,5,7,0,0,0,0,2,1,0,3
150277.0,Parapunov Radoslav,O,Bulgaria,25.0,205.0,2022,Bulgaria,Canada,2022-06-12,False,1,4,15,20,0,0,2,2,9,6,7,22,3,4,5,12,1,0,2,3,5,2,1,8
150277.0,Parapunov Radoslav,O,Bulgaria,25.0,205.0,2022,Iran,Bulgaria,2022-06-21,True,1,2,8,11,1,0,0,1,4,3,5,12,1,2,0,3,0,0,0,0,1,0,0,1
150277.0,Parapunov Radoslav,O,Bulgaria,25.0,205.0,2022,Australia,Bulgaria,2022-06-24,False,0,1,4,5,0,0,0,0,5,7,3,15,0,1,4,5,0,0,0,0,2,1,0,3
150277.0,Parapunov Radoslav,O,Bulgaria,25.0,205.0,2022,USA,Bulgaria,2022-06-25,False,0,2,9,11,0,0,0,0,13,6,8,27,2,3,3,8,1,0,1,2,3,1,0,4
150277.0,Parapunov Radoslav,O,Bulgaria,25.0,205.0,2022,Bulgaria,Brazil,2022-06-26,False,0,4,5,9,0,0,0,0,6,3,7,16,2,2,0,4,1,0,2,3,2,2,0,4
150277.0,Parapunov Radoslav,O,Bulgaria,25.0,205.0,2022,Bulgaria,Italy,2022-07-05,False,1,2,5,8,0,0,0,0,4,5,9,18,0,1,0,1,0,1,2,3,0,0,0,0
150277.0,Parapunov Radoslav,O,Bulgaria,25.0,205.0,2022,Bulgaria,Slovenia,2022-07-07,False,1,2,3,6,0,0,1,1,6,3,7,16,0,1,0,1,0,0,1,1,1,0,0,1
150277.0,Parapunov Radoslav,O,Bulgaria,25.0,205.0,2022,Bulgaria,Netherlands,2022-07-08,True,0,2,7,9,0,0,1,1,1,2,5,8,1,1,0,2,0,0,1,1,0,0,0,0
150277.0,Parapunov Radoslav,O,Bulgaria,25.0,205.0,2022,China,Bulgaria,2022-07-09,False,0,0,0,0,0,0,0,0,0,0,0,0,0,0,0,0,0,0,0,0,0,0,0,0
118484.0,Ivanov Vladislav,L,Bulgaria,36.0,188.0,2022,Iran,Bulgaria,2022-06-21,True,0,0,0,0,1,0,3,4,0,0,0,0,0,0,0,0,9,0,9,18,3,2,0,5
118484.0,Ivanov Vladislav,L,Bulgaria,36.0,188.0,2022,Australia,Bulgaria,2022-06-24,False,0,0,0,0,2,0,5,7,0,0,0,0,0,0,0,0,6,1,14,21,4,2,5,11
118484.0,Ivanov Vladislav,L,Bulgaria,36.0,188.0,2022,USA,Bulgaria,2022-06-25,False,0,0,0,0,0,0,2,2,0,0,0,0,0,0,0,0,1,1,12,14,2,4,0,6
118484.0,Ivanov Vladislav,L,Bulgaria,36.0,188.0,2022,Bulgaria,Brazil,2022-06-26,False,0,0,0,0,0,0,2,2,0,0,0,0,0,0,0,0,2,1,7,10,2,0,0,2
118484.0,Ivanov Vladislav,L,Bulgaria,36.0,188.0,2022,Bulgaria,Italy,2022-07-05,False,0,0,0,0,0,0,1,1,0,0,0,0,0,0,0,0,3,3,10,16,2,0,2,4
118484.0,Ivanov Vladislav,L,Bulgaria,36.0,188.0,2022,Bulgaria,Slovenia,2022-07-07,False,0,0,0,0,0,0,1,1,0,0,0,0,0,0,0,0,1,0,22,23,2,0,0,2
118484.0,Ivanov Vladislav,L,Bulgaria,36.0,188.0,2022,Bulgaria,Netherlands,2022-07-08,True,0,0,0,0,0,0,1,1,0,0,0,0,0,0,0,0,5,2,13,20,4,3,2,9
118484.0,Ivanov Vladislav,L,Bulgaria,36.0,188.0,2022,China,Bulgaria,2022-07-09,False,0,0,0,0,0,0,5,5,0,0,0,0,0,0,0,0,4,3,9,16,5,2,2,9
174444.0,Valchinov Samuil,OH,Bulgaria,21.0,202.0,2022,Bulgaria,Serbia,2022-06-07,False,0,0,0,0,0,0,0,0,0,0,0,0,0,0,0,0,0,0,0,0,0,0,0,0
174444.0,Valchinov Samuil,OH,Bulgaria,21.0,202.0,2022,Bulgaria,Germany,2022-06-10,False,0,0,0,0,0,0,0,0,0,0,0,0,0,0,0,0,0,0,0,0,0,0,0,0
174444.0,Valchinov Samuil,OH,Bulgaria,21.0,202.0,2022,Bulgaria,Poland,2022-06-11,False,0,0,0,0,0,0,0,0,0,0,0,0,0,0,0,0,0,0,0,0,0,0,0,0
174444.0,Valchinov Samuil,OH,Bulgaria,21.0,202.0,2022,Bulgaria,Canada,2022-06-12,False,0,0,0,0,0,0,0,0,0,0,0,0,0,0,0,0,0,0,0,0,0,0,0,0
174444.0,Valchinov Samuil,OH,Bulgaria,21.0,202.0,2022,Bulgaria,Italy,2022-07-05,False,0,0,0,0,0,0,0,0,0,0,0,0,0,0,0,0,0,0,0,0,0,0,0,0
174444.0,Valchinov Samuil,OH,Bulgaria,21.0,202.0,2022,Bulgaria,Slovenia,2022-07-07,False,0,0,0,0,0,0,0,0,0,0,0,0,0,0,0,0,0,0,0,0,0,0,0,0
174444.0,Valchinov Samuil,OH,Bulgaria,21.0,202.0,2022,Bulgaria,Netherlands,2022-07-08,True,0,0,0,0,0,0,0,0,0,0,0,0,0,0,0,0,0,0,0,0,0,0,0,0
174444.0,Valchinov Samuil,OH,Bulgaria,21.0,202.0,2022,China,Bulgaria,2022-07-09,False,0,0,0,0,0,0,0,0,0,0,0,0,0,0,0,0,0,0,0,0,0,0,0,0
164812.0,Ivanov Svetoslav,OH,Bulgaria,22.0,197.0,2022,Bulgaria,Serbia,2022-06-07,False,0,0,0,0,0,0,0,0,0,0,0,0,0,0,0,0,0,0,1,1,0,0,0,0
164812.0,Ivanov Svetoslav,OH,Bulgaria,22.0,197.0,2022,Bulgaria,Germany,2022-06-10,False,0,0,0,0,0,0,0,0,0,0,0,0,0,0,0,0,1,0,1,2,1,1,0,2
164812.0,Ivanov Svetoslav,OH,Bulgaria,22.0,197.0,2022,Bulgaria,Poland,2022-06-11,False,0,2,2,4,0,0,2,2,4,4,2,10,1,1,1,3,7,1,9,17,1,0,0,1
164812.0,Ivanov Svetoslav,OH,Bulgaria,22.0,197.0,2022,Bulgaria,Canada,2022-06-12,False,0,0,0,0,0,0,0,0,0,0,0,0,0,0,0,0,0,0,0,0,0,0,0,0
164812.0,Ivanov Svetoslav,OH,Bulgaria,22.0,197.0,2022,Iran,Bulgaria,2022-06-21,True,0,0,0,0,0,0,0,0,0,0,0,0,0,0,0,0,0,0,0,0,0,0,0,0
164812.0,Ivanov Svetoslav,OH,Bulgaria,22.0,197.0,2022,Australia,Bulgaria,2022-06-24,False,0,0,0,0,0,0,0,0,1,0,0,1,0,0,1,1,2,0,2,4,0,0,0,0
164812.0,Ivanov Svetoslav,OH,Bulgaria,22.0,197.0,2022,USA,Bulgaria,2022-06-25,False,0,0,0,0,0,0,0,0,0,0,0,0,0,0,0,0,1,0,1,2,0,0,0,0
164812.0,Ivanov Svetoslav,OH,Bulgaria,22.0,197.0,2022,Bulgaria,Brazil,2022-06-26,False,0,0,2,2,0,0,0,0,0,0,0,0,0,0,0,0,0,0,1,1,0,0,0,0
164812.0,Ivanov Svetoslav,OH,Bulgaria,22.0,197.0,2022,Bulgaria,Italy,2022-07-05,False,0,0,0,0,0,0,0,0,0,0,0,0,0,0,0,0,0,0,0,0,0,0,0,0
164812.0,Ivanov Svetoslav,OH,Bulgaria,22.0,197.0,2022,Bulgaria,Slovenia,2022-07-07,False,0,0,0,0,0,0,0,0,1,0,0,1,0,0,0,0,0,0,3,3,0,1,0,1
164812.0,Ivanov Svetoslav,OH,Bulgaria,22.0,197.0,2022,Bulgaria,Netherlands,2022-07-08,True,0,0,0,0,0,0,0,0,0,0,0,0,0,0,0,0,0,0,2,2,0,0,1,1
164812.0,Ivanov Svetoslav,OH,Bulgaria,22.0,197.0,2022,China,Bulgaria,2022-07-09,False,1,1,3,5,0,0,0,0,2,1,1,4,0,1,0,1,0,0,8,8,1,0,0,1
168268.0,Petkov Iliya,MB,Bulgaria,26.0,200.0,2022,Iran,Bulgaria,2022-06-21,True,0,0,0,0,0,0,0,0,0,0,0,0,0,0,0,0,0,0,0,0,0,0,0,0
168268.0,Petkov Iliya,MB,Bulgaria,26.0,200.0,2022,Australia,Bulgaria,2022-06-24,False,0,0,0,0,0,0,0,0,0,0,0,0,0,0,0,0,0,0,0,0,0,0,0,0
168268.0,Petkov Iliya,MB,Bulgaria,26.0,200.0,2022,USA,Bulgaria,2022-06-25,False,0,0,0,0,0,0,0,0,0,0,0,0,0,0,0,0,0,0,0,0,0,0,0,0
168268.0,Petkov Iliya,MB,Bulgaria,26.0,200.0,2022,Bulgaria,Brazil,2022-06-26,False,0,0,0,0,0,0,0,0,0,0,0,0,0,0,0,0,0,0,0,0,0,0,0,0
168268.0,Petkov Iliya,MB,Bulgaria,26.0,200.0,2022,Bulgaria,Italy,2022-07-05,False,0,0,0,0,0,0,0,0,0,0,0,0,0,0,0,0,0,0,0,0,0,0,0,0
168268.0,Petkov Iliya,MB,Bulgaria,26.0,200.0,2022,Bulgaria,Slovenia,2022-07-07,False,0,0,0,0,0,0,0,0,0,0,0,0,0,0,0,0,0,0,0,0,0,0,0,0
168268.0,Petkov Iliya,MB,Bulgaria,26.0,200.0,2022,Bulgaria,Netherlands,2022-07-08,True,0,0,0,0,0,0,0,0,0,0,0,0,0,0,0,0,0,0,0,0,0,0,0,0
168268.0,Petkov Iliya,MB,Bulgaria,26.0,200.0,2022,China,Bulgaria,2022-07-09,False,0,0,0,0,0,0,0,0,0,0,0,0,0,0,0,0,0,0,0,0,0,0,0,0
180586.0,Nikolov Aleksandar,OH,Bulgaria,19.0,207.0,2022,Bulgaria,Serbia,2022-06-07,False,0,1,16,17,0,0,1,1,12,6,7,25,1,4,0,5,5,3,27,35,1,2,5,8
180586.0,Nikolov Aleksandar,OH,Bulgaria,19.0,207.0,2022,Bulgaria,Germany,2022-06-10,False,1,6,10,17,0,0,0,0,21,4,8,33,3,3,4,10,10,4,21,35,3,2,1,6
180586.0,Nikolov Aleksandar,OH,Bulgaria,19.0,207.0,2022,Bulgaria,Poland,2022-06-11,False,0,0,8,8,0,0,2,2,8,0,11,19,1,2,1,4,4,0,13,17,5,0,1,6
180586.0,Nikolov Aleksandar,OH,Bulgaria,19.0,207.0,2022,Bulgaria,Canada,2022-06-12,False,2,3,12,17,0,0,7,7,13,6,13,32,2,5,3,10,5,3,22,30,8,1,1,10
180586.0,Nikolov Aleksandar,OH,Bulgaria,19.0,207.0,2022,Iran,Bulgaria,2022-06-21,True,0,4,5,9,0,0,1,1,20,4,7,31,0,2,1,3,6,0,13,19,0,1,1,2
180586.0,Nikolov Aleksandar,OH,Bulgaria,19.0,207.0,2022,Australia,Bulgaria,2022-06-24,False,2,2,12,16,2,0,0,2,12,4,9,25,3,3,3,9,9,5,25,39,4,2,1,7
180586.0,Nikolov Aleksandar,OH,Bulgaria,19.0,207.0,2022,USA,Bulgaria,2022-06-25,False,3,3,10,16,0,0,0,0,14,4,14,32,0,4,0,4,10,5,12,27,2,3,0,5
180586.0,Nikolov Aleksandar,OH,Bulgaria,19.0,207.0,2022,Bulgaria,Brazil,2022-06-26,False,1,0,6,7,0,0,0,0,4,2,2,8,0,1,0,1,1,3,3,7,0,0,0,0
180586.0,Nikolov Aleksandar,OH,Bulgaria,19.0,207.0,2022,Bulgaria,Italy,2022-07-05,False,0,2,6,8,0,0,0,0,11,2,5,18,0,0,0,0,5,2,24,31,0,1,0,1
180586.0,Nikolov Aleksandar,OH,Bulgaria,19.0,207.0,2022,Bulgaria,Slovenia,2022-07-07,False,0,6,9,15,0,0,0,0,10,6,7,23,3,3,0,6,2,1,22,25,1,0,0,1
180586.0,Nikolov Aleksandar,OH,Bulgaria,19.0,207.0,2022,Bulgaria,Netherlands,2022-07-08,True,0,4,14,18,0,0,1,1,14,3,7,24,0,3,0,3,4,3,24,31,0,2,0,2
180586.0,Nikolov Aleksandar,OH,Bulgaria,19.0,207.0,2022,China,Bulgaria,2022-07-09,False,0,0,10,10,0,0,1,1,11,2,7,20,0,2,0,2,1,2,24,27,2,0,0,2
173009.0,Ivanov Martin,L,Bulgaria,31.0,190.0,2022,Bulgaria,Serbia,2022-06-07,False,0,0,0,0,0,1,3,4,0,0,0,0,0,0,0,0,2,3,10,15,1,7,4,12
173009.0,Ivanov Martin,L,Bulgaria,31.0,190.0,2022,Bulgaria,Germany,2022-06-10,False,0,0,0,0,0,0,2,2,0,0,0,0,0,0,0,0,5,0,22,27,7,2,0,9
173009.0,Ivanov Martin,L,Bulgaria,31.0,190.0,2022,Bulgaria,Poland,2022-06-11,False,0,0,0,0,0,0,5,5,0,0,0,0,0,0,0,0,3,1,5,9,3,1,2,6
173009.0,Ivanov Martin,L,Bulgaria,31.0,190.0,2022,Bulgaria,Canada,2022-06-12,False,0,0,0,0,1,1,5,7,0,0,0,0,0,0,0,0,8,3,12,23,3,3,3,9
173009.0,Ivanov Martin,L,Bulgaria,31.0,190.0,2022,Iran,Bulgaria,2022-06-21,True,0,0,0,0,0,0,0,0,0,0,0,0,0,0,0,0,0,0,0,0,0,0,0,0
173009.0,Ivanov Martin,L,Bulgaria,31.0,190.0,2022,Australia,Bulgaria,2022-06-24,False,0,0,0,0,0,0,0,0,0,0,0,0,0,0,0,0,0,0,0,0,0,0,0,0
173009.0,Ivanov Martin,L,Bulgaria,31.0,190.0,2022,USA,Bulgaria,2022-06-25,False,0,0,0,0,0,0,0,0,0,0,0,0,0,0,0,0,0,0,0,0,0,0,0,0
173009.0,Ivanov Martin,L,Bulgaria,31.0,190.0,2022,Bulgaria,Brazil,2022-06-26,False,0,0,0,0,0,0,0,0,0,0,0,0,0,0,0,0,0,0,0,0,0,0,0,0
162249.0,Elser Jesse,OH,Canada,23.0,204.0,2022,Canada,Germany,2022-06-07,False,0,0,0,0,0,0,0,0,0,0,0,0,0,0,0,0,0,0,0,0,0,0,0,0
162249.0,Elser Jesse,OH,Canada,23.0,204.0,2022,France,Canada,2022-06-10,False,0,0,0,0,0,2,2,4,0,0,0,0,0,0,0,0,2,4,12,18,6,2,2,10
162249.0,Elser Jesse,OH,Canada,23.0,204.0,2022,Canada,Italy,2022-06-11,False,0,0,0,0,0,0,0,0,0,0,0,0,0,0,0,0,0,0,0,0,0,0,0,0
162249.0,Elser Jesse,OH,Canada,23.0,204.0,2022,Bulgaria,Canada,2022-06-12,True,0,0,0,0,0,0,0,0,0,0,0,0,0,0,0,0,0,0,0,0,0,0,0,0
136291.0,Hoag Nicholas,OH,Canada,30.0,200.0,2022,Canada,Germany,2022-06-07,False,2,4,10,16,0,0,6,6,10,2,3,15,0,2,1,3,4,2,11,17,3,1,0,4
136291.0,Hoag Nicholas,OH,Canada,30.0,200.0,2022,France,Canada,2022-06-10,False,0,0,4,4,0,0,0,0,0,0,0,0,0,0,0,0,0,0,0,0,0,0,0,0
136291.0,Hoag Nicholas,OH,Canada,30.0,200.0,2022,Canada,Italy,2022-06-11,False,0,1,10,11,0,0,5,5,5,4,9,18,1,0,0,1,2,0,10,12,4,0,0,4
136291.0,Hoag Nicholas,OH,Canada,30.0,200.0,2022,Bulgaria,Canada,2022-06-12,True,0,5,13,18,1,0,8,9,14,6,2,22,1,1,3,5,1,2,25,28,4,0,4,8
136291.0,Hoag Nicholas,OH,Canada,30.0,200.0,2022,Australia,Canada,2022-06-21,True,0,2,3,5,0,0,0,0,4,1,8,13,0,1,0,1,7,2,8,17,0,0,1,1
136291.0,Hoag Nicholas,OH,Canada,30.0,200.0,2022,Canada,Argentina,2022-07-05,False,0,0,5,5,0,0,0,0,0,0,0,0,0,0,0,0,0,0,0,0,0,1,0,1
136291.0,Hoag Nicholas,OH,Canada,30.0,200.0,2022,Canada,Brazil,2022-07-07,False,0,0,0,0,0,0,0,0,0,0,0,0,0,0,0,0,0,0,0,0,0,0,0,0
136291.0,Hoag Nicholas,OH,Canada,30.0,200.0,2022,Japan,Canada,2022-07-08,False,0,0,0,0,0,0,0,0,0,0,0,0,0,0,0,0,0,0,0,0,0,0,0,0
136291.0,Hoag Nicholas,OH,Canada,30.0,200.0,2022,Canada,USA,2022-07-09,False,0,0,0,0,0,0,0,0,0,0,0,0,0,0,0,0,0,0,0,0,0,0,0,0
157327.0,Loeppky Eric,OH,Canada,24.0,197.0,2022,Australia,Canada,2022-06-21,True,2,3,6,11,0,0,0,0,3,2,10,15,0,1,0,1,4,1,16,21,1,1,1,3
157327.0,Loeppky Eric,OH,Canada,24.0,197.0,2022,Poland,Canada,2022-06-23,False,0,1,2,3,0,0,0,0,0,0,0,0,0,0,0,0,0,0,0,0,0,0,0,0
157327.0,Loeppky Eric,OH,Canada,24.0,197.0,2022,Serbia,Canada,2022-06-24,False,4,6,9,19,0,0,3,3,14,5,7,26,1,2,0,3,2,1,26,29,0,2,0,2
157327.0,Loeppky Eric,OH,Canada,24.0,197.0,2022,Canada,Iran,2022-06-25,False,1,5,6,12,0,0,3,3,11,3,11,25,1,0,0,1,1,2,13,16,3,1,0,4
157327.0,Loeppky Eric,OH,Canada,24.0,197.0,2022,Canada,Argentina,2022-07-05,False,0,3,14,17,0,1,1,2,19,5,13,37,1,3,2,6,4,0,18,22,3,1,3,7
157327.0,Loeppky Eric,OH,Canada,24.0,197.0,2022,Canada,Brazil,2022-07-07,False,2,3,6,11,0,0,3,3,8,9,8,25,1,3,2,6,3,2,14,19,6,1,4,11
157327.0,Loeppky Eric,OH,Canada,24.0,197.0,2022,Japan,Canada,2022-07-08,False,0,3,3,6,2,0,4,6,4,3,5,12,0,0,0,0,3,1,5,9,2,0,2,4
157327.0,Loeppky Eric,OH,Canada,24.0,197.0,2022,Canada,USA,2022-07-09,False,0,0,0,0,0,0,0,0,1,0,0,1,0,0,0,0,0,1,2,3,0,0,1,1
140061.0,Maar Stephen Timothy,OH,Canada,28.0,201.0,2022,Canada,Germany,2022-06-07,False,1,1,9,11,0,0,3,3,17,8,9,34,0,3,2,5,1,1,10,12,3,0,3,6
140061.0,Maar Stephen Timothy,OH,Canada,28.0,201.0,2022,France,Canada,2022-06-10,False,2,2,8,12,0,0,0,0,10,7,7,24,0,3,2,5,2,1,10,13,6,2,3,11
140061.0,Maar Stephen Timothy,OH,Canada,28.0,201.0,2022,Canada,Italy,2022-06-11,False,0,2,7,9,0,0,4,4,6,3,16,25,0,4,0,4,5,1,12,18,4,0,1,5
140061.0,Maar Stephen Timothy,OH,Canada,28.0,201.0,2022,Bulgaria,Canada,2022-06-12,True,2,1,20,23,0,0,2,2,21,4,16,41,2,5,1,8,4,1,32,37,7,0,6,13
140061.0,Maar Stephen Timothy,OH,Canada,28.0,201.0,2022,Australia,Canada,2022-06-21,True,1,1,14,16,0,0,0,0,19,0,16,35,3,1,3,7,3,2,12,17,2,1,2,5
140061.0,Maar Stephen Timothy,OH,Canada,28.0,201.0,2022,Poland,Canada,2022-06-23,False,0,0,0,0,0,0,0,0,0,0,0,0,0,0,0,0,0,0,1,1,0,0,0,0
140061.0,Maar Stephen Timothy,OH,Canada,28.0,201.0,2022,Serbia,Canada,2022-06-24,False,3,1,14,18,0,0,2,2,18,5,13,36,1,7,2,10,5,1,16,22,0,1,0,1
140061.0,Maar Stephen Timothy,OH,Canada,28.0,201.0,2022,Canada,Iran,2022-06-25,False,2,4,8,14,0,0,2,2,14,2,11,27,2,3,0,5,4,1,16,21,4,3,0,7
140061.0,Maar Stephen Timothy,OH,Canada,28.0,201.0,2022,Canada,Argentina,2022-07-05,False,2,6,5,13,0,0,1,1,10,9,12,31,0,5,3,8,6,1,25,32,11,2,1,14
140061.0,Maar Stephen Timothy,OH,Canada,28.0,201.0,2022,Canada,Brazil,2022-07-07,False,0,0,0,0,0,0,0,0,0,0,0,0,0,0,0,0,0,0,0,0,0,0,0,0
140061.0,Maar Stephen Timothy,OH,Canada,28.0,201.0,2022,Japan,Canada,2022-07-08,False,2,2,9,13,1,0,4,5,17,6,14,37,1,3,4,8,10,2,22,34,11,4,1,16
140061.0,Maar Stephen Timothy,OH,Canada,28.0,201.0,2022,Canada,USA,2022-07-09,False,0,2,7,9,1,0,4,5,7,4,15,26,0,3,1,4,5,1,8,14,2,1,1,4
143745.0,Walsh Brett James,S,Canada,29.0,196.0,2022,Canada,Germany,2022-06-07,False,1,0,2,3,2,0,8,10,0,0,0,0,0,0,0,0,0,0,0,0,0,1,0,1
143745.0,Walsh Brett James,S,Canada,29.0,196.0,2022,France,Canada,2022-06-10,False,1,1,7,9,28,0,31,59,1,0,2,3,2,2,2,6,0,0,0,0,5,1,1,7
143745.0,Walsh Brett James,S,Canada,29.0,196.0,2022,Canada,Italy,2022-06-11,False,0,0,2,2,0,0,25,25,0,0,0,0,0,1,0,1,0,0,0,0,0,0,0,0
143745.0,Walsh Brett James,S,Canada,29.0,196.0,2022,Bulgaria,Canada,2022-06-12,True,0,3,11,14,53,2,44,99,3,0,3,6,3,2,8,13,0,0,0,0,6,1,0,7
143745.0,Walsh Brett James,S,Canada,29.0,196.0,2022,Australia,Canada,2022-06-21,True,0,0,12,12,29,0,59,88,1,0,0,1,0,1,3,4,0,0,0,0,1,0,0,1
143745.0,Walsh Brett James,S,Canada,29.0,196.0,2022,Poland,Canada,2022-06-23,False,1,1,7,9,9,1,58,68,0,0,0,0,0,2,1,3,0,0,0,0,1,1,0,2
143745.0,Walsh Brett James,S,Canada,29.0,196.0,2022,Serbia,Canada,2022-06-24,False,0,1,14,15,24,2,64,90,0,1,1,2,0,1,0,1,0,0,0,0,2,1,0,3
143745.0,Walsh Brett James,S,Canada,29.0,196.0,2022,Canada,Iran,2022-06-25,False,1,2,4,7,16,0,24,40,0,0,1,1,0,2,0,2,0,0,0,0,1,0,0,1
124553.0,Blankenau Jay,S,Canada,33.0,194.0,2022,Canada,Germany,2022-06-07,False,0,1,3,4,18,1,34,53,0,0,0,0,0,3,1,4,0,0,0,0,5,2,1,8
124553.0,Blankenau Jay,S,Canada,33.0,194.0,2022,France,Canada,2022-06-10,False,0,0,0,0,0,0,0,0,0,0,0,0,0,0,0,0,0,0,0,0,0,0,0,0
124553.0,Blankenau Jay,S,Canada,33.0,194.0,2022,Canada,Italy,2022-06-11,False,0,0,3,3,0,0,40,40,0,0,0,0,0,0,1,1,0,0,2,2,4,2,0,6
124553.0,Blankenau Jay,S,Canada,33.0,194.0,2022,Bulgaria,Canada,2022-06-12,True,0,0,0,0,0,0,0,0,0,0,0,0,0,0,0,0,0,0,0,0,0,0,0,0
124553.0,Blankenau Jay,S,Canada,33.0,194.0,2022,Canada,Argentina,2022-07-05,False,0,0,0,0,0,0,0,0,0,0,0,0,0,0,0,0,0,0,0,0,0,0,0,0
124553.0,Blankenau Jay,S,Canada,33.0,194.0,2022,Canada,Brazil,2022-07-07,False,2,1,7,10,24,2,40,66,0,0,1,1,0,0,5,5,0,0,0,0,3,1,1,5
124553.0,Blankenau Jay,S,Canada,33.0,194.0,2022,Japan,Canada,2022-07-08,False,0,1,8,9,26,1,26,53,2,0,1,3,0,2,1,3,0,0,0,0,7,1,1,9
124553.0,Blankenau Jay,S,Canada,33.0,194.0,2022,Canada,USA,2022-07-09,False,0,0,1,1,0,0,5,5,0,0,0,0,0,0,0,0,0,0,0,0,0,2,1,3
140428.0,Sclater Ryan Joseph,O,Canada,29.0,200.0,2022,Canada,Germany,2022-06-07,False,0,0,13,13,0,0,0,0,6,3,5,14,0,2,4,6,0,1,3,4,6,2,2,10
140428.0,Sclater Ryan Joseph,O,Canada,29.0,200.0,2022,France,Canada,2022-06-10,False,1,2,9,12,0,1,3,4,5,1,4,10,1,0,5,6,0,0,8,8,4,1,2,7
140428.0,Sclater Ryan Joseph,O,Canada,29.0,200.0,2022,Canada,Italy,2022-06-11,False,0,3,3,6,0,0,2,2,3,5,8,16,0,2,0,2,2,0,4,6,4,0,0,4
140428.0,Sclater Ryan Joseph,O,Canada,29.0,200.0,2022,Bulgaria,Canada,2022-06-12,True,4,4,11,19,0,0,1,1,11,4,9,24,2,3,2,7,0,1,0,1,6,2,0,8
140428.0,Sclater Ryan Joseph,O,Canada,29.0,200.0,2022,Australia,Canada,2022-06-21,True,2,2,14,18,0,0,0,0,13,4,7,24,1,2,3,6,0,0,2,2,2,0,0,2
140428.0,Sclater Ryan Joseph,O,Canada,29.0,200.0,2022,Poland,Canada,2022-06-23,False,0,0,0,0,0,0,0,0,0,0,0,0,0,0,0,0,0,0,0,0,0,0,0,0
140428.0,Sclater Ryan Joseph,O,Canada,29.0,200.0,2022,Serbia,Canada,2022-06-24,False,1,5,13,19,1,0,0,1,13,2,6,21,3,3,0,6,0,1,6,7,4,1,2,7
140428.0,Sclater Ryan Joseph,O,Canada,29.0,200.0,2022,Canada,Iran,2022-06-25,False,0,3,6,9,0,0,0,0,8,2,3,13,0,0,0,0,0,0,2,2,3,1,0,4
140428.0,Sclater Ryan Joseph,O,Canada,29.0,200.0,2022,Canada,Argentina,2022-07-05,False,1,8,7,16,0,0,2,2,13,0,7,20,2,5,8,15,0,1,2,3,4,0,1,5
140428.0,Sclater Ryan Joseph,O,Canada,29.0,200.0,2022,Canada,Brazil,2022-07-07,False,0,0,2,2,0,0,0,0,0,0,0,0,0,0,0,0,0,0,0,0,0,1,0,1
140428.0,Sclater Ryan Joseph,O,Canada,29.0,200.0,2022,Japan,Canada,2022-07-08,False,0,3,3,6,0,0,1,1,4,0,6,10,1,1,4,6,0,0,3,3,4,1,0,5
140428.0,Sclater Ryan Joseph,O,Canada,29.0,200.0,2022,Canada,USA,2022-07-09,False,0,0,3,3,0,0,0,0,7,2,6,15,0,0,2,2,0,0,2,2,5,1,1,7
157324.0,Eshenko Pearson,MB,Canada,25.0,204.0,2022,Canada,Germany,2022-06-07,False,0,3,2,5,0,0,0,0,0,1,0,1,1,2,3,6,1,0,1,2,0,0,1,1
157324.0,Eshenko Pearson,MB,Canada,25.0,204.0,2022,France,Canada,2022-06-10,False,1,3,3,7,0,0,0,0,4,1,4,9,3,4,2,9,0,0,2,2,0,0,1,1
157324.0,Eshenko Pearson,MB,Canada,25.0,204.0,2022,Canada,Italy,2022-06-11,False,0,0,7,7,0,0,0,0,2,0,1,3,5,0,1,6,0,1,1,2,1,1,0,2
157324.0,Eshenko Pearson,MB,Canada,25.0,204.0,2022,Bulgaria,Canada,2022-06-12,True,0,0,0,0,0,0,0,0,0,0,0,0,0,0,0,0,0,0,0,0,0,0,0,0
157324.0,Eshenko Pearson,MB,Canada,25.0,204.0,2022,Australia,Canada,2022-06-21,True,1,2,5,8,0,0,0,0,2,1,3,6,2,2,0,4,0,0,1,1,0,0,1,1
157324.0,Eshenko Pearson,MB,Canada,25.0,204.0,2022,Poland,Canada,2022-06-23,False,0,2,4,6,0,0,0,0,3,0,2,5,1,3,2,6,2,0,0,2,0,0,0,0
157324.0,Eshenko Pearson,MB,Canada,25.0,204.0,2022,Serbia,Canada,2022-06-24,False,0,0,0,0,0,0,0,0,0,0,0,0,0,0,0,0,0,0,0,0,0,0,0,0
157324.0,Eshenko Pearson,MB,Canada,25.0,204.0,2022,Canada,Iran,2022-06-25,False,0,1,8,9,0,0,1,1,3,2,5,10,0,6,2,8,0,0,0,0,1,0,0,1
157324.0,Eshenko Pearson,MB,Canada,25.0,204.0,2022,Canada,Argentina,2022-07-05,False,0,1,10,11,0,0,0,0,3,2,1,6,0,6,5,11,0,0,0,0,1,2,0,3
157324.0,Eshenko Pearson,MB,Canada,25.0,204.0,2022,Canada,Brazil,2022-07-07,False,0,0,0,0,0,0,0,0,0,0,0,0,0,0,0,0,0,0,0,0,0,0,0,0
157324.0,Eshenko Pearson,MB,Canada,25.0,204.0,2022,Japan,Canada,2022-07-08,False,0,3,5,8,0,0,0,0,7,3,2,12,0,5,2,7,4,2,4,10,0,0,0,0
157324.0,Eshenko Pearson,MB,Canada,25.0,204.0,2022,Canada,USA,2022-07-09,False,0,0,6,6,0,0,1,1,2,1,1,4,0,6,3,9,0,0,0,0,1,2,2,5
136296.0,Van Berkel Lucas,MB,Canada,31.0,210.0,2022,Canada,Germany,2022-06-07,False,0,0,5,5,0,0,0,0,1,0,1,2,1,2,5,8,0,0,0,0,0,0,0,0
136296.0,Van Berkel Lucas,MB,Canada,31.0,210.0,2022,France,Canada,2022-06-10,False,0,1,5,6,0,0,0,0,2,3,2,7,0,3,6,9,0,0,0,0,0,0,0,0
136296.0,Van Berkel Lucas,MB,Canada,31.0,210.0,2022,Canada,Italy,2022-06-11,False,0,0,1,1,0,0,0,0,0,0,0,0,0,0,0,0,0,0,0,0,0,0,0,0
136296.0,Van Berkel Lucas,MB,Canada,31.0,210.0,2022,Bulgaria,Canada,2022-06-12,True,0,0,15,15,1,0,1,2,9,2,1,12,2,8,7,17,0,1,2,3,5,0,1,6
136296.0,Van Berkel Lucas,MB,Canada,31.0,210.0,2022,Australia,Canada,2022-06-21,True,0,1,5,6,0,0,0,0,4,1,0,5,0,3,0,3,0,0,0,0,0,1,0,1
136296.0,Van Berkel Lucas,MB,Canada,31.0,210.0,2022,Poland,Canada,2022-06-23,False,0,0,2,2,0,0,0,0,2,0,2,4,0,5,0,5,1,0,1,2,0,1,0,1
136296.0,Van Berkel Lucas,MB,Canada,31.0,210.0,2022,Serbia,Canada,2022-06-24,False,0,1,5,6,0,0,0,0,2,0,1,3,2,2,6,10,0,0,2,2,0,0,0,0
136296.0,Van Berkel Lucas,MB,Canada,31.0,210.0,2022,Canada,Iran,2022-06-25,False,0,0,0,0,0,0,0,0,0,0,0,0,0,0,0,0,0,0,0,0,0,0,0,0
136296.0,Van Berkel Lucas,MB,Canada,31.0,210.0,2022,Canada,Argentina,2022-07-05,False,0,0,2,2,0,0,0,0,2,0,0,2,0,1,1,2,0,0,1,1,1,0,0,1
136296.0,Van Berkel Lucas,MB,Canada,31.0,210.0,2022,Canada,Brazil,2022-07-07,False,0,0,9,9,0,0,3,3,1,2,3,6,0,5,1,6,1,0,3,4,1,1,0,2
136296.0,Van Berkel Lucas,MB,Canada,31.0,210.0,2022,Japan,Canada,2022-07-08,False,0,0,0,0,0,0,0,0,0,0,0,0,0,0,0,0,0,0,0,0,0,0,0,0
136296.0,Van Berkel Lucas,MB,Canada,31.0,210.0,2022,Canada,USA,2022-07-09,False,0,0,9,9,1,0,0,1,2,0,2,4,0,8,1,9,0,0,4,4,3,0,2,5
153661.0,Wilson Marc Major,L,Canada,31.0,203.0,2022,Canada,Germany,2022-06-07,False,0,0,0,0,0,0,0,0,0,0,0,0,0,0,0,0,0,0,0,0,0,0,0,0
153661.0,Wilson Marc Major,L,Canada,31.0,203.0,2022,France,Canada,2022-06-10,False,0,1,1,2,0,0,1,1,2,0,1,3,1,1,2,4,0,0,0,0,0,0,0,0
153661.0,Wilson Marc Major,L,Canada,31.0,203.0,2022,Canada,Italy,2022-06-11,False,0,1,3,4,0,0,0,0,2,1,1,4,0,1,0,1,0,0,1,1,0,0,0,0
153661.0,Wilson Marc Major,L,Canada,31.0,203.0,2022,Bulgaria,Canada,2022-06-12,True,0,0,0,0,0,0,0,0,0,0,0,0,0,0,0,0,0,0,0,0,0,0,0,0
153661.0,Wilson Marc Major,L,Canada,31.0,203.0,2022,Australia,Canada,2022-06-21,True,0,0,0,0,0,0,0,0,0,0,0,0,0,0,0,0,0,0,0,0,0,0,0,0
153661.0,Wilson Marc Major,L,Canada,31.0,203.0,2022,Poland,Canada,2022-06-23,False,0,0,4,4,0,0,0,0,0,0,0,0,0,1,0,1,0,0,0,0,0,1,0,1
153661.0,Wilson Marc Major,L,Canada,31.0,203.0,2022,Serbia,Canada,2022-06-24,False,0,0,0,0,0,0,0,0,0,0,0,0,0,0,0,0,0,0,0,0,0,0,0,0
153661.0,Wilson Marc Major,L,Canada,31.0,203.0,2022,Canada,Iran,2022-06-25,False,0,0,0,0,0,0,0,0,0,0,0,0,0,0,0,0,0,0,0,0,0,0,0,0
140057.0,Barnes Ryley Brendan,OH,Canada,29.0,200.0,2022,Canada,Germany,2022-06-07,False,0,0,0,0,0,0,0,0,0,0,0,0,0,0,0,0,0,0,0,0,0,0,0,0
140057.0,Barnes Ryley Brendan,OH,Canada,29.0,200.0,2022,France,Canada,2022-06-10,False,0,2,2,4,0,0,0,0,3,3,5,11,0,2,0,2,0,0,7,7,1,1,2,4
140057.0,Barnes Ryley Brendan,OH,Canada,29.0,200.0,2022,Canada,Italy,2022-06-11,False,0,0,0,0,0,0,0,0,0,0,0,0,0,0,0,0,0,0,0,0,0,0,0,0
140057.0,Barnes Ryley Brendan,OH,Canada,29.0,200.0,2022,Bulgaria,Canada,2022-06-12,True,0,0,0,0,0,0,0,0,0,0,0,0,0,0,0,0,0,0,0,0,0,0,0,0
140057.0,Barnes Ryley Brendan,OH,Canada,29.0,200.0,2022,Australia,Canada,2022-06-21,True,0,0,0,0,2,0,0,2,0,0,0,0,0,0,0,0,2,1,4,7,5,1,0,6
140057.0,Barnes Ryley Brendan,OH,Canada,29.0,200.0,2022,Poland,Canada,2022-06-23,False,0,5,4,9,0,0,1,1,9,5,9,23,0,3,1,4,1,0,11,12,0,2,0,2
140057.0,Barnes Ryley Brendan,OH,Canada,29.0,200.0,2022,Serbia,Canada,2022-06-24,False,0,0,0,0,1,0,3,4,0,0,0,0,0,0,0,0,7,0,13,20,3,1,0,4
140057.0,Barnes Ryley Brendan,OH,Canada,29.0,200.0,2022,Canada,Iran,2022-06-25,False,0,0,0,0,0,0,2,2,0,0,0,0,0,0,0,0,5,1,17,23,1,5,2,8
140057.0,Barnes Ryley Brendan,OH,Canada,29.0,200.0,2022,Canada,Argentina,2022-07-05,False,0,0,0,0,1,0,3,4,0,0,0,0,0,0,0,0,2,2,14,18,4,4,3,11
140057.0,Barnes Ryley Brendan,OH,Canada,29.0,200.0,2022,Canada,Brazil,2022-07-07,False,0,0,0,0,0,0,0,0,0,0,0,0,0,0,0,0,0,0,0,0,0,0,0,0
140057.0,Barnes Ryley Brendan,OH,Canada,29.0,200.0,2022,Japan,Canada,2022-07-08,False,0,0,0,0,0,0,0,0,0,0,0,0,0,0,0,0,1,2,7,10,2,2,0,4
140057.0,Barnes Ryley Brendan,OH,Canada,29.0,200.0,2022,Canada,USA,2022-07-09,False,0,0,0,0,0,0,0,0,0,0,0,0,0,0,0,0,0,0,0,0,0,0,0,0
168925.0,Lui Justin,L,Canada,22.0,178.0,2022,Canada,Germany,2022-06-07,False,0,0,0,0,0,1,3,4,0,0,0,0,0,0,0,0,3,4,17,24,5,3,1,9
168925.0,Lui Justin,L,Canada,22.0,178.0,2022,France,Canada,2022-06-10,False,0,0,0,0,0,0,0,0,0,0,0,0,0,0,0,0,0,0,0,0,0,0,0,0
168925.0,Lui Justin,L,Canada,22.0,178.0,2022,Canada,Italy,2022-06-11,False,0,0,0,0,0,0,4,4,0,0,0,0,0,0,0,0,2,0,14,16,4,2,0,6
168925.0,Lui Justin,L,Canada,22.0,178.0,2022,Bulgaria,Canada,2022-06-12,True,0,0,0,0,0,1,1,2,0,0,0,0,0,0,0,0,1,2,12,15,7,2,6,15
168925.0,Lui Justin,L,Canada,22.0,178.0,2022,Australia,Canada,2022-06-21,True,0,0,0,0,0,0,0,0,0,0,0,0,0,0,0,0,3,1,3,7,0,0,1,1
168925.0,Lui Justin,L,Canada,22.0,178.0,2022,Poland,Canada,2022-06-23,False,0,0,0,0,0,0,1,1,0,0,0,0,0,0,0,0,1,1,11,13,3,1,0,4
168925.0,Lui Justin,L,Canada,22.0,178.0,2022,Serbia,Canada,2022-06-24,False,0,0,0,0,0,0,0,0,0,0,0,0,0,0,0,0,0,0,0,0,0,0,0,0
168925.0,Lui Justin,L,Canada,22.0,178.0,2022,Canada,Iran,2022-06-25,False,0,0,0,0,0,0,0,0,0,0,0,0,0,0,0,0,0,0,0,0,0,0,0,0
168925.0,Lui Justin,L,Canada,22.0,178.0,2022,Canada,Argentina,2022-07-05,False,0,0,0,0,1,0,0,1,0,0,0,0,0,0,0,0,0,0,1,1,5,3,0,8
168925.0,Lui Justin,L,Canada,22.0,178.0,2022,Canada,Brazil,2022-07-07,False,0,0,0,0,0,0,5,5,0,0,0,0,0,0,0,0,4,0,11,15,7,3,4,14
168925.0,Lui Justin,L,Canada,22.0,178.0,2022,Japan,Canada,2022-07-08,False,0,0,0,0,0,0,2,2,0,0,0,0,0,0,0,0,1,0,3,4,3,1,1,5
168925.0,Lui Justin,L,Canada,22.0,178.0,2022,Canada,USA,2022-07-09,False,0,0,0,0,0,0,5,5,0,0,0,0,0,0,0,0,7,1,12,20,5,3,0,8
168914.0,Hofer Brodie,OH,Canada,22.0,200.0,2022,Canada,Germany,2022-06-07,False,0,1,2,3,0,0,0,0,1,0,3,4,0,1,0,1,0,0,0,0,0,1,0,1
168914.0,Hofer Brodie,OH,Canada,22.0,200.0,2022,France,Canada,2022-06-10,False,0,1,0,1,0,0,0,0,0,0,0,0,0,0,0,0,0,0,0,0,0,0,0,0
168914.0,Hofer Brodie,OH,Canada,22.0,200.0,2022,Canada,Italy,2022-06-11,False,0,0,4,4,0,0,0,0,1,0,1,2,1,1,0,2,0,0,0,0,2,0,0,2
168914.0,Hofer Brodie,OH,Canada,22.0,200.0,2022,Bulgaria,Canada,2022-06-12,True,0,2,2,4,0,0,0,0,0,0,0,0,0,0,0,0,0,0,0,0,1,0,0,1
168914.0,Hofer Brodie,OH,Canada,22.0,200.0,2022,Australia,Canada,2022-06-21,True,0,1,2,3,0,0,0,0,2,2,0,4,0,1,0,1,0,0,1,1,0,0,0,0
168914.0,Hofer Brodie,OH,Canada,22.0,200.0,2022,Poland,Canada,2022-06-23,False,2,3,5,10,0,0,0,0,2,1,10,13,0,1,0,1,0,0,4,4,2,1,0,3
168914.0,Hofer Brodie,OH,Canada,22.0,200.0,2022,Serbia,Canada,2022-06-24,False,0,2,7,9,0,0,0,0,0,0,0,0,0,0,0,0,0,0,0,0,1,0,0,1
168914.0,Hofer Brodie,OH,Canada,22.0,200.0,2022,Canada,Iran,2022-06-25,False,0,2,1,3,0,0,0,0,0,0,0,0,0,0,0,0,0,0,0,0,0,0,0,0
168914.0,Hofer Brodie,OH,Canada,22.0,200.0,2022,Canada,Argentina,2022-07-05,False,0,0,0,0,0,0,0,0,0,0,0,0,0,0,0,0,0,0,0,0,0,0,0,0
168914.0,Hofer Brodie,OH,Canada,22.0,200.0,2022,Canada,Brazil,2022-07-07,False,1,2,7,10,0,0,2,2,12,2,3,17,0,2,1,3,1,1,3,5,2,0,2,4
168914.0,Hofer Brodie,OH,Canada,22.0,200.0,2022,Japan,Canada,2022-07-08,False,5,2,6,13,0,0,1,1,5,3,4,12,0,1,2,3,0,0,1,1,2,2,1,5
168914.0,Hofer Brodie,OH,Canada,22.0,200.0,2022,Canada,USA,2022-07-09,False,1,0,5,6,0,0,0,0,7,3,4,14,0,0,1,1,0,0,1,1,0,1,0,1
157332.0,Epp Derek,S,Canada,24.0,201.0,2022,Australia,Canada,2022-06-21,True,0,0,0,0,7,0,7,14,0,0,0,0,0,0,0,0,0,0,0,0,0,0,0,0
157332.0,Epp Derek,S,Canada,24.0,201.0,2022,Canada,Iran,2022-06-25,False,0,2,1,3,6,0,26,32,0,0,0,0,0,1,0,1,0,0,0,0,1,0,1,2
157332.0,Epp Derek,S,Canada,24.0,201.0,2022,Canada,Argentina,2022-07-05,False,0,3,13,16,32,1,64,97,1,1,0,2,0,1,5,6,0,0,0,0,5,3,0,8
157332.0,Epp Derek,S,Canada,24.0,201.0,2022,Canada,Brazil,2022-07-07,False,0,0,0,0,1,0,6,7,0,0,0,0,0,0,0,0,0,0,0,0,0,0,1,1
157332.0,Epp Derek,S,Canada,24.0,201.0,2022,Japan,Canada,2022-07-08,False,0,0,3,3,18,0,17,35,0,0,0,0,0,2,2,4,0,0,0,0,3,3,2,8
157332.0,Epp Derek,S,Canada,24.0,201.0,2022,Canada,USA,2022-07-09,False,0,4,8,12,18,0,42,60,1,0,2,3,1,2,0,3,0,0,1,1,4,2,2,8
169578.0,Howe Jackson,MB,Canada,24.0,198.0,2022,Canada,Germany,2022-06-07,False,0,1,5,6,0,0,1,1,2,2,0,4,2,4,3,9,1,0,2,3,1,0,0,1
169578.0,Howe Jackson,MB,Canada,24.0,198.0,2022,France,Canada,2022-06-10,False,0,0,0,0,0,0,0,0,0,0,0,0,0,0,0,0,0,0,0,0,0,0,0,0
169578.0,Howe Jackson,MB,Canada,24.0,198.0,2022,Canada,Italy,2022-06-11,False,0,1,5,6,0,0,0,0,6,0,1,7,2,4,0,6,0,1,2,3,0,0,0,0
169578.0,Howe Jackson,MB,Canada,24.0,198.0,2022,Bulgaria,Canada,2022-06-12,True,0,3,6,9,0,0,1,1,8,0,3,11,4,9,3,16,0,0,1,1,0,1,1,2
169578.0,Howe Jackson,MB,Canada,24.0,198.0,2022,Australia,Canada,2022-06-21,True,1,3,8,12,0,0,0,0,5,2,2,9,1,4,1,6,3,1,0,4,0,1,0,1
169578.0,Howe Jackson,MB,Canada,24.0,198.0,2022,Poland,Canada,2022-06-23,False,0,0,0,0,0,0,0,0,0,0,0,0,0,0,0,0,0,0,0,0,0,0,0,0
169578.0,Howe Jackson,MB,Canada,24.0,198.0,2022,Serbia,Canada,2022-06-24,False,0,6,8,14,0,0,0,0,7,2,3,12,2,7,2,11,0,0,3,3,0,1,0,1
169578.0,Howe Jackson,MB,Canada,24.0,198.0,2022,Canada,Iran,2022-06-25,False,0,0,6,6,0,0,0,0,3,1,1,5,0,2,0,2,0,0,0,0,0,0,0,0
169578.0,Howe Jackson,MB,Canada,24.0,198.0,2022,Canada,Argentina,2022-07-05,False,0,0,10,10,0,0,0,0,5,3,2,10,1,3,5,9,0,0,0,0,1,1,0,2
169578.0,Howe Jackson,MB,Canada,24.0,198.0,2022,Canada,Brazil,2022-07-07,False,0,1,5,6,0,0,0,0,7,2,3,12,0,5,4,9,0,0,0,0,1,0,1,2
169578.0,Howe Jackson,MB,Canada,24.0,198.0,2022,Japan,Canada,2022-07-08,False,1,1,9,11,0,0,0,0,2,1,6,9,1,5,5,11,2,0,0,2,1,0,1,2
169578.0,Howe Jackson,MB,Canada,24.0,198.0,2022,Canada,USA,2022-07-09,False,0,0,0,0,0,0,0,0,0,0,0,0,0,0,0,0,0,0,0,0,0,0,0,0
168908.0,Elser Mathias,OH,Canada,21.0,198.0,2022,Canada,Germany,2022-06-07,False,0,0,3,3,0,0,0,0,0,0,0,0,0,0,0,0,0,0,0,0,1,0,0,1
168908.0,Elser Mathias,OH,Canada,21.0,198.0,2022,France,Canada,2022-06-10,False,0,1,4,5,0,0,1,1,1,0,2,3,0,1,0,1,2,1,6,9,0,1,0,1
168908.0,Elser Mathias,OH,Canada,21.0,198.0,2022,Canada,Italy,2022-06-11,False,0,0,7,7,0,0,2,2,2,1,3,6,0,2,0,2,0,0,1,1,0,1,0,1
168908.0,Elser Mathias,OH,Canada,21.0,198.0,2022,Bulgaria,Canada,2022-06-12,True,1,2,4,7,0,0,0,0,0,0,0,0,0,0,0,0,0,0,0,0,0,0,0,0
168908.0,Elser Mathias,OH,Canada,21.0,198.0,2022,Australia,Canada,2022-06-21,True,0,2,2,4,0,0,0,0,0,0,0,0,0,0,0,0,0,0,0,0,0,0,0,0
168908.0,Elser Mathias,OH,Canada,21.0,198.0,2022,Poland,Canada,2022-06-23,False,0,1,3,4,0,0,0,0,6,5,3,14,1,0,0,1,2,2,11,15,0,0,0,0
168908.0,Elser Mathias,OH,Canada,21.0,198.0,2022,Serbia,Canada,2022-06-24,False,0,3,2,5,0,0,0,0,0,0,0,0,0,0,0,0,0,0,0,0,0,0,0,0
168908.0,Elser Mathias,OH,Canada,21.0,198.0,2022,Canada,Iran,2022-06-25,False,0,1,0,1,0,0,0,0,0,0,0,0,0,0,0,0,0,0,0,0,0,0,0,0
168908.0,Elser Mathias,OH,Canada,21.0,198.0,2022,Canada,Argentina,2022-07-05,False,0,0,2,2,0,0,0,0,0,0,0,0,0,0,0,0,0,0,0,0,0,0,0,0
168908.0,Elser Mathias,OH,Canada,21.0,198.0,2022,Canada,Brazil,2022-07-07,False,0,2,4,6,0,0,3,3,8,0,8,16,0,2,3,5,6,1,16,23,3,3,0,6
168908.0,Elser Mathias,OH,Canada,21.0,198.0,2022,Japan,Canada,2022-07-08,False,0,2,11,13,0,0,2,2,9,2,5,16,1,0,1,2,0,0,8,8,1,1,1,3
168908.0,Elser Mathias,OH,Canada,21.0,198.0,2022,Canada,USA,2022-07-09,False,0,0,0,0,0,0,0,0,0,0,0,0,0,0,0,0,0,0,0,0,0,0,0,0
182679.0,Cooper Samuel,OH,Canada,21.0,200.0,2022,Poland,Canada,2022-06-23,False,0,2,3,5,0,0,0,0,6,1,3,10,0,0,0,0,1,1,9,11,1,0,0,1
182679.0,Cooper Samuel,OH,Canada,21.0,200.0,2022,Serbia,Canada,2022-06-24,False,0,1,0,1,0,0,0,0,0,0,0,0,0,0,0,0,0,0,0,0,0,0,0,0
182679.0,Cooper Samuel,OH,Canada,21.0,200.0,2022,Canada,Iran,2022-06-25,False,0,2,0,2,0,0,0,0,1,0,1,2,0,1,0,1,0,0,0,0,0,0,1,1
182679.0,Cooper Samuel,OH,Canada,21.0,200.0,2022,Canada,Argentina,2022-07-05,False,0,0,0,0,0,0,0,0,0,0,0,0,0,0,0,0,0,0,0,0,0,0,0,0
182679.0,Cooper Samuel,OH,Canada,21.0,200.0,2022,Canada,Brazil,2022-07-07,False,0,1,0,1,1,0,1,2,0,1,2,3,0,1,3,4,0,0,1,1,0,0,0,0
182679.0,Cooper Samuel,OH,Canada,21.0,200.0,2022,Japan,Canada,2022-07-08,False,0,0,0,0,0,0,0,0,0,0,0,0,0,0,1,1,0,0,0,0,0,0,0,0
182679.0,Cooper Samuel,OH,Canada,21.0,200.0,2022,Canada,USA,2022-07-09,False,1,3,4,8,1,0,4,5,7,3,6,16,0,2,0,2,5,2,9,16,2,1,4,7
174295.0,Yang Yiming,L,China,23.0,186.0,2022,China,Iran,2022-06-07,False,0,0,0,0,0,0,0,0,0,0,0,0,0,0,0,0,0,0,0,0,0,0,0,0
174295.0,Yang Yiming,L,China,23.0,186.0,2022,Japan,China,2022-06-09,False,0,0,0,0,3,0,1,4,0,0,0,0,0,0,0,0,5,1,12,18,3,2,0,5
174295.0,Yang Yiming,L,China,23.0,186.0,2022,Slovenia,China,2022-06-11,False,0,0,0,0,3,0,2,5,0,0,0,0,0,0,0,0,3,0,12,15,3,3,1,7
174295.0,Yang Yiming,L,China,23.0,186.0,2022,Brazil,China,2022-06-12,True,0,0,0,0,1,0,0,1,0,0,0,0,0,0,0,0,6,1,14,21,6,1,1,8
174295.0,Yang Yiming,L,China,23.0,186.0,2022,Argentina,China,2022-06-24,False,0,0,0,0,0,0,7,7,0,0,0,0,0,0,0,0,7,1,23,31,13,2,2,17
174295.0,Yang Yiming,L,China,23.0,186.0,2022,Italy,China,2022-06-26,False,0,0,0,0,1,0,5,6,0,0,0,0,0,0,0,0,1,1,4,6,6,2,1,9
174295.0,Yang Yiming,L,China,23.0,186.0,2022,Netherlands,China,2022-07-06,False,0,0,0,0,0,0,3,3,0,0,0,0,0,0,0,0,2,5,9,16,3,2,1,6
174295.0,Yang Yiming,L,China,23.0,186.0,2022,Poland,China,2022-07-07,False,0,0,0,0,0,0,0,0,0,0,0,0,0,0,0,0,4,5,8,17,1,1,0,2
174295.0,Yang Yiming,L,China,23.0,186.0,2022,China,Bulgaria,2022-07-09,True,0,0,0,0,0,0,1,1,0,0,0,0,0,0,0,0,1,1,10,12,1,2,0,3
174295.0,Yang Yiming,L,China,23.0,186.0,2022,China,Serbia,2022-07-10,False,0,0,0,0,0,0,0,0,0,0,0,0,0,0,0,0,8,4,23,35,2,0,1,3
153610.0,Zhang Binglong,OH,China,28.0,197.0,2022,China,Iran,2022-06-07,False,0,0,0,0,0,0,0,0,0,0,0,0,0,0,0,0,0,0,0,0,0,0,0,0
153610.0,Zhang Binglong,OH,China,28.0,197.0,2022,Japan,China,2022-06-09,False,0,0,1,1,0,0,0,0,0,0,0,0,0,0,0,0,0,0,0,0,0,0,0,0
153610.0,Zhang Binglong,OH,China,28.0,197.0,2022,Slovenia,China,2022-06-11,False,0,0,1,1,0,0,0,0,0,0,0,0,0,0,0,0,0,0,0,0,0,0,0,0
153610.0,Zhang Binglong,OH,China,28.0,197.0,2022,Brazil,China,2022-06-12,True,0,0,0,0,0,0,0,0,0,0,0,0,0,0,0,0,0,0,0,0,0,0,0,0
153610.0,Zhang Binglong,OH,China,28.0,197.0,2022,Argentina,China,2022-06-24,False,0,1,6,7,0,0,0,0,0,0,1,1,0,0,0,0,0,0,0,0,0,0,0,0
153610.0,Zhang Binglong,OH,China,28.0,197.0,2022,Italy,China,2022-06-26,False,0,0,0,0,0,0,0,0,0,0,0,0,0,0,0,0,0,0,0,0,0,0,0,0
153610.0,Zhang Binglong,OH,China,28.0,197.0,2022,Netherlands,China,2022-07-06,False,0,0,2,2,0,0,1,1,0,2,0,2,0,1,0,1,4,2,6,12,0,0,0,0
153610.0,Zhang Binglong,OH,China,28.0,197.0,2022,Poland,China,2022-07-07,False,1,2,3,6,0,0,0,0,0,0,0,0,0,0,0,0,0,0,0,0,0,0,0,0
153610.0,Zhang Binglong,OH,China,28.0,197.0,2022,China,Bulgaria,2022-07-09,True,0,1,1,2,0,0,0,0,0,0,0,0,0,0,0,0,0,0,0,0,0,0,0,0
153610.0,Zhang Binglong,OH,China,28.0,197.0,2022,China,Serbia,2022-07-10,False,0,5,3,8,0,0,0,0,11,5,5,21,0,0,0,0,1,1,18,20,1,1,2,4
152518.0,Yu Yuantai,OH,China,25.0,186.0,2022,China,Iran,2022-06-07,False,2,1,12,15,0,0,3,3,13,5,8,26,1,1,0,2,3,3,4,10,2,2,2,6
152518.0,Yu Yuantai,OH,China,25.0,186.0,2022,Japan,China,2022-06-09,False,0,3,11,14,1,0,0,1,3,5,8,16,1,3,1,5,6,3,9,18,1,0,0,1
152518.0,Yu Yuantai,OH,China,25.0,186.0,2022,Slovenia,China,2022-06-11,False,0,2,10,12,0,0,2,2,4,1,4,9,2,1,1,4,5,1,19,25,5,0,1,6
152518.0,Yu Yuantai,OH,China,25.0,186.0,2022,Brazil,China,2022-06-12,True,1,2,11,14,2,0,0,2,4,2,2,8,1,1,0,2,4,1,11,16,4,0,0,4
152518.0,Yu Yuantai,OH,China,25.0,186.0,2022,Argentina,China,2022-06-24,False,0,1,11,12,0,0,1,1,9,2,6,17,0,2,0,2,5,0,5,10,7,2,0,9
152518.0,Yu Yuantai,OH,China,25.0,186.0,2022,Italy,China,2022-06-26,False,0,1,8,9,0,0,2,2,1,1,6,8,0,1,1,2,3,3,15,21,9,3,0,12
152518.0,Yu Yuantai,OH,China,25.0,186.0,2022,Netherlands,China,2022-07-06,False,0,1,5,6,0,0,0,0,1,1,2,4,0,1,0,1,1,0,5,6,1,0,0,1
152518.0,Yu Yuantai,OH,China,25.0,186.0,2022,Poland,China,2022-07-07,False,0,4,5,9,0,0,1,1,5,1,5,11,0,0,0,0,1,6,7,14,0,1,0,1
152518.0,Yu Yuantai,OH,China,25.0,186.0,2022,China,Bulgaria,2022-07-09,True,0,2,10,12,0,0,1,1,9,1,3,13,1,1,0,2,1,1,22,24,3,1,1,5
152518.0,Yu Yuantai,OH,China,25.0,186.0,2022,China,Serbia,2022-07-10,False,0,4,9,13,0,0,0,0,8,2,5,15,0,2,0,2,1,1,20,22,4,0,2,6
142593.0,Yu Yaochen,S,China,27.0,195.0,2022,China,Iran,2022-06-07,False,0,2,6,8,18,1,20,39,0,0,0,0,0,2,1,3,0,0,0,0,4,1,0,5
142593.0,Yu Yaochen,S,China,27.0,195.0,2022,Japan,China,2022-06-09,False,0,2,7,9,8,1,24,33,0,0,0,0,0,2,2,4,0,0,0,0,2,1,0,3
142593.0,Yu Yaochen,S,China,27.0,195.0,2022,Slovenia,China,2022-06-11,False,0,3,8,11,17,1,30,48,0,0,2,2,0,2,2,4,0,0,0,0,2,0,2,4
142593.0,Yu Yaochen,S,China,27.0,195.0,2022,Brazil,China,2022-06-12,True,0,1,13,14,26,0,46,72,1,0,0,1,3,2,3,8,0,0,0,0,2,1,1,4
142593.0,Yu Yaochen,S,China,27.0,195.0,2022,Argentina,China,2022-06-24,False,0,3,7,10,12,0,59,71,0,0,0,0,2,2,0,4,0,0,1,1,2,2,2,6
142593.0,Yu Yaochen,S,China,27.0,195.0,2022,Italy,China,2022-06-26,False,1,1,9,11,5,0,47,52,1,0,0,1,0,0,3,3,0,0,0,0,4,2,2,8
142593.0,Yu Yaochen,S,China,27.0,195.0,2022,Netherlands,China,2022-07-06,False,0,1,8,9,12,1,46,59,3,0,1,4,2,4,0,6,0,0,1,1,2,3,1,6
142593.0,Yu Yaochen,S,China,27.0,195.0,2022,Poland,China,2022-07-07,False,1,3,3,7,15,0,41,56,1,0,0,1,1,1,0,2,0,0,0,0,0,2,0,2
142593.0,Yu Yaochen,S,China,27.0,195.0,2022,China,Bulgaria,2022-07-09,True,1,0,13,14,23,0,61,84,2,0,1,3,1,2,0,3,1,0,0,1,2,1,0,3
142593.0,Yu Yaochen,S,China,27.0,195.0,2022,China,Serbia,2022-07-10,False,0,0,14,14,14,1,63,78,0,0,0,0,0,2,0,2,0,0,0,0,0,1,2,3
168272.0,Yang Tianyuan,L,China,28.0,180.0,2022,China,Iran,2022-06-07,False,0,0,0,0,0,1,2,3,0,0,0,0,0,0,0,0,6,5,16,27,3,1,2,6
168272.0,Yang Tianyuan,L,China,28.0,180.0,2022,Japan,China,2022-06-09,False,0,0,0,0,3,0,0,3,0,0,0,0,0,0,0,0,0,0,0,0,2,2,0,4
168272.0,Yang Tianyuan,L,China,28.0,180.0,2022,Slovenia,China,2022-06-11,False,0,0,0,0,0,0,0,0,0,0,0,0,0,0,0,0,0,0,0,0,0,0,0,0
168272.0,Yang Tianyuan,L,China,28.0,180.0,2022,Brazil,China,2022-06-12,True,0,0,0,0,1,0,0,1,0,0,0,0,0,0,0,0,0,0,0,0,0,0,0,0
168272.0,Yang Tianyuan,L,China,28.0,180.0,2022,Argentina,China,2022-06-24,False,0,0,0,0,0,0,0,0,0,0,0,0,0,0,0,0,0,0,0,0,0,0,0,0
168272.0,Yang Tianyuan,L,China,28.0,180.0,2022,Italy,China,2022-06-26,False,0,0,0,0,0,0,0,0,0,0,0,0,0,0,0,0,0,0,0,0,0,0,0,0
168272.0,Yang Tianyuan,L,China,28.0,180.0,2022,Netherlands,China,2022-07-06,False,0,0,0,0,0,0,0,0,0,0,0,0,0,0,0,0,0,0,0,0,0,0,0,0
168272.0,Yang Tianyuan,L,China,28.0,180.0,2022,Poland,China,2022-07-07,False,0,0,0,0,0,0,1,1,0,0,0,0,0,0,0,0,2,0,7,9,2,0,0,2
168272.0,Yang Tianyuan,L,China,28.0,180.0,2022,China,Bulgaria,2022-07-09,True,0,0,0,0,0,0,0,0,0,0,0,0,0,0,0,0,4,0,3,7,2,2,1,5
168272.0,Yang Tianyuan,L,China,28.0,180.0,2022,China,Serbia,2022-07-10,False,0,0,0,0,0,0,0,0,0,0,0,0,0,0,0,0,0,0,0,0,1,0,0,1
181103.0,Li Yongzhen,MB,China,24.0,198.0,2022,China,Iran,2022-06-07,False,0,4,10,14,0,2,0,2,5,1,1,7,3,5,2,10,0,0,1,1,0,0,1,1
181103.0,Li Yongzhen,MB,China,24.0,198.0,2022,Japan,China,2022-06-09,False,0,4,9,13,0,0,0,0,6,2,3,11,3,10,2,15,0,1,0,1,1,0,0,1
181103.0,Li Yongzhen,MB,China,24.0,198.0,2022,Slovenia,China,2022-06-11,False,0,3,9,12,0,1,0,1,6,3,1,10,2,7,4,13,0,0,0,0,1,0,0,1
181103.0,Li Yongzhen,MB,China,24.0,198.0,2022,Brazil,China,2022-06-12,True,0,2,7,9,0,0,0,0,4,1,0,5,3,4,3,10,0,0,0,0,1,1,0,2
181103.0,Li Yongzhen,MB,China,24.0,198.0,2022,Argentina,China,2022-06-24,False,1,3,9,13,0,0,3,3,4,1,3,8,1,4,4,9,0,0,0,0,0,0,0,0
181103.0,Li Yongzhen,MB,China,24.0,198.0,2022,Italy,China,2022-06-26,False,0,1,7,8,0,0,2,2,4,2,2,8,2,5,1,8,0,0,1,1,1,0,0,1
181103.0,Li Yongzhen,MB,China,24.0,198.0,2022,Netherlands,China,2022-07-06,False,0,0,0,0,0,0,0,0,0,0,0,0,0,0,0,0,0,0,0,0,0,0,0,0
181103.0,Li Yongzhen,MB,China,24.0,198.0,2022,Poland,China,2022-07-07,False,0,0,0,0,0,0,0,0,0,0,0,0,0,0,0,0,0,0,0,0,0,0,0,0
181103.0,Li Yongzhen,MB,China,24.0,198.0,2022,China,Bulgaria,2022-07-09,True,2,3,15,20,0,0,1,1,9,0,1,10,2,7,0,9,0,0,2,2,0,0,0,0
181103.0,Li Yongzhen,MB,China,24.0,198.0,2022,China,Serbia,2022-07-10,False,1,1,11,13,0,0,0,0,5,4,2,11,5,5,1,11,0,0,0,0,0,0,0,0
158965.0,Liu Meng,S,China,28.0,195.0,2022,China,Iran,2022-06-07,False,1,1,1,3,3,0,4,7,0,0,0,0,0,0,0,0,0,0,0,0,0,0,0,0
158965.0,Liu Meng,S,China,28.0,195.0,2022,Japan,China,2022-06-09,False,0,2,2,4,13,0,15,28,1,0,2,3,0,0,0,0,0,0,0,0,2,0,0,2
158965.0,Liu Meng,S,China,28.0,195.0,2022,Slovenia,China,2022-06-11,False,0,0,0,0,0,0,0,0,0,0,0,0,0,0,0,0,0,0,0,0,0,0,0,0
158965.0,Liu Meng,S,China,28.0,195.0,2022,Brazil,China,2022-06-12,True,0,0,0,0,0,0,0,0,0,0,0,0,0,0,0,0,0,0,0,0,0,0,0,0
152526.0,Jiang Zhengyang,MB,China,24.0,202.0,2022,China,Iran,2022-06-07,False,0,0,0,0,0,0,0,0,0,0,0,0,0,0,0,0,0,0,0,0,0,0,0,0
152526.0,Jiang Zhengyang,MB,China,24.0,202.0,2022,Japan,China,2022-06-09,False,0,0,0,0,0,0,0,0,0,0,0,0,0,0,0,0,0,0,0,0,0,0,0,0
152526.0,Jiang Zhengyang,MB,China,24.0,202.0,2022,Slovenia,China,2022-06-11,False,0,0,0,0,0,0,0,0,0,0,0,0,0,0,0,0,0,0,0,0,0,0,0,0
152526.0,Jiang Zhengyang,MB,China,24.0,202.0,2022,Brazil,China,2022-06-12,True,0,0,0,0,0,0,0,0,0,0,0,0,0,0,0,0,0,0,0,0,0,0,0,0
152526.0,Jiang Zhengyang,MB,China,24.0,202.0,2022,Argentina,China,2022-06-24,False,0,2,8,10,0,0,1,1,5,1,4,10,3,2,4,9,0,0,0,0,2,1,0,3
152526.0,Jiang Zhengyang,MB,China,24.0,202.0,2022,Italy,China,2022-06-26,False,0,0,2,2,0,0,0,0,0,0,0,0,0,0,1,1,0,0,0,0,1,0,0,1
152526.0,Jiang Zhengyang,MB,China,24.0,202.0,2022,Netherlands,China,2022-07-06,False,0,0,8,8,0,0,0,0,3,0,1,4,1,4,0,5,0,0,0,0,0,1,0,1
152526.0,Jiang Zhengyang,MB,China,24.0,202.0,2022,Poland,China,2022-07-07,False,0,1,7,8,0,0,1,1,4,0,0,4,4,1,0,5,0,0,1,1,0,0,0,0
152526.0,Jiang Zhengyang,MB,China,24.0,202.0,2022,China,Bulgaria,2022-07-09,True,0,0,0,0,0,0,0,0,0,0,0,0,0,1,0,1,0,0,0,0,0,0,0,0
152526.0,Jiang Zhengyang,MB,China,24.0,202.0,2022,China,Serbia,2022-07-10,False,0,0,0,0,0,0,0,0,0,0,0,0,0,0,0,0,0,0,0,0,0,0,0,0
168175.0,Peng Shikun,MB,China,22.0,208.0,2022,China,Iran,2022-06-07,False,0,1,10,11,0,0,3,3,2,0,3,5,1,2,3,6,0,0,1,1,2,0,0,2
168175.0,Peng Shikun,MB,China,22.0,208.0,2022,Japan,China,2022-06-09,False,0,1,13,14,0,0,0,0,7,1,0,8,3,5,7,15,0,0,1,1,1,0,0,1
168175.0,Peng Shikun,MB,China,22.0,208.0,2022,Slovenia,China,2022-06-11,False,0,1,12,13,0,0,0,0,6,3,3,12,4,6,1,11,0,0,0,0,1,0,0,1
168175.0,Peng Shikun,MB,China,22.0,208.0,2022,Brazil,China,2022-06-12,True,1,1,16,18,0,0,0,0,3,2,2,7,1,3,1,5,0,0,0,0,0,0,1,1
168175.0,Peng Shikun,MB,China,22.0,208.0,2022,Italy,China,2022-06-26,False,2,1,8,11,0,0,0,0,2,3,4,9,0,2,3,5,0,0,0,0,1,0,0,1
168175.0,Peng Shikun,MB,China,22.0,208.0,2022,Netherlands,China,2022-07-06,False,0,1,8,9,0,0,0,0,3,2,4,9,1,3,0,4,0,0,3,3,2,1,0,3
168175.0,Peng Shikun,MB,China,22.0,208.0,2022,Poland,China,2022-07-07,False,0,1,9,10,0,0,0,0,5,0,1,6,3,3,0,6,0,0,0,0,1,0,0,1
168175.0,Peng Shikun,MB,China,22.0,208.0,2022,China,Bulgaria,2022-07-09,True,3,3,12,18,0,0,1,1,10,1,2,13,1,6,0,7,0,1,1,2,0,0,0,0
168175.0,Peng Shikun,MB,China,22.0,208.0,2022,China,Serbia,2022-07-10,False,0,4,9,13,0,0,1,1,7,0,2,9,2,1,0,3,0,0,0,0,0,1,0,1
174297.0,Wang Hebin,S,China,23.0,188.0,2022,China,Iran,2022-06-07,False,0,0,0,0,0,0,0,0,0,0,0,0,0,0,0,0,0,0,0,0,0,0,0,0
174297.0,Wang Hebin,S,China,23.0,188.0,2022,Japan,China,2022-06-09,False,0,1,1,2,4,0,5,9,0,0,0,0,0,0,0,0,0,0,0,0,0,0,0,0
174297.0,Wang Hebin,S,China,23.0,188.0,2022,Slovenia,China,2022-06-11,False,0,0,4,4,17,2,16,35,0,0,0,0,0,2,3,5,0,0,0,0,3,0,0,3
174297.0,Wang Hebin,S,China,23.0,188.0,2022,Brazil,China,2022-06-12,True,0,0,0,0,0,0,0,0,0,0,0,0,0,0,0,0,0,0,0,0,0,0,0,0
174297.0,Wang Hebin,S,China,23.0,188.0,2022,Argentina,China,2022-06-24,False,0,1,1,2,2,0,12,14,1,0,1,2,0,0,1,1,0,0,0,0,3,0,0,3
174297.0,Wang Hebin,S,China,23.0,188.0,2022,Italy,China,2022-06-26,False,0,0,3,3,4,0,12,16,0,0,0,0,1,0,0,1,0,0,0,0,1,0,0,1
174297.0,Wang Hebin,S,China,23.0,188.0,2022,Netherlands,China,2022-07-06,False,0,0,0,0,0,0,3,3,0,0,0,0,0,0,0,0,0,0,0,0,0,0,0,0
174297.0,Wang Hebin,S,China,23.0,188.0,2022,Poland,China,2022-07-07,False,0,0,0,0,0,0,0,0,0,0,0,0,0,0,0,0,0,0,0,0,0,0,0,0
174297.0,Wang Hebin,S,China,23.0,188.0,2022,China,Bulgaria,2022-07-09,True,0,0,0,0,0,0,0,0,0,0,0,0,0,0,0,0,0,0,0,0,0,0,0,0
174297.0,Wang Hebin,S,China,23.0,188.0,2022,China,Serbia,2022-07-10,False,0,1,3,4,4,0,15,19,0,0,0,0,0,0,0,0,0,0,0,0,0,0,0,0
152513.0,Wang Jingyi,O,China,25.0,202.0,2022,Argentina,China,2022-06-24,False,0,3,8,11,0,0,2,2,14,7,8,29,0,1,1,2,0,0,0,0,2,0,1,3
152513.0,Wang Jingyi,O,China,25.0,202.0,2022,Italy,China,2022-06-26,False,0,1,2,3,0,0,1,1,2,4,4,10,0,0,0,0,0,0,0,0,0,0,1,1
152513.0,Wang Jingyi,O,China,25.0,202.0,2022,Netherlands,China,2022-07-06,False,0,0,0,0,0,0,0,0,0,0,0,0,0,0,0,0,0,0,0,0,0,0,0,0
152513.0,Wang Jingyi,O,China,25.0,202.0,2022,Poland,China,2022-07-07,False,0,0,0,0,0,0,0,0,0,0,0,0,0,0,0,0,0,0,0,0,0,0,0,0
152513.0,Wang Jingyi,O,China,25.0,202.0,2022,China,Bulgaria,2022-07-09,True,0,5,4,9,0,0,0,0,14,3,2,19,1,1,0,2,0,0,0,0,2,0,0,2
152513.0,Wang Jingyi,O,China,25.0,202.0,2022,China,Serbia,2022-07-10,False,0,2,2,4,0,0,0,0,4,3,4,11,0,0,0,0,0,0,0,0,1,0,0,1
162272.0,Yuan Dangyi,OH,China,26.0,200.0,2022,China,Iran,2022-06-07,False,0,0,0,0,0,0,0,0,0,0,0,0,0,0,0,0,0,0,0,0,0,0,0,0
162272.0,Yuan Dangyi,OH,China,26.0,200.0,2022,Japan,China,2022-06-09,False,0,0,0,0,0,0,0,0,0,0,0,0,0,0,0,0,0,1,1,2,0,0,0,0
162272.0,Yuan Dangyi,OH,China,26.0,200.0,2022,Slovenia,China,2022-06-11,False,0,0,0,0,0,0,0,0,0,0,0,0,0,0,0,0,0,0,0,0,0,0,0,0
162272.0,Yuan Dangyi,OH,China,26.0,200.0,2022,Brazil,China,2022-06-12,True,0,0,0,0,0,0,0,0,0,0,0,0,0,0,0,0,0,0,0,0,0,0,0,0
162272.0,Yuan Dangyi,OH,China,26.0,200.0,2022,Argentina,China,2022-06-24,False,0,2,3,5,0,0,1,1,0,0,1,1,0,1,0,1,1,1,3,5,0,1,0,1
162272.0,Yuan Dangyi,OH,China,26.0,200.0,2022,Italy,China,2022-06-26,False,0,0,0,0,0,0,0,0,0,0,0,0,0,0,0,0,0,0,0,0,0,0,0,0
162272.0,Yuan Dangyi,OH,China,26.0,200.0,2022,Netherlands,China,2022-07-06,False,0,0,4,4,0,0,0,0,1,0,3,4,0,1,0,1,1,1,6,8,1,0,0,1
162272.0,Yuan Dangyi,OH,China,26.0,200.0,2022,Poland,China,2022-07-07,False,0,0,0,0,0,0,0,0,0,0,0,0,0,0,0,0,0,0,0,0,0,0,0,0
162272.0,Yuan Dangyi,OH,China,26.0,200.0,2022,China,Bulgaria,2022-07-09,True,0,0,0,0,0,0,0,0,0,0,0,0,0,0,0,0,0,0,0,0,0,0,0,0
162272.0,Yuan Dangyi,OH,China,26.0,200.0,2022,China,Serbia,2022-07-10,False,0,0,0,0,0,0,0,0,0,0,0,0,0,0,0,0,0,0,0,0,0,0,0,0
182707.0,Zhang Guanhua,O,China,25.0,202.0,2022,China,Iran,2022-06-07,False,0,3,9,12,0,0,0,0,9,5,8,22,1,0,1,2,0,0,0,0,3,0,0,3
182707.0,Zhang Guanhua,O,China,25.0,202.0,2022,Japan,China,2022-06-09,False,0,2,10,12,0,0,0,0,7,1,7,15,1,1,2,4,0,0,0,0,2,1,0,3
182707.0,Zhang Guanhua,O,China,25.0,202.0,2022,Slovenia,China,2022-06-11,False,1,2,14,17,3,0,2,5,13,2,11,26,1,3,0,4,0,0,1,1,5,0,1,6
182707.0,Zhang Guanhua,O,China,25.0,202.0,2022,Brazil,China,2022-06-12,True,0,3,8,11,0,0,1,1,9,3,6,18,0,1,0,1,0,0,0,0,4,0,0,4
182707.0,Zhang Guanhua,O,China,25.0,202.0,2022,Argentina,China,2022-06-24,False,0,1,3,4,0,0,0,0,4,1,4,9,0,2,0,2,0,0,0,0,0,0,0,0
182707.0,Zhang Guanhua,O,China,25.0,202.0,2022,Italy,China,2022-06-26,False,0,0,5,5,0,0,1,1,10,3,5,18,1,1,2,4,0,0,0,0,2,1,0,3
182707.0,Zhang Guanhua,O,China,25.0,202.0,2022,Netherlands,China,2022-07-06,False,0,2,5,7,0,0,0,0,11,5,4,20,1,0,0,1,0,0,0,0,3,0,0,3
182707.0,Zhang Guanhua,O,China,25.0,202.0,2022,Poland,China,2022-07-07,False,0,2,7,9,0,0,0,0,9,1,9,19,0,0,0,0,0,0,0,0,1,1,0,2
182707.0,Zhang Guanhua,O,China,25.0,202.0,2022,China,Bulgaria,2022-07-09,True,0,1,3,4,0,0,0,0,2,3,5,10,1,1,0,2,0,0,0,0,0,0,0,0
182707.0,Zhang Guanhua,O,China,25.0,202.0,2022,China,Serbia,2022-07-10,False,0,3,3,6,0,0,1,1,5,4,5,14,0,0,1,1,0,0,0,0,0,1,1,2
153096.0,Miao Ruantong,MB,China,27.0,205.0,2022,China,Iran,2022-06-07,False,0,0,1,1,0,0,0,0,1,0,1,2,0,1,1,2,0,0,0,0,0,0,0,0
153096.0,Miao Ruantong,MB,China,27.0,205.0,2022,Japan,China,2022-06-09,False,0,0,0,0,0,0,0,0,0,0,0,0,0,0,0,0,0,0,0,0,0,0,0,0
153096.0,Miao Ruantong,MB,China,27.0,205.0,2022,Slovenia,China,2022-06-11,False,0,0,0,0,0,0,0,0,0,0,0,0,0,0,0,0,0,0,0,0,0,0,0,0
153096.0,Miao Ruantong,MB,China,27.0,205.0,2022,Brazil,China,2022-06-12,True,0,1,0,1,0,0,0,0,0,0,0,0,0,0,0,0,0,0,0,0,0,0,0,0
153096.0,Miao Ruantong,MB,China,27.0,205.0,2022,Argentina,China,2022-06-24,False,0,0,2,2,0,0,0,0,0,0,1,1,0,3,1,4,0,0,0,0,0,1,0,1
153096.0,Miao Ruantong,MB,China,27.0,205.0,2022,Italy,China,2022-06-26,False,0,0,0,0,0,0,0,0,0,0,0,0,0,0,0,0,0,0,0,0,0,0,0,0
153096.0,Miao Ruantong,MB,China,27.0,205.0,2022,Netherlands,China,2022-07-06,False,0,0,0,0,0,0,0,0,0,0,0,0,0,0,0,0,0,0,0,0,0,0,0,0
153096.0,Miao Ruantong,MB,China,27.0,205.0,2022,Poland,China,2022-07-07,False,0,0,0,0,0,0,0,0,0,0,0,0,0,0,0,0,0,0,0,0,0,0,0,0
153096.0,Miao Ruantong,MB,China,27.0,205.0,2022,China,Bulgaria,2022-07-09,True,0,0,0,0,0,0,0,0,0,0,0,0,0,0,0,0,0,0,0,0,0,0,0,0
153096.0,Miao Ruantong,MB,China,27.0,205.0,2022,China,Serbia,2022-07-10,False,0,0,0,0,0,0,0,0,0,0,0,0,0,0,0,0,0,0,0,0,0,0,0,0
168271.0,Zhang Jingyin,OH,China,23.0,207.0,2022,China,Iran,2022-06-07,False,2,0,11,13,0,0,2,2,14,3,2,19,0,1,0,1,5,6,28,39,4,2,1,7
168271.0,Zhang Jingyin,OH,China,23.0,207.0,2022,Japan,China,2022-06-09,False,0,3,10,13,0,0,0,0,13,3,10,26,2,2,1,5,7,2,20,29,5,1,2,8
168271.0,Zhang Jingyin,OH,China,23.0,207.0,2022,Slovenia,China,2022-06-11,False,2,0,14,16,0,0,1,1,18,7,11,36,0,6,1,7,11,1,26,38,4,4,0,8
168271.0,Zhang Jingyin,OH,China,23.0,207.0,2022,Brazil,China,2022-06-12,True,2,1,9,12,0,0,0,0,22,5,13,40,1,7,3,11,5,2,20,27,5,0,0,5
168271.0,Zhang Jingyin,OH,China,23.0,207.0,2022,Argentina,China,2022-06-24,False,1,1,14,16,0,0,2,2,17,3,9,29,0,4,2,6,8,1,19,28,5,2,2,9
168271.0,Zhang Jingyin,OH,China,23.0,207.0,2022,Italy,China,2022-06-26,False,0,2,5,7,0,0,0,0,11,3,10,24,0,6,3,9,6,3,22,31,1,1,0,2
168271.0,Zhang Jingyin,OH,China,23.0,207.0,2022,Netherlands,China,2022-07-06,False,0,0,9,9,0,0,1,1,11,9,8,28,1,2,0,3,6,2,12,20,3,0,0,3
168271.0,Zhang Jingyin,OH,China,23.0,207.0,2022,Poland,China,2022-07-07,False,0,3,7,10,0,0,0,0,10,6,3,19,0,0,0,0,5,1,18,24,1,1,1,3
168271.0,Zhang Jingyin,OH,China,23.0,207.0,2022,China,Bulgaria,2022-07-09,True,1,1,19,21,0,0,3,3,16,6,4,26,1,5,0,6,5,0,26,31,2,1,1,4
168271.0,Zhang Jingyin,OH,China,23.0,207.0,2022,China,Serbia,2022-07-10,False,1,1,5,7,0,0,0,0,8,4,3,15,0,0,0,0,1,0,8,9,1,0,0,1
152494.0,Chinenyeze Barthélémy,MB,France,25.0,204.0,2022,France,Italy,2022-06-08,True,1,3,5,9,0,0,0,0,7,0,6,13,3,3,7,13,0,1,2,3,1,1,0,2
152494.0,Chinenyeze Barthélémy,MB,France,25.0,204.0,2022,Serbia,France,2022-06-09,True,0,1,9,10,0,0,1,1,9,1,2,12,0,9,8,17,0,0,0,0,1,2,0,3
152494.0,Chinenyeze Barthélémy,MB,France,25.0,204.0,2022,France,Canada,2022-06-10,True,0,4,3,7,0,0,0,0,9,2,1,12,5,1,5,11,0,0,0,0,1,0,1,2
152494.0,Chinenyeze Barthélémy,MB,France,25.0,204.0,2022,France,Poland,2022-06-12,False,1,3,6,10,0,0,0,0,4,1,1,6,1,3,5,9,0,0,1,1,2,0,2,4
152494.0,Chinenyeze Barthélémy,MB,France,25.0,204.0,2022,France,Netherlands,2022-06-23,True,1,2,4,7,0,0,1,1,10,0,2,12,1,4,1,6,0,0,1,1,2,0,0,2
152494.0,Chinenyeze Barthélémy,MB,France,25.0,204.0,2022,Japan,France,2022-06-25,True,1,3,7,11,0,1,2,3,6,0,6,12,0,2,6,8,0,0,3,3,4,0,0,4
152494.0,Chinenyeze Barthélémy,MB,France,25.0,204.0,2022,Germany,France,2022-06-26,True,0,0,0,0,0,0,0,0,0,0,0,0,0,0,0,0,0,0,0,0,0,0,0,0
152494.0,Chinenyeze Barthélémy,MB,France,25.0,204.0,2022,France,USA,2022-07-07,False,2,9,6,17,0,0,2,2,8,2,3,13,2,3,3,8,1,0,1,2,4,1,3,8
152494.0,Chinenyeze Barthélémy,MB,France,25.0,204.0,2022,France,Brazil,2022-07-08,True,1,1,8,10,0,0,0,0,7,0,6,13,3,4,6,13,0,0,2,2,2,0,1,3
152494.0,Chinenyeze Barthélémy,MB,France,25.0,204.0,2022,France,Argentina,2022-07-09,False,0,0,0,0,0,0,0,0,0,0,0,0,0,0,0,0,0,0,0,0,0,0,0,0
152494.0,Chinenyeze Barthélémy,MB,France,25.0,204.0,2022,Australia,France,2022-07-10,True,0,0,0,0,0,0,0,0,0,0,0,0,0,0,0,0,0,0,0,0,0,0,0,0
152494.0,Chinenyeze Barthélémy,MB,France,25.0,204.0,2022,France,Japan,2022-07-21,True,0,5,5,10,0,0,0,0,5,0,1,6,1,3,0,4,1,0,1,2,2,0,0,2
152494.0,Chinenyeze Barthélémy,MB,France,25.0,204.0,2022,Italy,France,2022-07-23,True,0,3,5,8,0,0,0,0,5,0,0,5,3,1,2,6,1,0,0,1,1,0,0,1
152494.0,Chinenyeze Barthélémy,MB,France,25.0,204.0,2022,France,USA,2022-07-24,True,0,3,9,12,0,0,0,0,5,1,2,8,1,2,4,7,0,0,1,1,0,0,1,1
119792.0,Grebennikov Jenia,L,France,32.0,188.0,2022,France,Japan,2022-07-21,True,0,0,0,0,0,0,5,5,0,0,0,0,0,0,0,0,5,1,2,8,3,1,2,6
119792.0,Grebennikov Jenia,L,France,32.0,188.0,2022,Italy,France,2022-07-23,True,0,0,0,0,0,0,5,5,0,0,0,0,0,0,0,0,6,0,7,13,6,0,2,8
119792.0,Grebennikov Jenia,L,France,32.0,188.0,2022,France,USA,2022-07-24,True,0,0,0,0,1,0,10,11,0,0,0,0,0,0,0,0,5,0,15,20,12,3,0,15
119791.0,Corre Raphaël,S,France,33.0,196.0,2022,France,Italy,2022-06-08,True,0,0,1,1,0,0,0,0,0,0,0,0,0,0,0,0,0,0,0,0,0,1,0,1
119791.0,Corre Raphaël,S,France,33.0,196.0,2022,Serbia,France,2022-06-09,True,1,1,2,4,0,0,0,0,0,0,0,0,0,0,0,0,0,0,0,0,0,0,0,0
119791.0,Corre Raphaël,S,France,33.0,196.0,2022,France,Canada,2022-06-10,True,0,2,11,13,31,0,33,64,0,0,1,1,1,0,1,2,0,0,0,0,4,1,1,6
119791.0,Corre Raphaël,S,France,33.0,196.0,2022,France,Poland,2022-06-12,False,0,1,1,2,0,0,0,0,0,0,0,0,0,0,0,0,0,0,0,0,0,0,0,0
119791.0,Corre Raphaël,S,France,33.0,196.0,2022,France,Netherlands,2022-06-23,True,0,0,0,0,1,0,0,1,0,0,0,0,0,0,0,0,0,0,0,0,0,0,0,0
119791.0,Corre Raphaël,S,France,33.0,196.0,2022,Japan,France,2022-06-25,True,0,0,0,0,3,0,5,8,1,0,0,1,0,0,0,0,0,0,0,0,0,0,1,1
119791.0,Corre Raphaël,S,France,33.0,196.0,2022,Germany,France,2022-06-26,True,3,7,12,22,18,0,56,74,0,0,0,0,0,1,4,5,0,0,0,0,4,2,0,6
142694.0,Patry Jean,O,France,26.0,207.0,2022,France,Italy,2022-06-08,True,0,0,12,12,0,1,0,1,7,4,10,21,2,1,6,9,0,0,0,0,2,1,2,5
142694.0,Patry Jean,O,France,26.0,207.0,2022,Serbia,France,2022-06-09,True,0,0,0,0,0,0,0,0,0,0,0,0,0,0,0,0,0,0,0,0,0,0,0,0
142694.0,Patry Jean,O,France,26.0,207.0,2022,France,Canada,2022-06-10,True,1,3,13,17,0,0,0,0,7,2,12,21,0,2,0,2,0,0,0,0,2,0,6,8
142694.0,Patry Jean,O,France,26.0,207.0,2022,France,Poland,2022-06-12,False,0,2,10,12,0,0,3,3,16,5,16,37,2,2,1,5,0,0,0,0,1,3,0,4
142694.0,Patry Jean,O,France,26.0,207.0,2022,France,Netherlands,2022-06-23,True,0,1,1,2,0,0,0,0,0,0,0,0,0,0,0,0,0,0,0,0,0,0,0,0
142694.0,Patry Jean,O,France,26.0,207.0,2022,Japan,France,2022-06-25,True,1,2,9,12,0,0,2,2,10,1,14,25,3,1,1,5,0,0,0,0,6,2,0,8
142694.0,Patry Jean,O,France,26.0,207.0,2022,Germany,France,2022-06-26,True,0,0,0,0,0,0,0,0,0,0,0,0,0,0,0,0,0,0,0,0,0,0,0,0
142694.0,Patry Jean,O,France,26.0,207.0,2022,France,USA,2022-07-07,False,1,2,4,7,0,0,0,0,4,4,2,10,0,2,1,3,0,0,0,0,0,1,0,1
142694.0,Patry Jean,O,France,26.0,207.0,2022,France,Brazil,2022-07-08,True,3,6,4,13,0,0,1,1,16,1,11,28,0,2,2,4,0,0,0,0,2,1,2,5
142694.0,Patry Jean,O,France,26.0,207.0,2022,France,Argentina,2022-07-09,False,2,2,7,11,0,0,2,2,8,2,10,20,1,1,3,5,0,0,0,0,1,1,1,3
142694.0,Patry Jean,O,France,26.0,207.0,2022,Australia,France,2022-07-10,True,0,0,0,0,0,0,0,0,0,0,0,0,0,0,0,0,0,0,0,0,0,0,0,0
142694.0,Patry Jean,O,France,26.0,207.0,2022,France,Japan,2022-07-21,True,0,2,9,11,0,0,0,0,18,2,6,26,1,1,3,5,0,0,0,0,4,0,1,5
142694.0,Patry Jean,O,France,26.0,207.0,2022,Italy,France,2022-07-23,True,3,4,6,13,0,1,0,1,12,3,8,23,1,1,0,2,0,0,0,0,5,4,1,10
142694.0,Patry Jean,O,France,26.0,207.0,2022,France,USA,2022-07-24,True,0,0,16,16,1,0,1,2,17,2,9,28,0,5,1,6,0,0,1,1,2,1,2,5
142691.0,Mouiel Jérémie,L,France,27.0,176.0,2022,France,Italy,2022-06-08,True,0,0,0,0,0,0,0,0,0,0,0,0,0,0,0,0,0,0,0,0,0,0,0,0
142691.0,Mouiel Jérémie,L,France,27.0,176.0,2022,Serbia,France,2022-06-09,True,0,0,0,0,0,0,0,0,0,0,0,0,0,0,0,0,0,0,0,0,0,0,0,0
142691.0,Mouiel Jérémie,L,France,27.0,176.0,2022,France,Canada,2022-06-10,True,0,0,0,0,0,0,5,5,0,0,0,0,0,0,0,0,2,0,9,11,8,4,1,13
142691.0,Mouiel Jérémie,L,France,27.0,176.0,2022,France,Poland,2022-06-12,False,0,0,0,0,0,0,0,0,0,0,0,0,0,0,0,0,0,0,0,0,0,0,0,0
142691.0,Mouiel Jérémie,L,France,27.0,176.0,2022,France,Netherlands,2022-06-23,True,0,0,0,0,0,0,0,0,0,0,0,0,0,0,0,0,0,0,0,0,0,0,0,0
142691.0,Mouiel Jérémie,L,France,27.0,176.0,2022,Japan,France,2022-06-25,True,0,0,0,0,0,0,0,0,0,0,0,0,0,0,0,0,0,0,0,0,0,0,0,0
142691.0,Mouiel Jérémie,L,France,27.0,176.0,2022,Germany,France,2022-06-26,True,0,0,0,0,0,0,2,2,0,0,0,0,0,0,0,0,2,1,13,16,4,1,0,5
142691.0,Mouiel Jérémie,L,France,27.0,176.0,2022,France,USA,2022-07-07,False,0,0,0,0,0,0,0,0,0,0,0,0,0,0,0,0,0,0,0,0,0,0,1,1
142691.0,Mouiel Jérémie,L,France,27.0,176.0,2022,France,Brazil,2022-07-08,True,0,0,0,0,0,0,0,0,0,0,0,0,0,0,0,0,0,0,0,0,0,0,0,0
142691.0,Mouiel Jérémie,L,France,27.0,176.0,2022,France,Argentina,2022-07-09,False,0,0,0,0,0,0,0,0,0,0,0,0,0,0,0,0,8,0,21,29,6,7,3,16
142691.0,Mouiel Jérémie,L,France,27.0,176.0,2022,Australia,France,2022-07-10,True,0,0,0,0,0,0,0,0,0,0,0,0,0,0,0,0,0,0,0,0,0,0,0,0
119804.0,Toniutti Benjamin,S,France,33.0,183.0,2022,France,Netherlands,2022-06-23,True,0,1,13,14,14,0,38,52,0,0,0,0,1,2,5,8,0,0,0,0,3,1,0,4
119804.0,Toniutti Benjamin,S,France,33.0,183.0,2022,Japan,France,2022-06-25,True,0,0,7,7,16,0,43,59,0,0,0,0,0,1,0,1,0,0,0,0,5,1,1,7
119804.0,Toniutti Benjamin,S,France,33.0,183.0,2022,Germany,France,2022-06-26,True,0,0,0,0,0,0,0,0,0,0,0,0,0,0,0,0,0,0,0,0,0,0,0,0
119804.0,Toniutti Benjamin,S,France,33.0,183.0,2022,France,USA,2022-07-07,False,0,0,9,9,23,0,53,76,0,0,1,1,0,0,3,3,0,0,0,0,4,2,5,11
119804.0,Toniutti Benjamin,S,France,33.0,183.0,2022,France,Brazil,2022-07-08,True,0,0,0,0,0,0,0,0,0,0,0,0,0,0,0,0,0,0,0,0,0,0,0,0
119804.0,Toniutti Benjamin,S,France,33.0,183.0,2022,France,Argentina,2022-07-09,False,0,1,6,7,14,0,58,72,0,0,0,0,0,2,4,6,0,0,0,0,4,3,2,9
119804.0,Toniutti Benjamin,S,France,33.0,183.0,2022,Australia,France,2022-07-10,True,0,0,0,0,0,0,0,0,0,0,0,0,0,0,0,0,0,0,0,0,0,0,0,0
119804.0,Toniutti Benjamin,S,France,33.0,183.0,2022,France,Japan,2022-07-21,True,0,0,0,0,0,0,0,0,0,0,0,0,0,0,0,0,0,0,0,0,0,0,0,0
119804.0,Toniutti Benjamin,S,France,33.0,183.0,2022,Italy,France,2022-07-23,True,0,0,0,0,0,0,0,0,0,0,0,0,0,0,0,0,0,0,0,0,0,0,0,0
119804.0,Toniutti Benjamin,S,France,33.0,183.0,2022,France,USA,2022-07-24,True,0,0,0,0,1,1,7,9,0,0,0,0,0,0,0,0,0,0,0,0,0,0,0,0
124518.0,Tillie Kevin,OH,France,32.0,200.0,2022,France,Italy,2022-06-08,True,0,2,1,3,0,0,0,0,2,2,3,7,0,2,0,2,0,0,4,4,2,2,0,4
124518.0,Tillie Kevin,OH,France,32.0,200.0,2022,Serbia,France,2022-06-09,True,0,0,0,0,0,0,0,0,0,0,0,0,0,0,0,0,0,0,0,0,0,0,0,0
124518.0,Tillie Kevin,OH,France,32.0,200.0,2022,France,Canada,2022-06-10,True,0,0,0,0,0,0,0,0,0,0,0,0,0,0,0,0,0,0,0,0,0,0,0,0
124518.0,Tillie Kevin,OH,France,32.0,200.0,2022,France,Poland,2022-06-12,False,0,0,0,0,0,0,0,0,0,0,0,0,0,0,0,0,0,0,0,0,0,0,0,0
119800.0,Ngapeth Earvin,OH,France,32.0,194.0,2022,France,Italy,2022-06-08,True,1,2,15,18,0,0,7,7,11,3,4,18,1,3,0,4,6,0,10,16,5,2,4,11
119800.0,Ngapeth Earvin,OH,France,32.0,194.0,2022,Serbia,France,2022-06-09,True,3,6,8,17,1,0,7,8,11,4,13,28,2,6,1,9,9,0,14,23,5,3,1,9
119800.0,Ngapeth Earvin,OH,France,32.0,194.0,2022,France,Canada,2022-06-10,True,2,1,1,4,0,0,0,0,0,0,1,1,0,0,0,0,0,0,0,0,1,0,0,1
119800.0,Ngapeth Earvin,OH,France,32.0,194.0,2022,France,Poland,2022-06-12,False,0,4,9,13,0,1,4,5,8,6,8,22,0,6,1,7,4,0,10,14,7,0,3,10
119800.0,Ngapeth Earvin,OH,France,32.0,194.0,2022,France,Netherlands,2022-06-23,True,1,1,9,11,0,0,4,4,7,1,5,13,0,1,1,2,5,0,4,9,4,0,0,4
119800.0,Ngapeth Earvin,OH,France,32.0,194.0,2022,Japan,France,2022-06-25,True,0,0,0,0,0,0,0,0,0,0,0,0,0,0,0,0,0,0,0,0,0,0,0,0
119800.0,Ngapeth Earvin,OH,France,32.0,194.0,2022,Germany,France,2022-06-26,True,0,4,11,15,1,0,2,3,16,4,7,27,2,1,0,3,4,0,4,8,9,1,2,12
119800.0,Ngapeth Earvin,OH,France,32.0,194.0,2022,France,USA,2022-07-07,False,1,4,15,20,0,1,17,18,16,3,9,28,2,1,0,3,3,2,16,21,11,4,2,17
119800.0,Ngapeth Earvin,OH,France,32.0,194.0,2022,France,Brazil,2022-07-08,True,2,5,4,11,0,0,4,4,12,0,8,20,0,3,1,4,5,0,12,17,3,0,1,4
119800.0,Ngapeth Earvin,OH,France,32.0,194.0,2022,France,Argentina,2022-07-09,False,0,2,4,6,0,0,1,1,0,0,0,0,0,0,0,0,0,0,0,0,3,0,0,3
119800.0,Ngapeth Earvin,OH,France,32.0,194.0,2022,Australia,France,2022-07-10,True,0,2,7,9,0,1,1,2,4,0,1,5,0,1,0,1,3,0,9,12,4,0,0,4
119800.0,Ngapeth Earvin,OH,France,32.0,194.0,2022,France,Japan,2022-07-21,True,0,0,0,0,0,0,0,0,0,0,0,0,0,0,0,0,0,0,0,0,0,0,0,0
119800.0,Ngapeth Earvin,OH,France,32.0,194.0,2022,Italy,France,2022-07-23,True,4,4,5,13,0,0,3,3,10,2,5,17,0,4,2,6,9,1,10,20,7,2,0,9
119800.0,Ngapeth Earvin,OH,France,32.0,194.0,2022,France,USA,2022-07-24,True,0,6,12,18,0,0,5,5,21,5,13,39,1,2,0,3,10,1,20,31,5,1,1,7
136851.0,Brizard Antoine,S,France,28.0,196.0,2022,France,Italy,2022-06-08,True,0,3,12,15,48,0,25,73,3,0,2,5,0,2,1,3,0,0,0,0,4,2,3,9
136851.0,Brizard Antoine,S,France,28.0,196.0,2022,Serbia,France,2022-06-09,True,1,4,12,17,53,0,38,91,3,0,1,4,2,1,5,8,0,0,0,0,2,1,2,5
136851.0,Brizard Antoine,S,France,28.0,196.0,2022,France,Canada,2022-06-10,True,0,0,0,0,0,0,0,0,0,0,0,0,0,0,0,0,0,0,0,0,0,0,0,0
136851.0,Brizard Antoine,S,France,28.0,196.0,2022,France,Poland,2022-06-12,False,6,3,9,18,42,2,43,87,3,0,1,4,2,1,5,8,0,0,1,1,7,2,3,12
136851.0,Brizard Antoine,S,France,28.0,196.0,2022,France,USA,2022-07-07,False,0,0,0,0,4,0,17,21,0,0,1,1,0,0,1,1,0,0,0,0,0,1,0,1
136851.0,Brizard Antoine,S,France,28.0,196.0,2022,France,Brazil,2022-07-08,True,1,3,7,11,24,1,50,75,1,1,0,2,1,1,2,4,0,0,1,1,1,1,2,4
136851.0,Brizard Antoine,S,France,28.0,196.0,2022,France,Argentina,2022-07-09,False,0,1,1,2,5,0,12,17,0,0,1,1,1,0,0,1,0,0,0,0,1,1,0,2
136851.0,Brizard Antoine,S,France,28.0,196.0,2022,Australia,France,2022-07-10,True,0,3,8,11,18,0,42,60,2,0,3,5,3,1,3,7,0,0,0,0,0,3,2,5
136851.0,Brizard Antoine,S,France,28.0,196.0,2022,France,Japan,2022-07-21,True,2,4,6,12,18,1,37,56,2,0,1,3,0,0,2,2,0,0,0,0,6,3,0,9
136851.0,Brizard Antoine,S,France,28.0,196.0,2022,Italy,France,2022-07-23,True,2,1,9,12,15,0,46,61,1,0,0,1,0,1,2,3,0,0,0,0,5,3,0,8
136851.0,Brizard Antoine,S,France,28.0,196.0,2022,France,USA,2022-07-24,True,3,2,16,21,14,0,64,78,2,0,0,2,0,5,3,8,0,0,0,0,5,2,0,7
142710.0,Boyer Stephen,O,France,26.0,196.0,2022,France,Italy,2022-06-08,True,0,0,0,0,0,0,0,0,0,0,0,0,0,0,0,0,0,0,0,0,0,0,0,0
142710.0,Boyer Stephen,O,France,26.0,196.0,2022,Serbia,France,2022-06-09,True,2,2,14,18,0,0,1,1,19,4,22,45,3,3,2,8,0,0,0,0,6,5,0,11
142710.0,Boyer Stephen,O,France,26.0,196.0,2022,France,Canada,2022-06-10,True,0,0,0,0,0,0,0,0,0,0,0,0,0,0,0,0,0,0,0,0,0,0,0,0
142710.0,Boyer Stephen,O,France,26.0,196.0,2022,France,Poland,2022-06-12,False,0,0,0,0,0,0,0,0,0,0,0,0,0,0,0,0,0,0,0,0,0,0,0,0
142710.0,Boyer Stephen,O,France,26.0,196.0,2022,France,Netherlands,2022-06-23,True,0,3,11,14,0,0,0,0,11,1,5,17,4,2,4,10,0,0,0,0,3,1,0,4
142710.0,Boyer Stephen,O,France,26.0,196.0,2022,Japan,France,2022-06-25,True,0,1,4,5,0,0,1,1,3,0,3,6,0,1,0,1,0,0,0,0,3,0,0,3
142710.0,Boyer Stephen,O,France,26.0,196.0,2022,Germany,France,2022-06-26,True,1,7,5,13,0,0,0,0,14,6,7,27,1,5,1,7,0,0,0,0,6,2,1,9
142710.0,Boyer Stephen,O,France,26.0,196.0,2022,France,USA,2022-07-07,False,1,6,7,14,0,0,1,1,13,6,12,31,0,0,5,5,0,0,1,1,7,1,4,12
142710.0,Boyer Stephen,O,France,26.0,196.0,2022,France,Brazil,2022-07-08,True,0,0,0,0,0,0,0,0,0,0,0,0,0,0,0,0,0,0,0,0,0,0,0,0
142710.0,Boyer Stephen,O,France,26.0,196.0,2022,France,Argentina,2022-07-09,False,0,3,5,8,0,0,2,2,13,1,7,21,0,4,1,5,0,0,0,0,5,2,2,9
142710.0,Boyer Stephen,O,France,26.0,196.0,2022,Australia,France,2022-07-10,True,2,3,13,18,0,0,0,0,16,3,6,25,1,0,0,1,0,0,0,0,4,2,0,6
142710.0,Boyer Stephen,O,France,26.0,196.0,2022,France,Japan,2022-07-21,True,0,0,0,0,0,0,0,0,0,0,0,0,0,0,0,0,0,0,0,0,0,0,0,0
142710.0,Boyer Stephen,O,France,26.0,196.0,2022,Italy,France,2022-07-23,True,0,0,0,0,0,0,0,0,0,0,0,0,0,0,0,0,0,0,0,0,0,0,0,0
142710.0,Boyer Stephen,O,France,26.0,196.0,2022,France,USA,2022-07-24,True,0,0,0,0,0,0,0,0,0,1,1,2,0,0,0,0,0,0,0,0,0,0,0,0
125073.0,Le Goff Nicolas,MB,France,31.0,206.0,2022,France,Netherlands,2022-06-23,True,0,2,7,9,0,0,0,0,4,0,1,5,6,4,1,11,0,0,0,0,1,1,1,3
125073.0,Le Goff Nicolas,MB,France,31.0,206.0,2022,Japan,France,2022-06-25,True,0,2,5,7,0,0,1,1,4,0,2,6,3,5,6,14,0,0,0,0,2,0,0,2
125073.0,Le Goff Nicolas,MB,France,31.0,206.0,2022,Germany,France,2022-06-26,True,0,0,0,0,0,0,0,0,0,0,0,0,0,0,0,0,0,0,0,0,0,0,0,0
125073.0,Le Goff Nicolas,MB,France,31.0,206.0,2022,France,USA,2022-07-07,False,0,2,3,5,0,0,1,1,4,1,7,12,1,0,4,5,0,0,0,0,0,1,1,2
125073.0,Le Goff Nicolas,MB,France,31.0,206.0,2022,France,Brazil,2022-07-08,True,2,1,8,11,0,0,1,1,4,1,1,6,1,2,2,5,0,0,1,1,4,0,2,6
125073.0,Le Goff Nicolas,MB,France,31.0,206.0,2022,France,Argentina,2022-07-09,False,0,0,0,0,0,0,0,0,0,0,0,0,0,0,0,0,0,0,0,0,0,0,0,0
125073.0,Le Goff Nicolas,MB,France,31.0,206.0,2022,Australia,France,2022-07-10,True,0,4,7,11,0,0,0,0,6,1,5,12,1,5,2,8,0,0,1,1,1,0,1,2
125073.0,Le Goff Nicolas,MB,France,31.0,206.0,2022,France,Japan,2022-07-21,True,0,3,10,13,0,0,0,0,3,0,2,5,3,4,3,10,0,0,0,0,1,0,0,1
125073.0,Le Goff Nicolas,MB,France,31.0,206.0,2022,Italy,France,2022-07-23,True,0,1,6,7,0,0,0,0,5,0,3,8,0,3,2,5,0,0,0,0,2,1,0,3
125073.0,Le Goff Nicolas,MB,France,31.0,206.0,2022,France,USA,2022-07-24,True,1,3,5,9,0,0,0,0,4,2,6,12,3,5,1,9,0,0,0,0,2,0,0,2
136855.0,Henry Médéric,MB,France,27.0,212.0,2022,France,Italy,2022-06-08,True,0,0,0,0,0,0,0,0,0,0,0,0,0,0,0,0,0,0,0,0,0,0,0,0
136855.0,Henry Médéric,MB,France,27.0,212.0,2022,Serbia,France,2022-06-09,True,0,0,0,0,0,0,0,0,0,0,0,0,0,0,0,0,0,0,0,0,0,0,0,0
136855.0,Henry Médéric,MB,France,27.0,212.0,2022,France,Canada,2022-06-10,True,0,0,7,7,0,0,1,1,5,0,5,10,0,4,8,12,0,0,0,0,2,1,0,3
136855.0,Henry Médéric,MB,France,27.0,212.0,2022,France,Poland,2022-06-12,False,0,0,1,1,0,0,0,0,1,0,0,1,0,1,0,1,0,0,0,0,0,0,0,0
136855.0,Henry Médéric,MB,France,27.0,212.0,2022,France,Netherlands,2022-06-23,True,0,0,0,0,0,0,0,0,0,0,0,0,0,0,0,0,0,0,0,0,0,0,0,0
136855.0,Henry Médéric,MB,France,27.0,212.0,2022,Japan,France,2022-06-25,True,0,0,0,0,0,0,0,0,0,0,0,0,1,0,1,2,0,0,0,0,0,0,0,0
136855.0,Henry Médéric,MB,France,27.0,212.0,2022,Germany,France,2022-06-26,True,0,1,10,11,0,0,1,1,1,2,2,5,3,2,3,8,0,1,1,2,5,0,0,5
136855.0,Henry Médéric,MB,France,27.0,212.0,2022,France,USA,2022-07-07,False,0,0,0,0,0,0,0,0,0,0,0,0,0,0,0,0,0,0,0,0,0,0,0,0
136855.0,Henry Médéric,MB,France,27.0,212.0,2022,France,Brazil,2022-07-08,True,0,0,0,0,0,0,0,0,0,0,0,0,0,0,0,0,0,0,0,0,0,0,0,0
136855.0,Henry Médéric,MB,France,27.0,212.0,2022,France,Argentina,2022-07-09,False,0,2,8,10,0,0,2,2,3,1,4,8,0,5,7,12,0,0,0,0,3,0,0,3
136855.0,Henry Médéric,MB,France,27.0,212.0,2022,Australia,France,2022-07-10,True,0,0,0,0,0,0,0,0,0,0,0,0,0,0,0,0,0,0,0,0,0,0,0,0
136855.0,Henry Médéric,MB,France,27.0,212.0,2022,France,Japan,2022-07-21,True,0,0,0,0,0,0,0,0,0,0,0,0,0,0,0,0,0,0,0,0,0,0,0,0
136855.0,Henry Médéric,MB,France,27.0,212.0,2022,Italy,France,2022-07-23,True,0,0,0,0,0,0,0,0,0,0,0,0,0,0,0,0,0,0,0,0,0,0,0,0
136855.0,Henry Médéric,MB,France,27.0,212.0,2022,France,USA,2022-07-24,True,0,0,0,0,0,0,0,0,0,0,0,0,0,0,0,0,0,0,0,0,0,0,0,0
132948.0,Clevenot Trevor,OH,France,28.0,199.0,2022,France,Netherlands,2022-06-23,True,2,3,11,16,0,0,1,1,9,0,5,14,0,0,3,3,1,0,6,7,4,1,0,5
132948.0,Clevenot Trevor,OH,France,28.0,199.0,2022,Japan,France,2022-06-25,True,1,0,10,11,0,1,5,6,9,2,9,20,0,2,1,3,7,1,9,17,4,2,0,6
132948.0,Clevenot Trevor,OH,France,28.0,199.0,2022,Germany,France,2022-06-26,True,0,0,0,0,0,0,0,0,0,0,0,0,0,0,0,0,0,0,0,0,0,0,0,0
132948.0,Clevenot Trevor,OH,France,28.0,199.0,2022,France,USA,2022-07-07,False,2,1,12,15,0,0,7,7,8,5,15,28,0,0,5,5,5,3,20,28,4,4,1,9
132948.0,Clevenot Trevor,OH,France,28.0,199.0,2022,France,Brazil,2022-07-08,True,0,0,1,1,0,0,0,0,0,0,0,0,0,0,0,0,0,0,0,0,0,0,0,0
132948.0,Clevenot Trevor,OH,France,28.0,199.0,2022,France,Argentina,2022-07-09,False,0,1,15,16,0,0,8,8,10,1,9,20,0,1,4,5,5,1,12,18,4,2,3,9
132948.0,Clevenot Trevor,OH,France,28.0,199.0,2022,Australia,France,2022-07-10,True,3,5,7,15,0,0,2,2,7,1,3,11,2,0,3,5,5,2,13,20,4,1,1,6
132948.0,Clevenot Trevor,OH,France,28.0,199.0,2022,France,Japan,2022-07-21,True,0,2,8,10,0,0,1,1,6,1,7,14,1,1,2,4,13,0,8,21,3,1,0,4
132948.0,Clevenot Trevor,OH,France,28.0,199.0,2022,Italy,France,2022-07-23,True,2,3,12,17,0,0,1,1,13,0,4,17,0,4,1,5,8,1,7,16,3,2,0,5
132948.0,Clevenot Trevor,OH,France,28.0,199.0,2022,France,USA,2022-07-24,True,0,3,13,16,0,0,3,3,10,2,5,17,1,6,0,7,11,0,18,29,5,3,1,9
120735.0,Louati Yacine,OH,France,31.0,198.0,2022,France,Italy,2022-06-08,True,0,2,3,5,0,0,1,1,2,5,5,12,0,0,1,1,6,1,9,16,4,0,0,4
120735.0,Louati Yacine,OH,France,31.0,198.0,2022,Serbia,France,2022-06-09,True,2,2,11,15,2,0,3,5,8,1,6,15,0,5,2,7,8,3,24,35,3,2,2,7
120735.0,Louati Yacine,OH,France,31.0,198.0,2022,France,Canada,2022-06-10,True,1,1,6,8,0,0,2,2,9,3,4,16,2,1,3,6,6,2,14,22,6,3,1,10
120735.0,Louati Yacine,OH,France,31.0,198.0,2022,France,Poland,2022-06-12,False,0,4,10,14,0,0,5,5,10,3,7,20,0,3,5,8,9,5,24,38,4,7,2,13
120735.0,Louati Yacine,OH,France,31.0,198.0,2022,France,Netherlands,2022-06-23,True,0,0,1,1,0,0,0,0,0,0,0,0,0,0,0,0,0,0,0,0,0,0,0,0
120735.0,Louati Yacine,OH,France,31.0,198.0,2022,Japan,France,2022-06-25,True,1,4,14,19,0,0,5,5,6,3,9,18,1,4,2,7,7,0,12,19,4,0,3,7
120735.0,Louati Yacine,OH,France,31.0,198.0,2022,Germany,France,2022-06-26,True,1,5,8,14,0,1,4,5,11,3,5,19,1,5,0,6,7,2,22,31,5,1,0,6
120735.0,Louati Yacine,OH,France,31.0,198.0,2022,France,USA,2022-07-07,False,0,0,1,1,0,0,0,0,0,1,2,3,0,0,0,0,1,0,2,3,1,0,1,2
120735.0,Louati Yacine,OH,France,31.0,198.0,2022,France,Brazil,2022-07-08,True,2,4,8,14,0,0,3,3,9,3,5,17,1,3,2,6,4,4,17,25,4,1,1,6
120735.0,Louati Yacine,OH,France,31.0,198.0,2022,France,Argentina,2022-07-09,False,0,4,8,12,0,0,2,2,7,3,12,22,1,5,7,13,5,4,16,25,12,5,1,18
120735.0,Louati Yacine,OH,France,31.0,198.0,2022,Australia,France,2022-07-10,True,0,0,0,0,0,0,0,0,0,0,0,0,0,0,0,0,0,0,0,0,0,0,0,0
120735.0,Louati Yacine,OH,France,31.0,198.0,2022,France,Japan,2022-07-21,True,1,3,13,17,0,0,3,3,7,2,3,12,2,2,1,5,6,3,7,16,4,2,0,6
120735.0,Louati Yacine,OH,France,31.0,198.0,2022,Italy,France,2022-07-23,True,0,0,0,0,0,0,0,0,0,0,0,0,0,0,0,0,0,0,0,0,0,0,0,0
120735.0,Louati Yacine,OH,France,31.0,198.0,2022,France,USA,2022-07-24,True,0,0,0,0,0,0,0,0,0,0,0,0,0,0,0,0,0,0,0,0,0,0,0,0
152506.0,Diez Benjamin,L,France,24.0,183.0,2022,France,Italy,2022-06-08,True,0,0,0,0,0,0,0,0,0,0,0,0,0,0,0,0,2,0,8,10,13,1,4,18
152506.0,Diez Benjamin,L,France,24.0,183.0,2022,Serbia,France,2022-06-09,True,0,0,0,0,1,0,0,1,0,0,0,0,0,0,0,0,6,0,12,18,16,4,3,23
152506.0,Diez Benjamin,L,France,24.0,183.0,2022,France,Canada,2022-06-10,True,0,0,0,0,0,0,0,0,0,0,0,0,0,0,0,0,0,0,0,0,0,0,0,0
152506.0,Diez Benjamin,L,France,24.0,183.0,2022,France,Poland,2022-06-12,False,0,0,0,0,0,0,2,2,0,0,0,0,0,0,0,0,5,2,16,23,9,5,1,15
152506.0,Diez Benjamin,L,France,24.0,183.0,2022,France,Netherlands,2022-06-23,True,0,0,0,0,0,0,0,0,0,0,0,0,0,0,0,0,7,5,11,23,6,1,0,7
152506.0,Diez Benjamin,L,France,24.0,183.0,2022,Japan,France,2022-06-25,True,0,0,0,0,0,0,1,1,0,0,0,0,0,0,0,0,6,0,3,9,11,3,2,16
152506.0,Diez Benjamin,L,France,24.0,183.0,2022,Germany,France,2022-06-26,True,0,0,0,0,0,0,0,0,0,0,0,0,0,0,0,0,0,0,0,0,0,0,0,0
152506.0,Diez Benjamin,L,France,24.0,183.0,2022,France,USA,2022-07-07,False,0,0,0,0,0,0,6,6,0,0,0,0,0,0,0,0,13,1,13,27,14,3,4,21
152506.0,Diez Benjamin,L,France,24.0,183.0,2022,France,Brazil,2022-07-08,True,0,0,0,0,0,0,2,2,0,0,0,0,0,0,0,0,3,1,10,14,11,0,2,13
152506.0,Diez Benjamin,L,France,24.0,183.0,2022,France,Argentina,2022-07-09,False,0,0,0,0,0,0,0,0,0,0,0,0,0,0,0,0,0,0,0,0,0,0,0,0
152506.0,Diez Benjamin,L,France,24.0,183.0,2022,Australia,France,2022-07-10,True,0,0,0,0,0,0,0,0,0,0,0,0,0,0,0,0,1,0,5,6,10,0,0,10
152506.0,Diez Benjamin,L,France,24.0,183.0,2022,France,Japan,2022-07-21,True,0,0,0,0,0,0,0,0,0,0,0,0,0,0,0,0,0,0,0,0,0,0,0,0
152506.0,Diez Benjamin,L,France,24.0,183.0,2022,Italy,France,2022-07-23,True,0,0,0,0,0,0,0,0,0,0,0,0,0,0,0,0,0,0,0,0,0,0,0,0
152506.0,Diez Benjamin,L,France,24.0,183.0,2022,France,USA,2022-07-24,True,0,0,0,0,0,0,0,0,0,0,0,0,0,0,0,0,0,0,0,0,0,0,0,0
152531.0,Derouillon Pierre,OH,France,23.0,197.0,2022,France,Italy,2022-06-08,True,0,0,0,0,0,0,0,0,0,0,0,0,0,0,0,0,0,0,0,0,0,0,0,0
152531.0,Derouillon Pierre,OH,France,23.0,197.0,2022,Serbia,France,2022-06-09,True,0,0,0,0,0,0,0,0,0,0,0,0,0,0,0,0,0,0,0,0,0,0,0,0
152531.0,Derouillon Pierre,OH,France,23.0,197.0,2022,France,Canada,2022-06-10,True,2,5,7,14,0,1,0,1,6,3,9,18,0,0,0,0,2,3,10,15,1,0,1,2
152531.0,Derouillon Pierre,OH,France,23.0,197.0,2022,France,Poland,2022-06-12,False,0,1,1,2,0,0,1,1,4,0,1,5,0,0,0,0,0,0,3,3,1,0,0,1
152531.0,Derouillon Pierre,OH,France,23.0,197.0,2022,France,Netherlands,2022-06-23,True,0,0,0,0,0,0,0,0,0,0,0,0,0,0,0,0,0,0,0,0,0,0,0,0
152531.0,Derouillon Pierre,OH,France,23.0,197.0,2022,Japan,France,2022-06-25,True,0,0,0,0,0,0,0,0,0,0,0,0,0,0,0,0,0,0,0,0,0,0,0,0
152531.0,Derouillon Pierre,OH,France,23.0,197.0,2022,Germany,France,2022-06-26,True,0,0,0,0,0,0,0,0,0,0,0,0,0,0,0,0,0,0,0,0,0,0,0,0
152531.0,Derouillon Pierre,OH,France,23.0,197.0,2022,France,USA,2022-07-07,False,0,0,0,0,0,0,0,0,0,0,0,0,0,0,0,0,0,0,0,0,0,0,0,0
152531.0,Derouillon Pierre,OH,France,23.0,197.0,2022,France,Brazil,2022-07-08,True,0,0,0,0,0,0,0,0,0,0,0,0,0,0,0,0,0,0,0,0,0,0,0,0
152531.0,Derouillon Pierre,OH,France,23.0,197.0,2022,France,Argentina,2022-07-09,False,0,0,0,0,0,0,0,0,0,0,0,0,0,0,0,0,0,0,0,0,0,0,0,0
152531.0,Derouillon Pierre,OH,France,23.0,197.0,2022,Australia,France,2022-07-10,True,0,2,1,3,0,0,1,1,5,1,2,8,0,2,0,2,1,0,3,4,1,0,0,1
152531.0,Derouillon Pierre,OH,France,23.0,197.0,2022,France,Japan,2022-07-21,True,0,0,0,0,0,0,0,0,0,0,0,0,0,0,0,0,0,0,0,0,0,0,0,0
152531.0,Derouillon Pierre,OH,France,23.0,197.0,2022,Italy,France,2022-07-23,True,0,0,0,0,0,0,0,0,0,0,0,0,0,0,0,0,0,0,0,0,0,0,0,0
152531.0,Derouillon Pierre,OH,France,23.0,197.0,2022,France,USA,2022-07-24,True,0,0,0,0,0,0,0,0,0,0,0,0,0,0,0,0,0,0,0,0,0,0,0,0
181197.0,Gueye Mousse,MB,France,26.0,198.0,2022,France,Italy,2022-06-08,True,0,0,0,0,0,0,0,0,0,0,0,0,0,0,0,0,0,0,0,0,0,0,0,0
181197.0,Gueye Mousse,MB,France,26.0,198.0,2022,Serbia,France,2022-06-09,True,0,0,0,0,0,0,0,0,0,0,0,0,0,0,0,0,0,0,0,0,0,0,0,0
181197.0,Gueye Mousse,MB,France,26.0,198.0,2022,France,Canada,2022-06-10,True,0,0,0,0,0,0,0,0,0,0,0,0,0,0,0,0,0,0,0,0,0,0,0,0
181197.0,Gueye Mousse,MB,France,26.0,198.0,2022,France,Poland,2022-06-12,False,0,0,0,0,0,0,0,0,0,0,0,0,0,0,0,0,0,0,0,0,0,0,0,0
136856.0,Jouffroy Quentin,MB,France,29.0,202.0,2022,France,Italy,2022-06-08,True,2,2,7,11,0,0,1,1,5,0,4,9,0,4,7,11,0,0,0,0,3,0,2,5
136856.0,Jouffroy Quentin,MB,France,29.0,202.0,2022,Serbia,France,2022-06-09,True,1,3,10,14,0,1,0,1,1,2,3,6,3,6,10,19,0,0,1,1,3,0,3,6
136856.0,Jouffroy Quentin,MB,France,29.0,202.0,2022,France,Canada,2022-06-10,True,0,0,3,3,0,0,0,0,0,0,0,0,0,0,0,0,0,0,0,0,0,1,0,1
136856.0,Jouffroy Quentin,MB,France,29.0,202.0,2022,France,Poland,2022-06-12,False,2,3,14,19,0,0,0,0,4,1,3,8,1,3,4,8,0,0,1,1,0,1,1,2
136856.0,Jouffroy Quentin,MB,France,29.0,202.0,2022,France,Netherlands,2022-06-23,True,0,0,0,0,0,0,0,0,0,0,0,0,0,0,0,0,0,0,0,0,0,0,0,0
136856.0,Jouffroy Quentin,MB,France,29.0,202.0,2022,Japan,France,2022-06-25,True,1,2,1,4,0,0,0,0,0,0,0,0,0,0,0,0,0,0,0,0,0,0,0,0
136856.0,Jouffroy Quentin,MB,France,29.0,202.0,2022,Germany,France,2022-06-26,True,3,5,10,18,0,0,1,1,6,0,3,9,3,1,5,9,0,0,0,0,2,0,0,2
136856.0,Jouffroy Quentin,MB,France,29.0,202.0,2022,France,USA,2022-07-07,False,0,2,4,6,0,0,0,0,0,0,0,0,0,0,0,0,0,0,0,0,1,0,0,1
136856.0,Jouffroy Quentin,MB,France,29.0,202.0,2022,France,Brazil,2022-07-08,True,0,1,1,2,0,0,0,0,0,0,0,0,0,0,0,0,0,0,0,0,0,0,0,0
136856.0,Jouffroy Quentin,MB,France,29.0,202.0,2022,France,Argentina,2022-07-09,False,1,6,11,18,0,0,2,2,6,1,2,9,1,3,6,10,0,0,0,0,2,0,1,3
136856.0,Jouffroy Quentin,MB,France,29.0,202.0,2022,Australia,France,2022-07-10,True,1,3,6,10,0,0,1,1,3,0,1,4,1,1,3,5,0,0,0,0,1,1,0,2
136856.0,Jouffroy Quentin,MB,France,29.0,202.0,2022,France,Japan,2022-07-21,True,0,1,0,1,0,0,0,0,0,0,0,0,0,0,0,0,0,0,0,0,0,0,0,0
136856.0,Jouffroy Quentin,MB,France,29.0,202.0,2022,Italy,France,2022-07-23,True,0,0,3,3,0,0,0,0,0,0,0,0,0,0,0,0,0,0,0,0,0,0,0,0
136856.0,Jouffroy Quentin,MB,France,29.0,202.0,2022,France,USA,2022-07-24,True,2,3,3,8,0,0,0,0,0,0,0,0,0,0,0,0,0,0,0,0,2,0,0,2
119779.0,Fromm Christian,OH,Germany,32.0,204.0,2022,Canada,Germany,2022-06-07,True,3,0,11,14,0,0,2,2,14,1,11,26,1,4,1,6,2,3,14,19,6,1,1,8
119779.0,Fromm Christian,OH,Germany,32.0,204.0,2022,Germany,Argentina,2022-06-09,False,1,1,6,8,0,0,2,2,7,4,9,20,1,1,2,4,1,2,19,22,1,3,0,4
119779.0,Fromm Christian,OH,Germany,32.0,204.0,2022,Bulgaria,Germany,2022-06-10,True,2,3,17,22,0,0,7,7,17,4,7,28,3,1,2,6,9,0,23,32,2,1,2,5
119779.0,Fromm Christian,OH,Germany,32.0,204.0,2022,Germany,Serbia,2022-06-11,True,1,5,8,14,0,0,7,7,13,1,11,25,4,1,1,6,2,4,18,24,6,3,2,11
119779.0,Fromm Christian,OH,Germany,32.0,204.0,2022,Germany,Italy,2022-06-22,False,0,4,2,6,0,0,2,2,4,1,2,7,0,0,1,1,1,3,10,14,0,0,1,1
119779.0,Fromm Christian,OH,Germany,32.0,204.0,2022,Germany,Netherlands,2022-06-24,False,0,5,9,14,1,0,3,4,8,5,18,31,1,3,3,7,3,1,13,17,9,3,1,13
119779.0,Fromm Christian,OH,Germany,32.0,204.0,2022,Germany,France,2022-06-26,False,0,4,5,9,0,0,1,1,5,3,10,18,1,1,2,4,1,2,14,17,2,0,0,2
119779.0,Fromm Christian,OH,Germany,32.0,204.0,2022,USA,Germany,2022-07-05,False,0,3,7,10,0,0,3,3,7,3,14,24,2,2,2,6,7,5,11,23,3,0,0,3
119779.0,Fromm Christian,OH,Germany,32.0,204.0,2022,Brazil,Germany,2022-07-06,False,1,2,9,12,0,0,3,3,10,3,12,25,1,3,0,4,6,1,24,31,2,4,1,7
119779.0,Fromm Christian,OH,Germany,32.0,204.0,2022,Germany,Australia,2022-07-07,True,0,1,14,15,0,0,0,0,13,6,6,25,0,1,2,3,0,0,1,1,4,0,2,6
119779.0,Fromm Christian,OH,Germany,32.0,204.0,2022,Germany,Japan,2022-07-09,False,0,5,8,13,0,0,5,5,9,4,11,24,1,1,2,4,7,1,11,19,1,1,3,5
152469.0,Tille Johannes,S,Germany,25.0,186.0,2022,Canada,Germany,2022-06-07,True,0,1,1,2,0,0,0,0,0,0,0,0,0,0,0,0,0,0,0,0,0,0,0,0
152469.0,Tille Johannes,S,Germany,25.0,186.0,2022,Germany,Argentina,2022-06-09,False,0,1,3,4,3,0,19,22,0,0,0,0,0,0,1,1,0,0,0,0,2,0,0,2
152469.0,Tille Johannes,S,Germany,25.0,186.0,2022,Bulgaria,Germany,2022-06-10,True,0,0,0,0,1,0,0,1,0,0,0,0,0,1,0,1,0,0,0,0,0,0,0,0
152469.0,Tille Johannes,S,Germany,25.0,186.0,2022,Germany,Serbia,2022-06-11,True,1,0,11,12,7,0,21,28,0,0,0,0,2,2,0,4,0,1,0,1,2,0,2,4
152469.0,Tille Johannes,S,Germany,25.0,186.0,2022,Germany,Italy,2022-06-22,False,0,2,3,5,6,0,13,19,0,1,0,1,0,0,0,0,0,0,0,0,1,1,1,3
152469.0,Tille Johannes,S,Germany,25.0,186.0,2022,Germany,Netherlands,2022-06-24,False,0,1,3,4,2,0,9,11,0,0,0,0,0,0,0,0,0,0,0,0,0,0,0,0
152469.0,Tille Johannes,S,Germany,25.0,186.0,2022,Germany,France,2022-06-26,False,2,3,13,18,15,1,44,60,1,0,0,1,1,4,0,5,0,0,1,1,8,0,1,9
182291.0,Graven Leonard,L,Germany,18.0,180.0,2022,Germany,Italy,2022-06-22,False,0,0,0,0,0,0,0,0,0,0,0,0,0,0,0,0,0,0,0,0,0,0,0,0
182291.0,Graven Leonard,L,Germany,18.0,180.0,2022,Germany,Netherlands,2022-06-24,False,0,0,0,0,0,0,0,0,0,0,0,0,0,0,0,0,0,0,1,1,0,0,0,0
182291.0,Graven Leonard,L,Germany,18.0,180.0,2022,Germany,France,2022-06-26,False,0,0,0,0,0,0,2,2,0,0,0,0,0,0,0,0,1,1,5,7,0,0,0,0
182291.0,Graven Leonard,L,Germany,18.0,180.0,2022,USA,Germany,2022-07-05,False,0,0,0,0,0,0,0,0,0,0,0,0,0,0,0,0,0,0,0,0,0,0,0,0
182291.0,Graven Leonard,L,Germany,18.0,180.0,2022,Brazil,Germany,2022-07-06,False,0,0,0,0,0,0,0,0,0,0,0,0,0,0,0,0,0,0,0,0,0,0,0,0
182291.0,Graven Leonard,L,Germany,18.0,180.0,2022,Germany,Australia,2022-07-07,True,0,0,0,0,0,0,0,0,0,0,0,0,0,0,0,0,0,0,0,0,0,0,0,0
182291.0,Graven Leonard,L,Germany,18.0,180.0,2022,Germany,Japan,2022-07-09,False,0,0,0,0,0,0,2,2,0,0,0,0,0,0,0,0,0,0,0,0,4,2,0,6
139386.0,Reichert Moritz,OH,Germany,28.0,194.0,2022,Canada,Germany,2022-06-07,True,2,1,13,16,0,0,5,5,12,1,7,20,1,1,0,2,6,1,11,18,3,0,1,4
139386.0,Reichert Moritz,OH,Germany,28.0,194.0,2022,Germany,Argentina,2022-06-09,False,2,1,15,18,0,1,2,3,14,5,6,25,2,3,5,10,8,2,19,29,1,2,1,4
139386.0,Reichert Moritz,OH,Germany,28.0,194.0,2022,Bulgaria,Germany,2022-06-10,True,0,4,19,23,0,0,2,2,13,4,11,28,1,3,2,6,8,1,21,30,3,3,4,10
139386.0,Reichert Moritz,OH,Germany,28.0,194.0,2022,Germany,Serbia,2022-06-11,True,3,3,18,24,0,0,4,4,14,4,19,37,1,2,1,4,16,0,25,41,4,0,7,11
139386.0,Reichert Moritz,OH,Germany,28.0,194.0,2022,Germany,Italy,2022-06-22,False,0,2,7,9,0,0,3,3,3,3,7,13,0,1,1,2,2,1,13,16,6,2,0,8
139386.0,Reichert Moritz,OH,Germany,28.0,194.0,2022,Germany,Netherlands,2022-06-24,False,0,0,0,0,0,0,0,0,0,0,0,0,0,0,0,0,0,0,0,0,0,0,0,0
139386.0,Reichert Moritz,OH,Germany,28.0,194.0,2022,Germany,France,2022-06-26,False,0,0,0,0,0,0,0,0,0,0,0,0,0,0,0,0,0,0,0,0,0,0,0,0
139386.0,Reichert Moritz,OH,Germany,28.0,194.0,2022,USA,Germany,2022-07-05,False,0,0,1,1,0,0,3,3,0,0,1,1,0,0,0,0,3,0,1,4,0,0,0,0
139386.0,Reichert Moritz,OH,Germany,28.0,194.0,2022,Brazil,Germany,2022-07-06,False,0,0,0,0,0,1,0,1,0,0,0,0,0,0,0,0,0,0,4,4,1,0,1,2
139386.0,Reichert Moritz,OH,Germany,28.0,194.0,2022,Germany,Australia,2022-07-07,True,1,4,14,19,0,0,5,5,21,1,10,32,0,5,1,6,9,2,8,19,5,4,2,11
139386.0,Reichert Moritz,OH,Germany,28.0,194.0,2022,Germany,Japan,2022-07-09,False,0,0,0,0,0,0,0,0,0,0,0,0,0,0,0,0,1,0,1,2,0,0,0,0
152470.0,Zenger Julian,L,Germany,25.0,190.0,2022,Canada,Germany,2022-06-07,True,0,0,0,0,0,0,3,3,0,0,0,0,0,0,0,0,9,0,11,20,5,1,5,11
152470.0,Zenger Julian,L,Germany,25.0,190.0,2022,Germany,Argentina,2022-06-09,False,0,0,0,0,0,0,3,3,0,0,0,0,0,0,0,0,3,1,20,24,10,4,2,16
152470.0,Zenger Julian,L,Germany,25.0,190.0,2022,Bulgaria,Germany,2022-06-10,True,0,0,0,0,0,0,6,6,0,0,0,0,0,0,0,0,4,1,6,11,14,6,5,25
152470.0,Zenger Julian,L,Germany,25.0,190.0,2022,Germany,Serbia,2022-06-11,True,0,0,0,0,0,0,4,4,0,0,0,0,0,0,0,0,7,3,17,27,12,5,3,20
152470.0,Zenger Julian,L,Germany,25.0,190.0,2022,Germany,Italy,2022-06-22,False,0,0,0,0,0,0,2,2,0,0,0,0,0,0,0,0,7,0,5,12,7,2,1,10
152470.0,Zenger Julian,L,Germany,25.0,190.0,2022,Germany,Netherlands,2022-06-24,False,0,0,0,0,1,0,12,13,0,0,0,0,0,0,0,0,6,4,16,26,25,1,1,27
152470.0,Zenger Julian,L,Germany,25.0,190.0,2022,Germany,France,2022-06-26,False,0,0,0,0,0,0,6,6,0,0,0,0,0,0,0,0,5,2,6,13,2,3,0,5
152470.0,Zenger Julian,L,Germany,25.0,190.0,2022,USA,Germany,2022-07-05,False,0,0,0,0,3,0,11,14,0,0,0,0,0,0,0,0,11,0,11,22,3,6,15,24
152470.0,Zenger Julian,L,Germany,25.0,190.0,2022,Brazil,Germany,2022-07-06,False,0,0,0,0,0,0,12,12,0,0,0,0,0,0,0,0,8,3,10,21,10,4,5,19
152470.0,Zenger Julian,L,Germany,25.0,190.0,2022,Germany,Australia,2022-07-07,True,0,0,0,0,2,0,6,8,0,0,0,0,0,0,0,0,10,0,10,20,10,1,1,12
152470.0,Zenger Julian,L,Germany,25.0,190.0,2022,Germany,Japan,2022-07-09,False,0,0,0,0,0,0,5,5,0,0,0,0,0,0,0,0,4,1,11,16,2,1,1,4
136442.0,Zimmermann Jan,S,Germany,30.0,190.0,2022,Canada,Germany,2022-06-07,True,1,1,11,13,25,1,45,71,0,0,0,0,0,0,0,0,0,0,0,0,6,1,1,8
136442.0,Zimmermann Jan,S,Germany,30.0,190.0,2022,Germany,Argentina,2022-06-09,False,1,0,10,11,13,0,51,64,0,0,1,1,0,0,2,2,0,0,0,0,4,2,1,7
136442.0,Zimmermann Jan,S,Germany,30.0,190.0,2022,Bulgaria,Germany,2022-06-10,True,0,2,6,8,32,1,59,92,1,1,0,2,0,2,1,3,0,0,2,2,4,0,2,6
136442.0,Zimmermann Jan,S,Germany,30.0,190.0,2022,Germany,Serbia,2022-06-11,True,0,0,11,11,26,2,66,94,0,0,2,2,0,2,2,4,0,1,1,2,4,5,1,10
136442.0,Zimmermann Jan,S,Germany,30.0,190.0,2022,Germany,Italy,2022-06-22,False,1,1,4,6,9,0,38,47,0,0,0,0,0,4,0,4,0,0,0,0,1,0,0,1
136442.0,Zimmermann Jan,S,Germany,30.0,190.0,2022,Germany,Netherlands,2022-06-24,False,0,0,21,21,11,1,90,102,0,0,2,2,0,4,4,8,0,0,0,0,8,2,3,13
136442.0,Zimmermann Jan,S,Germany,30.0,190.0,2022,Germany,France,2022-06-26,False,0,0,0,0,0,0,0,0,0,0,0,0,0,0,0,0,0,0,0,0,0,0,0,0
136442.0,Zimmermann Jan,S,Germany,30.0,190.0,2022,USA,Germany,2022-07-05,False,0,2,12,14,30,0,62,92,2,0,1,3,0,3,2,5,0,0,0,0,8,2,3,13
136442.0,Zimmermann Jan,S,Germany,30.0,190.0,2022,Brazil,Germany,2022-07-06,False,0,1,16,17,28,0,58,86,0,0,0,0,0,1,1,2,0,0,0,0,2,2,3,7
136442.0,Zimmermann Jan,S,Germany,30.0,190.0,2022,Germany,Australia,2022-07-07,True,1,2,10,13,33,0,50,83,1,0,1,2,0,2,2,4,0,0,0,0,4,0,2,6
136442.0,Zimmermann Jan,S,Germany,30.0,190.0,2022,Germany,Japan,2022-07-09,False,0,1,12,13,20,0,44,64,0,0,2,2,1,3,1,5,0,0,0,0,3,2,5,10
162790.0,Krage Florian,MB,Germany,26.0,203.0,2022,Canada,Germany,2022-06-07,True,0,0,0,0,0,0,0,0,0,0,0,0,0,0,0,0,0,0,0,0,0,0,0,0
162790.0,Krage Florian,MB,Germany,26.0,203.0,2022,Germany,Argentina,2022-06-09,False,2,4,9,15,0,1,0,1,5,1,1,7,1,3,4,8,0,0,0,0,2,2,3,7
162790.0,Krage Florian,MB,Germany,26.0,203.0,2022,Bulgaria,Germany,2022-06-10,True,0,0,0,0,0,0,0,0,0,0,0,0,0,0,0,0,0,0,0,0,0,0,0,0
162790.0,Krage Florian,MB,Germany,26.0,203.0,2022,Germany,Serbia,2022-06-11,True,0,3,8,11,0,0,0,0,6,1,2,9,4,3,4,11,0,0,1,1,5,1,1,7
162790.0,Krage Florian,MB,Germany,26.0,203.0,2022,Germany,Italy,2022-06-22,False,0,1,5,6,0,0,0,0,1,2,0,3,1,0,1,2,1,0,1,2,1,0,0,1
162790.0,Krage Florian,MB,Germany,26.0,203.0,2022,Germany,Netherlands,2022-06-24,False,0,0,1,1,0,0,0,0,0,0,0,0,0,0,0,0,0,0,0,0,0,0,0,0
162790.0,Krage Florian,MB,Germany,26.0,203.0,2022,Germany,France,2022-06-26,False,0,5,4,9,0,0,1,1,3,1,0,4,1,9,3,13,1,1,1,3,1,0,2,3
162790.0,Krage Florian,MB,Germany,26.0,203.0,2022,USA,Germany,2022-07-05,False,0,3,11,14,0,0,2,2,7,1,5,13,0,2,3,5,0,0,1,1,1,2,0,3
162790.0,Krage Florian,MB,Germany,26.0,203.0,2022,Brazil,Germany,2022-07-06,False,1,2,11,14,0,0,4,4,8,2,3,13,0,9,4,13,0,0,0,0,1,0,0,1
162790.0,Krage Florian,MB,Germany,26.0,203.0,2022,Germany,Australia,2022-07-07,True,1,2,13,16,0,0,0,0,3,2,3,8,1,4,2,7,0,0,0,0,0,2,1,3
162790.0,Krage Florian,MB,Germany,26.0,203.0,2022,Germany,Japan,2022-07-09,False,0,3,13,16,0,0,0,0,3,1,3,7,2,3,1,6,1,0,0,1,1,0,1,2
174660.0,Röhrs Erik,OH,Germany,21.0,194.0,2022,Germany,Italy,2022-06-22,False,2,0,6,8,0,0,0,0,0,1,3,4,0,0,0,0,2,0,4,6,0,0,0,0
174660.0,Röhrs Erik,OH,Germany,21.0,194.0,2022,Germany,Netherlands,2022-06-24,False,0,0,0,0,0,0,0,0,0,0,0,0,0,0,0,0,0,0,0,0,0,0,0,0
162082.0,Weber Linus,O,Germany,23.0,203.0,2022,Canada,Germany,2022-06-07,True,0,5,7,12,0,0,2,2,12,4,9,25,3,4,3,10,0,0,0,0,1,1,3,5
162082.0,Weber Linus,O,Germany,23.0,203.0,2022,Germany,Argentina,2022-06-09,False,3,6,5,14,0,0,3,3,16,8,10,34,1,1,5,7,0,0,0,0,4,1,2,7
162082.0,Weber Linus,O,Germany,23.0,203.0,2022,Bulgaria,Germany,2022-06-10,True,1,3,14,18,0,0,1,1,13,7,7,27,1,5,0,6,0,0,0,0,4,2,3,9
162082.0,Weber Linus,O,Germany,23.0,203.0,2022,Germany,Serbia,2022-06-11,True,2,5,10,17,0,0,3,3,15,8,20,43,2,2,5,9,0,0,0,0,3,2,0,5
162082.0,Weber Linus,O,Germany,23.0,203.0,2022,Germany,Italy,2022-06-22,False,0,4,3,7,0,0,0,0,14,7,5,26,0,2,0,2,0,0,1,1,1,1,0,2
162082.0,Weber Linus,O,Germany,23.0,203.0,2022,Germany,Netherlands,2022-06-24,False,1,8,5,14,0,0,0,0,22,8,20,50,2,3,5,10,0,0,0,0,7,3,1,11
162082.0,Weber Linus,O,Germany,23.0,203.0,2022,Germany,France,2022-06-26,False,1,7,5,13,0,0,2,2,14,6,8,28,1,4,4,9,0,0,0,0,3,3,0,6
162082.0,Weber Linus,O,Germany,23.0,203.0,2022,USA,Germany,2022-07-05,False,0,0,0,0,0,0,0,0,0,0,0,0,0,0,0,0,0,0,0,0,0,0,0,0
152349.0,Krick Tobias,MB,Germany,24.0,210.0,2022,Canada,Germany,2022-06-07,True,1,3,1,5,0,0,2,2,1,3,4,8,1,3,4,8,0,0,0,0,1,0,0,1
152349.0,Krick Tobias,MB,Germany,24.0,210.0,2022,Germany,Argentina,2022-06-09,False,0,0,0,0,0,0,0,0,0,0,0,0,0,0,0,0,0,0,0,0,0,0,0,0
152349.0,Krick Tobias,MB,Germany,24.0,210.0,2022,Bulgaria,Germany,2022-06-10,True,1,1,10,12,0,0,0,0,11,1,4,16,5,4,5,14,1,0,0,1,0,0,1,1
152349.0,Krick Tobias,MB,Germany,24.0,210.0,2022,Germany,Serbia,2022-06-11,True,0,0,0,0,0,0,0,0,0,0,0,0,0,0,0,0,0,0,0,0,0,0,0,0
152349.0,Krick Tobias,MB,Germany,24.0,210.0,2022,Germany,Italy,2022-06-22,False,0,1,1,2,0,0,0,0,4,0,1,5,1,0,2,3,0,0,0,0,1,0,0,1
152349.0,Krick Tobias,MB,Germany,24.0,210.0,2022,Germany,Netherlands,2022-06-24,False,0,2,7,9,0,0,0,0,11,2,2,15,1,3,5,9,0,0,0,0,1,0,0,1
152349.0,Krick Tobias,MB,Germany,24.0,210.0,2022,Germany,France,2022-06-26,False,0,0,0,0,0,0,0,0,0,0,0,0,0,0,0,0,0,0,0,0,0,0,0,0
152349.0,Krick Tobias,MB,Germany,24.0,210.0,2022,USA,Germany,2022-07-05,False,1,5,5,11,0,0,2,2,6,1,12,19,1,4,4,9,1,0,1,2,0,0,3,3
152349.0,Krick Tobias,MB,Germany,24.0,210.0,2022,Brazil,Germany,2022-07-06,False,0,4,3,7,0,0,0,0,5,1,2,8,1,9,2,12,0,0,2,2,1,1,0,2
152349.0,Krick Tobias,MB,Germany,24.0,210.0,2022,Germany,Australia,2022-07-07,True,2,4,7,13,0,0,0,0,9,3,3,15,6,7,5,18,0,0,0,0,0,0,0,0
152349.0,Krick Tobias,MB,Germany,24.0,210.0,2022,Germany,Japan,2022-07-09,False,0,4,7,11,0,0,0,0,8,2,4,14,1,5,3,9,0,0,3,3,2,0,2,4
163592.0,Brand Tobias,OH,Germany,24.0,193.0,2022,Canada,Germany,2022-06-07,True,0,0,0,0,0,0,0,0,0,0,0,0,0,0,0,0,0,0,0,0,0,0,0,0
163592.0,Brand Tobias,OH,Germany,24.0,193.0,2022,Germany,Argentina,2022-06-09,False,0,0,1,1,0,0,1,1,0,1,0,1,0,0,1,1,0,0,2,2,0,0,0,0
163592.0,Brand Tobias,OH,Germany,24.0,193.0,2022,Bulgaria,Germany,2022-06-10,True,0,0,2,2,0,0,0,0,0,0,0,0,0,0,0,0,0,0,0,0,0,0,0,0
163592.0,Brand Tobias,OH,Germany,24.0,193.0,2022,Germany,Serbia,2022-06-11,True,0,0,5,5,0,0,1,1,0,0,3,3,0,0,0,0,2,1,2,5,1,2,3,6
163592.0,Brand Tobias,OH,Germany,24.0,193.0,2022,Germany,Italy,2022-06-22,False,0,0,1,1,0,0,0,0,1,2,2,5,0,1,1,2,0,0,6,6,2,0,0,2
163592.0,Brand Tobias,OH,Germany,24.0,193.0,2022,Germany,Netherlands,2022-06-24,False,0,1,13,14,0,0,2,2,7,1,13,21,0,4,5,9,8,1,25,34,10,3,0,13
163592.0,Brand Tobias,OH,Germany,24.0,193.0,2022,Germany,France,2022-06-26,False,1,2,13,16,0,0,6,6,4,1,10,15,0,1,1,2,8,2,11,21,3,1,0,4
163592.0,Brand Tobias,OH,Germany,24.0,193.0,2022,USA,Germany,2022-07-05,False,0,2,15,17,1,0,3,4,11,1,8,20,0,3,3,6,11,2,12,25,9,2,3,14
163592.0,Brand Tobias,OH,Germany,24.0,193.0,2022,Brazil,Germany,2022-07-06,False,0,2,11,13,0,0,4,4,14,2,11,27,3,4,2,9,7,2,17,26,4,0,3,7
163592.0,Brand Tobias,OH,Germany,24.0,193.0,2022,Germany,Australia,2022-07-07,True,0,4,12,16,0,0,0,0,5,4,9,18,1,2,1,4,6,2,18,26,7,2,1,10
163592.0,Brand Tobias,OH,Germany,24.0,193.0,2022,Germany,Japan,2022-07-09,False,0,4,8,12,0,0,3,3,12,2,13,27,0,2,0,2,5,2,18,25,3,2,1,6
183112.0,Goralik Yannick,MB,Germany,25.0,206.0,2022,Canada,Germany,2022-06-07,True,0,0,0,0,0,0,0,0,0,0,0,0,0,0,0,0,0,0,0,0,0,0,0,0
183112.0,Goralik Yannick,MB,Germany,25.0,206.0,2022,Germany,Argentina,2022-06-09,False,0,0,0,0,0,0,0,0,0,0,0,0,0,0,0,0,0,0,0,0,0,0,0,0
183112.0,Goralik Yannick,MB,Germany,25.0,206.0,2022,Bulgaria,Germany,2022-06-10,True,0,0,0,0,0,0,0,0,0,0,0,0,0,0,0,0,0,0,0,0,0,0,0,0
183112.0,Goralik Yannick,MB,Germany,25.0,206.0,2022,Germany,Serbia,2022-06-11,True,0,0,0,0,0,0,0,0,0,0,0,0,0,0,0,0,0,0,0,0,0,0,0,0
152352.0,Maase Lukas,MB,Germany,24.0,208.0,2022,Canada,Germany,2022-06-07,True,1,3,10,14,0,0,0,0,4,0,3,7,0,6,1,7,0,0,1,1,1,0,4,5
152352.0,Maase Lukas,MB,Germany,24.0,208.0,2022,Germany,Argentina,2022-06-09,False,0,3,9,12,0,0,2,2,6,1,6,13,1,5,2,8,1,1,1,3,1,0,4,5
152352.0,Maase Lukas,MB,Germany,24.0,208.0,2022,Bulgaria,Germany,2022-06-10,True,1,3,18,22,0,1,1,2,6,1,3,10,3,4,4,11,0,0,2,2,3,2,2,7
152352.0,Maase Lukas,MB,Germany,24.0,208.0,2022,Germany,Serbia,2022-06-11,True,2,3,16,21,0,0,0,0,12,3,7,22,3,14,7,24,0,0,1,1,0,4,3,7
152352.0,Maase Lukas,MB,Germany,24.0,208.0,2022,Germany,Italy,2022-06-22,False,0,2,7,9,0,0,1,1,5,1,4,10,2,5,2,9,0,0,3,3,3,1,0,4
152352.0,Maase Lukas,MB,Germany,24.0,208.0,2022,Germany,Netherlands,2022-06-24,False,0,2,13,15,0,0,1,1,5,0,6,11,5,7,10,22,1,0,2,3,4,2,1,7
152352.0,Maase Lukas,MB,Germany,24.0,208.0,2022,Germany,France,2022-06-26,False,0,3,13,16,0,0,1,1,5,1,5,11,3,4,3,10,0,0,2,2,3,0,0,3
152352.0,Maase Lukas,MB,Germany,24.0,208.0,2022,USA,Germany,2022-07-05,False,1,2,12,15,0,1,2,3,14,4,22,40,0,3,1,4,0,0,1,1,2,3,3,8
152352.0,Maase Lukas,MB,Germany,24.0,208.0,2022,Brazil,Germany,2022-07-06,False,1,3,12,16,0,2,2,4,13,5,14,32,1,3,1,5,0,0,1,1,5,2,5,12
176931.0,Dervisaj Leon,S,Germany,26.0,194.0,2022,USA,Germany,2022-07-05,False,0,0,0,0,1,0,1,2,0,0,0,0,0,0,0,0,0,0,0,0,0,0,0,0
176931.0,Dervisaj Leon,S,Germany,26.0,194.0,2022,Brazil,Germany,2022-07-06,False,0,0,0,0,0,0,4,4,0,0,0,0,0,0,0,0,0,0,0,0,0,0,0,0
176931.0,Dervisaj Leon,S,Germany,26.0,194.0,2022,Germany,Australia,2022-07-07,True,0,0,0,0,0,0,0,0,0,0,0,0,0,0,0,0,0,0,0,0,0,0,0,0
176931.0,Dervisaj Leon,S,Germany,26.0,194.0,2022,Germany,Japan,2022-07-09,False,0,1,1,2,5,0,16,21,1,0,0,1,0,1,0,1,0,0,0,0,1,4,0,5
152751.0,Ferch Iven,MB,Germany,25.0,208.0,2022,Canada,Germany,2022-06-07,True,0,0,0,0,0,0,0,0,0,0,0,0,0,0,0,0,0,0,0,0,0,0,0,0
152751.0,Ferch Iven,MB,Germany,25.0,208.0,2022,Germany,Argentina,2022-06-09,False,0,0,0,0,0,0,0,0,0,0,0,0,0,0,0,0,0,0,0,0,0,0,0,0
152751.0,Ferch Iven,MB,Germany,25.0,208.0,2022,Bulgaria,Germany,2022-06-10,True,0,0,0,0,0,0,0,0,0,0,0,0,0,0,0,0,0,0,0,0,0,0,0,0
152751.0,Ferch Iven,MB,Germany,25.0,208.0,2022,Germany,Serbia,2022-06-11,True,0,0,0,0,0,0,0,0,0,0,0,0,0,0,0,0,0,0,0,0,0,0,0,0
152751.0,Ferch Iven,MB,Germany,25.0,208.0,2022,Germany,Italy,2022-06-22,False,0,0,0,0,0,0,0,0,0,0,0,0,0,0,0,0,0,0,0,0,0,0,0,0
152751.0,Ferch Iven,MB,Germany,25.0,208.0,2022,Germany,Netherlands,2022-06-24,False,0,0,0,0,0,0,0,0,1,0,0,1,0,0,1,1,0,0,0,0,0,0,0,0
152751.0,Ferch Iven,MB,Germany,25.0,208.0,2022,Germany,France,2022-06-26,False,0,1,0,1,0,0,0,0,0,0,0,0,0,0,0,0,0,0,0,0,0,0,0,0
152751.0,Ferch Iven,MB,Germany,25.0,208.0,2022,USA,Germany,2022-07-05,False,0,0,0,0,0,0,0,0,0,0,0,0,0,0,0,0,0,0,0,0,0,0,0,0
152751.0,Ferch Iven,MB,Germany,25.0,208.0,2022,Brazil,Germany,2022-07-06,False,0,0,0,0,0,0,0,0,0,0,0,0,0,0,0,0,0,0,0,0,0,0,0,0
152751.0,Ferch Iven,MB,Germany,25.0,208.0,2022,Germany,Australia,2022-07-07,True,0,0,0,0,0,0,0,0,0,0,0,0,0,0,0,0,0,0,0,0,0,0,0,0
152751.0,Ferch Iven,MB,Germany,25.0,208.0,2022,Germany,Japan,2022-07-09,False,0,0,0,0,0,0,0,0,0,0,0,0,0,0,0,0,0,0,0,0,0,0,0,0
152713.0,Peter Tim,OH,Germany,25.0,197.0,2022,Canada,Germany,2022-06-07,True,0,1,0,1,0,0,0,0,0,0,0,0,0,0,0,0,0,0,0,0,0,0,0,0
152713.0,Peter Tim,OH,Germany,25.0,197.0,2022,Germany,Argentina,2022-06-09,False,0,1,0,1,0,0,0,0,0,0,0,0,0,0,0,0,0,0,0,0,0,0,0,0
152713.0,Peter Tim,OH,Germany,25.0,197.0,2022,Bulgaria,Germany,2022-06-10,True,0,0,0,0,0,0,0,0,0,0,0,0,0,0,0,0,0,0,0,0,0,0,0,0
152713.0,Peter Tim,OH,Germany,25.0,197.0,2022,Germany,Serbia,2022-06-11,True,0,0,0,0,0,0,0,0,0,0,0,0,0,0,0,0,0,0,0,0,0,0,0,0
152713.0,Peter Tim,OH,Germany,25.0,197.0,2022,Germany,Italy,2022-06-22,False,0,0,1,1,0,0,1,1,1,1,0,2,0,0,0,0,0,0,1,1,0,0,0,0
152713.0,Peter Tim,OH,Germany,25.0,197.0,2022,Germany,Netherlands,2022-06-24,False,0,1,1,2,0,0,0,0,1,2,0,3,0,0,1,1,0,0,0,0,0,1,0,1
152713.0,Peter Tim,OH,Germany,25.0,197.0,2022,Germany,France,2022-06-26,False,0,0,0,0,0,0,0,0,0,0,0,0,0,0,0,0,0,0,0,0,0,0,0,0
152713.0,Peter Tim,OH,Germany,25.0,197.0,2022,USA,Germany,2022-07-05,False,0,0,2,2,0,0,0,0,0,0,0,0,0,0,0,0,0,0,0,0,0,0,0,0
152713.0,Peter Tim,OH,Germany,25.0,197.0,2022,Brazil,Germany,2022-07-06,False,0,0,3,3,0,0,0,0,0,0,0,0,0,0,0,0,0,0,0,0,0,0,0,0
152713.0,Peter Tim,OH,Germany,25.0,197.0,2022,Germany,Australia,2022-07-07,True,0,1,2,3,0,0,0,0,0,0,0,0,0,0,0,0,0,0,0,0,0,0,0,0
152713.0,Peter Tim,OH,Germany,25.0,197.0,2022,Germany,Japan,2022-07-09,False,2,1,6,9,0,0,0,0,5,2,1,8,0,0,0,0,0,0,10,10,0,1,3,4
174640.0,Schulz Max,OH,Germany,20.0,200.0,2022,Canada,Germany,2022-06-07,True,0,0,0,0,0,0,0,0,0,0,0,0,0,0,0,0,0,0,0,0,0,0,0,0
174640.0,Schulz Max,OH,Germany,20.0,200.0,2022,Germany,Argentina,2022-06-09,False,0,1,0,1,0,0,0,0,0,0,2,2,0,0,0,0,0,0,0,0,0,0,0,0
174640.0,Schulz Max,OH,Germany,20.0,200.0,2022,Bulgaria,Germany,2022-06-10,True,0,0,0,0,0,0,0,0,0,0,0,0,0,0,0,0,0,0,0,0,0,0,0,0
174640.0,Schulz Max,OH,Germany,20.0,200.0,2022,Germany,Serbia,2022-06-11,True,0,0,0,0,0,0,0,0,0,0,0,0,0,0,0,0,0,0,0,0,0,0,0,0
174640.0,Schulz Max,OH,Germany,20.0,200.0,2022,USA,Germany,2022-07-05,False,0,0,0,0,0,0,0,0,0,1,1,2,0,0,0,0,0,0,0,0,0,0,0,0
174640.0,Schulz Max,OH,Germany,20.0,200.0,2022,Brazil,Germany,2022-07-06,False,0,1,1,2,0,0,0,0,1,0,2,3,0,0,0,0,0,0,0,0,0,0,0,0
174640.0,Schulz Max,OH,Germany,20.0,200.0,2022,Germany,Australia,2022-07-07,True,0,0,0,0,0,0,0,0,0,0,0,0,0,0,0,0,0,0,0,0,0,0,0,0
174640.0,Schulz Max,OH,Germany,20.0,200.0,2022,Germany,Japan,2022-07-09,False,0,5,7,12,0,0,1,1,9,7,3,19,3,4,5,12,0,0,1,1,6,3,1,10
163173.0,Jelveh Ghaziani Mahdi,MB,Iran,21.0,208.0,2022,China,Iran,2022-06-07,True,0,0,0,0,0,0,0,0,0,0,0,0,0,0,0,0,0,0,0,0,0,0,0,0
163173.0,Jelveh Ghaziani Mahdi,MB,Iran,21.0,208.0,2022,Netherlands,Iran,2022-06-10,False,2,0,7,9,0,0,0,0,2,0,3,5,1,5,1,7,0,0,2,2,1,0,1,2
163173.0,Jelveh Ghaziani Mahdi,MB,Iran,21.0,208.0,2022,Iran,Japan,2022-06-12,False,0,0,5,5,0,0,0,0,2,0,0,2,0,1,1,2,1,0,0,1,1,0,0,1
163173.0,Jelveh Ghaziani Mahdi,MB,Iran,21.0,208.0,2022,Iran,Bulgaria,2022-06-21,False,0,1,13,14,0,0,0,0,0,0,2,2,1,3,3,7,1,0,0,1,0,1,0,1
163173.0,Jelveh Ghaziani Mahdi,MB,Iran,21.0,208.0,2022,USA,Iran,2022-06-23,True,0,0,9,9,0,0,0,0,4,1,1,6,1,3,0,4,0,0,0,0,1,2,0,3
163173.0,Jelveh Ghaziani Mahdi,MB,Iran,21.0,208.0,2022,Iran,Brazil,2022-06-24,False,1,0,13,14,0,0,0,0,2,1,3,6,0,1,0,1,0,0,0,0,0,0,0,0
163173.0,Jelveh Ghaziani Mahdi,MB,Iran,21.0,208.0,2022,Canada,Iran,2022-06-25,True,0,0,10,10,0,0,0,0,3,0,0,3,2,3,2,7,0,0,1,1,0,1,0,1
163173.0,Jelveh Ghaziani Mahdi,MB,Iran,21.0,208.0,2022,Iran,Poland,2022-07-05,True,0,1,9,10,0,0,1,1,3,1,2,6,3,4,1,8,0,0,0,0,1,2,1,4
163173.0,Jelveh Ghaziani Mahdi,MB,Iran,21.0,208.0,2022,Italy,Iran,2022-07-07,False,0,2,2,4,0,0,0,0,0,0,1,1,0,3,1,4,0,0,0,0,0,0,0,0
163173.0,Jelveh Ghaziani Mahdi,MB,Iran,21.0,208.0,2022,Slovenia,Iran,2022-07-08,True,0,2,7,9,0,0,0,0,4,0,1,5,0,2,0,2,0,0,0,0,0,0,0,0
163173.0,Jelveh Ghaziani Mahdi,MB,Iran,21.0,208.0,2022,Iran,Serbia,2022-07-09,True,0,0,11,11,0,0,0,0,3,2,0,5,6,3,0,9,0,0,1,1,2,1,0,3
163173.0,Jelveh Ghaziani Mahdi,MB,Iran,21.0,208.0,2022,Poland,Iran,2022-07-21,False,0,2,12,14,0,0,4,4,5,2,2,9,1,2,9,12,2,0,0,2,1,1,1,3
136751.0,Ebadipour Ghara H. Milad,OH,Iran,29.0,196.0,2022,China,Iran,2022-06-07,True,1,3,11,15,0,0,3,3,13,5,8,26,1,2,0,3,5,2,17,24,3,0,0,3
136751.0,Ebadipour Ghara H. Milad,OH,Iran,29.0,196.0,2022,Netherlands,Iran,2022-06-10,False,1,3,5,9,1,0,0,1,5,4,7,16,0,2,0,2,3,1,14,18,4,0,0,4
136751.0,Ebadipour Ghara H. Milad,OH,Iran,29.0,196.0,2022,Iran,Japan,2022-06-12,False,0,1,5,6,2,0,0,2,2,2,8,12,1,1,1,3,3,3,12,18,1,1,0,2
136751.0,Ebadipour Ghara H. Milad,OH,Iran,29.0,196.0,2022,Iran,Bulgaria,2022-06-21,False,0,0,2,2,0,0,0,0,1,0,1,2,0,1,1,2,1,0,4,5,0,0,0,0
136751.0,Ebadipour Ghara H. Milad,OH,Iran,29.0,196.0,2022,USA,Iran,2022-06-23,True,2,3,8,13,0,1,0,1,12,2,7,21,1,0,0,1,3,2,15,20,0,1,0,1
136751.0,Ebadipour Ghara H. Milad,OH,Iran,29.0,196.0,2022,Iran,Brazil,2022-06-24,False,0,1,9,10,0,0,2,2,3,5,7,15,2,1,0,3,8,0,7,15,1,3,1,5
136751.0,Ebadipour Ghara H. Milad,OH,Iran,29.0,196.0,2022,Canada,Iran,2022-06-25,True,2,4,10,16,0,1,1,2,7,2,4,13,1,2,0,3,4,1,8,13,4,0,0,4
136751.0,Ebadipour Ghara H. Milad,OH,Iran,29.0,196.0,2022,Iran,Poland,2022-07-05,True,3,2,14,19,0,0,4,4,14,4,6,24,1,1,0,2,2,3,10,15,8,2,2,12
136751.0,Ebadipour Ghara H. Milad,OH,Iran,29.0,196.0,2022,Italy,Iran,2022-07-07,False,4,2,14,20,0,0,3,3,20,1,9,30,2,2,0,4,3,7,14,24,9,0,0,9
136751.0,Ebadipour Ghara H. Milad,OH,Iran,29.0,196.0,2022,Slovenia,Iran,2022-07-08,True,1,2,8,11,0,0,2,2,10,2,5,17,1,0,0,1,3,2,10,15,0,1,0,1
136751.0,Ebadipour Ghara H. Milad,OH,Iran,29.0,196.0,2022,Iran,Serbia,2022-07-09,True,1,3,12,16,0,0,2,2,9,3,7,19,0,3,0,3,2,1,8,11,3,1,0,4
136751.0,Ebadipour Ghara H. Milad,OH,Iran,29.0,196.0,2022,Poland,Iran,2022-07-21,False,3,5,11,19,0,2,2,4,12,4,11,27,2,3,2,7,7,1,10,18,11,4,0,15
150817.0,Abedini Reza,MB,Iran,31.0,203.0,2022,China,Iran,2022-06-07,True,1,2,8,11,0,0,0,0,2,2,0,4,2,7,4,13,0,1,3,4,5,1,2,8
150817.0,Abedini Reza,MB,Iran,31.0,203.0,2022,Iran,Japan,2022-06-12,False,0,0,0,0,0,0,0,0,0,0,0,0,0,0,0,0,0,0,0,0,0,0,0,0
163179.0,Toukhteh Amir Hossein,MB,Iran,21.0,203.0,2022,China,Iran,2022-06-07,True,2,2,12,16,0,0,1,1,9,0,3,12,1,4,0,5,0,0,3,3,3,0,0,3
163179.0,Toukhteh Amir Hossein,MB,Iran,21.0,203.0,2022,Netherlands,Iran,2022-06-10,False,1,1,5,7,0,0,0,0,1,0,0,1,0,4,0,4,0,0,2,2,0,0,0,0
163179.0,Toukhteh Amir Hossein,MB,Iran,21.0,203.0,2022,Iran,Japan,2022-06-12,False,0,3,3,6,0,0,0,0,2,1,3,6,0,6,1,7,2,0,1,3,2,1,1,4
163179.0,Toukhteh Amir Hossein,MB,Iran,21.0,203.0,2022,Iran,Bulgaria,2022-06-21,False,0,1,8,9,0,0,1,1,2,0,1,3,1,3,1,5,0,1,1,2,0,0,0,0
163179.0,Toukhteh Amir Hossein,MB,Iran,21.0,203.0,2022,USA,Iran,2022-06-23,True,0,1,2,3,0,0,0,0,2,1,2,5,0,2,1,3,0,0,0,0,1,0,0,1
163179.0,Toukhteh Amir Hossein,MB,Iran,21.0,203.0,2022,Iran,Brazil,2022-06-24,False,0,2,7,9,0,0,0,0,5,0,1,6,1,2,1,4,0,0,0,0,0,0,0,0
163179.0,Toukhteh Amir Hossein,MB,Iran,21.0,203.0,2022,Canada,Iran,2022-06-25,True,0,0,0,0,0,0,0,0,0,0,0,0,0,0,0,0,0,0,0,0,0,0,0,0
163179.0,Toukhteh Amir Hossein,MB,Iran,21.0,203.0,2022,Iran,Poland,2022-07-05,True,1,3,21,25,0,0,0,0,6,3,5,14,0,5,1,6,0,0,3,3,1,1,1,3
163179.0,Toukhteh Amir Hossein,MB,Iran,21.0,203.0,2022,Italy,Iran,2022-07-07,False,1,2,11,14,0,0,0,0,2,2,4,8,1,6,1,8,0,0,4,4,1,0,0,1
163179.0,Toukhteh Amir Hossein,MB,Iran,21.0,203.0,2022,Slovenia,Iran,2022-07-08,True,1,4,5,10,0,0,0,0,3,0,1,4,1,0,1,2,0,0,1,1,0,0,0,0
163179.0,Toukhteh Amir Hossein,MB,Iran,21.0,203.0,2022,Iran,Serbia,2022-07-09,True,1,3,15,19,0,0,0,0,10,1,1,12,2,2,0,4,0,0,2,2,0,0,0,0
163179.0,Toukhteh Amir Hossein,MB,Iran,21.0,203.0,2022,Poland,Iran,2022-07-21,False,2,4,8,14,0,0,2,2,4,3,1,8,0,3,2,5,1,1,2,4,2,0,0,2
152741.0,Mosaferdashliboroun Esmaeil,OH,Iran,25.0,192.0,2022,China,Iran,2022-06-07,True,0,0,0,0,0,0,0,0,0,0,0,0,0,0,0,0,0,0,0,0,0,0,0,0
152741.0,Mosaferdashliboroun Esmaeil,OH,Iran,25.0,192.0,2022,Netherlands,Iran,2022-06-10,False,0,0,0,0,0,0,0,0,0,0,0,0,0,0,0,0,0,0,0,0,0,0,0,0
152741.0,Mosaferdashliboroun Esmaeil,OH,Iran,25.0,192.0,2022,Iran,Japan,2022-06-12,False,0,1,1,2,0,0,1,1,2,1,2,5,1,1,1,3,0,1,8,9,1,0,1,2
152741.0,Mosaferdashliboroun Esmaeil,OH,Iran,25.0,192.0,2022,Iran,Bulgaria,2022-06-21,False,0,0,0,0,0,0,0,0,0,0,0,0,0,0,0,0,0,0,3,3,1,0,0,1
152741.0,Mosaferdashliboroun Esmaeil,OH,Iran,25.0,192.0,2022,USA,Iran,2022-06-23,True,0,0,0,0,0,0,0,0,0,0,0,0,0,0,0,0,0,0,0,0,0,0,0,0
152741.0,Mosaferdashliboroun Esmaeil,OH,Iran,25.0,192.0,2022,Iran,Brazil,2022-06-24,False,0,0,0,0,0,0,0,0,0,0,0,0,0,0,0,0,0,0,0,0,0,0,0,0
152741.0,Mosaferdashliboroun Esmaeil,OH,Iran,25.0,192.0,2022,Canada,Iran,2022-06-25,True,0,0,0,0,0,0,0,0,0,0,0,0,0,0,0,0,0,0,0,0,0,0,0,0
163176.0,Hazratpourtalatappeh Mohammadreza,L,Iran,23.0,187.0,2022,China,Iran,2022-06-07,True,0,0,0,0,0,0,8,8,0,0,0,0,0,0,0,0,4,0,15,19,5,1,4,10
163176.0,Hazratpourtalatappeh Mohammadreza,L,Iran,23.0,187.0,2022,Netherlands,Iran,2022-06-10,False,0,0,0,0,5,0,0,5,0,0,0,0,0,0,0,0,8,0,11,19,6,3,3,12
163176.0,Hazratpourtalatappeh Mohammadreza,L,Iran,23.0,187.0,2022,Iran,Japan,2022-06-12,False,0,0,0,0,2,0,0,2,0,0,0,0,0,0,0,0,0,0,4,4,4,1,0,5
163176.0,Hazratpourtalatappeh Mohammadreza,L,Iran,23.0,187.0,2022,Iran,Bulgaria,2022-06-21,False,0,0,0,0,0,0,4,4,0,0,0,0,0,0,0,0,0,1,9,10,3,2,3,8
163176.0,Hazratpourtalatappeh Mohammadreza,L,Iran,23.0,187.0,2022,USA,Iran,2022-06-23,True,0,0,0,0,0,0,6,6,0,0,0,0,0,0,0,0,2,0,9,11,0,1,1,2
163176.0,Hazratpourtalatappeh Mohammadreza,L,Iran,23.0,187.0,2022,Iran,Brazil,2022-06-24,False,0,0,0,0,0,0,1,1,0,0,0,0,0,0,0,0,8,3,11,22,0,1,1,2
163176.0,Hazratpourtalatappeh Mohammadreza,L,Iran,23.0,187.0,2022,Canada,Iran,2022-06-25,True,0,0,0,0,0,0,2,2,0,0,0,0,0,0,0,0,3,1,5,9,3,1,0,4
163176.0,Hazratpourtalatappeh Mohammadreza,L,Iran,23.0,187.0,2022,Iran,Poland,2022-07-05,True,0,0,0,0,0,0,3,3,0,0,0,0,0,0,0,0,6,3,11,20,5,2,0,7
163176.0,Hazratpourtalatappeh Mohammadreza,L,Iran,23.0,187.0,2022,Italy,Iran,2022-07-07,False,0,0,0,0,0,0,7,7,0,0,0,0,0,0,0,0,2,0,19,21,7,2,1,10
163176.0,Hazratpourtalatappeh Mohammadreza,L,Iran,23.0,187.0,2022,Slovenia,Iran,2022-07-08,True,0,0,0,0,0,0,4,4,0,0,0,0,0,0,0,0,4,1,3,8,7,2,2,11
163176.0,Hazratpourtalatappeh Mohammadreza,L,Iran,23.0,187.0,2022,Iran,Serbia,2022-07-09,True,0,0,0,0,0,0,2,2,0,0,0,0,0,0,0,0,1,0,15,16,4,4,1,9
163176.0,Hazratpourtalatappeh Mohammadreza,L,Iran,23.0,187.0,2022,Poland,Iran,2022-07-21,False,0,0,0,0,0,0,8,8,0,0,0,0,0,0,0,0,10,0,10,20,9,2,2,13
153535.0,Moazzen Mohammadreza,L,Iran,31.0,175.0,2022,China,Iran,2022-06-07,True,0,0,0,0,0,0,0,0,0,0,0,0,0,0,0,0,0,0,0,0,0,0,0,0
153535.0,Moazzen Mohammadreza,L,Iran,31.0,175.0,2022,Netherlands,Iran,2022-06-10,False,0,0,0,0,0,0,0,0,0,0,0,0,0,0,0,0,0,0,0,0,0,0,0,0
153535.0,Moazzen Mohammadreza,L,Iran,31.0,175.0,2022,Iran,Japan,2022-06-12,False,0,0,0,0,2,0,1,3,0,0,0,0,0,0,0,0,4,0,1,5,2,0,0,2
153535.0,Moazzen Mohammadreza,L,Iran,31.0,175.0,2022,Iran,Bulgaria,2022-06-21,False,0,0,0,0,0,0,0,0,0,0,0,0,0,0,0,0,2,0,3,5,0,1,0,1
153535.0,Moazzen Mohammadreza,L,Iran,31.0,175.0,2022,USA,Iran,2022-06-23,True,0,0,0,0,0,0,0,0,0,0,0,0,0,0,0,0,0,0,0,0,0,0,0,0
153535.0,Moazzen Mohammadreza,L,Iran,31.0,175.0,2022,Iran,Brazil,2022-06-24,False,0,0,0,0,0,0,0,0,0,0,0,0,0,0,0,0,0,0,0,0,0,0,0,0
153535.0,Moazzen Mohammadreza,L,Iran,31.0,175.0,2022,Canada,Iran,2022-06-25,True,0,0,0,0,0,0,0,0,0,0,0,0,0,0,0,0,0,0,0,0,0,0,0,0
164188.0,Kazemi Saber,O,Iran,24.0,205.0,2022,China,Iran,2022-06-07,True,4,2,6,12,0,1,0,1,3,5,5,13,0,1,1,2,0,0,1,1,4,1,0,5
164188.0,Kazemi Saber,O,Iran,24.0,205.0,2022,Netherlands,Iran,2022-06-10,False,0,0,1,1,0,0,0,0,1,1,1,3,0,0,0,0,0,0,0,0,0,0,0,0
164188.0,Kazemi Saber,O,Iran,24.0,205.0,2022,Iran,Japan,2022-06-12,False,0,0,5,5,0,0,0,0,3,1,5,9,0,0,0,0,0,0,0,0,2,0,0,2
152753.0,Ramezani Ali,S,Iran,24.0,200.0,2022,China,Iran,2022-06-07,True,0,0,0,0,0,0,2,2,0,0,0,0,0,0,0,0,0,0,0,0,0,0,0,0
152753.0,Ramezani Ali,S,Iran,24.0,200.0,2022,Netherlands,Iran,2022-06-10,False,0,0,6,6,9,1,17,27,1,0,0,1,0,3,0,3,0,0,1,1,1,1,1,3
152753.0,Ramezani Ali,S,Iran,24.0,200.0,2022,Iran,Japan,2022-06-12,False,1,0,5,6,12,2,21,35,0,0,2,2,0,0,1,1,0,0,0,0,2,1,0,3
152753.0,Ramezani Ali,S,Iran,24.0,200.0,2022,Iran,Bulgaria,2022-06-21,False,0,1,0,1,2,0,1,3,0,0,0,0,0,0,0,0,0,0,0,0,0,0,0,0
152753.0,Ramezani Ali,S,Iran,24.0,200.0,2022,USA,Iran,2022-06-23,True,0,0,0,0,0,0,1,1,0,0,0,0,0,0,0,0,0,0,0,0,0,0,0,0
152753.0,Ramezani Ali,S,Iran,24.0,200.0,2022,Iran,Brazil,2022-06-24,False,0,0,2,2,0,0,10,10,0,0,0,0,0,0,0,0,0,0,0,0,0,0,0,0
152753.0,Ramezani Ali,S,Iran,24.0,200.0,2022,Canada,Iran,2022-06-25,True,0,0,0,0,0,0,3,3,0,0,0,0,0,0,0,0,0,0,0,0,0,0,0,0
132534.0,Gholipour Gholchi Abolfazl,L,Iran,30.0,178.0,2022,Iran,Poland,2022-07-05,True,0,0,0,0,0,0,0,0,0,0,0,0,0,0,0,0,0,0,0,0,0,0,0,0
132534.0,Gholipour Gholchi Abolfazl,L,Iran,30.0,178.0,2022,Italy,Iran,2022-07-07,False,0,0,0,0,0,0,0,0,0,0,0,0,0,0,0,0,0,0,0,0,0,0,0,0
132534.0,Gholipour Gholchi Abolfazl,L,Iran,30.0,178.0,2022,Slovenia,Iran,2022-07-08,True,0,0,0,0,0,0,0,0,0,0,0,0,0,0,0,0,0,0,0,0,0,0,0,0
132534.0,Gholipour Gholchi Abolfazl,L,Iran,30.0,178.0,2022,Iran,Serbia,2022-07-09,True,0,0,0,0,0,0,0,0,0,0,0,0,0,0,0,0,0,0,0,0,0,0,0,0
132534.0,Gholipour Gholchi Abolfazl,L,Iran,30.0,178.0,2022,Poland,Iran,2022-07-21,False,0,0,0,0,0,0,0,0,0,0,0,0,0,0,0,0,0,0,0,0,0,0,0,0
153539.0,Esmaeilnezhad Amin,O,Iran,26.0,203.0,2022,China,Iran,2022-06-07,True,0,1,4,5,0,0,0,0,6,0,0,6,1,0,2,3,0,0,0,0,1,0,0,1
153539.0,Esmaeilnezhad Amin,O,Iran,26.0,203.0,2022,Netherlands,Iran,2022-06-10,False,0,2,8,10,0,0,1,1,15,4,11,30,0,3,2,5,0,0,0,0,3,0,0,3
153539.0,Esmaeilnezhad Amin,O,Iran,26.0,203.0,2022,Iran,Japan,2022-06-12,False,2,2,4,8,1,0,0,1,7,2,8,17,1,1,1,3,0,0,0,0,1,1,0,2
153539.0,Esmaeilnezhad Amin,O,Iran,26.0,203.0,2022,Iran,Bulgaria,2022-06-21,False,0,1,6,7,0,0,0,0,15,6,8,29,2,2,0,4,0,0,0,0,2,0,1,3
153539.0,Esmaeilnezhad Amin,O,Iran,26.0,203.0,2022,USA,Iran,2022-06-23,True,0,2,12,14,0,1,0,1,19,4,6,29,1,1,3,5,0,0,1,1,1,1,1,3
153539.0,Esmaeilnezhad Amin,O,Iran,26.0,203.0,2022,Iran,Brazil,2022-06-24,False,0,2,7,9,0,0,0,0,15,3,3,21,0,2,2,4,0,0,0,0,0,0,0,0
153539.0,Esmaeilnezhad Amin,O,Iran,26.0,203.0,2022,Canada,Iran,2022-06-25,True,0,5,11,16,0,0,0,0,15,3,6,24,0,1,2,3,0,0,0,0,2,0,3,5
153539.0,Esmaeilnezhad Amin,O,Iran,26.0,203.0,2022,Iran,Poland,2022-07-05,True,3,4,17,24,0,0,2,2,14,5,8,27,1,4,0,5,0,0,0,0,2,1,1,4
153539.0,Esmaeilnezhad Amin,O,Iran,26.0,203.0,2022,Italy,Iran,2022-07-07,False,2,2,11,15,0,0,5,5,18,6,18,42,3,2,0,5,0,0,2,2,0,2,0,2
153539.0,Esmaeilnezhad Amin,O,Iran,26.0,203.0,2022,Slovenia,Iran,2022-07-08,True,3,5,14,22,0,0,0,0,11,5,10,26,0,2,0,2,0,0,0,0,4,0,0,4
153539.0,Esmaeilnezhad Amin,O,Iran,26.0,203.0,2022,Iran,Serbia,2022-07-09,True,2,2,11,15,0,0,2,2,13,2,9,24,1,4,0,5,0,0,0,0,4,2,0,6
153539.0,Esmaeilnezhad Amin,O,Iran,26.0,203.0,2022,Poland,Iran,2022-07-21,False,0,3,12,15,1,0,1,2,21,9,9,39,1,6,4,11,1,0,0,1,2,2,2,6
119750.0,Vadi Mohammad Taher,S,Iran,33.0,194.0,2022,China,Iran,2022-06-07,True,2,0,11,13,29,1,16,46,1,0,1,2,0,0,1,1,0,0,2,2,2,2,2,6
119750.0,Vadi Mohammad Taher,S,Iran,33.0,194.0,2022,Netherlands,Iran,2022-06-10,False,0,0,6,6,13,0,27,40,0,0,0,0,0,1,0,1,0,0,0,0,3,1,0,4
119750.0,Vadi Mohammad Taher,S,Iran,33.0,194.0,2022,Iran,Japan,2022-06-12,False,0,0,4,4,8,0,16,24,0,0,0,0,0,1,1,2,0,0,0,0,4,0,0,4
119750.0,Vadi Mohammad Taher,S,Iran,33.0,194.0,2022,Iran,Bulgaria,2022-06-21,False,0,1,13,14,14,0,53,67,1,0,0,1,1,2,0,3,0,0,0,0,1,0,0,1
119750.0,Vadi Mohammad Taher,S,Iran,33.0,194.0,2022,USA,Iran,2022-06-23,True,0,1,11,12,12,0,53,65,1,0,0,1,0,4,2,6,0,0,0,0,1,0,2,3
119750.0,Vadi Mohammad Taher,S,Iran,33.0,194.0,2022,Iran,Brazil,2022-06-24,False,0,0,8,8,10,0,43,53,1,0,2,3,1,2,0,3,0,0,0,0,1,0,0,1
119750.0,Vadi Mohammad Taher,S,Iran,33.0,194.0,2022,Canada,Iran,2022-06-25,True,0,1,10,11,10,0,44,54,0,0,1,1,0,1,0,1,0,0,0,0,4,0,0,4
119750.0,Vadi Mohammad Taher,S,Iran,33.0,194.0,2022,Iran,Poland,2022-07-05,True,0,3,8,11,19,0,75,94,0,0,1,1,0,3,0,3,0,0,0,0,1,0,1,2
119750.0,Vadi Mohammad Taher,S,Iran,33.0,194.0,2022,Italy,Iran,2022-07-07,False,0,0,14,14,12,0,62,74,1,0,0,1,0,0,0,0,0,0,0,0,0,1,1,2
119750.0,Vadi Mohammad Taher,S,Iran,33.0,194.0,2022,Slovenia,Iran,2022-07-08,True,0,1,10,11,18,0,44,62,0,0,0,0,3,1,0,4,0,0,0,0,0,1,0,1
119750.0,Vadi Mohammad Taher,S,Iran,33.0,194.0,2022,Iran,Serbia,2022-07-09,True,1,1,7,9,24,0,49,73,2,0,0,2,1,0,0,1,0,0,0,0,1,1,0,2
119750.0,Vadi Mohammad Taher,S,Iran,33.0,194.0,2022,Poland,Iran,2022-07-21,False,0,1,16,17,15,0,80,95,0,0,0,0,0,4,2,6,0,1,1,2,8,2,0,10
163174.0,Daneshdoust Ehsan,OH,Iran,23.0,192.0,2022,Iran,Poland,2022-07-05,True,0,0,0,0,0,0,0,0,0,0,0,0,0,0,0,0,0,0,0,0,0,0,0,0
163174.0,Daneshdoust Ehsan,OH,Iran,23.0,192.0,2022,Italy,Iran,2022-07-07,False,0,0,0,0,0,0,0,0,0,0,0,0,0,0,0,0,0,0,2,2,0,0,0,0
163174.0,Daneshdoust Ehsan,OH,Iran,23.0,192.0,2022,Slovenia,Iran,2022-07-08,True,0,0,0,0,0,0,0,0,0,0,0,0,0,0,0,0,0,0,0,0,0,0,0,0
163174.0,Daneshdoust Ehsan,OH,Iran,23.0,192.0,2022,Iran,Serbia,2022-07-09,True,0,0,0,0,0,0,0,0,0,0,0,0,0,0,0,0,0,0,0,0,0,0,0,0
163174.0,Daneshdoust Ehsan,OH,Iran,23.0,192.0,2022,Poland,Iran,2022-07-21,False,0,0,0,0,0,0,0,0,1,0,0,1,0,0,0,0,2,0,2,4,0,1,0,1
174560.0,Sarlak Amir Reza,MB,Iran,21.0,201.0,2022,Iran,Bulgaria,2022-06-21,False,0,1,1,2,0,0,0,0,0,0,0,0,0,0,0,0,0,0,0,0,1,0,0,1
174560.0,Sarlak Amir Reza,MB,Iran,21.0,201.0,2022,USA,Iran,2022-06-23,True,0,1,7,8,0,0,0,0,0,0,1,1,1,0,0,1,0,0,2,2,0,0,0,0
174560.0,Sarlak Amir Reza,MB,Iran,21.0,201.0,2022,Iran,Brazil,2022-06-24,False,0,0,2,2,0,0,0,0,0,1,0,1,0,2,0,2,0,0,0,0,0,1,0,1
174560.0,Sarlak Amir Reza,MB,Iran,21.0,201.0,2022,Canada,Iran,2022-06-25,True,0,0,10,10,0,0,1,1,3,0,1,4,1,2,4,7,0,0,0,0,0,1,0,1
174560.0,Sarlak Amir Reza,MB,Iran,21.0,201.0,2022,Iran,Poland,2022-07-05,True,0,0,1,1,0,0,0,0,0,0,0,0,0,0,0,0,0,0,0,0,0,0,0,0
174560.0,Sarlak Amir Reza,MB,Iran,21.0,201.0,2022,Italy,Iran,2022-07-07,False,0,0,8,8,0,0,0,0,1,0,0,1,0,2,0,2,0,0,0,0,1,0,1,2
174560.0,Sarlak Amir Reza,MB,Iran,21.0,201.0,2022,Slovenia,Iran,2022-07-08,True,0,0,0,0,0,0,0,0,0,0,0,0,0,0,0,0,0,0,0,0,0,0,0,0
174560.0,Sarlak Amir Reza,MB,Iran,21.0,201.0,2022,Iran,Serbia,2022-07-09,True,0,0,1,1,0,0,0,0,0,0,0,0,0,0,0,0,0,0,0,0,0,0,0,0
174560.0,Sarlak Amir Reza,MB,Iran,21.0,201.0,2022,Poland,Iran,2022-07-21,False,0,0,1,1,0,0,0,0,1,1,0,2,0,0,0,0,0,0,0,0,0,0,0,0
152752.0,Esfandiar Amirhossein,OH,Iran,24.0,209.0,2022,China,Iran,2022-06-07,True,0,0,0,0,0,0,0,0,0,0,0,0,0,0,0,0,0,0,0,0,0,0,0,0
152752.0,Esfandiar Amirhossein,OH,Iran,24.0,209.0,2022,Netherlands,Iran,2022-06-10,False,2,1,3,6,0,0,0,0,3,0,1,4,0,3,2,5,4,0,5,9,3,1,1,5
152752.0,Esfandiar Amirhossein,OH,Iran,24.0,209.0,2022,Iran,Japan,2022-06-12,False,0,2,2,4,1,0,1,2,4,1,1,6,0,2,4,6,3,5,5,13,1,0,1,2
152752.0,Esfandiar Amirhossein,OH,Iran,24.0,209.0,2022,Iran,Bulgaria,2022-06-21,False,0,0,7,7,0,0,1,1,8,5,4,17,0,1,1,2,5,2,9,16,0,1,0,1
152752.0,Esfandiar Amirhossein,OH,Iran,24.0,209.0,2022,USA,Iran,2022-06-23,True,3,5,9,17,0,0,0,0,8,1,4,13,2,2,2,6,5,1,20,26,1,1,0,2
152752.0,Esfandiar Amirhossein,OH,Iran,24.0,209.0,2022,Iran,Brazil,2022-06-24,False,1,4,3,8,0,0,0,0,4,3,5,12,1,3,1,5,5,1,10,16,0,0,0,0
152752.0,Esfandiar Amirhossein,OH,Iran,24.0,209.0,2022,Canada,Iran,2022-06-25,True,2,3,6,11,0,0,1,1,12,1,8,21,0,1,3,4,8,2,11,21,2,2,0,4
152752.0,Esfandiar Amirhossein,OH,Iran,24.0,209.0,2022,Iran,Poland,2022-07-05,True,2,2,14,18,0,0,1,1,19,3,10,32,0,4,1,5,3,4,34,41,1,3,1,5
152752.0,Esfandiar Amirhossein,OH,Iran,24.0,209.0,2022,Italy,Iran,2022-07-07,False,1,5,2,8,0,0,2,2,4,4,6,14,0,0,0,0,3,1,12,16,1,0,1,2
152752.0,Esfandiar Amirhossein,OH,Iran,24.0,209.0,2022,Slovenia,Iran,2022-07-08,True,1,3,6,10,0,0,0,0,8,3,5,16,1,0,0,1,3,1,19,23,1,1,1,3
152752.0,Esfandiar Amirhossein,OH,Iran,24.0,209.0,2022,Iran,Serbia,2022-07-09,True,2,2,8,12,0,0,4,4,11,3,7,21,4,3,0,7,4,0,21,25,1,0,0,1
152752.0,Esfandiar Amirhossein,OH,Iran,24.0,209.0,2022,Poland,Iran,2022-07-21,False,1,4,9,14,0,0,2,2,10,5,14,29,3,3,3,9,10,3,13,26,5,3,2,10
168551.0,Saadat Bardia,O,Iran,20.0,205.0,2022,Iran,Bulgaria,2022-06-21,False,0,0,1,1,0,0,0,0,2,0,0,2,0,0,0,0,0,0,0,0,0,0,0,0
168551.0,Saadat Bardia,O,Iran,20.0,205.0,2022,USA,Iran,2022-06-23,True,0,0,0,0,0,0,0,0,0,0,0,0,0,0,0,0,0,0,0,0,0,0,0,0
168551.0,Saadat Bardia,O,Iran,20.0,205.0,2022,Iran,Brazil,2022-06-24,False,1,1,1,3,0,0,0,0,1,0,4,5,0,1,0,1,0,0,0,0,1,1,0,2
168551.0,Saadat Bardia,O,Iran,20.0,205.0,2022,Canada,Iran,2022-06-25,True,0,0,0,0,0,0,0,0,0,0,0,0,0,0,0,0,0,0,0,0,0,0,0,0
168551.0,Saadat Bardia,O,Iran,20.0,205.0,2022,Iran,Poland,2022-07-05,True,0,0,0,0,0,0,0,0,0,0,0,0,0,1,0,1,0,0,0,0,0,0,0,0
168551.0,Saadat Bardia,O,Iran,20.0,205.0,2022,Italy,Iran,2022-07-07,False,0,0,0,0,0,0,0,0,0,0,0,0,0,0,0,0,0,0,0,0,0,0,0,0
168551.0,Saadat Bardia,O,Iran,20.0,205.0,2022,Slovenia,Iran,2022-07-08,True,0,0,0,0,0,0,0,0,1,0,0,1,0,0,0,0,0,0,0,0,0,0,0,0
168551.0,Saadat Bardia,O,Iran,20.0,205.0,2022,Iran,Serbia,2022-07-09,True,0,0,0,0,0,0,0,0,0,0,0,0,0,0,0,0,0,0,0,0,0,0,0,0
168551.0,Saadat Bardia,O,Iran,20.0,205.0,2022,Poland,Iran,2022-07-21,False,0,0,0,0,0,0,1,1,0,0,0,0,0,0,0,0,0,0,0,0,0,0,0,0
189118.0,Pazhooman Fazel,S,Iran,29.0,204.0,2022,Iran,Poland,2022-07-05,True,0,0,1,1,0,0,1,1,0,0,0,0,0,0,0,0,0,0,0,0,0,0,0,0
189118.0,Pazhooman Fazel,S,Iran,29.0,204.0,2022,Italy,Iran,2022-07-07,False,0,1,1,2,1,0,22,23,0,0,1,1,0,0,0,0,0,0,0,0,0,0,0,0
189118.0,Pazhooman Fazel,S,Iran,29.0,204.0,2022,Slovenia,Iran,2022-07-08,True,0,0,0,0,0,0,0,0,0,0,0,0,0,0,0,0,0,0,0,0,0,0,0,0
189118.0,Pazhooman Fazel,S,Iran,29.0,204.0,2022,Iran,Serbia,2022-07-09,True,0,0,0,0,0,0,0,0,0,0,0,0,0,0,0,0,0,0,0,0,0,0,0,0
189118.0,Pazhooman Fazel,S,Iran,29.0,204.0,2022,Poland,Iran,2022-07-21,False,0,0,1,1,3,0,1,4,0,0,0,0,0,0,0,0,0,0,0,0,0,0,0,0
189175.0,Malakisorkhi Mehrab,MB,Iran,24.0,206.0,2022,China,Iran,2022-06-07,True,0,0,0,0,0,0,0,0,0,0,0,0,0,0,0,0,0,0,0,0,0,0,0,0
189175.0,Malakisorkhi Mehrab,MB,Iran,24.0,206.0,2022,Netherlands,Iran,2022-06-10,False,1,1,4,6,0,0,0,0,4,0,2,6,0,4,4,8,0,0,0,0,1,0,0,1
189175.0,Malakisorkhi Mehrab,MB,Iran,24.0,206.0,2022,Iran,Japan,2022-06-12,False,0,1,2,3,0,1,0,1,1,1,1,3,0,2,3,5,0,0,1,1,0,1,0,1
189175.0,Malakisorkhi Mehrab,MB,Iran,24.0,206.0,2022,Iran,Bulgaria,2022-06-21,False,0,0,0,0,0,0,0,0,0,0,0,0,0,0,0,0,0,0,0,0,0,0,0,0
189175.0,Malakisorkhi Mehrab,MB,Iran,24.0,206.0,2022,USA,Iran,2022-06-23,True,0,0,0,0,0,0,0,0,0,0,0,0,0,0,0,0,0,0,0,0,0,0,0,0
189175.0,Malakisorkhi Mehrab,MB,Iran,24.0,206.0,2022,Iran,Brazil,2022-06-24,False,0,1,1,2,0,0,0,0,0,0,1,1,0,1,0,1,0,0,0,0,0,0,0,0
189175.0,Malakisorkhi Mehrab,MB,Iran,24.0,206.0,2022,Canada,Iran,2022-06-25,True,0,0,0,0,0,0,0,0,0,0,0,0,0,0,0,0,0,0,0,0,0,0,0,0
189175.0,Malakisorkhi Mehrab,MB,Iran,24.0,206.0,2022,Iran,Poland,2022-07-05,True,0,0,0,0,0,0,0,0,0,0,0,0,0,0,0,0,0,0,0,0,0,0,0,0
189175.0,Malakisorkhi Mehrab,MB,Iran,24.0,206.0,2022,Italy,Iran,2022-07-07,False,0,1,0,1,0,0,0,0,0,0,0,0,0,0,0,0,0,0,0,0,0,0,0,0
189175.0,Malakisorkhi Mehrab,MB,Iran,24.0,206.0,2022,Slovenia,Iran,2022-07-08,True,0,0,0,0,0,0,0,0,0,0,0,0,0,0,0,0,0,0,0,0,0,0,0,0
189175.0,Malakisorkhi Mehrab,MB,Iran,24.0,206.0,2022,Iran,Serbia,2022-07-09,True,0,0,0,0,0,0,0,0,0,0,0,0,0,0,0,0,0,0,0,0,0,0,0,0
189175.0,Malakisorkhi Mehrab,MB,Iran,24.0,206.0,2022,Poland,Iran,2022-07-21,False,0,0,0,0,0,0,0,0,0,0,0,0,0,0,0,0,0,0,0,0,0,0,0,0
152742.0,Sharifi Morteza,OH,Iran,23.0,193.0,2022,China,Iran,2022-06-07,True,4,3,12,19,0,0,2,2,14,1,5,20,2,1,2,5,2,2,8,12,3,0,0,3
152742.0,Sharifi Morteza,OH,Iran,23.0,193.0,2022,Netherlands,Iran,2022-06-10,False,0,2,5,7,1,0,0,1,4,4,2,10,0,3,2,5,1,1,5,7,0,0,1,1
152742.0,Sharifi Morteza,OH,Iran,23.0,193.0,2022,Iran,Japan,2022-06-12,False,1,3,1,5,0,0,1,1,4,1,3,8,0,0,0,0,1,1,6,8,2,0,0,2
152742.0,Sharifi Morteza,OH,Iran,23.0,193.0,2022,Iran,Bulgaria,2022-06-21,False,1,4,5,10,0,0,0,0,10,4,6,20,0,2,0,2,2,2,18,22,0,0,0,0
152742.0,Sharifi Morteza,OH,Iran,23.0,193.0,2022,USA,Iran,2022-06-23,True,0,0,3,3,0,0,0,0,0,0,0,0,0,0,0,0,0,0,0,0,1,0,0,1
152742.0,Sharifi Morteza,OH,Iran,23.0,193.0,2022,Iran,Brazil,2022-06-24,False,1,1,2,4,0,0,0,0,4,0,0,4,0,1,0,1,1,1,5,7,0,2,0,2
152742.0,Sharifi Morteza,OH,Iran,23.0,193.0,2022,Canada,Iran,2022-06-25,True,0,0,1,1,0,0,0,0,0,0,0,0,0,0,0,0,0,0,0,0,0,0,0,0
152742.0,Sharifi Morteza,OH,Iran,23.0,193.0,2022,Iran,Poland,2022-07-05,True,0,0,1,1,0,0,0,0,0,0,0,0,0,0,0,0,0,0,0,0,0,0,0,0
152742.0,Sharifi Morteza,OH,Iran,23.0,193.0,2022,Italy,Iran,2022-07-07,False,0,2,2,4,0,0,0,0,3,4,3,10,1,1,0,2,1,0,13,14,4,0,0,4
152742.0,Sharifi Morteza,OH,Iran,23.0,193.0,2022,Slovenia,Iran,2022-07-08,True,0,0,1,1,0,0,0,0,0,0,0,0,0,0,0,0,0,0,0,0,0,0,0,0
152742.0,Sharifi Morteza,OH,Iran,23.0,193.0,2022,Iran,Serbia,2022-07-09,True,0,1,0,1,0,0,0,0,0,0,0,0,0,0,0,0,0,0,3,3,0,0,0,0
152742.0,Sharifi Morteza,OH,Iran,23.0,193.0,2022,Poland,Iran,2022-07-21,False,0,1,2,3,0,0,0,0,1,0,0,1,0,1,0,1,0,0,4,4,0,1,0,1
162518.0,Pinali Giulio,O,Italy,25.0,199.0,2022,France,Italy,2022-06-08,False,0,0,0,0,0,0,0,0,0,0,0,0,0,0,0,0,0,0,0,0,0,0,0,0
162518.0,Pinali Giulio,O,Italy,25.0,199.0,2022,Poland,Italy,2022-06-09,True,0,0,0,0,0,0,0,0,0,0,0,0,0,0,0,0,0,0,0,0,0,0,0,0
162518.0,Pinali Giulio,O,Italy,25.0,199.0,2022,Canada,Italy,2022-06-11,True,0,0,0,0,0,0,0,0,0,1,0,1,0,0,0,0,0,0,0,0,0,0,0,0
162518.0,Pinali Giulio,O,Italy,25.0,199.0,2022,Argentina,Italy,2022-06-12,True,0,3,2,5,0,0,2,2,9,3,11,23,0,0,4,4,0,0,0,0,0,3,1,4
162518.0,Pinali Giulio,O,Italy,25.0,199.0,2022,Germany,Italy,2022-06-22,True,0,1,3,4,0,0,0,0,0,0,0,0,0,0,0,0,0,0,0,0,0,0,0,0
162518.0,Pinali Giulio,O,Italy,25.0,199.0,2022,Japan,Italy,2022-06-24,False,0,0,0,0,0,0,0,0,0,0,0,0,0,0,0,0,0,0,0,0,0,0,0,0
162518.0,Pinali Giulio,O,Italy,25.0,199.0,2022,Italy,Slovenia,2022-06-25,True,0,2,2,4,1,0,0,1,5,2,1,8,0,3,1,4,0,0,0,0,3,1,0,4
162518.0,Pinali Giulio,O,Italy,25.0,199.0,2022,Italy,China,2022-06-26,True,2,3,7,12,0,0,0,0,12,4,4,20,1,4,1,6,0,0,0,0,6,0,2,8
141638.0,Ricci Fabio,MB,Italy,28.0,204.0,2022,Germany,Italy,2022-06-22,True,0,0,0,0,0,0,0,0,0,0,0,0,0,0,0,0,0,0,0,0,0,0,0,0
141638.0,Ricci Fabio,MB,Italy,28.0,204.0,2022,Japan,Italy,2022-06-24,False,0,0,0,0,0,0,0,0,0,0,0,0,0,0,0,0,0,0,0,0,0,0,0,0
141638.0,Ricci Fabio,MB,Italy,28.0,204.0,2022,Italy,Slovenia,2022-06-25,True,0,0,0,0,0,0,0,0,0,0,0,0,0,0,0,0,0,0,0,0,0,0,0,0
141638.0,Ricci Fabio,MB,Italy,28.0,204.0,2022,Italy,China,2022-06-26,True,0,0,1,1,0,0,0,0,0,0,0,0,0,0,0,0,0,0,0,0,0,0,0,0
163033.0,Recine Francesco,OH,Italy,24.0,186.0,2022,France,Italy,2022-06-08,False,1,3,9,13,0,0,8,8,8,2,5,15,0,5,1,6,2,1,19,22,7,2,3,12
163033.0,Recine Francesco,OH,Italy,24.0,186.0,2022,Poland,Italy,2022-06-09,True,0,2,14,16,0,0,8,8,8,3,14,25,1,3,1,5,3,2,17,22,5,2,4,11
163033.0,Recine Francesco,OH,Italy,24.0,186.0,2022,Canada,Italy,2022-06-11,True,0,2,7,9,0,0,2,2,7,4,4,15,0,1,1,2,6,0,12,18,5,0,1,6
163033.0,Recine Francesco,OH,Italy,24.0,186.0,2022,Argentina,Italy,2022-06-12,True,0,4,15,19,0,0,4,4,13,4,6,23,2,3,2,7,5,1,23,29,5,0,3,8
163033.0,Recine Francesco,OH,Italy,24.0,186.0,2022,Italy,Netherlands,2022-07-20,True,0,0,0,0,0,0,0,0,0,0,0,0,0,0,0,0,0,0,0,0,0,0,0,0
163033.0,Recine Francesco,OH,Italy,24.0,186.0,2022,Italy,France,2022-07-23,False,0,1,1,2,0,0,0,0,0,0,2,2,0,0,0,0,1,1,1,3,1,0,0,1
163033.0,Recine Francesco,OH,Italy,24.0,186.0,2022,Italy,Poland,2022-07-24,False,0,0,0,0,0,0,0,0,0,0,0,0,0,0,0,0,0,0,0,0,0,0,0,0
152492.0,Cavuto Oreste,OH,Italy,26.0,196.0,2022,Germany,Italy,2022-06-22,True,0,0,0,0,0,0,0,0,0,0,0,0,0,0,0,0,0,0,0,0,0,0,0,0
152492.0,Cavuto Oreste,OH,Italy,26.0,196.0,2022,Japan,Italy,2022-06-24,False,0,0,0,0,0,0,0,0,0,0,0,0,0,0,0,0,0,1,1,2,0,0,0,0
152492.0,Cavuto Oreste,OH,Italy,26.0,196.0,2022,Italy,Slovenia,2022-06-25,True,0,0,0,0,0,0,0,0,0,0,0,0,0,0,0,0,0,0,0,0,0,0,0,0
152492.0,Cavuto Oreste,OH,Italy,26.0,196.0,2022,Italy,China,2022-06-26,True,0,0,0,0,0,0,0,0,0,0,0,0,0,0,0,0,0,0,0,0,0,0,0,0
152492.0,Cavuto Oreste,OH,Italy,26.0,196.0,2022,Bulgaria,Italy,2022-07-05,True,0,0,0,0,0,0,0,0,0,0,0,0,0,0,0,0,0,0,0,0,0,0,0,0
152492.0,Cavuto Oreste,OH,Italy,26.0,196.0,2022,Italy,Iran,2022-07-07,True,0,0,0,0,0,0,0,0,0,0,0,0,0,0,0,0,0,0,0,0,0,0,0,0
152492.0,Cavuto Oreste,OH,Italy,26.0,196.0,2022,Italy,Serbia,2022-07-08,True,0,0,0,0,0,0,0,0,0,0,0,0,0,0,0,0,0,0,0,0,0,0,0,0
152492.0,Cavuto Oreste,OH,Italy,26.0,196.0,2022,Italy,Netherlands,2022-07-10,True,0,0,0,0,0,0,0,0,0,0,0,0,0,0,0,0,0,0,0,0,0,0,0,0
171191.0,Michieletto Alessandro,OH,Italy,21.0,205.0,2022,Germany,Italy,2022-06-22,True,1,1,8,10,0,0,0,0,6,5,4,15,1,1,0,2,1,1,11,13,6,2,1,9
171191.0,Michieletto Alessandro,OH,Italy,21.0,205.0,2022,Japan,Italy,2022-06-24,False,0,6,8,14,0,0,2,2,14,2,5,21,2,2,0,4,11,5,26,42,4,1,0,5
171191.0,Michieletto Alessandro,OH,Italy,21.0,205.0,2022,Italy,Slovenia,2022-06-25,True,1,2,10,13,0,0,1,1,13,1,10,24,2,1,1,4,8,0,10,18,6,2,1,9
171191.0,Michieletto Alessandro,OH,Italy,21.0,205.0,2022,Italy,China,2022-06-26,True,1,2,8,11,0,0,1,1,8,2,5,15,0,1,1,2,8,2,14,24,3,0,0,3
171191.0,Michieletto Alessandro,OH,Italy,21.0,205.0,2022,Bulgaria,Italy,2022-07-05,True,1,1,13,15,0,0,3,3,10,1,9,20,1,0,0,1,5,0,19,24,2,0,1,3
171191.0,Michieletto Alessandro,OH,Italy,21.0,205.0,2022,Italy,Iran,2022-07-07,True,0,0,19,19,0,0,0,0,11,1,10,22,0,2,0,2,3,2,23,28,4,1,0,5
171191.0,Michieletto Alessandro,OH,Italy,21.0,205.0,2022,Italy,Serbia,2022-07-08,True,0,1,14,15,0,0,0,0,7,4,6,17,0,3,0,3,2,0,6,8,5,0,1,6
171191.0,Michieletto Alessandro,OH,Italy,21.0,205.0,2022,Italy,Netherlands,2022-07-10,True,3,2,12,17,0,0,0,0,9,4,5,18,2,3,0,5,0,0,15,15,1,1,0,2
171191.0,Michieletto Alessandro,OH,Italy,21.0,205.0,2022,Italy,Netherlands,2022-07-20,True,1,2,11,14,0,0,3,3,10,5,10,25,1,4,5,10,3,0,14,17,2,3,1,6
171191.0,Michieletto Alessandro,OH,Italy,21.0,205.0,2022,Italy,France,2022-07-23,False,1,1,11,13,0,0,1,1,9,2,4,15,0,3,2,5,11,3,6,20,3,5,0,8
171191.0,Michieletto Alessandro,OH,Italy,21.0,205.0,2022,Italy,Poland,2022-07-24,False,1,3,7,11,0,0,4,4,3,4,7,14,1,2,3,6,1,3,8,12,2,2,0,4
144005.0,Giannelli Simone,S,Italy,26.0,200.0,2022,France,Italy,2022-06-08,False,1,3,8,12,45,1,22,68,0,1,2,3,4,4,1,9,0,0,0,0,8,3,1,12
144005.0,Giannelli Simone,S,Italy,26.0,200.0,2022,Poland,Italy,2022-06-09,True,0,5,11,16,32,0,38,70,4,0,4,8,0,3,4,7,0,0,0,0,6,2,4,12
144005.0,Giannelli Simone,S,Italy,26.0,200.0,2022,Canada,Italy,2022-06-11,True,1,4,14,19,0,0,71,71,6,0,0,6,2,1,1,4,0,0,0,0,5,1,0,6
144005.0,Giannelli Simone,S,Italy,26.0,200.0,2022,Argentina,Italy,2022-06-12,True,1,2,12,15,52,0,35,87,1,0,3,4,1,2,3,6,0,0,0,0,6,7,2,15
144005.0,Giannelli Simone,S,Italy,26.0,200.0,2022,Germany,Italy,2022-06-22,True,0,2,8,10,16,0,38,54,0,0,0,0,1,2,2,5,0,0,0,0,5,1,2,8
144005.0,Giannelli Simone,S,Italy,26.0,200.0,2022,Japan,Italy,2022-06-24,False,1,2,20,23,31,0,60,91,4,0,1,5,3,0,4,7,0,0,0,0,6,1,2,9
144005.0,Giannelli Simone,S,Italy,26.0,200.0,2022,Italy,Slovenia,2022-06-25,True,1,2,10,13,20,0,43,63,4,0,0,4,0,4,0,4,0,0,0,0,6,1,0,7
144005.0,Giannelli Simone,S,Italy,26.0,200.0,2022,Italy,China,2022-06-26,True,1,2,9,12,16,1,40,57,1,0,1,2,3,0,3,6,0,0,0,0,2,1,1,4
144005.0,Giannelli Simone,S,Italy,26.0,200.0,2022,Bulgaria,Italy,2022-07-05,True,3,1,10,14,7,1,51,59,2,0,0,2,2,1,0,3,0,0,1,1,2,0,0,2
144005.0,Giannelli Simone,S,Italy,26.0,200.0,2022,Italy,Iran,2022-07-07,True,3,2,11,16,26,0,70,96,2,1,1,4,2,3,0,5,0,0,2,2,2,2,0,4
144005.0,Giannelli Simone,S,Italy,26.0,200.0,2022,Italy,Serbia,2022-07-08,True,0,1,9,10,13,0,51,64,2,0,2,4,3,1,0,4,0,0,0,0,0,2,0,2
144005.0,Giannelli Simone,S,Italy,26.0,200.0,2022,Italy,Netherlands,2022-07-10,True,0,4,9,13,11,0,58,69,1,0,0,1,0,2,0,2,0,0,1,1,1,0,0,1
144005.0,Giannelli Simone,S,Italy,26.0,200.0,2022,Italy,Netherlands,2022-07-20,True,0,1,20,21,16,1,67,84,1,0,1,2,2,7,2,11,0,0,2,2,5,1,1,7
144005.0,Giannelli Simone,S,Italy,26.0,200.0,2022,Italy,France,2022-07-23,False,0,0,11,11,14,0,38,52,0,0,1,1,0,4,1,5,0,0,1,1,3,2,0,5
144005.0,Giannelli Simone,S,Italy,26.0,200.0,2022,Italy,Poland,2022-07-24,False,0,1,7,8,9,0,60,69,1,0,3,4,0,6,2,8,0,0,0,0,8,1,0,9
150436.0,Balaso Fabio,L,Italy,27.0,178.0,2022,Germany,Italy,2022-06-22,True,0,0,0,0,0,0,4,4,0,0,0,0,0,0,0,0,4,2,11,17,6,2,0,8
150436.0,Balaso Fabio,L,Italy,27.0,178.0,2022,Japan,Italy,2022-06-24,False,0,0,0,0,1,0,7,8,0,0,0,0,0,0,0,0,6,3,13,22,8,2,1,11
150436.0,Balaso Fabio,L,Italy,27.0,178.0,2022,Italy,Slovenia,2022-06-25,True,0,0,0,0,0,1,6,7,0,0,0,0,0,0,0,0,3,0,3,6,7,1,2,10
150436.0,Balaso Fabio,L,Italy,27.0,178.0,2022,Italy,China,2022-06-26,True,0,0,0,0,0,0,1,1,0,0,0,0,0,0,0,0,4,0,5,9,9,2,1,12
150436.0,Balaso Fabio,L,Italy,27.0,178.0,2022,Bulgaria,Italy,2022-07-05,True,0,0,0,0,0,0,4,4,0,0,0,0,0,0,0,0,1,1,11,13,3,3,1,7
150436.0,Balaso Fabio,L,Italy,27.0,178.0,2022,Italy,Iran,2022-07-07,True,0,0,0,0,0,0,4,4,0,0,0,0,0,0,0,0,7,1,12,20,5,3,1,9
150436.0,Balaso Fabio,L,Italy,27.0,178.0,2022,Italy,Serbia,2022-07-08,True,0,0,0,0,0,0,0,0,0,0,0,0,0,0,0,0,2,1,4,7,3,0,0,3
150436.0,Balaso Fabio,L,Italy,27.0,178.0,2022,Italy,Netherlands,2022-07-10,True,0,0,0,0,0,0,0,0,0,0,0,0,0,0,0,0,0,0,0,0,0,0,0,0
150436.0,Balaso Fabio,L,Italy,27.0,178.0,2022,Italy,Netherlands,2022-07-20,True,0,0,0,0,0,0,4,4,0,0,0,0,0,0,0,0,3,3,18,24,15,1,0,16
150436.0,Balaso Fabio,L,Italy,27.0,178.0,2022,Italy,France,2022-07-23,False,0,0,0,0,0,0,4,4,0,0,0,0,0,0,0,0,6,1,11,18,7,2,1,10
150436.0,Balaso Fabio,L,Italy,27.0,178.0,2022,Italy,Poland,2022-07-24,False,0,0,0,0,0,0,7,7,0,0,0,0,0,0,0,0,3,6,10,19,13,3,2,18
152370.0,Sbertoli Riccardo,S,Italy,24.0,188.0,2022,Germany,Italy,2022-06-22,True,0,0,0,0,0,0,0,0,0,0,0,0,0,0,0,0,0,0,0,0,0,0,0,0
152370.0,Sbertoli Riccardo,S,Italy,24.0,188.0,2022,Japan,Italy,2022-06-24,False,0,0,5,5,0,0,0,0,0,0,0,0,0,0,0,0,0,0,0,0,0,0,0,0
152370.0,Sbertoli Riccardo,S,Italy,24.0,188.0,2022,Italy,Slovenia,2022-06-25,True,0,0,3,3,1,0,9,10,0,0,0,0,0,2,1,3,0,0,0,0,0,0,0,0
152370.0,Sbertoli Riccardo,S,Italy,24.0,188.0,2022,Italy,China,2022-06-26,True,0,1,1,2,3,0,8,11,0,0,0,0,1,1,0,2,0,0,0,0,0,0,0,0
152370.0,Sbertoli Riccardo,S,Italy,24.0,188.0,2022,Bulgaria,Italy,2022-07-05,True,0,0,1,1,0,0,0,0,0,0,0,0,0,0,0,0,0,0,0,0,0,0,0,0
152370.0,Sbertoli Riccardo,S,Italy,24.0,188.0,2022,Italy,Iran,2022-07-07,True,0,1,1,2,0,0,1,1,0,0,0,0,0,0,0,0,0,0,0,0,0,0,0,0
152370.0,Sbertoli Riccardo,S,Italy,24.0,188.0,2022,Italy,Serbia,2022-07-08,True,0,0,0,0,1,1,5,7,0,0,0,0,0,0,0,0,0,0,0,0,0,0,0,0
152370.0,Sbertoli Riccardo,S,Italy,24.0,188.0,2022,Italy,Netherlands,2022-07-10,True,0,0,3,3,0,0,4,4,0,0,0,0,0,0,0,0,0,0,0,0,0,0,0,0
152370.0,Sbertoli Riccardo,S,Italy,24.0,188.0,2022,Italy,Netherlands,2022-07-20,True,0,0,0,0,0,0,0,0,0,0,0,0,0,0,0,0,0,0,0,0,0,0,0,0
152370.0,Sbertoli Riccardo,S,Italy,24.0,188.0,2022,Italy,France,2022-07-23,False,0,0,2,2,5,0,8,13,0,0,0,0,0,2,0,2,0,0,0,0,0,0,0,0
152370.0,Sbertoli Riccardo,S,Italy,24.0,188.0,2022,Italy,Poland,2022-07-24,False,0,1,3,4,0,0,0,0,0,0,0,0,0,0,0,0,0,0,0,0,0,0,0,0
120511.0,Zaytsev Ivan,OH,Italy,34.0,204.0,2022,Bulgaria,Italy,2022-07-05,True,0,0,0,0,0,0,0,0,0,0,0,0,0,0,0,0,0,0,0,0,0,0,0,0
120511.0,Zaytsev Ivan,OH,Italy,34.0,204.0,2022,Italy,Iran,2022-07-07,True,1,5,9,15,0,0,1,1,14,5,11,30,2,2,0,4,0,0,3,3,3,0,2,5
120511.0,Zaytsev Ivan,OH,Italy,34.0,204.0,2022,Italy,Serbia,2022-07-08,True,0,0,0,0,0,0,0,0,0,0,0,0,0,0,0,0,0,0,0,0,0,0,0,0
120511.0,Zaytsev Ivan,OH,Italy,34.0,204.0,2022,Italy,Netherlands,2022-07-10,True,0,4,7,11,0,0,0,0,11,5,8,24,0,4,0,4,0,0,2,2,2,1,0,3
120511.0,Zaytsev Ivan,OH,Italy,34.0,204.0,2022,Italy,Netherlands,2022-07-20,True,0,1,1,2,0,0,0,0,1,0,0,1,0,0,0,0,0,0,0,0,2,0,0,2
120511.0,Zaytsev Ivan,OH,Italy,34.0,204.0,2022,Italy,France,2022-07-23,False,0,1,1,2,0,0,1,1,5,2,2,9,0,2,1,3,1,1,1,3,0,1,0,1
120511.0,Zaytsev Ivan,OH,Italy,34.0,204.0,2022,Italy,Poland,2022-07-24,False,0,0,0,0,0,0,0,0,0,0,0,0,0,0,0,0,0,0,0,0,0,0,0,0
115843.0,Falaschi Marco,S,Italy,35.0,188.0,2022,France,Italy,2022-06-08,False,0,0,0,0,0,0,0,0,0,0,0,0,0,0,0,0,0,0,0,0,0,0,0,0
115843.0,Falaschi Marco,S,Italy,35.0,188.0,2022,Poland,Italy,2022-06-09,True,0,0,0,0,0,0,0,0,0,0,0,0,0,0,0,0,0,0,0,0,0,0,0,0
115843.0,Falaschi Marco,S,Italy,35.0,188.0,2022,Canada,Italy,2022-06-11,True,0,0,0,0,0,0,0,0,0,0,0,0,0,0,0,0,0,0,0,0,0,0,0,0
115843.0,Falaschi Marco,S,Italy,35.0,188.0,2022,Argentina,Italy,2022-06-12,True,0,1,2,3,5,1,4,10,0,0,0,0,0,0,1,1,0,0,0,0,0,0,0,0
152422.0,Gardini Davide,OH,Italy,24.0,205.0,2022,France,Italy,2022-06-08,False,0,1,2,3,0,0,1,1,0,1,7,8,0,0,2,2,0,2,6,8,1,1,0,2
152422.0,Gardini Davide,OH,Italy,24.0,205.0,2022,Poland,Italy,2022-06-09,True,0,0,0,0,0,0,0,0,0,0,0,0,0,0,0,0,0,0,0,0,0,0,0,0
152422.0,Gardini Davide,OH,Italy,24.0,205.0,2022,Canada,Italy,2022-06-11,True,0,0,0,0,0,0,0,0,0,0,0,0,0,0,0,0,0,0,0,0,0,0,0,0
152422.0,Gardini Davide,OH,Italy,24.0,205.0,2022,Argentina,Italy,2022-06-12,True,0,0,0,0,0,0,0,0,0,0,0,0,0,0,0,0,0,0,0,0,0,0,0,0
163447.0,Bottolo Mattia,OH,Italy,23.0,196.0,2022,France,Italy,2022-06-08,False,0,2,7,9,0,0,0,0,3,5,10,18,0,2,2,4,1,0,13,14,2,2,0,4
163447.0,Bottolo Mattia,OH,Italy,23.0,196.0,2022,Poland,Italy,2022-06-09,True,2,3,15,20,1,0,5,6,13,4,1,18,1,2,0,3,7,1,19,27,1,0,2,3
163447.0,Bottolo Mattia,OH,Italy,23.0,196.0,2022,Canada,Italy,2022-06-11,True,1,4,9,14,0,0,2,2,11,5,9,25,1,1,2,4,0,0,13,13,8,0,0,8
163447.0,Bottolo Mattia,OH,Italy,23.0,196.0,2022,Argentina,Italy,2022-06-12,True,4,4,11,19,0,0,1,1,14,4,12,30,3,5,5,13,5,1,18,24,4,2,4,10
163447.0,Bottolo Mattia,OH,Italy,23.0,196.0,2022,Germany,Italy,2022-06-22,True,0,0,0,0,0,0,0,0,0,0,0,0,0,0,0,0,0,0,0,0,0,0,0,0
163447.0,Bottolo Mattia,OH,Italy,23.0,196.0,2022,Japan,Italy,2022-06-24,False,0,1,2,3,0,0,0,0,0,0,0,0,0,1,0,1,1,1,1,3,0,2,0,2
163447.0,Bottolo Mattia,OH,Italy,23.0,196.0,2022,Italy,Slovenia,2022-06-25,True,0,0,0,0,0,0,0,0,0,0,0,0,0,0,0,0,0,0,0,0,0,0,0,0
163447.0,Bottolo Mattia,OH,Italy,23.0,196.0,2022,Italy,China,2022-06-26,True,0,1,1,2,0,0,0,0,2,1,2,5,0,2,2,4,0,0,6,6,0,0,0,0
163447.0,Bottolo Mattia,OH,Italy,23.0,196.0,2022,Bulgaria,Italy,2022-07-05,True,0,0,0,0,0,0,0,0,0,0,0,0,0,0,0,0,0,0,0,0,0,0,0,0
163447.0,Bottolo Mattia,OH,Italy,23.0,196.0,2022,Italy,Iran,2022-07-07,True,2,2,4,8,0,0,1,1,2,3,5,10,0,0,0,0,1,1,6,8,2,0,0,2
163447.0,Bottolo Mattia,OH,Italy,23.0,196.0,2022,Italy,Serbia,2022-07-08,True,0,0,0,0,0,0,0,0,0,0,0,0,0,0,0,0,0,0,0,0,0,0,0,0
163447.0,Bottolo Mattia,OH,Italy,23.0,196.0,2022,Italy,Netherlands,2022-07-10,True,0,0,0,0,0,0,0,0,0,0,0,0,0,0,0,0,0,0,0,0,0,0,0,0
163447.0,Bottolo Mattia,OH,Italy,23.0,196.0,2022,Italy,Netherlands,2022-07-20,True,0,0,0,0,0,0,0,0,0,0,0,0,0,0,0,0,0,1,0,1,0,0,0,0
163447.0,Bottolo Mattia,OH,Italy,23.0,196.0,2022,Italy,France,2022-07-23,False,0,0,1,1,0,0,1,1,0,1,1,2,0,0,0,0,1,1,1,3,0,2,0,2
163447.0,Bottolo Mattia,OH,Italy,23.0,196.0,2022,Italy,Poland,2022-07-24,False,0,0,0,0,0,0,0,0,0,0,0,0,0,0,0,0,0,0,0,0,0,0,0,0
163028.0,Cortesia Lorenzo,MB,Italy,23.0,198.0,2022,France,Italy,2022-06-08,False,0,3,5,8,0,0,1,1,5,1,2,8,0,3,4,7,0,0,2,2,2,0,1,3
163028.0,Cortesia Lorenzo,MB,Italy,23.0,198.0,2022,Poland,Italy,2022-06-09,True,0,2,4,6,0,0,0,0,2,0,4,6,0,2,0,2,0,0,0,0,0,0,2,2
163028.0,Cortesia Lorenzo,MB,Italy,23.0,198.0,2022,Canada,Italy,2022-06-11,True,0,0,0,0,0,0,0,0,0,0,0,0,0,0,0,0,0,0,0,0,0,0,0,0
163028.0,Cortesia Lorenzo,MB,Italy,23.0,198.0,2022,Argentina,Italy,2022-06-12,True,0,0,0,0,0,0,0,0,0,0,0,0,0,0,0,0,0,0,0,0,0,0,0,0
163028.0,Cortesia Lorenzo,MB,Italy,23.0,198.0,2022,Bulgaria,Italy,2022-07-05,True,0,0,0,0,0,0,0,0,0,0,0,0,0,0,0,0,0,0,0,0,0,0,0,0
163028.0,Cortesia Lorenzo,MB,Italy,23.0,198.0,2022,Italy,Iran,2022-07-07,True,0,0,0,0,0,0,0,0,0,0,0,0,0,0,0,0,0,0,0,0,0,0,0,0
163028.0,Cortesia Lorenzo,MB,Italy,23.0,198.0,2022,Italy,Serbia,2022-07-08,True,0,0,3,3,0,0,0,0,3,0,4,7,2,5,0,7,0,0,0,0,0,1,0,1
163028.0,Cortesia Lorenzo,MB,Italy,23.0,198.0,2022,Italy,Netherlands,2022-07-10,True,0,0,0,0,0,0,0,0,0,0,0,0,0,0,0,0,0,0,0,0,0,0,0,0
163028.0,Cortesia Lorenzo,MB,Italy,23.0,198.0,2022,Italy,Netherlands,2022-07-20,True,0,0,0,0,0,0,0,0,0,0,0,0,0,0,0,0,0,0,0,0,0,0,0,0
163028.0,Cortesia Lorenzo,MB,Italy,23.0,198.0,2022,Italy,France,2022-07-23,False,0,0,0,0,0,0,0,0,0,0,0,0,0,0,0,0,0,0,0,0,0,0,0,0
163028.0,Cortesia Lorenzo,MB,Italy,23.0,198.0,2022,Italy,Poland,2022-07-24,False,0,0,0,0,0,0,0,0,0,0,0,0,0,0,0,0,0,0,0,0,0,0,0,0
152408.0,Galassi Gianluca,MB,Italy,25.0,201.0,2022,France,Italy,2022-06-08,False,0,1,6,7,0,0,1,1,3,1,4,8,0,2,4,6,0,0,2,2,0,0,4,4
152408.0,Galassi Gianluca,MB,Italy,25.0,201.0,2022,Poland,Italy,2022-06-09,True,2,2,3,7,0,0,0,0,2,2,3,7,1,5,3,9,0,0,0,0,0,0,4,4
152408.0,Galassi Gianluca,MB,Italy,25.0,201.0,2022,Canada,Italy,2022-06-11,True,0,0,10,10,0,0,0,0,5,2,0,7,1,2,1,4,0,0,2,2,1,0,0,1
152408.0,Galassi Gianluca,MB,Italy,25.0,201.0,2022,Argentina,Italy,2022-06-12,True,0,2,5,7,0,0,0,0,3,3,2,8,2,2,2,6,0,0,0,0,0,1,1,2
152408.0,Galassi Gianluca,MB,Italy,25.0,201.0,2022,Germany,Italy,2022-06-22,True,0,3,6,9,0,0,0,0,7,0,1,8,4,6,2,12,0,0,0,0,1,1,0,2
152408.0,Galassi Gianluca,MB,Italy,25.0,201.0,2022,Japan,Italy,2022-06-24,False,1,4,8,13,0,0,0,0,6,0,5,11,1,8,5,14,1,0,0,1,2,1,1,4
152408.0,Galassi Gianluca,MB,Italy,25.0,201.0,2022,Italy,Slovenia,2022-06-25,True,1,3,5,9,1,0,1,2,5,1,3,9,1,2,2,5,0,0,0,0,1,0,0,1
152408.0,Galassi Gianluca,MB,Italy,25.0,201.0,2022,Italy,China,2022-06-26,True,0,3,5,8,0,0,0,0,3,0,4,7,1,5,4,10,0,0,1,1,2,1,0,3
152408.0,Galassi Gianluca,MB,Italy,25.0,201.0,2022,Bulgaria,Italy,2022-07-05,True,0,0,4,4,0,0,0,0,0,0,0,0,0,0,0,0,0,0,0,0,0,0,1,1
152408.0,Galassi Gianluca,MB,Italy,25.0,201.0,2022,Italy,Iran,2022-07-07,True,2,2,13,17,0,0,0,0,9,0,1,10,2,3,0,5,0,0,0,0,0,0,0,0
152408.0,Galassi Gianluca,MB,Italy,25.0,201.0,2022,Italy,Serbia,2022-07-08,True,0,2,4,6,0,0,1,1,3,0,2,5,3,3,0,6,0,0,0,0,0,0,0,0
152408.0,Galassi Gianluca,MB,Italy,25.0,201.0,2022,Italy,Netherlands,2022-07-10,True,1,2,2,5,0,0,0,0,3,0,2,5,2,2,0,4,0,0,0,0,0,0,0,0
152408.0,Galassi Gianluca,MB,Italy,25.0,201.0,2022,Italy,Netherlands,2022-07-20,True,1,0,2,3,0,0,0,0,4,0,3,7,2,2,2,6,0,0,0,0,1,0,0,1
152408.0,Galassi Gianluca,MB,Italy,25.0,201.0,2022,Italy,France,2022-07-23,False,1,2,5,8,0,0,0,0,5,0,1,6,0,2,4,6,0,0,0,0,0,0,0,0
152408.0,Galassi Gianluca,MB,Italy,25.0,201.0,2022,Italy,Poland,2022-07-24,False,0,2,2,4,0,0,1,1,2,1,3,6,1,1,4,6,0,0,1,1,0,0,0,0
153200.0,Lavia Daniele,OH,Italy,23.0,200.0,2022,Germany,Italy,2022-06-22,True,0,1,11,12,0,0,1,1,8,2,8,18,1,2,0,3,2,0,11,13,1,0,0,1
153200.0,Lavia Daniele,OH,Italy,23.0,200.0,2022,Japan,Italy,2022-06-24,False,1,3,14,18,0,0,1,1,18,2,11,31,3,5,6,14,7,4,15,26,1,1,1,3
153200.0,Lavia Daniele,OH,Italy,23.0,200.0,2022,Italy,Slovenia,2022-06-25,True,2,2,10,14,0,0,2,2,12,2,10,24,0,2,0,2,5,0,19,24,2,0,2,4
153200.0,Lavia Daniele,OH,Italy,23.0,200.0,2022,Italy,China,2022-06-26,True,3,2,12,17,0,0,2,2,16,1,6,23,3,3,0,6,4,0,2,6,5,0,0,5
153200.0,Lavia Daniele,OH,Italy,23.0,200.0,2022,Bulgaria,Italy,2022-07-05,True,0,1,11,12,0,0,0,0,10,1,7,18,2,3,1,6,1,0,8,9,3,1,2,6
153200.0,Lavia Daniele,OH,Italy,23.0,200.0,2022,Italy,Iran,2022-07-07,True,0,2,8,10,0,0,1,1,11,5,8,24,0,3,0,3,2,4,6,12,2,1,0,3
153200.0,Lavia Daniele,OH,Italy,23.0,200.0,2022,Italy,Serbia,2022-07-08,True,2,1,15,18,0,0,0,0,7,3,7,17,1,1,0,2,5,1,26,32,1,1,1,3
153200.0,Lavia Daniele,OH,Italy,23.0,200.0,2022,Italy,Netherlands,2022-07-10,True,0,0,15,15,0,0,0,0,15,3,7,25,0,2,0,2,0,3,11,14,2,1,0,3
153200.0,Lavia Daniele,OH,Italy,23.0,200.0,2022,Italy,Netherlands,2022-07-20,True,1,1,14,16,1,0,2,3,10,1,12,23,2,5,0,7,6,2,9,17,10,1,1,12
153200.0,Lavia Daniele,OH,Italy,23.0,200.0,2022,Italy,France,2022-07-23,False,0,0,6,6,0,0,1,1,4,2,11,17,2,3,1,6,0,4,5,9,2,1,0,3
153200.0,Lavia Daniele,OH,Italy,23.0,200.0,2022,Italy,Poland,2022-07-24,False,0,1,10,11,1,0,4,5,14,3,16,33,0,0,1,1,6,0,14,20,6,4,0,10
162520.0,Romanò Yuri,O,Italy,25.0,201.0,2022,France,Italy,2022-06-08,False,0,4,9,13,0,0,2,2,14,5,13,32,2,1,0,3,,,,,3,1,5,9
162520.0,Romanò Yuri,O,Italy,25.0,201.0,2022,Poland,Italy,2022-06-09,True,0,6,10,16,1,0,1,2,16,5,9,30,0,7,1,8,,,,,7,1,1,9
162520.0,Romanò Yuri,O,Italy,25.0,201.0,2022,Canada,Italy,2022-06-11,True,1,2,6,9,0,0,0,0,11,3,8,22,1,1,1,3,,,,,2,0,0,2
162520.0,Romanò Yuri,O,Italy,25.0,201.0,2022,Argentina,Italy,2022-06-12,True,0,3,2,5,0,0,1,1,2,2,8,12,2,2,2,6,,,,,1,1,1,3
162520.0,Romanò Yuri,O,Italy,25.0,201.0,2022,Germany,Italy,2022-06-22,True,2,4,10,16,0,0,0,0,10,2,4,16,1,2,5,8,,,,,2,3,0,5
162520.0,Romanò Yuri,O,Italy,25.0,201.0,2022,Japan,Italy,2022-06-24,False,0,6,8,14,0,0,0,0,14,3,11,28,2,3,3,8,,,,,7,1,0,8
162520.0,Romanò Yuri,O,Italy,25.0,201.0,2022,Italy,Slovenia,2022-06-25,True,1,1,3,5,0,0,0,0,4,2,4,10,1,1,0,2,,,,,7,1,0,8
162520.0,Romanò Yuri,O,Italy,25.0,201.0,2022,Italy,China,2022-06-26,True,0,0,0,0,0,0,0,0,0,0,0,0,0,0,0,0,,,,,0,0,0,0
162520.0,Romanò Yuri,O,Italy,25.0,201.0,2022,Bulgaria,Italy,2022-07-05,True,1,3,8,12,0,0,1,1,10,3,7,20,2,2,0,4,,,,,0,0,0,0
162520.0,Romanò Yuri,O,Italy,25.0,201.0,2022,Italy,Iran,2022-07-07,True,0,0,0,0,0,0,0,0,0,0,0,0,0,0,0,0,,,,,0,0,0,0
162520.0,Romanò Yuri,O,Italy,25.0,201.0,2022,Italy,Serbia,2022-07-08,True,3,3,8,14,0,0,1,1,9,3,7,19,1,2,0,3,,,,,1,0,0,1
162520.0,Romanò Yuri,O,Italy,25.0,201.0,2022,Italy,Netherlands,2022-07-10,True,0,0,0,0,0,0,0,0,0,0,0,0,0,0,0,0,,,,,0,0,0,0
162520.0,Romanò Yuri,O,Italy,25.0,201.0,2022,Italy,Netherlands,2022-07-20,True,4,0,12,16,0,0,1,1,12,6,8,26,0,7,5,12,,,,,1,2,0,3
162520.0,Romanò Yuri,O,Italy,25.0,201.0,2022,Italy,France,2022-07-23,False,0,3,2,5,0,0,0,0,6,1,8,15,0,1,0,1,,,,,6,1,0,7
162520.0,Romanò Yuri,O,Italy,25.0,201.0,2022,Italy,Poland,2022-07-24,False,0,4,8,12,0,0,1,1,12,5,11,28,0,1,0,1,,,,,4,1,0,5
124865.0,Anzani Simone,MB,Italy,31.0,204.0,2022,Germany,Italy,2022-06-22,True,1,1,11,13,0,0,0,0,4,1,0,5,4,2,2,8,0,0,0,0,1,3,1,5
124865.0,Anzani Simone,MB,Italy,31.0,204.0,2022,Japan,Italy,2022-06-24,False,0,1,13,14,0,0,2,2,7,0,3,10,3,7,9,19,0,0,0,0,1,2,2,5
124865.0,Anzani Simone,MB,Italy,31.0,204.0,2022,Italy,Slovenia,2022-06-25,True,0,1,11,12,0,0,2,2,6,1,2,9,1,1,7,9,0,0,0,0,3,0,0,3
124865.0,Anzani Simone,MB,Italy,31.0,204.0,2022,Italy,China,2022-06-26,True,0,1,8,9,0,0,2,2,3,0,0,3,2,2,3,7,1,1,0,2,1,0,0,1
124865.0,Anzani Simone,MB,Italy,31.0,204.0,2022,Bulgaria,Italy,2022-07-05,True,0,1,5,6,0,0,0,0,2,0,2,4,1,2,0,3,0,1,0,1,1,0,0,1
124865.0,Anzani Simone,MB,Italy,31.0,204.0,2022,Italy,Iran,2022-07-07,True,0,2,10,12,0,0,0,0,6,1,2,9,4,5,0,9,0,0,0,0,1,0,1,2
124865.0,Anzani Simone,MB,Italy,31.0,204.0,2022,Italy,Serbia,2022-07-08,True,0,0,0,0,0,0,0,0,0,0,0,0,0,0,0,0,0,0,0,0,0,0,0,0
124865.0,Anzani Simone,MB,Italy,31.0,204.0,2022,Italy,Netherlands,2022-07-10,True,0,0,7,7,0,0,0,0,3,0,0,3,2,1,0,3,0,0,1,1,0,0,0,0
124865.0,Anzani Simone,MB,Italy,31.0,204.0,2022,Italy,Netherlands,2022-07-20,True,0,1,4,5,0,0,0,0,0,1,1,2,2,1,2,5,0,0,0,0,0,1,0,1
124865.0,Anzani Simone,MB,Italy,31.0,204.0,2022,Italy,France,2022-07-23,False,0,0,1,1,0,0,0,0,0,0,0,0,1,2,1,4,0,0,0,0,1,0,0,1
124865.0,Anzani Simone,MB,Italy,31.0,204.0,2022,Italy,Poland,2022-07-24,False,0,0,8,8,0,0,0,0,1,0,5,6,0,6,2,8,0,0,0,0,2,0,0,2
163032.0,Gironi Fabrizio,OH,Italy,23.0,200.0,2022,France,Italy,2022-06-08,False,0,0,0,0,0,0,0,0,0,0,0,0,0,0,0,0,0,0,0,0,0,0,0,0
163032.0,Gironi Fabrizio,OH,Italy,23.0,200.0,2022,Poland,Italy,2022-06-09,True,0,0,0,0,0,0,0,0,0,0,0,0,0,0,0,0,0,0,0,0,0,0,0,0
163032.0,Gironi Fabrizio,OH,Italy,23.0,200.0,2022,Canada,Italy,2022-06-11,True,0,0,0,0,0,0,0,0,0,0,0,0,0,0,0,0,0,0,0,0,0,0,0,0
163032.0,Gironi Fabrizio,OH,Italy,23.0,200.0,2022,Argentina,Italy,2022-06-12,True,0,0,0,0,0,0,0,0,0,0,0,0,0,0,0,0,0,0,0,0,0,0,0,0
152405.0,Russo Roberto,MB,Italy,26.0,207.0,2022,Bulgaria,Italy,2022-07-05,True,1,2,7,10,0,0,1,1,3,0,3,6,3,5,0,8,0,0,0,0,0,0,0,0
152405.0,Russo Roberto,MB,Italy,26.0,207.0,2022,Italy,Iran,2022-07-07,True,0,0,0,0,0,0,0,0,0,0,0,0,0,0,0,0,0,0,0,0,0,0,0,0
152405.0,Russo Roberto,MB,Italy,26.0,207.0,2022,Italy,Serbia,2022-07-08,True,1,2,5,8,0,0,0,0,5,0,3,8,4,4,0,8,0,0,0,0,0,0,0,0
152405.0,Russo Roberto,MB,Italy,26.0,207.0,2022,Italy,Netherlands,2022-07-10,True,0,1,3,4,0,0,0,0,2,0,0,2,0,3,1,4,0,0,0,0,0,0,0,0
152405.0,Russo Roberto,MB,Italy,26.0,207.0,2022,Italy,Netherlands,2022-07-20,True,0,1,17,18,0,0,0,0,9,0,2,11,3,9,1,13,1,0,0,1,2,1,0,3
152405.0,Russo Roberto,MB,Italy,26.0,207.0,2022,Italy,France,2022-07-23,False,0,1,7,8,0,0,0,0,3,1,2,6,0,4,0,4,0,0,0,0,1,0,0,1
152405.0,Russo Roberto,MB,Italy,26.0,207.0,2022,Italy,Poland,2022-07-24,False,0,0,2,2,0,0,1,1,0,1,0,1,0,1,2,3,0,0,0,0,2,0,0,2
152412.0,Piccinelli Alessandro,L,Italy,26.0,189.0,2022,France,Italy,2022-06-08,False,0,0,0,0,0,0,13,13,0,0,0,0,0,0,0,0,1,1,9,11,8,0,3,11
152412.0,Piccinelli Alessandro,L,Italy,26.0,189.0,2022,Poland,Italy,2022-06-09,True,0,0,0,0,0,1,6,7,0,0,0,0,0,0,0,0,5,1,9,15,5,5,3,13
152412.0,Piccinelli Alessandro,L,Italy,26.0,189.0,2022,Canada,Italy,2022-06-11,True,0,0,0,0,0,0,2,2,0,0,0,0,0,0,0,0,8,0,11,19,7,0,1,8
152412.0,Piccinelli Alessandro,L,Italy,26.0,189.0,2022,Argentina,Italy,2022-06-12,True,0,0,0,0,0,0,4,4,0,0,0,0,0,0,0,0,9,0,11,20,17,5,5,27
152412.0,Piccinelli Alessandro,L,Italy,26.0,189.0,2022,Germany,Italy,2022-06-22,True,0,0,0,0,0,0,0,0,0,0,0,0,0,0,0,0,0,0,0,0,0,0,0,0
152412.0,Piccinelli Alessandro,L,Italy,26.0,189.0,2022,Japan,Italy,2022-06-24,False,0,0,0,0,0,0,0,0,0,0,0,0,0,0,0,0,0,0,0,0,0,0,0,0
152412.0,Piccinelli Alessandro,L,Italy,26.0,189.0,2022,Italy,Slovenia,2022-06-25,True,0,0,0,0,0,0,0,0,0,0,0,0,0,0,0,0,0,0,0,0,0,0,0,0
152412.0,Piccinelli Alessandro,L,Italy,26.0,189.0,2022,Italy,China,2022-06-26,True,0,0,0,0,0,0,0,0,0,0,0,0,0,0,0,0,1,0,3,4,2,0,0,2
181128.0,Scanferla Leonardo,L,Italy,24.0,184.0,2022,France,Italy,2022-06-08,False,0,0,0,0,0,0,1,1,0,0,0,0,0,0,0,0,0,0,0,0,1,0,0,1
181128.0,Scanferla Leonardo,L,Italy,24.0,184.0,2022,Poland,Italy,2022-06-09,True,0,0,0,0,0,0,0,0,0,0,0,0,0,0,0,0,0,0,0,0,0,0,0,0
181128.0,Scanferla Leonardo,L,Italy,24.0,184.0,2022,Canada,Italy,2022-06-11,True,0,0,0,0,0,0,0,0,0,0,0,0,0,0,0,0,0,0,0,0,0,0,0,0
181128.0,Scanferla Leonardo,L,Italy,24.0,184.0,2022,Argentina,Italy,2022-06-12,True,0,0,0,0,0,0,0,0,0,0,0,0,0,0,0,0,0,0,0,0,0,0,0,0
181128.0,Scanferla Leonardo,L,Italy,24.0,184.0,2022,Bulgaria,Italy,2022-07-05,True,0,0,0,0,0,0,0,0,0,0,0,0,0,0,0,0,0,0,0,0,0,0,0,0
181128.0,Scanferla Leonardo,L,Italy,24.0,184.0,2022,Italy,Iran,2022-07-07,True,0,0,0,0,0,0,0,0,0,0,0,0,0,0,0,0,0,0,0,0,1,1,1,3
181128.0,Scanferla Leonardo,L,Italy,24.0,184.0,2022,Italy,Serbia,2022-07-08,True,0,0,0,0,0,0,0,0,0,0,0,0,0,0,0,0,0,0,4,4,0,0,2,2
181128.0,Scanferla Leonardo,L,Italy,24.0,184.0,2022,Italy,Netherlands,2022-07-10,True,0,0,0,0,0,0,1,1,0,0,0,0,0,0,0,0,0,1,15,16,8,1,0,9
181128.0,Scanferla Leonardo,L,Italy,24.0,184.0,2022,Italy,Netherlands,2022-07-20,True,0,0,0,0,0,0,0,0,0,0,0,0,0,0,0,0,0,0,0,0,0,0,0,0
181128.0,Scanferla Leonardo,L,Italy,24.0,184.0,2022,Italy,France,2022-07-23,False,0,0,0,0,0,0,0,0,0,0,0,0,0,0,0,0,0,0,0,0,0,0,0,0
181128.0,Scanferla Leonardo,L,Italy,24.0,184.0,2022,Italy,Poland,2022-07-24,False,0,0,0,0,0,0,0,0,0,0,0,0,0,0,0,0,0,0,3,3,1,1,0,2
150435.0,Vitelli Marco,MB,Italy,26.0,203.0,2022,France,Italy,2022-06-08,False,0,1,1,2,0,0,0,0,1,0,0,1,0,1,2,3,0,0,0,0,0,0,2,2
150435.0,Vitelli Marco,MB,Italy,26.0,203.0,2022,Poland,Italy,2022-06-09,True,1,2,7,10,0,0,0,0,2,0,1,3,0,4,1,5,0,0,0,0,0,0,2,2
150435.0,Vitelli Marco,MB,Italy,26.0,203.0,2022,Canada,Italy,2022-06-11,True,0,0,0,0,0,0,0,0,0,0,0,0,0,0,0,0,0,0,0,0,0,0,0,0
150435.0,Vitelli Marco,MB,Italy,26.0,203.0,2022,Argentina,Italy,2022-06-12,True,2,2,14,18,1,0,2,3,5,2,5,12,2,6,7,15,0,0,0,0,3,0,0,3
174074.0,Mosca Leandro Ausibio,MB,Italy,22.0,208.0,2022,France,Italy,2022-06-08,False,0,0,0,0,0,0,0,0,0,0,0,0,0,0,0,0,0,0,0,0,0,0,0,0
174074.0,Mosca Leandro Ausibio,MB,Italy,22.0,208.0,2022,Poland,Italy,2022-06-09,True,0,0,4,4,0,0,1,1,1,0,1,2,2,1,5,8,0,0,0,0,1,1,0,2
174074.0,Mosca Leandro Ausibio,MB,Italy,22.0,208.0,2022,Canada,Italy,2022-06-11,True,0,0,12,12,0,0,0,0,7,2,0,9,2,4,5,11,0,0,0,0,2,1,0,3
174074.0,Mosca Leandro Ausibio,MB,Italy,22.0,208.0,2022,Argentina,Italy,2022-06-12,True,0,1,3,4,0,0,0,0,1,0,0,1,1,0,0,1,0,0,1,1,1,0,0,1
174074.0,Mosca Leandro Ausibio,MB,Italy,22.0,208.0,2022,Germany,Italy,2022-06-22,True,0,0,0,0,0,0,0,0,0,0,0,0,0,0,0,0,0,0,0,0,0,0,0,0
174074.0,Mosca Leandro Ausibio,MB,Italy,22.0,208.0,2022,Japan,Italy,2022-06-24,False,0,0,0,0,0,0,0,0,0,0,0,0,0,0,0,0,0,0,0,0,0,0,0,0
163519.0,Nishida Yuji,O,Japan,23.0,187.0,2022,Japan,Netherlands,2022-06-08,True,1,5,10,16,1,0,1,2,23,7,7,37,1,4,0,5,0,0,0,0,3,3,0,6
163519.0,Nishida Yuji,O,Japan,23.0,187.0,2022,Japan,China,2022-06-09,True,3,7,8,18,0,0,0,0,22,7,4,33,1,2,0,3,0,0,0,0,3,1,1,5
163519.0,Nishida Yuji,O,Japan,23.0,187.0,2022,Japan,USA,2022-06-10,False,0,0,0,0,0,0,0,0,0,0,0,0,0,0,0,0,0,0,0,0,0,0,0,0
163519.0,Nishida Yuji,O,Japan,23.0,187.0,2022,Iran,Japan,2022-06-12,True,5,4,6,15,1,0,0,1,11,3,8,22,1,1,1,3,0,0,0,0,3,0,0,3
163519.0,Nishida Yuji,O,Japan,23.0,187.0,2022,Argentina,Japan,2022-06-21,True,3,5,9,17,0,0,1,1,20,4,11,35,2,4,3,9,0,0,0,0,6,2,1,9
163519.0,Nishida Yuji,O,Japan,23.0,187.0,2022,Japan,Italy,2022-06-24,True,5,5,6,16,0,0,2,2,22,9,9,40,1,6,2,9,0,0,1,1,4,3,0,7
163519.0,Nishida Yuji,O,Japan,23.0,187.0,2022,Japan,France,2022-06-25,False,0,0,0,0,0,0,0,0,0,0,0,0,0,0,0,0,0,0,0,0,0,0,0,0
163519.0,Nishida Yuji,O,Japan,23.0,187.0,2022,Japan,Slovenia,2022-06-26,True,2,4,10,16,0,0,1,1,10,5,10,25,0,6,3,9,0,0,0,0,2,2,0,4
163519.0,Nishida Yuji,O,Japan,23.0,187.0,2022,Japan,Australia,2022-07-06,True,6,7,8,21,0,0,0,0,17,4,1,22,1,2,3,6,0,0,0,0,4,1,0,5
163519.0,Nishida Yuji,O,Japan,23.0,187.0,2022,Japan,Canada,2022-07-08,True,1,6,8,15,0,0,0,0,16,2,11,29,1,5,3,9,0,0,0,0,5,5,2,12
163519.0,Nishida Yuji,O,Japan,23.0,187.0,2022,Germany,Japan,2022-07-09,True,0,0,1,1,0,0,0,0,0,0,1,1,1,0,0,1,0,0,0,0,0,1,0,1
163519.0,Nishida Yuji,O,Japan,23.0,187.0,2022,Brazil,Japan,2022-07-10,False,1,6,6,13,0,0,0,0,15,6,8,29,1,2,2,5,1,0,0,1,0,0,2,2
163519.0,Nishida Yuji,O,Japan,23.0,187.0,2022,France,Japan,2022-07-21,False,2,5,4,11,0,0,0,0,6,5,11,22,0,3,1,4,0,0,0,0,3,4,0,7
142565.0,Onodera Taishi,MB,Japan,27.0,200.0,2022,Japan,Netherlands,2022-06-08,True,1,2,15,18,0,1,1,2,4,2,3,9,2,5,6,13,2,0,4,6,3,0,1,4
142565.0,Onodera Taishi,MB,Japan,27.0,200.0,2022,Japan,China,2022-06-09,True,0,0,0,0,0,0,0,0,0,0,0,0,0,0,0,0,0,0,0,0,0,0,0,0
142565.0,Onodera Taishi,MB,Japan,27.0,200.0,2022,Japan,USA,2022-06-10,False,0,1,11,12,0,1,0,1,5,1,2,8,0,3,2,5,1,0,0,1,2,2,1,5
142565.0,Onodera Taishi,MB,Japan,27.0,200.0,2022,Iran,Japan,2022-06-12,True,0,1,4,5,0,0,0,0,2,1,1,4,2,3,2,7,1,0,1,2,4,1,0,5
142565.0,Onodera Taishi,MB,Japan,27.0,200.0,2022,Argentina,Japan,2022-06-21,True,2,2,11,15,0,0,0,0,5,0,5,10,2,2,3,7,0,0,1,1,4,0,1,5
142565.0,Onodera Taishi,MB,Japan,27.0,200.0,2022,Japan,Italy,2022-06-24,True,1,1,20,22,0,0,1,1,5,1,3,9,0,3,2,5,2,0,1,3,5,1,2,8
142565.0,Onodera Taishi,MB,Japan,27.0,200.0,2022,Japan,France,2022-06-25,False,0,0,0,0,0,0,0,0,0,0,0,0,0,0,0,0,0,0,0,0,0,0,0,0
142565.0,Onodera Taishi,MB,Japan,27.0,200.0,2022,Japan,Slovenia,2022-06-26,True,0,0,2,2,0,0,0,0,0,0,0,0,0,0,0,0,0,0,0,0,1,0,0,1
142565.0,Onodera Taishi,MB,Japan,27.0,200.0,2022,Japan,Australia,2022-07-06,True,0,1,7,8,0,0,0,0,0,0,0,0,0,0,0,0,0,0,0,0,0,0,0,0
142565.0,Onodera Taishi,MB,Japan,27.0,200.0,2022,Japan,Canada,2022-07-08,True,0,0,10,10,0,0,1,1,9,1,2,12,1,4,2,7,1,1,2,4,2,2,0,4
142565.0,Onodera Taishi,MB,Japan,27.0,200.0,2022,Germany,Japan,2022-07-09,True,0,4,13,17,0,0,1,1,5,0,3,8,1,5,6,12,1,0,1,2,2,0,0,2
142565.0,Onodera Taishi,MB,Japan,27.0,200.0,2022,Brazil,Japan,2022-07-10,False,0,1,8,9,0,0,0,0,3,1,3,7,0,1,3,4,0,0,3,3,3,4,3,10
142565.0,Onodera Taishi,MB,Japan,27.0,200.0,2022,France,Japan,2022-07-21,False,1,2,10,13,0,0,1,1,5,0,1,6,1,3,1,5,0,0,1,1,1,1,0,2
163516.0,Otsuka Tatsunori,OH,Japan,22.0,194.0,2022,Japan,Netherlands,2022-06-08,True,0,0,1,1,0,0,0,0,3,0,2,5,0,1,0,1,0,0,1,1,1,0,0,1
163516.0,Otsuka Tatsunori,OH,Japan,22.0,194.0,2022,Japan,China,2022-06-09,True,0,0,0,0,0,0,0,0,0,0,1,1,0,0,0,0,1,0,0,1,0,0,0,0
163516.0,Otsuka Tatsunori,OH,Japan,22.0,194.0,2022,Japan,USA,2022-06-10,False,0,1,4,5,0,0,0,0,5,3,11,19,0,1,2,3,2,0,4,6,3,1,0,4
163516.0,Otsuka Tatsunori,OH,Japan,22.0,194.0,2022,Iran,Japan,2022-06-12,True,0,1,1,2,0,0,0,0,2,0,0,2,0,0,0,0,1,1,3,5,0,0,0,0
163516.0,Otsuka Tatsunori,OH,Japan,22.0,194.0,2022,Argentina,Japan,2022-06-21,True,0,0,0,0,0,0,1,1,0,0,1,1,0,0,0,0,0,0,0,0,0,0,0,0
163516.0,Otsuka Tatsunori,OH,Japan,22.0,194.0,2022,Japan,Italy,2022-06-24,True,0,0,0,0,0,0,0,0,0,0,0,0,0,0,0,0,0,0,0,0,0,0,0,0
163516.0,Otsuka Tatsunori,OH,Japan,22.0,194.0,2022,Japan,France,2022-06-25,False,0,2,5,7,0,1,0,1,15,6,13,34,0,0,3,3,0,0,0,0,5,1,1,7
163516.0,Otsuka Tatsunori,OH,Japan,22.0,194.0,2022,Japan,Slovenia,2022-06-26,True,0,3,10,13,0,0,3,3,13,3,6,22,0,0,2,2,10,1,26,37,8,2,0,10
163516.0,Otsuka Tatsunori,OH,Japan,22.0,194.0,2022,Japan,Australia,2022-07-06,True,0,0,13,13,1,0,1,2,11,2,6,19,0,2,1,3,9,0,14,23,2,3,1,6
163516.0,Otsuka Tatsunori,OH,Japan,22.0,194.0,2022,Japan,Canada,2022-07-08,True,1,2,13,16,0,0,2,2,8,0,12,20,0,5,1,6,7,3,11,21,4,3,3,10
163516.0,Otsuka Tatsunori,OH,Japan,22.0,194.0,2022,Germany,Japan,2022-07-09,True,0,0,0,0,0,0,0,0,0,0,0,0,0,0,0,0,0,0,0,0,0,0,0,0
163516.0,Otsuka Tatsunori,OH,Japan,22.0,194.0,2022,Brazil,Japan,2022-07-10,False,1,0,8,9,0,0,2,2,3,1,3,7,1,0,1,2,3,0,11,14,4,0,0,4
163516.0,Otsuka Tatsunori,OH,Japan,22.0,194.0,2022,France,Japan,2022-07-21,False,0,1,6,7,0,0,2,2,5,4,5,14,0,3,1,4,2,0,12,14,2,3,0,5
146409.0,Yamauchi Akihiro,MB,Japan,29.0,204.0,2022,Japan,Netherlands,2022-06-08,True,0,0,7,7,0,0,0,0,1,1,4,6,0,3,0,3,1,0,1,2,3,0,1,4
146409.0,Yamauchi Akihiro,MB,Japan,29.0,204.0,2022,Japan,China,2022-06-09,True,0,2,8,10,1,0,0,1,5,2,1,8,0,2,2,4,0,0,0,0,2,0,1,3
146409.0,Yamauchi Akihiro,MB,Japan,29.0,204.0,2022,Japan,USA,2022-06-10,False,0,2,18,20,0,0,0,0,6,0,6,12,0,8,7,15,0,0,0,0,4,1,2,7
146409.0,Yamauchi Akihiro,MB,Japan,29.0,204.0,2022,Iran,Japan,2022-06-12,True,1,1,8,10,0,0,0,0,4,0,1,5,2,2,4,8,0,0,0,0,1,0,0,1
146409.0,Yamauchi Akihiro,MB,Japan,29.0,204.0,2022,Argentina,Japan,2022-06-21,True,1,2,14,17,0,0,0,0,7,1,5,13,2,3,2,7,0,0,0,0,3,0,0,3
146409.0,Yamauchi Akihiro,MB,Japan,29.0,204.0,2022,Japan,Italy,2022-06-24,True,1,1,15,17,0,0,3,3,14,1,3,18,0,5,8,13,0,0,0,0,3,1,0,4
146409.0,Yamauchi Akihiro,MB,Japan,29.0,204.0,2022,Japan,France,2022-06-25,False,0,0,0,0,0,0,0,0,0,0,0,0,0,0,0,0,0,0,0,0,0,0,0,0
146409.0,Yamauchi Akihiro,MB,Japan,29.0,204.0,2022,Japan,Slovenia,2022-06-26,True,0,3,14,17,0,0,1,1,5,1,5,11,2,5,5,12,0,0,1,1,6,1,0,7
146409.0,Yamauchi Akihiro,MB,Japan,29.0,204.0,2022,Japan,Australia,2022-07-06,True,0,2,14,16,1,0,0,1,7,0,5,12,0,7,1,8,0,0,0,0,2,1,1,4
146409.0,Yamauchi Akihiro,MB,Japan,29.0,204.0,2022,Japan,Canada,2022-07-08,True,1,1,12,14,0,0,0,0,5,1,3,9,2,5,7,14,0,0,2,2,0,0,2,2
146409.0,Yamauchi Akihiro,MB,Japan,29.0,204.0,2022,Germany,Japan,2022-07-09,True,0,0,0,0,0,0,0,0,0,0,0,0,0,0,0,0,0,0,0,0,0,0,0,0
146409.0,Yamauchi Akihiro,MB,Japan,29.0,204.0,2022,Brazil,Japan,2022-07-10,False,0,1,8,9,0,0,0,0,3,2,3,8,0,3,2,5,0,0,1,1,1,1,0,2
146409.0,Yamauchi Akihiro,MB,Japan,29.0,204.0,2022,France,Japan,2022-07-21,False,0,1,8,9,0,0,1,1,5,2,1,8,2,4,1,7,0,0,0,0,3,1,0,4
153365.0,Takanashi Kenta,OH,Japan,26.0,190.0,2022,Argentina,Japan,2022-06-21,True,0,2,3,5,0,0,2,2,4,3,3,10,0,0,1,1,4,1,11,16,4,1,0,5
153365.0,Takanashi Kenta,OH,Japan,26.0,190.0,2022,Japan,Italy,2022-06-24,True,0,0,0,0,0,0,1,1,1,1,1,3,0,1,0,1,1,0,1,2,1,0,0,1
153365.0,Takanashi Kenta,OH,Japan,26.0,190.0,2022,Japan,France,2022-06-25,False,0,7,4,11,0,1,2,3,12,5,11,28,1,1,1,3,2,4,17,23,6,2,0,8
153365.0,Takanashi Kenta,OH,Japan,26.0,190.0,2022,Japan,Slovenia,2022-06-26,True,0,0,0,0,0,0,0,0,0,0,0,0,0,0,0,0,0,0,0,0,0,0,0,0
153365.0,Takanashi Kenta,OH,Japan,26.0,190.0,2022,Japan,Australia,2022-07-06,True,0,0,0,0,0,0,0,0,0,0,0,0,0,0,0,0,0,0,0,0,0,0,0,0
153365.0,Takanashi Kenta,OH,Japan,26.0,190.0,2022,Japan,Canada,2022-07-08,True,0,0,0,0,0,0,0,0,0,0,0,0,0,0,0,0,0,0,0,0,0,0,0,0
153365.0,Takanashi Kenta,OH,Japan,26.0,190.0,2022,Germany,Japan,2022-07-09,True,0,4,7,11,0,0,5,5,14,4,3,21,2,6,6,14,3,1,16,20,4,3,1,8
153365.0,Takanashi Kenta,OH,Japan,26.0,190.0,2022,Brazil,Japan,2022-07-10,False,0,0,0,0,0,0,2,2,1,0,0,1,0,0,0,0,0,0,0,0,1,0,0,1
153365.0,Takanashi Kenta,OH,Japan,26.0,190.0,2022,France,Japan,2022-07-21,False,0,3,1,4,0,0,5,5,3,2,7,12,0,2,0,2,2,1,4,7,0,1,1,2
133009.0,Sekita Masahiro,S,Japan,29.0,175.0,2022,Japan,Netherlands,2022-06-08,True,0,0,8,8,31,0,47,78,0,0,0,0,0,1,3,4,0,0,1,1,5,3,0,8
133009.0,Sekita Masahiro,S,Japan,29.0,175.0,2022,Japan,China,2022-06-09,True,0,0,0,0,0,0,0,0,0,0,0,0,0,0,0,0,0,0,0,0,0,0,0,0
133009.0,Sekita Masahiro,S,Japan,29.0,175.0,2022,Japan,USA,2022-06-10,False,0,1,4,5,11,0,25,36,0,0,0,0,0,1,0,1,0,0,0,0,4,0,0,4
133009.0,Sekita Masahiro,S,Japan,29.0,175.0,2022,Iran,Japan,2022-06-12,True,0,1,14,15,18,1,31,50,0,0,0,0,0,1,5,6,0,0,1,1,8,1,0,9
133009.0,Sekita Masahiro,S,Japan,29.0,175.0,2022,Argentina,Japan,2022-06-21,True,0,2,14,16,15,0,69,84,0,0,0,0,0,2,2,4,0,0,0,0,8,2,0,10
133009.0,Sekita Masahiro,S,Japan,29.0,175.0,2022,Japan,Italy,2022-06-24,True,1,0,18,19,24,0,81,105,1,0,0,1,0,3,1,4,0,0,2,2,6,4,3,13
133009.0,Sekita Masahiro,S,Japan,29.0,175.0,2022,Japan,France,2022-06-25,False,0,0,2,2,0,0,1,1,0,0,0,0,0,0,0,0,0,0,0,0,0,0,0,0
133009.0,Sekita Masahiro,S,Japan,29.0,175.0,2022,Japan,Slovenia,2022-06-26,True,0,0,16,16,20,0,71,91,1,0,1,2,1,2,4,7,0,0,2,2,5,2,0,7
133009.0,Sekita Masahiro,S,Japan,29.0,175.0,2022,Japan,Australia,2022-07-06,True,2,0,10,12,31,0,41,72,1,0,0,1,0,2,2,4,0,0,1,1,4,2,2,8
133009.0,Sekita Masahiro,S,Japan,29.0,175.0,2022,Japan,Canada,2022-07-08,True,0,2,16,18,29,0,48,77,1,0,1,2,0,1,7,8,0,0,0,0,12,3,4,19
133009.0,Sekita Masahiro,S,Japan,29.0,175.0,2022,Germany,Japan,2022-07-09,True,0,0,0,0,0,0,4,4,0,0,0,0,0,0,0,0,0,0,0,0,0,0,0,0
133009.0,Sekita Masahiro,S,Japan,29.0,175.0,2022,Brazil,Japan,2022-07-10,False,0,1,9,10,29,0,40,69,0,0,0,0,0,0,3,3,0,1,0,1,3,4,2,9
133009.0,Sekita Masahiro,S,Japan,29.0,175.0,2022,France,Japan,2022-07-21,False,0,0,8,8,10,0,41,51,0,0,1,1,0,0,0,0,0,1,0,1,6,3,0,9
142570.0,Oya Masaki,S,Japan,27.0,178.0,2022,Argentina,Japan,2022-06-21,True,0,0,1,1,0,0,1,1,0,0,0,0,0,0,0,0,0,0,0,0,0,0,0,0
142570.0,Oya Masaki,S,Japan,27.0,178.0,2022,Japan,Italy,2022-06-24,True,0,0,0,0,0,0,0,0,0,0,0,0,0,0,0,0,0,0,0,0,0,0,0,0
142570.0,Oya Masaki,S,Japan,27.0,178.0,2022,Japan,France,2022-06-25,False,0,1,12,13,16,1,64,81,3,0,1,4,1,1,5,7,0,0,1,1,6,2,2,10
142570.0,Oya Masaki,S,Japan,27.0,178.0,2022,Japan,Slovenia,2022-06-26,True,0,0,0,0,0,0,0,0,0,0,0,0,0,0,0,0,0,0,0,0,0,0,0,0
142570.0,Oya Masaki,S,Japan,27.0,178.0,2022,Japan,Australia,2022-07-06,True,0,0,0,0,5,1,4,10,0,0,0,0,0,0,0,0,0,0,0,0,1,0,0,1
142570.0,Oya Masaki,S,Japan,27.0,178.0,2022,Japan,Canada,2022-07-08,True,0,0,0,0,1,0,2,3,0,0,0,0,0,0,0,0,0,0,0,0,1,0,0,1
142570.0,Oya Masaki,S,Japan,27.0,178.0,2022,Germany,Japan,2022-07-09,True,0,0,13,13,16,1,54,71,0,1,0,1,0,1,8,9,0,0,0,0,6,3,2,11
142570.0,Oya Masaki,S,Japan,27.0,178.0,2022,Brazil,Japan,2022-07-10,False,0,0,0,0,1,0,1,2,0,0,0,0,0,0,0,0,0,0,0,0,0,0,1,1
142570.0,Oya Masaki,S,Japan,27.0,178.0,2022,France,Japan,2022-07-21,False,0,0,0,0,4,0,5,9,0,0,0,0,0,0,0,0,0,0,1,1,0,1,1,2
142561.0,Takahashi Kentaro,MB,Japan,28.0,202.0,2022,Argentina,Japan,2022-06-21,True,0,0,0,0,0,0,0,0,0,0,0,0,0,0,0,0,0,0,0,0,0,0,0,0
142561.0,Takahashi Kentaro,MB,Japan,28.0,202.0,2022,Japan,Italy,2022-06-24,True,0,0,0,0,0,0,0,0,0,0,0,0,0,0,1,1,0,0,0,0,0,0,0,0
142561.0,Takahashi Kentaro,MB,Japan,28.0,202.0,2022,Japan,France,2022-06-25,False,0,1,6,7,0,0,1,1,6,1,2,9,0,6,10,16,0,0,0,0,4,0,0,4
142561.0,Takahashi Kentaro,MB,Japan,28.0,202.0,2022,Japan,Slovenia,2022-06-26,True,0,3,12,15,0,0,0,0,9,0,3,12,2,2,5,9,0,0,0,0,2,0,1,3
142561.0,Takahashi Kentaro,MB,Japan,28.0,202.0,2022,Japan,Australia,2022-07-06,True,0,1,6,7,0,0,0,0,12,0,4,16,2,5,8,15,0,0,0,0,1,0,2,3
142561.0,Takahashi Kentaro,MB,Japan,28.0,202.0,2022,Japan,Canada,2022-07-08,True,0,0,1,1,0,0,0,0,0,1,0,1,1,0,0,1,0,0,0,0,1,0,0,1
142561.0,Takahashi Kentaro,MB,Japan,28.0,202.0,2022,Germany,Japan,2022-07-09,True,0,2,12,14,0,0,1,1,4,0,2,6,6,3,4,13,0,0,1,1,3,3,0,6
142561.0,Takahashi Kentaro,MB,Japan,28.0,202.0,2022,Brazil,Japan,2022-07-10,False,0,0,0,0,0,0,0,0,0,0,0,0,0,0,0,0,0,0,0,0,0,0,0,0
142561.0,Takahashi Kentaro,MB,Japan,28.0,202.0,2022,France,Japan,2022-07-21,False,0,0,0,0,0,0,0,0,0,0,0,0,0,0,0,0,0,0,0,0,0,0,0,0
178761.0,Tomita Shoma,OH,Japan,25.0,190.0,2022,Japan,Netherlands,2022-06-08,True,0,0,0,0,0,0,0,0,0,0,0,0,0,0,0,0,0,0,0,0,0,0,0,0
178761.0,Tomita Shoma,OH,Japan,25.0,190.0,2022,Japan,China,2022-06-09,True,0,0,0,0,0,0,0,0,0,0,0,0,0,0,0,0,0,0,0,0,0,0,0,0
178761.0,Tomita Shoma,OH,Japan,25.0,190.0,2022,Japan,USA,2022-06-10,False,0,2,1,3,0,0,1,1,1,1,1,3,0,3,0,3,2,0,7,9,4,0,0,4
178761.0,Tomita Shoma,OH,Japan,25.0,190.0,2022,Iran,Japan,2022-06-12,True,0,0,0,0,0,0,0,0,0,0,0,0,0,0,0,0,0,0,0,0,0,0,0,0
178761.0,Tomita Shoma,OH,Japan,25.0,190.0,2022,Argentina,Japan,2022-06-21,True,0,1,1,2,0,0,0,0,1,1,1,3,0,0,0,0,0,0,3,3,0,0,0,0
178761.0,Tomita Shoma,OH,Japan,25.0,190.0,2022,Japan,Italy,2022-06-24,True,0,0,0,0,0,0,1,1,0,0,0,0,0,0,0,0,0,0,0,0,0,0,0,0
178761.0,Tomita Shoma,OH,Japan,25.0,190.0,2022,Japan,France,2022-06-25,False,0,3,7,10,0,0,3,3,2,1,8,11,0,0,0,0,7,0,16,23,10,1,1,12
178761.0,Tomita Shoma,OH,Japan,25.0,190.0,2022,Japan,Slovenia,2022-06-26,True,0,0,0,0,0,0,0,0,0,1,0,1,0,0,0,0,0,0,1,1,0,0,0,0
178762.0,Takahashi Ran,OH,Japan,21.0,188.0,2022,Japan,Netherlands,2022-06-08,True,2,3,13,18,0,0,0,0,8,3,8,19,0,1,1,2,7,0,13,20,3,0,1,4
178762.0,Takahashi Ran,OH,Japan,21.0,188.0,2022,Japan,China,2022-06-09,True,1,2,18,21,1,0,1,2,13,3,6,22,0,2,0,2,7,0,13,20,6,1,0,7
178762.0,Takahashi Ran,OH,Japan,21.0,188.0,2022,Japan,USA,2022-06-10,False,0,2,18,20,2,0,0,2,12,1,15,28,0,3,6,9,13,3,24,40,12,1,2,15
178762.0,Takahashi Ran,OH,Japan,21.0,188.0,2022,Iran,Japan,2022-06-12,True,3,2,8,13,2,0,2,4,6,2,8,16,0,3,3,6,4,0,6,10,9,1,0,10
178762.0,Takahashi Ran,OH,Japan,21.0,188.0,2022,Argentina,Japan,2022-06-21,True,0,0,4,4,0,0,3,3,4,1,1,6,0,0,0,0,4,0,5,9,3,2,0,5
178762.0,Takahashi Ran,OH,Japan,21.0,188.0,2022,Japan,Italy,2022-06-24,True,0,4,9,13,0,0,2,2,7,4,8,19,1,3,1,5,5,1,21,27,4,3,0,7
178762.0,Takahashi Ran,OH,Japan,21.0,188.0,2022,Japan,France,2022-06-25,False,0,0,0,0,0,0,0,0,0,0,0,0,0,0,0,0,0,0,0,0,0,0,0,0
178762.0,Takahashi Ran,OH,Japan,21.0,188.0,2022,Japan,Slovenia,2022-06-26,True,0,0,0,0,0,0,0,0,0,0,0,0,0,0,0,0,0,0,0,0,0,0,0,0
178762.0,Takahashi Ran,OH,Japan,21.0,188.0,2022,Japan,Australia,2022-07-06,True,0,0,0,0,0,0,0,0,0,0,0,0,0,0,0,0,0,0,0,0,0,0,0,0
178762.0,Takahashi Ran,OH,Japan,21.0,188.0,2022,Japan,Canada,2022-07-08,True,0,0,0,0,0,0,0,0,0,0,0,0,0,0,0,0,0,0,1,1,0,0,0,0
178762.0,Takahashi Ran,OH,Japan,21.0,188.0,2022,Germany,Japan,2022-07-09,True,1,4,14,19,0,0,5,5,13,4,6,23,0,4,3,7,3,0,21,24,6,1,0,7
178762.0,Takahashi Ran,OH,Japan,21.0,188.0,2022,Brazil,Japan,2022-07-10,False,0,3,5,8,0,0,0,0,3,3,5,11,0,1,0,1,2,1,9,12,1,2,1,4
178762.0,Takahashi Ran,OH,Japan,21.0,188.0,2022,France,Japan,2022-07-21,False,1,2,4,7,0,0,0,0,3,2,1,6,0,0,0,0,8,1,12,21,1,1,0,2
180990.0,Ogawa Tomohiro,L,Japan,26.0,176.0,2022,Japan,Netherlands,2022-06-08,True,0,0,0,0,0,0,0,0,0,0,0,0,0,0,0,0,0,0,0,0,0,0,0,0
180990.0,Ogawa Tomohiro,L,Japan,26.0,176.0,2022,Japan,China,2022-06-09,True,0,0,0,0,0,0,0,0,0,0,0,0,0,0,0,0,0,0,0,0,0,0,0,0
180990.0,Ogawa Tomohiro,L,Japan,26.0,176.0,2022,Japan,USA,2022-06-10,False,0,0,0,0,0,0,0,0,0,0,0,0,0,0,0,0,0,0,0,0,0,0,0,0
180990.0,Ogawa Tomohiro,L,Japan,26.0,176.0,2022,Iran,Japan,2022-06-12,True,0,0,0,0,0,0,0,0,0,0,0,0,0,0,0,0,0,0,0,0,0,1,0,1
180990.0,Ogawa Tomohiro,L,Japan,26.0,176.0,2022,Argentina,Japan,2022-06-21,True,0,0,0,0,0,0,0,0,0,0,0,0,0,0,0,0,0,0,0,0,0,0,0,0
180990.0,Ogawa Tomohiro,L,Japan,26.0,176.0,2022,Japan,Italy,2022-06-24,True,0,0,0,0,0,0,0,0,0,0,0,0,0,0,0,0,0,0,0,0,0,0,0,0
180990.0,Ogawa Tomohiro,L,Japan,26.0,176.0,2022,Japan,France,2022-06-25,False,0,0,0,0,0,0,5,5,0,0,0,0,0,0,0,0,2,1,11,14,8,1,5,14
180990.0,Ogawa Tomohiro,L,Japan,26.0,176.0,2022,Japan,Slovenia,2022-06-26,True,0,0,0,0,0,0,0,0,0,0,0,0,0,0,0,0,0,0,0,0,0,0,0,0
180990.0,Ogawa Tomohiro,L,Japan,26.0,176.0,2022,Japan,Australia,2022-07-06,True,0,0,0,0,0,0,0,0,0,0,0,0,0,0,0,0,0,0,0,0,0,0,0,0
180990.0,Ogawa Tomohiro,L,Japan,26.0,176.0,2022,Japan,Canada,2022-07-08,True,0,0,0,0,0,0,0,0,0,0,0,0,0,0,0,0,0,0,0,0,0,0,0,0
180990.0,Ogawa Tomohiro,L,Japan,26.0,176.0,2022,Germany,Japan,2022-07-09,True,0,0,0,0,0,0,4,4,0,0,0,0,0,0,0,0,4,1,12,17,4,2,1,7
180990.0,Ogawa Tomohiro,L,Japan,26.0,176.0,2022,Brazil,Japan,2022-07-10,False,0,0,0,0,0,0,0,0,0,0,0,0,0,0,0,0,0,0,0,0,0,0,0,0
180990.0,Ogawa Tomohiro,L,Japan,26.0,176.0,2022,France,Japan,2022-07-21,False,0,0,0,0,0,0,0,0,0,0,0,0,0,0,0,0,0,0,0,0,0,0,0,0
142568.0,Ishikawa Yuki,OH,Japan,27.0,191.0,2022,Japan,Netherlands,2022-06-08,True,1,3,13,17,1,0,4,5,6,5,8,19,5,7,1,13,8,1,11,20,6,2,1,9
142568.0,Ishikawa Yuki,OH,Japan,27.0,191.0,2022,Japan,China,2022-06-09,True,3,9,7,19,3,0,0,3,11,3,7,21,2,2,3,7,7,0,14,21,5,2,0,7
142568.0,Ishikawa Yuki,OH,Japan,27.0,191.0,2022,Japan,USA,2022-06-10,False,1,3,3,7,1,1,0,2,7,4,9,20,1,4,0,5,5,1,3,9,2,1,0,3
142568.0,Ishikawa Yuki,OH,Japan,27.0,191.0,2022,Iran,Japan,2022-06-12,True,1,2,11,14,3,0,1,4,14,1,5,20,1,3,3,7,4,0,9,13,4,1,0,5
142568.0,Ishikawa Yuki,OH,Japan,27.0,191.0,2022,Argentina,Japan,2022-06-21,True,3,6,7,16,0,0,9,9,15,4,10,29,0,1,2,3,8,0,17,25,6,2,2,10
142568.0,Ishikawa Yuki,OH,Japan,27.0,191.0,2022,Japan,Italy,2022-06-24,True,6,2,14,22,3,0,4,7,14,8,17,39,0,2,1,3,7,1,20,28,10,2,4,16
142568.0,Ishikawa Yuki,OH,Japan,27.0,191.0,2022,Japan,France,2022-06-25,False,0,0,0,0,0,0,0,0,0,0,0,0,0,0,0,0,0,0,0,0,0,0,0,0
142568.0,Ishikawa Yuki,OH,Japan,27.0,191.0,2022,Japan,Slovenia,2022-06-26,True,3,4,10,17,0,0,3,3,17,2,15,34,1,2,0,3,7,1,7,15,8,2,2,12
142568.0,Ishikawa Yuki,OH,Japan,27.0,191.0,2022,Japan,Australia,2022-07-06,True,5,5,9,19,2,0,4,6,11,2,6,19,2,2,1,5,9,1,13,23,4,2,4,10
142568.0,Ishikawa Yuki,OH,Japan,27.0,191.0,2022,Japan,Canada,2022-07-08,True,4,4,12,20,1,0,5,6,15,3,12,30,0,3,3,6,4,2,10,16,7,1,2,10
142568.0,Ishikawa Yuki,OH,Japan,27.0,191.0,2022,Germany,Japan,2022-07-09,True,1,1,2,4,0,0,0,0,0,0,0,0,0,0,0,0,0,0,0,0,0,0,0,0
142568.0,Ishikawa Yuki,OH,Japan,27.0,191.0,2022,Brazil,Japan,2022-07-10,False,1,2,9,12,0,0,6,6,12,2,3,17,1,3,2,6,8,1,8,17,3,4,0,7
163038.0,Miyaura Kento,O,Japan,24.0,190.0,2022,Japan,Netherlands,2022-06-08,True,0,1,0,1,0,0,0,0,0,0,0,0,0,0,0,0,0,0,0,0,0,0,0,0
163038.0,Miyaura Kento,O,Japan,24.0,190.0,2022,Japan,China,2022-06-09,True,0,0,1,1,0,0,0,0,0,0,0,0,0,0,0,0,0,0,0,0,0,0,0,0
163038.0,Miyaura Kento,O,Japan,24.0,190.0,2022,Japan,USA,2022-06-10,False,0,3,11,14,0,0,2,2,19,6,17,42,1,3,7,11,0,0,0,0,11,2,1,14
163038.0,Miyaura Kento,O,Japan,24.0,190.0,2022,Iran,Japan,2022-06-12,True,0,0,0,0,0,0,0,0,0,0,0,0,0,0,0,0,0,0,0,0,0,0,0,0
163038.0,Miyaura Kento,O,Japan,24.0,190.0,2022,Japan,Australia,2022-07-06,True,0,0,1,1,0,0,0,0,2,0,2,4,1,1,1,3,0,0,0,0,0,0,0,0
163038.0,Miyaura Kento,O,Japan,24.0,190.0,2022,Japan,Canada,2022-07-08,True,0,0,2,2,0,0,0,0,0,0,2,2,0,0,0,0,0,0,0,0,0,0,0,0
163038.0,Miyaura Kento,O,Japan,24.0,190.0,2022,Germany,Japan,2022-07-09,True,2,5,10,17,0,0,0,0,15,7,10,32,0,1,3,4,0,0,0,0,7,3,0,10
163038.0,Miyaura Kento,O,Japan,24.0,190.0,2022,Brazil,Japan,2022-07-10,False,0,0,0,0,0,0,0,0,0,0,0,0,0,0,0,0,0,0,0,0,0,0,0,0
163038.0,Miyaura Kento,O,Japan,24.0,190.0,2022,France,Japan,2022-07-21,False,0,1,2,3,0,0,1,1,3,0,1,4,0,0,0,0,0,0,0,0,0,0,0,0
172893.0,Yamamoto Tomohiro,L,Japan,28.0,171.0,2022,Japan,Netherlands,2022-06-08,True,0,0,0,0,1,0,1,2,0,0,0,0,0,0,0,0,10,2,10,22,12,3,2,17
172893.0,Yamamoto Tomohiro,L,Japan,28.0,171.0,2022,Japan,China,2022-06-09,True,0,0,0,0,4,0,0,4,0,0,0,0,0,0,0,0,11,0,11,22,12,1,3,16
172893.0,Yamamoto Tomohiro,L,Japan,28.0,171.0,2022,Japan,USA,2022-06-10,False,0,0,0,0,10,0,5,15,0,0,0,0,0,0,0,0,11,0,7,18,20,2,2,24
172893.0,Yamamoto Tomohiro,L,Japan,28.0,171.0,2022,Iran,Japan,2022-06-12,True,0,0,0,0,3,0,1,4,0,0,0,0,0,0,0,0,3,3,4,10,5,0,2,7
172893.0,Yamamoto Tomohiro,L,Japan,28.0,171.0,2022,Argentina,Japan,2022-06-21,True,0,0,0,0,0,0,5,5,0,0,0,0,0,0,0,0,0,0,13,13,6,7,1,14
172893.0,Yamamoto Tomohiro,L,Japan,28.0,171.0,2022,Japan,Italy,2022-06-24,True,0,0,0,0,1,0,4,5,0,0,0,0,0,0,0,0,6,1,11,18,14,1,0,15
172893.0,Yamamoto Tomohiro,L,Japan,28.0,171.0,2022,Japan,France,2022-06-25,False,0,0,0,0,0,0,0,0,0,0,0,0,0,0,0,0,0,0,1,1,0,0,0,0
172893.0,Yamamoto Tomohiro,L,Japan,28.0,171.0,2022,Japan,Slovenia,2022-06-26,True,0,0,0,0,0,0,3,3,0,0,0,0,0,0,0,0,2,0,7,9,11,1,0,12
172893.0,Yamamoto Tomohiro,L,Japan,28.0,171.0,2022,Japan,Australia,2022-07-06,True,0,0,0,0,1,0,4,5,0,0,0,0,0,0,0,0,12,0,8,20,6,5,3,14
172893.0,Yamamoto Tomohiro,L,Japan,28.0,171.0,2022,Japan,Canada,2022-07-08,True,0,0,0,0,2,0,9,11,0,0,0,0,0,0,0,0,10,2,9,21,7,0,5,12
172893.0,Yamamoto Tomohiro,L,Japan,28.0,171.0,2022,Germany,Japan,2022-07-09,True,0,0,0,0,0,0,0,0,0,0,0,0,0,0,0,0,0,0,0,0,0,0,0,0
172893.0,Yamamoto Tomohiro,L,Japan,28.0,171.0,2022,Brazil,Japan,2022-07-10,False,0,0,0,0,0,0,0,0,0,0,0,0,0,0,0,0,4,1,6,11,8,2,2,12
172893.0,Yamamoto Tomohiro,L,Japan,28.0,171.0,2022,France,Japan,2022-07-21,False,0,0,0,0,0,0,3,3,0,0,0,0,0,0,0,0,3,0,6,9,6,0,0,6
142562.0,Eiro Motoki,S,Japan,26.0,192.0,2022,Japan,Netherlands,2022-06-08,True,0,0,3,3,5,0,14,19,0,0,0,0,0,0,1,1,0,0,0,0,3,0,0,3
142562.0,Eiro Motoki,S,Japan,26.0,192.0,2022,Japan,China,2022-06-09,True,0,4,8,12,38,0,46,84,0,0,0,0,0,1,5,6,0,0,0,0,5,1,2,8
142562.0,Eiro Motoki,S,Japan,26.0,192.0,2022,Japan,USA,2022-06-10,False,0,0,8,8,32,2,47,81,3,1,0,4,1,0,2,3,0,0,0,0,4,0,1,5
142562.0,Eiro Motoki,S,Japan,26.0,192.0,2022,Iran,Japan,2022-06-12,True,0,0,0,0,2,0,4,6,0,0,1,1,0,1,0,1,0,0,0,0,0,0,0,0
189037.0,Murayama Go,MB,Japan,24.0,192.0,2022,Japan,Netherlands,2022-06-08,True,1,1,6,8,0,0,0,0,9,0,3,12,2,3,4,9,0,0,1,1,1,0,0,1
189037.0,Murayama Go,MB,Japan,24.0,192.0,2022,Japan,China,2022-06-09,True,1,2,11,14,0,0,1,1,5,2,2,9,1,6,1,8,0,0,0,0,0,2,0,2
189037.0,Murayama Go,MB,Japan,24.0,192.0,2022,Japan,USA,2022-06-10,False,0,1,3,4,0,0,0,0,2,0,2,4,0,1,0,1,0,0,0,0,0,0,0,0
189037.0,Murayama Go,MB,Japan,24.0,192.0,2022,Iran,Japan,2022-06-12,True,0,0,0,0,0,0,0,0,0,0,0,0,0,0,0,0,0,0,0,0,0,0,0,0
189037.0,Murayama Go,MB,Japan,24.0,192.0,2022,Argentina,Japan,2022-06-21,True,0,0,0,0,0,0,0,0,0,0,0,0,0,0,0,0,0,0,0,0,0,0,0,0
189037.0,Murayama Go,MB,Japan,24.0,192.0,2022,Japan,Italy,2022-06-24,True,0,0,0,0,0,0,0,0,0,0,0,0,0,0,0,0,0,0,0,0,0,0,0,0
189037.0,Murayama Go,MB,Japan,24.0,192.0,2022,Japan,France,2022-06-25,False,1,2,11,14,0,0,0,0,2,1,3,6,0,3,3,6,0,0,0,0,4,0,1,5
189037.0,Murayama Go,MB,Japan,24.0,192.0,2022,Japan,Slovenia,2022-06-26,True,0,0,0,0,0,0,0,0,0,0,0,0,0,0,0,0,0,0,0,0,0,0,0,0
189037.0,Murayama Go,MB,Japan,24.0,192.0,2022,Japan,Australia,2022-07-06,True,0,0,0,0,0,0,0,0,0,0,0,0,0,0,0,0,0,0,0,0,0,0,0,0
189037.0,Murayama Go,MB,Japan,24.0,192.0,2022,Japan,Canada,2022-07-08,True,0,0,0,0,0,0,0,0,0,0,0,0,0,0,0,0,0,0,0,0,0,0,0,0
189037.0,Murayama Go,MB,Japan,24.0,192.0,2022,Germany,Japan,2022-07-09,True,0,0,1,1,0,0,1,1,1,0,0,1,0,0,0,0,0,0,0,0,1,0,0,1
189037.0,Murayama Go,MB,Japan,24.0,192.0,2022,Brazil,Japan,2022-07-10,False,0,0,0,0,0,0,0,0,0,0,0,0,0,0,0,0,0,0,0,0,0,0,0,0
189037.0,Murayama Go,MB,Japan,24.0,192.0,2022,France,Japan,2022-07-21,False,0,0,0,0,0,0,0,0,0,0,0,0,0,0,0,0,0,0,0,0,0,0,0,0
141546.0,Keemink Wessel,S,Netherlands,29.0,197.0,2022,Japan,Netherlands,2022-06-08,False,0,0,10,10,20,0,54,74,1,0,2,3,2,5,2,9,1,0,0,1,3,2,1,6
141546.0,Keemink Wessel,S,Netherlands,29.0,197.0,2022,Netherlands,USA,2022-06-09,False,0,0,0,0,0,1,7,8,0,0,0,0,0,0,0,0,0,0,0,0,1,0,0,1
141546.0,Keemink Wessel,S,Netherlands,29.0,197.0,2022,Netherlands,Iran,2022-06-10,True,0,0,12,12,25,0,46,71,0,0,1,1,0,1,2,3,0,3,0,3,3,1,1,5
141546.0,Keemink Wessel,S,Netherlands,29.0,197.0,2022,Netherlands,Australia,2022-06-12,True,0,1,6,7,22,0,38,60,2,0,0,2,1,1,1,3,0,0,0,0,2,0,0,2
141546.0,Keemink Wessel,S,Netherlands,29.0,197.0,2022,Slovenia,Netherlands,2022-06-21,True,0,0,13,13,12,0,47,59,0,1,0,1,1,1,4,6,0,0,0,0,3,0,1,4
141546.0,Keemink Wessel,S,Netherlands,29.0,197.0,2022,France,Netherlands,2022-06-23,False,0,0,6,6,13,0,38,51,0,0,0,0,0,1,0,1,0,0,2,2,3,3,0,6
141546.0,Keemink Wessel,S,Netherlands,29.0,197.0,2022,Germany,Netherlands,2022-06-24,True,1,1,12,14,12,1,85,98,2,0,1,3,0,4,5,9,0,0,0,0,4,1,2,7
141546.0,Keemink Wessel,S,Netherlands,29.0,197.0,2022,Argentina,Netherlands,2022-06-25,True,0,0,17,17,12,0,93,105,1,0,1,2,1,2,2,5,0,0,1,1,10,2,1,13
141546.0,Keemink Wessel,S,Netherlands,29.0,197.0,2022,Netherlands,China,2022-07-06,True,0,1,15,16,7,0,63,70,0,0,0,0,0,0,0,0,0,0,0,0,0,1,0,1
141546.0,Keemink Wessel,S,Netherlands,29.0,197.0,2022,Bulgaria,Netherlands,2022-07-08,False,0,0,14,14,19,0,63,82,0,1,0,1,0,1,0,1,1,0,3,4,1,0,0,1
141546.0,Keemink Wessel,S,Netherlands,29.0,197.0,2022,Poland,Netherlands,2022-07-09,False,1,1,7,9,6,0,57,63,3,0,1,4,0,0,0,0,0,0,1,1,1,1,0,2
141546.0,Keemink Wessel,S,Netherlands,29.0,197.0,2022,Italy,Netherlands,2022-07-10,False,0,2,6,8,8,0,62,70,3,0,0,3,0,2,0,2,0,0,0,0,2,0,0,2
141546.0,Keemink Wessel,S,Netherlands,29.0,197.0,2022,Italy,Netherlands,2022-07-20,False,0,0,14,14,14,0,82,96,1,0,0,1,0,3,3,6,0,1,0,1,10,2,0,12
139929.0,Van Garderen Maarten,OH,Netherlands,33.0,200.0,2022,Japan,Netherlands,2022-06-08,False,0,5,9,14,1,0,0,1,12,8,9,29,2,3,1,6,4,1,19,24,4,2,1,7
139929.0,Van Garderen Maarten,OH,Netherlands,33.0,200.0,2022,Netherlands,USA,2022-06-09,False,0,1,2,3,0,0,0,0,2,0,1,3,0,0,0,0,0,0,1,1,0,1,1,2
139929.0,Van Garderen Maarten,OH,Netherlands,33.0,200.0,2022,Netherlands,Iran,2022-06-10,True,0,0,0,0,0,0,0,0,0,0,0,0,0,0,0,0,0,0,0,0,0,0,0,0
139929.0,Van Garderen Maarten,OH,Netherlands,33.0,200.0,2022,Netherlands,Australia,2022-06-12,True,1,2,4,7,1,0,0,1,2,1,5,8,2,2,0,4,8,0,5,13,2,0,1,3
139929.0,Van Garderen Maarten,OH,Netherlands,33.0,200.0,2022,Netherlands,China,2022-07-06,True,0,0,0,0,0,0,0,0,1,0,0,1,0,0,0,0,0,0,2,2,0,0,0,0
139929.0,Van Garderen Maarten,OH,Netherlands,33.0,200.0,2022,Bulgaria,Netherlands,2022-07-08,False,0,0,5,5,0,0,1,1,1,2,3,6,0,0,0,0,1,1,11,13,0,0,0,0
139929.0,Van Garderen Maarten,OH,Netherlands,33.0,200.0,2022,Poland,Netherlands,2022-07-09,False,0,3,4,7,0,0,3,3,7,4,6,17,0,4,0,4,0,1,12,13,1,2,0,3
139929.0,Van Garderen Maarten,OH,Netherlands,33.0,200.0,2022,Italy,Netherlands,2022-07-10,False,0,1,0,1,0,0,0,0,2,0,2,4,0,0,0,0,0,0,1,1,0,0,0,0
139929.0,Van Garderen Maarten,OH,Netherlands,33.0,200.0,2022,Italy,Netherlands,2022-07-20,False,0,4,4,8,0,0,2,2,4,1,9,14,1,2,2,5,3,0,6,9,2,4,0,6
137345.0,Ter Horst Thijs,OH,Netherlands,31.0,204.0,2022,Japan,Netherlands,2022-06-08,False,0,0,1,1,0,0,0,0,1,0,1,2,0,0,0,0,1,0,0,1,0,0,0,0
137345.0,Ter Horst Thijs,OH,Netherlands,31.0,204.0,2022,Netherlands,USA,2022-06-09,False,0,3,3,6,1,0,1,2,9,3,8,20,0,2,0,2,7,2,15,24,4,1,0,5
137345.0,Ter Horst Thijs,OH,Netherlands,31.0,204.0,2022,Netherlands,Iran,2022-06-10,True,0,3,5,8,0,0,1,1,14,1,5,20,0,1,4,5,0,0,7,7,5,2,1,8
137345.0,Ter Horst Thijs,OH,Netherlands,31.0,204.0,2022,Netherlands,Australia,2022-06-12,True,0,3,1,4,1,0,0,1,2,2,4,8,1,1,2,4,4,1,4,9,5,0,0,5
137345.0,Ter Horst Thijs,OH,Netherlands,31.0,204.0,2022,Slovenia,Netherlands,2022-06-21,True,2,2,6,10,0,0,4,4,9,2,3,14,1,4,3,8,3,2,10,15,4,1,1,6
137345.0,Ter Horst Thijs,OH,Netherlands,31.0,204.0,2022,France,Netherlands,2022-06-23,False,0,0,2,2,0,0,0,0,4,4,2,10,0,1,1,2,3,1,9,13,1,2,0,3
137345.0,Ter Horst Thijs,OH,Netherlands,31.0,204.0,2022,Germany,Netherlands,2022-06-24,True,0,1,1,2,0,0,0,0,3,1,2,6,2,0,0,2,0,0,7,7,1,0,0,1
137345.0,Ter Horst Thijs,OH,Netherlands,31.0,204.0,2022,Argentina,Netherlands,2022-06-25,True,0,0,0,0,0,0,0,0,0,1,1,2,0,1,0,1,0,1,0,1,0,0,0,0
137345.0,Ter Horst Thijs,OH,Netherlands,31.0,204.0,2022,Netherlands,China,2022-07-06,True,2,2,7,11,0,0,0,0,10,2,4,16,2,0,0,2,2,0,17,19,4,0,0,4
137345.0,Ter Horst Thijs,OH,Netherlands,31.0,204.0,2022,Poland,Netherlands,2022-07-09,False,0,1,4,5,0,0,0,0,3,0,2,5,0,0,0,0,1,0,3,4,1,0,0,1
137345.0,Ter Horst Thijs,OH,Netherlands,31.0,204.0,2022,Italy,Netherlands,2022-07-10,False,1,2,8,11,0,0,0,0,8,2,6,16,1,1,0,2,4,2,16,22,3,0,0,3
137345.0,Ter Horst Thijs,OH,Netherlands,31.0,204.0,2022,Italy,Netherlands,2022-07-20,False,0,2,1,3,0,1,1,2,3,4,3,10,0,1,0,1,5,1,1,7,2,0,0,2
169921.0,van Der Ent Cornelis Luuc,MB,Netherlands,24.0,208.0,2022,Japan,Netherlands,2022-06-08,False,1,1,9,11,0,0,0,0,0,1,3,4,2,6,4,12,0,0,1,1,1,0,0,1
169921.0,van Der Ent Cornelis Luuc,MB,Netherlands,24.0,208.0,2022,Netherlands,USA,2022-06-09,False,0,0,0,0,0,0,0,0,0,0,0,0,0,0,0,0,0,0,0,0,0,0,0,0
169921.0,van Der Ent Cornelis Luuc,MB,Netherlands,24.0,208.0,2022,Netherlands,Iran,2022-06-10,True,0,0,0,0,0,0,0,0,0,0,0,0,1,0,0,1,0,0,0,0,0,0,0,0
169921.0,van Der Ent Cornelis Luuc,MB,Netherlands,24.0,208.0,2022,Netherlands,Australia,2022-06-12,True,1,0,3,4,0,0,0,0,0,0,1,1,0,3,3,6,1,0,0,1,0,0,0,0
169921.0,van Der Ent Cornelis Luuc,MB,Netherlands,24.0,208.0,2022,Slovenia,Netherlands,2022-06-21,True,1,0,12,13,0,0,0,0,2,0,2,4,0,2,1,3,1,0,1,2,2,0,0,2
169921.0,van Der Ent Cornelis Luuc,MB,Netherlands,24.0,208.0,2022,France,Netherlands,2022-06-23,False,0,0,0,0,0,0,0,0,0,0,0,0,0,0,0,0,0,0,0,0,0,0,0,0
169921.0,van Der Ent Cornelis Luuc,MB,Netherlands,24.0,208.0,2022,Germany,Netherlands,2022-06-24,True,0,0,3,3,0,0,0,0,0,0,0,0,2,3,1,6,0,0,0,0,0,1,0,1
169921.0,van Der Ent Cornelis Luuc,MB,Netherlands,24.0,208.0,2022,Argentina,Netherlands,2022-06-25,True,0,0,0,0,0,0,0,0,0,0,0,0,0,0,0,0,0,0,0,0,0,0,0,0
169921.0,van Der Ent Cornelis Luuc,MB,Netherlands,24.0,208.0,2022,Netherlands,China,2022-07-06,True,0,0,0,0,0,0,0,0,0,0,0,0,0,0,0,0,0,0,0,0,0,0,0,0
169921.0,van Der Ent Cornelis Luuc,MB,Netherlands,24.0,208.0,2022,Bulgaria,Netherlands,2022-07-08,False,0,0,1,1,0,0,0,0,0,0,0,0,0,0,0,0,0,1,0,1,0,0,0,0
169921.0,van Der Ent Cornelis Luuc,MB,Netherlands,24.0,208.0,2022,Poland,Netherlands,2022-07-09,False,0,0,2,2,0,0,0,0,0,0,0,0,0,1,0,1,0,0,0,0,0,0,0,0
169921.0,van Der Ent Cornelis Luuc,MB,Netherlands,24.0,208.0,2022,Italy,Netherlands,2022-07-10,False,0,1,6,7,0,0,0,0,1,0,3,4,0,1,0,1,0,0,3,3,0,1,0,1
169921.0,van Der Ent Cornelis Luuc,MB,Netherlands,24.0,208.0,2022,Italy,Netherlands,2022-07-20,False,0,0,0,0,0,0,0,0,0,0,0,0,0,0,0,0,0,0,0,0,0,0,0,0
131980.0,Jorna Gijs,OH,Netherlands,33.0,196.0,2022,Japan,Netherlands,2022-06-08,False,0,0,1,1,0,0,0,0,1,1,1,3,0,0,0,0,1,1,1,3,3,0,1,4
131980.0,Jorna Gijs,OH,Netherlands,33.0,196.0,2022,Netherlands,USA,2022-06-09,False,0,1,8,9,3,0,1,4,3,4,6,13,1,3,2,6,8,0,14,22,4,3,1,8
131980.0,Jorna Gijs,OH,Netherlands,33.0,196.0,2022,Netherlands,Iran,2022-06-10,True,0,0,2,2,0,0,0,0,0,0,0,0,0,0,0,0,0,0,2,2,0,0,0,0
131980.0,Jorna Gijs,OH,Netherlands,33.0,196.0,2022,Netherlands,Australia,2022-06-12,True,0,1,3,4,1,0,0,1,0,0,0,0,0,0,0,0,4,0,3,7,1,1,0,2
131980.0,Jorna Gijs,OH,Netherlands,33.0,196.0,2022,Slovenia,Netherlands,2022-06-21,True,0,0,3,3,0,0,0,0,0,0,1,1,0,0,0,0,3,0,4,7,1,0,0,1
131980.0,Jorna Gijs,OH,Netherlands,33.0,196.0,2022,France,Netherlands,2022-06-23,False,0,1,4,5,0,0,5,5,3,3,1,7,0,1,0,1,4,0,4,8,3,2,0,5
131980.0,Jorna Gijs,OH,Netherlands,33.0,196.0,2022,Germany,Netherlands,2022-06-24,True,0,2,19,21,1,0,7,8,10,3,10,23,1,4,3,8,9,0,14,23,16,2,0,18
131980.0,Jorna Gijs,OH,Netherlands,33.0,196.0,2022,Argentina,Netherlands,2022-06-25,True,1,3,16,20,0,0,2,2,10,5,9,24,1,0,0,1,7,1,27,35,18,4,1,23
131980.0,Jorna Gijs,OH,Netherlands,33.0,196.0,2022,Netherlands,China,2022-07-06,True,1,0,7,8,0,0,0,0,5,2,1,8,1,0,0,1,0,0,13,13,3,1,2,6
131980.0,Jorna Gijs,OH,Netherlands,33.0,196.0,2022,Bulgaria,Netherlands,2022-07-08,False,1,0,12,13,0,0,2,2,4,4,11,19,0,2,0,2,0,2,15,17,1,1,1,3
131980.0,Jorna Gijs,OH,Netherlands,33.0,196.0,2022,Poland,Netherlands,2022-07-09,False,0,0,2,2,0,0,0,0,0,0,0,0,0,0,0,0,0,0,4,4,0,0,0,0
131980.0,Jorna Gijs,OH,Netherlands,33.0,196.0,2022,Italy,Netherlands,2022-07-10,False,0,1,1,2,0,0,0,0,0,0,0,0,0,0,0,0,0,0,1,1,0,0,0,0
131980.0,Jorna Gijs,OH,Netherlands,33.0,196.0,2022,Italy,Netherlands,2022-07-20,False,1,1,5,7,0,0,0,0,3,0,3,6,0,1,0,1,5,1,4,10,3,1,1,5
156678.0,Plak Fabian,MB,Netherlands,25.0,198.0,2022,Japan,Netherlands,2022-06-08,False,1,2,13,16,0,0,1,1,6,0,4,10,2,4,5,11,1,0,1,2,2,0,1,3
156678.0,Plak Fabian,MB,Netherlands,25.0,198.0,2022,Netherlands,USA,2022-06-09,False,0,0,0,0,0,0,0,0,0,0,0,0,0,0,0,0,0,0,0,0,0,0,0,0
156678.0,Plak Fabian,MB,Netherlands,25.0,198.0,2022,Netherlands,Iran,2022-06-10,True,0,4,9,13,0,1,0,1,8,1,2,11,3,5,2,10,0,1,0,1,5,1,1,7
156678.0,Plak Fabian,MB,Netherlands,25.0,198.0,2022,Netherlands,Australia,2022-06-12,True,0,2,11,13,0,0,0,0,10,0,1,11,0,3,4,7,0,0,0,0,2,0,0,2
156678.0,Plak Fabian,MB,Netherlands,25.0,198.0,2022,Slovenia,Netherlands,2022-06-21,True,0,0,0,0,0,0,0,0,1,0,0,1,0,1,0,1,0,0,0,0,0,0,0,0
156678.0,Plak Fabian,MB,Netherlands,25.0,198.0,2022,France,Netherlands,2022-06-23,False,0,2,4,6,1,0,1,2,3,0,1,4,0,5,3,8,0,0,1,1,0,0,0,0
156678.0,Plak Fabian,MB,Netherlands,25.0,198.0,2022,Germany,Netherlands,2022-06-24,True,1,4,8,13,0,0,1,1,5,0,4,9,2,5,5,12,0,0,0,0,7,0,0,7
156678.0,Plak Fabian,MB,Netherlands,25.0,198.0,2022,Argentina,Netherlands,2022-06-25,True,5,4,10,19,1,0,3,4,5,1,4,10,4,4,5,13,0,0,2,2,1,0,0,1
156678.0,Plak Fabian,MB,Netherlands,25.0,198.0,2022,Netherlands,China,2022-07-06,True,0,3,9,12,0,0,0,0,4,0,1,5,5,4,1,10,0,0,0,0,2,0,0,2
156678.0,Plak Fabian,MB,Netherlands,25.0,198.0,2022,Bulgaria,Netherlands,2022-07-08,False,0,3,7,10,0,0,0,0,7,1,2,10,1,7,1,9,0,0,2,2,0,0,0,0
156678.0,Plak Fabian,MB,Netherlands,25.0,198.0,2022,Poland,Netherlands,2022-07-09,False,0,2,2,4,0,0,1,1,2,1,4,7,0,4,0,4,0,1,0,1,0,0,1,1
156678.0,Plak Fabian,MB,Netherlands,25.0,198.0,2022,Italy,Netherlands,2022-07-10,False,1,0,1,2,0,0,0,0,1,0,1,2,0,1,0,1,0,0,0,0,0,0,0,0
156678.0,Plak Fabian,MB,Netherlands,25.0,198.0,2022,Italy,Netherlands,2022-07-20,False,1,2,11,14,0,0,2,2,5,2,1,8,2,5,4,11,0,0,3,3,2,0,0,2
176460.0,Ottevanger Steven,L,Netherlands,28.0,183.0,2022,Japan,Netherlands,2022-06-08,False,0,0,0,0,0,0,0,0,0,0,0,0,0,0,0,0,0,0,0,0,0,0,0,0
176460.0,Ottevanger Steven,L,Netherlands,28.0,183.0,2022,Netherlands,USA,2022-06-09,False,0,0,0,0,0,0,0,0,0,0,0,0,0,0,0,0,0,0,0,0,0,0,0,0
176460.0,Ottevanger Steven,L,Netherlands,28.0,183.0,2022,Netherlands,Iran,2022-06-10,True,0,0,0,0,0,0,0,0,0,0,0,0,0,0,0,0,0,0,0,0,0,0,0,0
176460.0,Ottevanger Steven,L,Netherlands,28.0,183.0,2022,Netherlands,Australia,2022-06-12,True,0,0,0,0,0,0,0,0,0,0,0,0,0,0,0,0,0,0,0,0,0,0,0,0
176460.0,Ottevanger Steven,L,Netherlands,28.0,183.0,2022,Slovenia,Netherlands,2022-06-21,True,0,0,0,0,0,0,0,0,0,0,0,0,0,0,0,0,0,0,0,0,0,0,0,0
176460.0,Ottevanger Steven,L,Netherlands,28.0,183.0,2022,France,Netherlands,2022-06-23,False,0,0,0,0,0,0,0,0,0,0,0,0,0,0,0,0,0,0,0,0,0,0,0,0
176460.0,Ottevanger Steven,L,Netherlands,28.0,183.0,2022,Germany,Netherlands,2022-06-24,True,0,0,0,0,0,0,0,0,0,0,0,0,0,0,0,0,0,0,0,0,0,0,0,0
176460.0,Ottevanger Steven,L,Netherlands,28.0,183.0,2022,Argentina,Netherlands,2022-06-25,True,0,0,0,0,0,0,0,0,0,0,0,0,0,0,0,0,0,0,0,0,0,0,0,0
169923.0,van Tilburg Stijn,O,Netherlands,26.0,203.0,2022,Japan,Netherlands,2022-06-08,False,0,0,1,1,0,0,0,0,0,0,0,0,0,0,0,0,0,0,0,0,1,0,0,1
169923.0,van Tilburg Stijn,O,Netherlands,26.0,203.0,2022,Netherlands,USA,2022-06-09,False,0,1,8,9,0,0,0,0,6,5,10,21,1,2,0,3,0,0,0,0,2,0,0,2
169923.0,van Tilburg Stijn,O,Netherlands,26.0,203.0,2022,Netherlands,Iran,2022-06-10,True,0,0,0,0,0,0,0,0,0,0,0,0,0,0,0,0,0,0,0,0,0,0,0,0
169923.0,van Tilburg Stijn,O,Netherlands,26.0,203.0,2022,Netherlands,Australia,2022-06-12,True,0,0,0,0,0,0,0,0,0,0,0,0,0,0,0,0,0,0,0,0,0,0,0,0
169923.0,van Tilburg Stijn,O,Netherlands,26.0,203.0,2022,Slovenia,Netherlands,2022-06-21,True,0,0,0,0,0,0,0,0,0,0,0,0,0,0,0,0,0,0,0,0,0,0,0,0
169923.0,van Tilburg Stijn,O,Netherlands,26.0,203.0,2022,France,Netherlands,2022-06-23,False,0,1,2,3,0,0,1,1,3,1,1,5,0,0,1,1,0,0,0,0,0,0,0,0
169923.0,van Tilburg Stijn,O,Netherlands,26.0,203.0,2022,Germany,Netherlands,2022-06-24,True,0,0,1,1,0,0,2,2,0,0,0,0,0,0,0,0,0,0,0,0,0,0,0,0
169923.0,van Tilburg Stijn,O,Netherlands,26.0,203.0,2022,Argentina,Netherlands,2022-06-25,True,0,1,0,1,0,0,0,0,7,2,2,11,0,2,2,4,0,0,0,0,1,1,0,2
169923.0,van Tilburg Stijn,O,Netherlands,26.0,203.0,2022,Netherlands,China,2022-07-06,True,0,0,0,0,0,0,0,0,0,0,0,0,0,0,0,0,0,0,0,0,0,0,0,0
169923.0,van Tilburg Stijn,O,Netherlands,26.0,203.0,2022,Bulgaria,Netherlands,2022-07-08,False,0,0,0,0,0,0,0,0,0,0,0,0,0,0,0,0,0,0,0,0,0,0,0,0
169923.0,van Tilburg Stijn,O,Netherlands,26.0,203.0,2022,Poland,Netherlands,2022-07-09,False,0,0,0,0,0,0,0,0,0,0,0,0,0,0,0,0,0,0,0,0,0,0,0,0
169923.0,van Tilburg Stijn,O,Netherlands,26.0,203.0,2022,Italy,Netherlands,2022-07-10,False,0,0,0,0,0,0,0,0,0,0,0,0,0,0,0,0,0,0,0,0,0,0,0,0
169923.0,van Tilburg Stijn,O,Netherlands,26.0,203.0,2022,Italy,Netherlands,2022-07-20,False,0,0,0,0,0,0,1,1,2,0,1,3,0,0,0,0,0,0,0,0,0,0,0,0
170436.0,Tuinstra Bennie Junior,OH,Netherlands,22.0,200.0,2022,Japan,Netherlands,2022-06-08,False,0,0,12,12,2,0,1,3,10,4,9,23,1,2,2,5,9,3,24,36,7,2,0,9
170436.0,Tuinstra Bennie Junior,OH,Netherlands,22.0,200.0,2022,Netherlands,USA,2022-06-09,False,0,1,0,1,1,0,0,1,2,0,1,3,0,1,0,1,0,0,0,0,0,0,0,0
170436.0,Tuinstra Bennie Junior,OH,Netherlands,22.0,200.0,2022,Netherlands,Iran,2022-06-10,True,0,5,10,15,1,0,0,1,7,2,4,13,1,3,1,5,4,2,13,19,6,0,0,6
170436.0,Tuinstra Bennie Junior,OH,Netherlands,22.0,200.0,2022,Netherlands,Australia,2022-06-12,True,1,1,4,6,1,0,1,2,4,2,3,9,0,2,0,2,1,0,6,7,2,0,1,3
170436.0,Tuinstra Bennie Junior,OH,Netherlands,22.0,200.0,2022,Slovenia,Netherlands,2022-06-21,True,2,2,10,14,0,0,3,3,10,4,4,18,1,3,2,6,2,0,10,12,6,2,0,8
170436.0,Tuinstra Bennie Junior,OH,Netherlands,22.0,200.0,2022,France,Netherlands,2022-06-23,False,3,2,6,11,1,0,0,1,7,3,9,19,1,1,1,3,10,2,15,27,3,1,0,4
170436.0,Tuinstra Bennie Junior,OH,Netherlands,22.0,200.0,2022,Germany,Netherlands,2022-06-24,True,1,4,9,14,0,0,0,0,8,4,17,29,1,3,3,7,2,1,16,19,7,1,3,11
170436.0,Tuinstra Bennie Junior,OH,Netherlands,22.0,200.0,2022,Argentina,Netherlands,2022-06-25,True,0,4,16,20,0,0,3,3,17,1,13,31,1,5,2,8,5,1,18,24,4,1,1,6
170436.0,Tuinstra Bennie Junior,OH,Netherlands,22.0,200.0,2022,Netherlands,China,2022-07-06,True,0,1,2,3,0,0,1,1,0,2,4,6,0,0,0,0,3,0,5,8,0,0,0,0
170436.0,Tuinstra Bennie Junior,OH,Netherlands,22.0,200.0,2022,Bulgaria,Netherlands,2022-07-08,False,2,1,6,9,0,0,6,6,6,2,5,13,0,0,0,0,1,1,14,16,2,0,1,3
170436.0,Tuinstra Bennie Junior,OH,Netherlands,22.0,200.0,2022,Poland,Netherlands,2022-07-09,False,1,2,6,9,0,0,2,2,7,3,5,15,0,4,0,4,1,2,15,18,1,1,0,2
170436.0,Tuinstra Bennie Junior,OH,Netherlands,22.0,200.0,2022,Italy,Netherlands,2022-07-10,False,1,4,10,15,0,0,0,0,5,1,9,15,2,1,0,3,0,1,17,18,2,0,1,3
170436.0,Tuinstra Bennie Junior,OH,Netherlands,22.0,200.0,2022,Italy,Netherlands,2022-07-20,False,4,4,9,17,0,0,3,3,16,4,11,31,0,1,1,2,13,2,14,29,8,1,0,9
184896.0,Bleeker Mats,L,Netherlands,24.0,180.0,2022,Netherlands,China,2022-07-06,True,0,0,0,0,0,0,0,0,0,0,0,0,0,0,0,0,0,0,0,0,0,0,0,0
184896.0,Bleeker Mats,L,Netherlands,24.0,180.0,2022,Bulgaria,Netherlands,2022-07-08,False,0,0,0,0,0,0,0,0,0,0,0,0,0,0,0,0,0,0,0,0,0,0,0,0
184896.0,Bleeker Mats,L,Netherlands,24.0,180.0,2022,Poland,Netherlands,2022-07-09,False,0,0,0,0,0,0,0,0,0,0,0,0,0,0,0,0,0,0,0,0,0,0,0,0
184896.0,Bleeker Mats,L,Netherlands,24.0,180.0,2022,Italy,Netherlands,2022-07-10,False,0,0,0,0,0,0,0,0,0,0,0,0,0,0,0,0,0,0,0,0,0,0,0,0
184896.0,Bleeker Mats,L,Netherlands,24.0,180.0,2022,Italy,Netherlands,2022-07-20,False,0,0,0,0,0,0,0,0,0,0,0,0,0,0,0,0,0,0,0,0,0,0,0,0
137498.0,Abdel-Aziz Nimir,O,Netherlands,31.0,201.0,2022,Japan,Netherlands,2022-06-08,False,1,7,10,18,1,0,3,4,17,6,8,31,0,2,3,5,0,0,1,1,4,1,2,7
137498.0,Abdel-Aziz Nimir,O,Netherlands,31.0,201.0,2022,Netherlands,USA,2022-06-09,False,0,0,0,0,0,0,0,0,0,0,0,0,0,0,0,0,0,0,0,0,0,0,0,0
137498.0,Abdel-Aziz Nimir,O,Netherlands,31.0,201.0,2022,Netherlands,Iran,2022-06-10,True,2,5,8,15,0,0,0,0,17,1,10,28,1,1,2,4,0,0,1,1,2,2,0,4
137498.0,Abdel-Aziz Nimir,O,Netherlands,31.0,201.0,2022,Netherlands,Australia,2022-06-12,True,5,6,7,18,1,0,0,1,14,2,8,24,1,3,1,5,0,0,0,0,2,2,0,4
137498.0,Abdel-Aziz Nimir,O,Netherlands,31.0,201.0,2022,Slovenia,Netherlands,2022-06-21,True,3,5,3,11,1,0,2,3,15,6,13,34,0,3,4,7,0,0,0,0,6,2,1,9
137498.0,Abdel-Aziz Nimir,O,Netherlands,31.0,201.0,2022,France,Netherlands,2022-06-23,False,1,5,2,8,1,0,1,2,10,4,8,22,0,2,1,3,1,0,1,2,0,4,0,4
137498.0,Abdel-Aziz Nimir,O,Netherlands,31.0,201.0,2022,Germany,Netherlands,2022-06-24,True,3,5,9,17,0,0,1,1,25,5,23,53,3,0,6,9,0,0,2,2,7,5,0,12
137498.0,Abdel-Aziz Nimir,O,Netherlands,31.0,201.0,2022,Argentina,Netherlands,2022-06-25,True,2,5,6,13,0,0,4,4,21,8,13,42,1,2,1,4,0,0,0,0,3,2,0,5
137498.0,Abdel-Aziz Nimir,O,Netherlands,31.0,201.0,2022,Netherlands,China,2022-07-06,True,6,3,7,16,0,0,0,0,21,2,11,34,3,2,0,5,0,0,2,2,0,0,0,0
137498.0,Abdel-Aziz Nimir,O,Netherlands,31.0,201.0,2022,Bulgaria,Netherlands,2022-07-08,False,2,5,11,18,0,1,2,3,22,10,14,46,1,2,0,3,0,0,2,2,5,0,1,6
137498.0,Abdel-Aziz Nimir,O,Netherlands,31.0,201.0,2022,Poland,Netherlands,2022-07-09,False,4,5,9,18,0,0,2,2,15,5,6,26,0,0,0,0,0,0,1,1,1,1,0,2
137498.0,Abdel-Aziz Nimir,O,Netherlands,31.0,201.0,2022,Italy,Netherlands,2022-07-10,False,1,4,7,12,0,0,0,0,14,4,11,29,0,4,0,4,0,0,2,2,0,0,0,0
137498.0,Abdel-Aziz Nimir,O,Netherlands,31.0,201.0,2022,Italy,Netherlands,2022-07-20,False,0,6,5,11,0,0,1,1,16,7,18,41,0,3,2,5,0,0,1,1,6,1,0,7
164837.0,van Solkema Gijs,S,Netherlands,24.0,193.0,2022,Japan,Netherlands,2022-06-08,False,0,0,0,0,0,2,13,15,0,0,0,0,0,0,0,0,0,0,0,0,0,0,0,0
164837.0,van Solkema Gijs,S,Netherlands,24.0,193.0,2022,Netherlands,USA,2022-06-09,False,0,0,3,3,15,4,37,56,0,0,1,1,1,0,3,4,0,0,0,0,2,1,0,3
164837.0,van Solkema Gijs,S,Netherlands,24.0,193.0,2022,Netherlands,Iran,2022-06-10,True,0,0,0,0,0,0,0,0,0,0,0,0,0,0,0,0,0,0,0,0,0,0,0,0
164837.0,van Solkema Gijs,S,Netherlands,24.0,193.0,2022,Netherlands,Australia,2022-06-12,True,0,0,0,0,0,0,0,0,0,0,0,0,0,0,0,0,0,0,0,0,0,0,0,0
164837.0,van Solkema Gijs,S,Netherlands,24.0,193.0,2022,Slovenia,Netherlands,2022-06-21,True,0,0,0,0,0,0,0,0,0,0,0,0,0,0,0,0,0,0,0,0,0,0,0,0
164837.0,van Solkema Gijs,S,Netherlands,24.0,193.0,2022,France,Netherlands,2022-06-23,False,0,0,0,0,3,0,8,11,0,0,0,0,0,0,0,0,0,0,0,0,1,0,0,1
164837.0,van Solkema Gijs,S,Netherlands,24.0,193.0,2022,Germany,Netherlands,2022-06-24,True,0,0,1,1,0,0,10,10,0,0,0,0,0,0,1,1,0,0,0,0,0,0,0,0
164837.0,van Solkema Gijs,S,Netherlands,24.0,193.0,2022,Argentina,Netherlands,2022-06-25,True,0,0,2,2,0,0,1,1,0,0,0,0,0,1,1,2,0,0,0,0,0,0,0,0
137337.0,Parkinson Michael,MB,Netherlands,31.0,203.0,2022,Japan,Netherlands,2022-06-08,False,0,1,2,3,0,0,0,0,0,0,0,0,0,0,1,1,0,0,0,0,0,0,0,0
137337.0,Parkinson Michael,MB,Netherlands,31.0,203.0,2022,Netherlands,USA,2022-06-09,False,0,1,9,10,1,0,0,1,2,1,3,6,1,2,3,6,1,0,1,2,2,0,0,2
137337.0,Parkinson Michael,MB,Netherlands,31.0,203.0,2022,Netherlands,Iran,2022-06-10,True,0,0,0,0,0,0,0,0,0,0,0,0,0,0,0,0,0,0,0,0,0,0,0,0
137337.0,Parkinson Michael,MB,Netherlands,31.0,203.0,2022,Netherlands,Australia,2022-06-12,True,0,0,0,0,0,0,0,0,0,0,0,0,0,0,0,0,0,0,0,0,0,0,0,0
137337.0,Parkinson Michael,MB,Netherlands,31.0,203.0,2022,Slovenia,Netherlands,2022-06-21,True,0,0,0,0,0,0,0,0,0,0,0,0,0,0,0,0,0,0,0,0,0,0,0,0
137337.0,Parkinson Michael,MB,Netherlands,31.0,203.0,2022,France,Netherlands,2022-06-23,False,1,0,2,3,0,0,0,0,0,2,1,3,0,1,1,2,0,0,1,1,0,0,0,0
137337.0,Parkinson Michael,MB,Netherlands,31.0,203.0,2022,Germany,Netherlands,2022-06-24,True,0,0,0,0,0,0,0,0,0,0,0,0,0,0,0,0,0,0,0,0,0,0,0,0
137337.0,Parkinson Michael,MB,Netherlands,31.0,203.0,2022,Argentina,Netherlands,2022-06-25,True,0,1,6,7,0,0,1,1,5,0,1,6,0,5,1,6,0,0,0,0,3,1,0,4
137337.0,Parkinson Michael,MB,Netherlands,31.0,203.0,2022,Netherlands,China,2022-07-06,True,0,0,0,0,0,0,0,0,0,0,0,0,0,0,0,0,0,0,0,0,0,0,0,0
137337.0,Parkinson Michael,MB,Netherlands,31.0,203.0,2022,Bulgaria,Netherlands,2022-07-08,False,1,0,5,6,0,1,2,3,6,0,0,6,1,5,0,6,0,0,2,2,0,0,0,0
137337.0,Parkinson Michael,MB,Netherlands,31.0,203.0,2022,Poland,Netherlands,2022-07-09,False,0,0,1,1,0,0,0,0,0,0,0,0,0,0,0,0,0,0,0,0,0,0,0,0
137337.0,Parkinson Michael,MB,Netherlands,31.0,203.0,2022,Italy,Netherlands,2022-07-10,False,0,0,0,0,0,0,0,0,0,0,0,0,0,0,0,0,0,0,0,0,0,0,0,0
137337.0,Parkinson Michael,MB,Netherlands,31.0,203.0,2022,Italy,Netherlands,2022-07-20,False,0,0,1,1,0,0,0,0,0,0,0,0,0,0,0,0,0,0,0,0,0,0,0,0
121992.0,Andringa Robbert,L,Netherlands,32.0,192.0,2022,Japan,Netherlands,2022-06-08,False,0,0,0,0,2,0,2,4,0,0,0,0,0,0,0,0,3,1,9,13,6,0,0,6
121992.0,Andringa Robbert,L,Netherlands,32.0,192.0,2022,Netherlands,USA,2022-06-09,False,0,0,0,0,3,0,0,3,0,0,0,0,0,0,0,0,2,3,9,14,2,4,0,6
121992.0,Andringa Robbert,L,Netherlands,32.0,192.0,2022,Netherlands,Iran,2022-06-10,True,0,0,0,0,1,0,1,2,0,0,0,0,0,0,0,0,6,1,17,24,6,1,1,8
121992.0,Andringa Robbert,L,Netherlands,32.0,192.0,2022,Netherlands,Australia,2022-06-12,True,0,0,0,0,0,0,0,0,0,0,0,0,0,0,0,0,2,0,6,8,6,1,0,7
121992.0,Andringa Robbert,L,Netherlands,32.0,192.0,2022,Slovenia,Netherlands,2022-06-21,True,0,0,0,0,0,0,4,4,0,0,0,0,0,0,0,0,3,0,7,10,7,2,1,10
121992.0,Andringa Robbert,L,Netherlands,32.0,192.0,2022,France,Netherlands,2022-06-23,False,0,0,0,0,0,0,3,3,0,0,0,0,0,0,0,0,2,1,4,7,8,2,0,10
121992.0,Andringa Robbert,L,Netherlands,32.0,192.0,2022,Germany,Netherlands,2022-06-24,True,0,0,0,0,0,0,4,4,0,0,0,0,0,0,0,0,6,0,16,22,8,6,3,17
121992.0,Andringa Robbert,L,Netherlands,32.0,192.0,2022,Argentina,Netherlands,2022-06-25,True,0,0,0,0,0,0,6,6,0,0,0,0,0,0,0,0,9,1,15,25,10,3,0,13
121992.0,Andringa Robbert,L,Netherlands,32.0,192.0,2022,Netherlands,China,2022-07-06,True,0,0,0,0,0,0,0,0,0,0,0,0,0,0,0,0,0,0,5,5,1,2,1,4
121992.0,Andringa Robbert,L,Netherlands,32.0,192.0,2022,Bulgaria,Netherlands,2022-07-08,False,0,0,0,0,0,0,0,0,0,0,0,0,0,0,0,0,15,0,10,25,9,4,2,15
121992.0,Andringa Robbert,L,Netherlands,32.0,192.0,2022,Poland,Netherlands,2022-07-09,False,0,0,0,0,0,0,3,3,0,0,0,0,0,0,0,0,1,0,20,21,4,1,1,6
121992.0,Andringa Robbert,L,Netherlands,32.0,192.0,2022,Italy,Netherlands,2022-07-10,False,0,0,0,0,0,0,0,0,0,0,0,0,0,0,0,0,2,1,10,13,5,3,1,9
121992.0,Andringa Robbert,L,Netherlands,32.0,192.0,2022,Italy,Netherlands,2022-07-20,False,0,0,0,0,1,0,5,6,0,0,0,0,0,0,0,0,9,2,16,27,4,3,0,7
162642.0,de Weijer Freek,S,Netherlands,27.0,191.0,2022,Netherlands,China,2022-07-06,True,0,0,0,0,0,0,0,0,0,0,0,0,0,0,0,0,0,0,0,0,0,0,0,0
162642.0,de Weijer Freek,S,Netherlands,27.0,191.0,2022,Bulgaria,Netherlands,2022-07-08,False,0,2,1,3,7,0,11,18,0,0,0,0,0,2,0,2,0,0,0,0,0,0,0,0
162642.0,de Weijer Freek,S,Netherlands,27.0,191.0,2022,Poland,Netherlands,2022-07-09,False,0,0,0,0,0,0,2,2,0,0,0,0,0,0,0,0,0,0,0,0,0,0,0,0
162642.0,de Weijer Freek,S,Netherlands,27.0,191.0,2022,Italy,Netherlands,2022-07-10,False,0,0,0,0,0,0,0,0,0,0,0,0,0,0,0,0,0,0,0,0,0,0,0,0
162642.0,de Weijer Freek,S,Netherlands,27.0,191.0,2022,Italy,Netherlands,2022-07-20,False,0,0,0,0,1,0,7,8,0,0,0,0,0,0,0,0,0,0,0,0,0,1,0,1
150703.0,Wiltenburg Twan,MB,Netherlands,26.0,205.0,2022,Japan,Netherlands,2022-06-08,False,0,0,2,2,0,0,0,0,0,0,0,0,0,0,0,0,0,0,0,0,0,1,0,1
150703.0,Wiltenburg Twan,MB,Netherlands,26.0,205.0,2022,Netherlands,USA,2022-06-09,False,0,1,5,6,0,0,0,0,2,0,2,4,1,1,1,3,0,0,2,2,0,0,0,0
150703.0,Wiltenburg Twan,MB,Netherlands,26.0,205.0,2022,Netherlands,Iran,2022-06-10,True,0,0,10,10,0,0,1,1,2,0,1,3,2,2,3,7,0,0,0,0,0,2,0,2
150703.0,Wiltenburg Twan,MB,Netherlands,26.0,205.0,2022,Netherlands,Australia,2022-06-12,True,1,0,9,10,0,0,0,0,3,0,1,4,1,2,0,3,0,0,0,0,0,1,1,2
150703.0,Wiltenburg Twan,MB,Netherlands,26.0,205.0,2022,Slovenia,Netherlands,2022-06-21,True,1,1,8,10,0,0,1,1,1,2,1,4,2,3,10,15,0,0,1,1,1,3,0,4
150703.0,Wiltenburg Twan,MB,Netherlands,26.0,205.0,2022,France,Netherlands,2022-06-23,False,0,0,7,7,0,0,0,0,0,2,2,4,0,4,4,8,0,0,0,0,1,0,0,1
150703.0,Wiltenburg Twan,MB,Netherlands,26.0,205.0,2022,Germany,Netherlands,2022-06-24,True,0,4,12,16,0,1,0,1,4,0,0,4,4,4,15,23,0,0,1,1,4,0,0,4
150703.0,Wiltenburg Twan,MB,Netherlands,26.0,205.0,2022,Argentina,Netherlands,2022-06-25,True,0,2,4,6,0,0,1,1,0,0,0,0,0,0,0,0,0,0,0,0,0,0,0,0
150703.0,Wiltenburg Twan,MB,Netherlands,26.0,205.0,2022,Netherlands,China,2022-07-06,True,1,1,9,11,0,0,0,0,2,0,2,4,2,3,0,5,0,0,0,0,1,0,0,1
150703.0,Wiltenburg Twan,MB,Netherlands,26.0,205.0,2022,Bulgaria,Netherlands,2022-07-08,False,0,0,5,5,0,0,0,0,2,2,1,5,0,3,0,3,0,0,2,2,1,0,0,1
150703.0,Wiltenburg Twan,MB,Netherlands,26.0,205.0,2022,Poland,Netherlands,2022-07-09,False,0,2,6,8,0,0,0,0,0,0,1,1,4,3,0,7,0,0,0,0,0,2,0,2
150703.0,Wiltenburg Twan,MB,Netherlands,26.0,205.0,2022,Italy,Netherlands,2022-07-10,False,1,2,8,11,0,1,1,2,2,1,0,3,2,6,0,8,0,0,2,2,0,0,0,0
150703.0,Wiltenburg Twan,MB,Netherlands,26.0,205.0,2022,Italy,Netherlands,2022-07-20,False,0,1,7,8,0,0,1,1,2,2,2,6,1,2,3,6,0,0,1,1,1,0,1,2
153394.0,Lipinski Bartlomiej,OH,Poland,26.0,201.0,2022,Poland,Argentina,2022-06-08,True,0,0,0,0,0,0,0,0,0,0,0,0,0,0,0,0,0,0,0,0,0,0,0,0
153394.0,Lipinski Bartlomiej,OH,Poland,26.0,201.0,2022,Poland,Italy,2022-06-09,False,0,0,0,0,0,0,0,0,0,0,0,0,0,0,0,0,0,0,0,0,0,0,0,0
153394.0,Lipinski Bartlomiej,OH,Poland,26.0,201.0,2022,Bulgaria,Poland,2022-06-11,True,1,3,9,13,0,0,1,1,11,4,12,27,0,3,2,5,3,0,12,15,7,2,3,12
153394.0,Lipinski Bartlomiej,OH,Poland,26.0,201.0,2022,France,Poland,2022-06-12,True,0,0,1,1,0,0,0,0,0,1,0,1,0,0,0,0,0,0,0,0,0,0,0,0
156531.0,Muzaj Maciej,O,Poland,28.0,208.0,2022,Poland,Argentina,2022-06-08,True,0,2,9,11,0,1,1,2,9,6,9,24,1,0,2,3,0,0,0,0,3,1,1,5
156531.0,Muzaj Maciej,O,Poland,28.0,208.0,2022,Poland,Italy,2022-06-09,False,0,0,0,0,0,0,0,0,0,0,1,1,0,1,0,1,0,0,0,0,0,0,0,0
156531.0,Muzaj Maciej,O,Poland,28.0,208.0,2022,Bulgaria,Poland,2022-06-11,True,0,4,7,11,0,0,1,1,12,1,4,17,1,3,3,7,0,0,0,0,4,4,1,9
156531.0,Muzaj Maciej,O,Poland,28.0,208.0,2022,France,Poland,2022-06-12,True,0,0,0,0,0,0,0,0,0,0,0,0,0,0,0,0,0,0,0,0,0,0,0,0
153388.0,Popiwczak Jakub,L,Poland,26.0,180.0,2022,Poland,Argentina,2022-06-08,True,0,0,0,0,0,0,7,7,0,0,0,0,0,0,0,0,7,0,5,12,10,2,2,14
153388.0,Popiwczak Jakub,L,Poland,26.0,180.0,2022,Poland,Italy,2022-06-09,False,0,0,0,0,0,0,3,3,0,0,0,0,0,0,0,0,3,2,16,21,1,3,3,7
153388.0,Popiwczak Jakub,L,Poland,26.0,180.0,2022,Bulgaria,Poland,2022-06-11,True,0,0,0,0,0,0,0,0,0,0,0,0,0,0,0,0,0,0,0,0,0,0,1,1
153388.0,Popiwczak Jakub,L,Poland,26.0,180.0,2022,France,Poland,2022-06-12,True,0,0,0,0,0,0,3,3,0,0,0,0,0,0,0,0,2,3,15,20,8,4,0,12
153388.0,Popiwczak Jakub,L,Poland,26.0,180.0,2022,Brazil,Poland,2022-06-22,True,0,0,0,0,0,0,0,0,0,0,0,0,0,0,0,0,0,0,0,0,0,0,0,0
153388.0,Popiwczak Jakub,L,Poland,26.0,180.0,2022,Poland,Canada,2022-06-23,True,0,0,0,0,0,0,2,2,0,0,0,0,0,0,0,0,0,2,7,9,3,0,0,3
153388.0,Popiwczak Jakub,L,Poland,26.0,180.0,2022,Poland,Australia,2022-06-25,True,0,0,0,0,0,0,0,0,0,0,0,0,0,0,0,0,0,0,0,0,0,0,0,0
153388.0,Popiwczak Jakub,L,Poland,26.0,180.0,2022,USA,Poland,2022-06-26,True,0,0,0,0,0,0,0,0,0,0,0,0,0,0,0,0,5,3,7,15,2,3,0,5
153388.0,Popiwczak Jakub,L,Poland,26.0,180.0,2022,Iran,Poland,2022-07-05,False,0,0,0,0,0,0,0,0,0,0,0,0,0,0,0,0,0,0,0,0,0,1,0,1
153388.0,Popiwczak Jakub,L,Poland,26.0,180.0,2022,Poland,China,2022-07-07,True,0,0,0,0,0,0,2,2,0,0,0,0,0,0,0,0,5,0,10,15,4,0,0,4
153388.0,Popiwczak Jakub,L,Poland,26.0,180.0,2022,Poland,Netherlands,2022-07-09,True,0,0,0,0,0,0,0,0,0,0,0,0,0,0,0,0,0,0,0,0,0,0,0,0
153388.0,Popiwczak Jakub,L,Poland,26.0,180.0,2022,Poland,Slovenia,2022-07-10,True,0,0,0,0,0,0,0,0,0,0,0,0,0,0,0,0,0,0,0,0,0,0,0,0
153388.0,Popiwczak Jakub,L,Poland,26.0,180.0,2022,Poland,Iran,2022-07-21,True,0,0,0,0,0,0,0,0,0,0,0,0,0,0,0,0,0,0,0,0,0,0,0,0
153388.0,Popiwczak Jakub,L,Poland,26.0,180.0,2022,Poland,USA,2022-07-23,False,0,0,0,0,0,0,0,0,0,0,0,0,0,0,0,0,0,0,0,0,0,0,0,0
153388.0,Popiwczak Jakub,L,Poland,26.0,180.0,2022,Italy,Poland,2022-07-24,True,0,0,0,0,0,0,0,0,0,0,0,0,0,0,0,0,0,0,0,0,0,0,0,0
152872.0,Kozub Lukasz,S,Poland,25.0,186.0,2022,Poland,Argentina,2022-06-08,True,0,0,0,0,0,0,0,0,0,0,0,0,0,0,0,0,0,0,0,0,0,0,0,0
152872.0,Kozub Lukasz,S,Poland,25.0,186.0,2022,Poland,Italy,2022-06-09,False,0,0,0,0,1,0,0,1,0,0,0,0,0,0,0,0,0,0,0,0,0,0,1,1
152872.0,Kozub Lukasz,S,Poland,25.0,186.0,2022,Bulgaria,Poland,2022-06-11,True,0,0,7,7,39,0,32,71,1,0,0,1,1,1,3,5,0,0,1,1,1,0,4,5
152872.0,Kozub Lukasz,S,Poland,25.0,186.0,2022,France,Poland,2022-06-12,True,0,0,0,0,0,0,0,0,0,0,0,0,0,0,0,0,0,0,0,0,0,0,0,0
162105.0,Kaczmarek Lukasz,O,Poland,28.0,204.0,2022,Brazil,Poland,2022-06-22,True,0,0,1,1,0,0,2,2,2,2,3,7,0,0,1,1,0,0,0,0,0,0,0,0
162105.0,Kaczmarek Lukasz,O,Poland,28.0,204.0,2022,Poland,Canada,2022-06-23,True,0,1,13,14,0,0,1,1,12,1,4,17,1,0,0,1,0,0,0,0,2,1,1,4
162105.0,Kaczmarek Lukasz,O,Poland,28.0,204.0,2022,Poland,Australia,2022-06-25,True,1,1,12,14,0,0,1,1,7,4,6,17,0,2,3,5,0,0,0,0,2,1,0,3
162105.0,Kaczmarek Lukasz,O,Poland,28.0,204.0,2022,USA,Poland,2022-06-26,True,0,1,0,1,0,0,0,0,0,0,0,0,0,0,0,0,0,0,0,0,0,0,0,0
162105.0,Kaczmarek Lukasz,O,Poland,28.0,204.0,2022,Iran,Poland,2022-07-05,False,0,0,1,1,0,0,0,0,1,0,1,2,0,0,0,0,0,0,0,0,0,0,0,0
162105.0,Kaczmarek Lukasz,O,Poland,28.0,204.0,2022,Poland,China,2022-07-07,True,2,2,10,14,0,0,0,0,7,4,5,16,1,1,0,2,0,0,0,0,2,1,0,3
162105.0,Kaczmarek Lukasz,O,Poland,28.0,204.0,2022,Poland,Netherlands,2022-07-09,True,0,0,1,1,0,0,0,0,0,0,0,0,0,0,0,0,0,0,0,0,0,0,0,0
162105.0,Kaczmarek Lukasz,O,Poland,28.0,204.0,2022,Poland,Slovenia,2022-07-10,True,0,0,3,3,0,0,0,0,0,1,1,2,1,0,0,1,0,0,0,0,1,0,0,1
162105.0,Kaczmarek Lukasz,O,Poland,28.0,204.0,2022,Poland,Iran,2022-07-21,True,0,1,2,3,0,0,0,0,3,0,3,6,0,0,0,0,0,0,0,0,0,0,0,0
162105.0,Kaczmarek Lukasz,O,Poland,28.0,204.0,2022,Poland,USA,2022-07-23,False,0,0,0,0,0,0,0,0,1,0,0,1,0,2,0,2,0,0,0,0,0,0,0,0
162105.0,Kaczmarek Lukasz,O,Poland,28.0,204.0,2022,Italy,Poland,2022-07-24,True,0,0,0,0,0,0,0,0,0,0,0,0,0,0,0,0,0,0,0,0,0,0,0,0
115806.0,Kurek Bartosz,O,Poland,34.0,205.0,2022,Brazil,Poland,2022-06-22,True,0,6,9,15,0,0,3,3,16,7,17,40,1,1,2,4,0,0,0,0,1,0,2,3
115806.0,Kurek Bartosz,O,Poland,34.0,205.0,2022,Poland,Canada,2022-06-23,True,0,0,2,2,0,0,0,0,1,0,0,1,0,0,0,0,0,0,0,0,0,0,0,0
115806.0,Kurek Bartosz,O,Poland,34.0,205.0,2022,Poland,Australia,2022-06-25,True,0,0,1,1,0,0,0,0,5,0,1,6,0,0,1,1,0,0,0,0,0,1,0,1
115806.0,Kurek Bartosz,O,Poland,34.0,205.0,2022,USA,Poland,2022-06-26,True,0,3,16,19,0,0,2,2,21,5,2,28,2,1,1,4,1,0,1,2,2,1,2,5
115806.0,Kurek Bartosz,O,Poland,34.0,205.0,2022,Iran,Poland,2022-07-05,False,2,3,13,18,0,0,0,0,19,4,11,34,2,2,0,4,0,0,1,1,1,4,1,6
115806.0,Kurek Bartosz,O,Poland,34.0,205.0,2022,Poland,China,2022-07-07,True,0,0,0,0,0,0,0,0,0,0,0,0,0,0,0,0,0,0,0,0,0,0,0,0
115806.0,Kurek Bartosz,O,Poland,34.0,205.0,2022,Poland,Netherlands,2022-07-09,True,1,0,2,3,0,0,1,1,2,0,1,3,0,1,0,1,0,0,0,0,0,0,0,0
115806.0,Kurek Bartosz,O,Poland,34.0,205.0,2022,Poland,Slovenia,2022-07-10,True,5,6,8,19,0,0,0,0,14,3,8,25,4,1,0,5,0,0,0,0,2,0,0,2
115806.0,Kurek Bartosz,O,Poland,34.0,205.0,2022,Poland,Iran,2022-07-21,True,1,6,6,13,0,0,2,2,13,5,10,28,1,1,5,7,0,0,0,0,1,5,0,6
115806.0,Kurek Bartosz,O,Poland,34.0,205.0,2022,Poland,USA,2022-07-23,False,1,3,7,11,0,0,1,1,10,3,11,24,0,1,1,2,0,0,0,0,2,4,0,6
115806.0,Kurek Bartosz,O,Poland,34.0,205.0,2022,Italy,Poland,2022-07-24,True,3,4,7,14,0,0,3,3,10,3,12,25,0,0,5,5,0,0,0,0,8,1,1,10
118618.0,Klos Karol,MB,Poland,33.0,201.0,2022,Poland,Argentina,2022-06-08,True,1,1,9,11,0,0,3,3,5,0,3,8,3,3,4,10,0,0,1,1,0,1,0,1
118618.0,Klos Karol,MB,Poland,33.0,201.0,2022,Poland,Italy,2022-06-09,False,0,0,1,1,0,0,0,0,0,0,0,0,0,1,0,1,0,0,0,0,1,0,0,1
118618.0,Klos Karol,MB,Poland,33.0,201.0,2022,Bulgaria,Poland,2022-06-11,True,1,1,7,9,0,0,0,0,3,1,0,4,1,1,2,4,0,1,0,1,1,0,1,2
118618.0,Klos Karol,MB,Poland,33.0,201.0,2022,France,Poland,2022-06-12,True,0,1,4,5,0,0,0,0,0,1,2,3,2,2,0,4,0,0,0,0,0,0,0,0
118618.0,Klos Karol,MB,Poland,33.0,201.0,2022,Brazil,Poland,2022-06-22,True,0,0,0,0,0,0,0,0,0,0,0,0,0,0,0,0,0,0,0,0,0,0,0,0
118618.0,Klos Karol,MB,Poland,33.0,201.0,2022,Poland,Canada,2022-06-23,True,0,0,8,8,0,0,0,0,7,0,1,8,2,1,3,6,1,0,1,2,1,0,0,1
118618.0,Klos Karol,MB,Poland,33.0,201.0,2022,Poland,Australia,2022-06-25,True,1,0,12,13,1,0,0,1,6,3,2,11,2,3,5,10,0,0,0,0,1,0,0,1
118618.0,Klos Karol,MB,Poland,33.0,201.0,2022,USA,Poland,2022-06-26,True,0,0,0,0,0,0,0,0,0,0,0,0,0,0,0,0,0,0,0,0,0,0,0,0
118618.0,Klos Karol,MB,Poland,33.0,201.0,2022,Iran,Poland,2022-07-05,False,0,0,5,5,0,0,0,0,3,0,1,4,1,2,0,3,0,0,1,1,0,0,1,1
118618.0,Klos Karol,MB,Poland,33.0,201.0,2022,Poland,China,2022-07-07,True,0,0,6,6,0,0,1,1,8,1,0,9,0,4,0,4,0,0,0,0,0,1,0,1
118618.0,Klos Karol,MB,Poland,33.0,201.0,2022,Poland,Netherlands,2022-07-09,True,0,1,7,8,0,0,0,0,5,0,1,6,5,2,1,8,0,0,0,0,2,0,0,2
118618.0,Klos Karol,MB,Poland,33.0,201.0,2022,Poland,Slovenia,2022-07-10,True,0,0,2,2,0,0,0,0,0,0,0,0,2,0,0,2,0,0,0,0,0,0,0,0
118618.0,Klos Karol,MB,Poland,33.0,201.0,2022,Poland,Iran,2022-07-21,True,1,1,10,12,0,0,0,0,2,1,0,3,3,2,0,5,1,0,0,1,0,0,2,2
118618.0,Klos Karol,MB,Poland,33.0,201.0,2022,Poland,USA,2022-07-23,False,0,0,0,0,0,0,0,0,0,0,0,0,0,0,0,0,0,0,0,0,0,0,0,0
118618.0,Klos Karol,MB,Poland,33.0,201.0,2022,Italy,Poland,2022-07-24,True,0,0,0,0,0,0,0,0,0,0,0,0,0,0,0,0,0,0,0,0,0,0,0,0
150742.0,Bednorz Bartosz,OH,Poland,28.0,201.0,2022,Iran,Poland,2022-07-05,False,0,6,9,15,0,0,3,3,16,8,6,30,1,1,0,2,5,2,22,29,1,0,0,1
150742.0,Bednorz Bartosz,OH,Poland,28.0,201.0,2022,Poland,China,2022-07-07,True,0,0,0,0,0,0,0,0,0,0,0,0,0,0,0,0,0,0,0,0,0,0,0,0
150742.0,Bednorz Bartosz,OH,Poland,28.0,201.0,2022,Poland,Netherlands,2022-07-09,True,1,2,3,6,0,0,0,0,5,1,0,6,0,0,0,0,0,3,7,10,1,3,0,4
150742.0,Bednorz Bartosz,OH,Poland,28.0,201.0,2022,Poland,Slovenia,2022-07-10,True,0,0,0,0,0,0,0,0,0,0,0,0,0,0,0,0,0,0,0,0,0,0,0,0
150742.0,Bednorz Bartosz,OH,Poland,28.0,201.0,2022,Poland,Iran,2022-07-21,True,0,0,0,0,0,0,0,0,0,0,1,1,0,0,0,0,1,0,2,3,0,0,0,0
150742.0,Bednorz Bartosz,OH,Poland,28.0,201.0,2022,Poland,USA,2022-07-23,False,0,1,3,4,0,0,0,0,2,0,2,4,0,0,1,1,1,3,2,6,0,1,0,1
150742.0,Bednorz Bartosz,OH,Poland,28.0,201.0,2022,Italy,Poland,2022-07-24,True,0,0,0,0,0,0,0,0,0,0,0,0,0,0,0,0,0,0,0,0,0,0,0,0
115794.0,Lomacz Grzegorz,S,Poland,35.0,187.0,2022,Brazil,Poland,2022-06-22,True,0,0,1,1,2,0,1,3,0,0,0,0,0,0,0,0,0,0,0,0,0,0,1,1
115794.0,Lomacz Grzegorz,S,Poland,35.0,187.0,2022,Poland,Canada,2022-06-23,True,0,0,3,3,4,0,7,11,0,0,0,0,0,1,0,1,0,0,0,0,1,0,0,1
115794.0,Lomacz Grzegorz,S,Poland,35.0,187.0,2022,Poland,Australia,2022-06-25,True,0,0,7,7,26,0,39,65,0,0,0,0,0,1,2,3,0,0,0,0,2,2,1,5
115794.0,Lomacz Grzegorz,S,Poland,35.0,187.0,2022,USA,Poland,2022-06-26,True,0,0,0,0,1,0,5,6,0,0,0,0,0,0,0,0,0,0,0,0,0,0,1,1
115794.0,Lomacz Grzegorz,S,Poland,35.0,187.0,2022,Poland,Iran,2022-07-21,True,0,0,3,3,3,0,15,18,0,0,0,0,0,1,0,1,0,0,0,0,1,1,0,2
115794.0,Lomacz Grzegorz,S,Poland,35.0,187.0,2022,Poland,USA,2022-07-23,False,0,0,1,1,5,0,6,11,0,0,0,0,0,1,0,1,0,0,0,0,0,0,0,0
115794.0,Lomacz Grzegorz,S,Poland,35.0,187.0,2022,Italy,Poland,2022-07-24,True,0,0,0,0,0,0,0,0,0,0,0,0,0,0,0,0,0,0,0,0,0,0,0,0
142678.0,Szymura Rafal,OH,Poland,27.0,196.0,2022,Poland,Argentina,2022-06-08,True,0,0,0,0,0,0,0,0,0,0,0,0,0,0,0,0,0,0,0,0,0,0,0,0
142678.0,Szymura Rafal,OH,Poland,27.0,196.0,2022,Poland,Italy,2022-06-09,False,0,1,13,14,0,0,6,6,13,4,9,26,0,4,5,9,10,3,13,26,7,2,2,11
142678.0,Szymura Rafal,OH,Poland,27.0,196.0,2022,Bulgaria,Poland,2022-06-11,True,0,0,0,0,0,0,0,0,0,0,1,1,0,0,0,0,0,0,0,0,0,0,0,0
142678.0,Szymura Rafal,OH,Poland,27.0,196.0,2022,France,Poland,2022-06-12,True,0,0,1,1,0,0,0,0,0,1,2,3,0,0,1,1,0,2,3,5,2,0,0,2
142679.0,Sliwka Aleksander,OH,Poland,27.0,196.0,2022,Brazil,Poland,2022-06-22,True,2,0,12,14,0,0,1,1,7,1,6,14,0,1,1,2,7,1,18,26,3,0,0,3
142679.0,Sliwka Aleksander,OH,Poland,27.0,196.0,2022,Poland,Canada,2022-06-23,True,0,0,0,0,0,0,0,0,0,0,0,0,0,0,0,0,0,0,0,0,0,0,0,0
142679.0,Sliwka Aleksander,OH,Poland,27.0,196.0,2022,Poland,Australia,2022-06-25,True,0,2,7,9,0,0,0,0,7,0,3,10,1,1,2,4,3,0,6,9,2,1,0,3
142679.0,Sliwka Aleksander,OH,Poland,27.0,196.0,2022,USA,Poland,2022-06-26,True,2,2,15,19,1,0,1,2,10,5,9,24,1,2,0,3,6,4,20,30,1,1,0,2
142679.0,Sliwka Aleksander,OH,Poland,27.0,196.0,2022,Iran,Poland,2022-07-05,False,1,6,10,17,0,0,3,3,9,0,8,17,0,2,0,2,3,2,28,33,5,3,0,8
142679.0,Sliwka Aleksander,OH,Poland,27.0,196.0,2022,Poland,China,2022-07-07,True,0,0,0,0,0,0,0,0,0,0,0,0,0,0,0,0,0,0,0,0,0,0,0,0
142679.0,Sliwka Aleksander,OH,Poland,27.0,196.0,2022,Poland,Netherlands,2022-07-09,True,0,1,9,10,0,0,0,0,5,0,3,8,0,0,0,0,0,1,6,7,2,0,1,3
142679.0,Sliwka Aleksander,OH,Poland,27.0,196.0,2022,Poland,Slovenia,2022-07-10,True,0,2,4,6,0,0,0,0,6,0,5,11,2,3,0,5,1,3,14,18,1,1,1,3
142679.0,Sliwka Aleksander,OH,Poland,27.0,196.0,2022,Poland,Iran,2022-07-21,True,0,2,6,8,1,0,2,3,10,1,7,18,0,1,3,4,5,1,15,21,5,5,0,10
142679.0,Sliwka Aleksander,OH,Poland,27.0,196.0,2022,Poland,USA,2022-07-23,False,0,3,1,4,0,0,2,2,4,2,4,10,0,1,0,1,4,1,9,14,3,2,1,6
142679.0,Sliwka Aleksander,OH,Poland,27.0,196.0,2022,Italy,Poland,2022-07-24,True,0,0,1,1,0,0,1,1,1,0,3,4,0,1,2,3,2,0,6,8,5,0,0,5
152870.0,Kochanowski Jakub,MB,Poland,25.0,199.0,2022,Poland,Argentina,2022-06-08,True,1,5,9,15,0,0,1,1,5,0,1,6,1,6,9,16,0,0,0,0,2,0,0,2
152870.0,Kochanowski Jakub,MB,Poland,25.0,199.0,2022,Poland,Italy,2022-06-09,False,0,4,8,12,0,0,0,0,4,2,3,9,1,3,2,6,1,0,2,3,1,0,0,1
152870.0,Kochanowski Jakub,MB,Poland,25.0,199.0,2022,Bulgaria,Poland,2022-06-11,True,0,0,0,0,0,0,0,0,0,0,0,0,0,0,0,0,0,0,0,0,0,0,0,0
152870.0,Kochanowski Jakub,MB,Poland,25.0,199.0,2022,France,Poland,2022-06-12,True,0,2,9,11,0,0,1,1,7,0,4,11,3,5,7,15,0,0,0,0,2,0,2,4
152870.0,Kochanowski Jakub,MB,Poland,25.0,199.0,2022,Brazil,Poland,2022-06-22,True,0,3,10,13,0,0,1,1,8,0,4,12,4,3,5,12,1,0,1,2,1,1,1,3
152870.0,Kochanowski Jakub,MB,Poland,25.0,199.0,2022,Poland,Canada,2022-06-23,True,0,3,2,5,0,0,0,0,4,1,1,6,0,1,1,2,0,0,0,0,0,0,0,0
152870.0,Kochanowski Jakub,MB,Poland,25.0,199.0,2022,Poland,Australia,2022-06-25,True,0,0,0,0,0,0,0,0,0,0,0,0,0,0,0,0,0,0,0,0,0,0,0,0
152870.0,Kochanowski Jakub,MB,Poland,25.0,199.0,2022,USA,Poland,2022-06-26,True,0,3,5,8,0,0,1,1,4,0,1,5,4,3,3,10,0,0,1,1,1,1,0,2
152870.0,Kochanowski Jakub,MB,Poland,25.0,199.0,2022,Iran,Poland,2022-07-05,False,0,3,7,10,0,0,0,0,3,2,4,9,2,3,0,5,0,0,0,0,0,0,0,0
152870.0,Kochanowski Jakub,MB,Poland,25.0,199.0,2022,Poland,China,2022-07-07,True,3,2,14,19,0,0,1,1,5,1,2,8,0,1,0,1,0,0,0,0,1,0,0,1
152870.0,Kochanowski Jakub,MB,Poland,25.0,199.0,2022,Poland,Netherlands,2022-07-09,True,0,0,0,0,0,0,0,0,0,0,0,0,0,0,0,0,0,0,0,0,0,0,0,0
152870.0,Kochanowski Jakub,MB,Poland,25.0,199.0,2022,Poland,Slovenia,2022-07-10,True,1,2,9,12,0,0,0,0,4,2,1,7,1,1,0,2,0,0,2,2,2,0,0,2
152870.0,Kochanowski Jakub,MB,Poland,25.0,199.0,2022,Poland,Iran,2022-07-21,True,3,2,7,12,0,0,0,0,1,1,3,5,2,0,2,4,0,0,1,1,2,0,0,2
152870.0,Kochanowski Jakub,MB,Poland,25.0,199.0,2022,Poland,USA,2022-07-23,False,2,1,10,13,0,0,0,0,4,1,2,7,1,3,4,8,0,0,0,0,3,0,1,4
152870.0,Kochanowski Jakub,MB,Poland,25.0,199.0,2022,Italy,Poland,2022-07-24,True,1,5,9,15,0,0,1,1,5,0,1,6,0,3,3,6,1,0,0,1,2,0,0,2
153395.0,Semeniuk Kamil,OH,Poland,26.0,195.0,2022,Brazil,Poland,2022-06-22,True,4,1,10,15,0,0,0,0,12,2,10,24,2,2,2,6,3,0,13,16,1,1,0,2
153395.0,Semeniuk Kamil,OH,Poland,26.0,195.0,2022,Poland,Canada,2022-06-23,True,0,3,8,11,0,0,0,0,6,0,3,9,0,0,0,0,1,0,6,7,2,0,0,2
153395.0,Semeniuk Kamil,OH,Poland,26.0,195.0,2022,Poland,Australia,2022-06-25,True,0,0,0,0,0,0,0,0,0,0,0,0,0,0,0,0,0,0,0,0,0,0,0,0
153395.0,Semeniuk Kamil,OH,Poland,26.0,195.0,2022,USA,Poland,2022-06-26,True,1,1,14,16,0,0,1,1,14,3,11,28,0,2,3,5,5,1,16,22,2,2,0,4
153395.0,Semeniuk Kamil,OH,Poland,26.0,195.0,2022,Iran,Poland,2022-07-05,False,0,1,0,1,0,0,0,0,0,0,1,1,0,0,0,0,0,1,1,2,0,0,0,0
153395.0,Semeniuk Kamil,OH,Poland,26.0,195.0,2022,Poland,China,2022-07-07,True,0,4,6,10,0,0,1,1,5,2,3,10,1,3,0,4,3,1,11,15,1,0,0,1
153395.0,Semeniuk Kamil,OH,Poland,26.0,195.0,2022,Poland,Netherlands,2022-07-09,True,1,1,5,7,0,0,0,0,7,0,3,10,2,1,0,3,1,0,7,8,0,0,0,0
153395.0,Semeniuk Kamil,OH,Poland,26.0,195.0,2022,Poland,Slovenia,2022-07-10,True,1,3,19,23,0,0,1,1,11,3,11,25,1,0,0,1,0,0,14,14,4,1,0,5
153395.0,Semeniuk Kamil,OH,Poland,26.0,195.0,2022,Poland,Iran,2022-07-21,True,0,3,10,13,0,0,1,1,15,3,12,30,2,3,2,7,9,1,12,22,4,1,0,5
153395.0,Semeniuk Kamil,OH,Poland,26.0,195.0,2022,Poland,USA,2022-07-23,False,0,3,4,7,0,0,0,0,7,5,8,20,0,2,0,2,8,0,14,22,4,0,0,4
153395.0,Semeniuk Kamil,OH,Poland,26.0,195.0,2022,Italy,Poland,2022-07-24,True,2,2,12,16,0,0,0,0,9,0,12,21,1,6,0,7,3,0,4,7,5,1,1,7
118614.0,Zatorski Pawel,L,Poland,32.0,184.0,2022,Brazil,Poland,2022-06-22,True,0,0,0,0,0,0,0,0,0,0,0,0,0,0,0,0,6,0,13,19,5,3,4,12
118614.0,Zatorski Pawel,L,Poland,32.0,184.0,2022,Poland,Canada,2022-06-23,True,0,0,0,0,0,0,0,0,0,0,0,0,0,0,0,0,0,0,0,0,0,0,0,0
118614.0,Zatorski Pawel,L,Poland,32.0,184.0,2022,Poland,Australia,2022-06-25,True,0,0,0,0,1,0,1,2,0,0,0,0,0,0,0,0,4,1,7,12,3,1,1,5
118614.0,Zatorski Pawel,L,Poland,32.0,184.0,2022,USA,Poland,2022-06-26,True,0,0,0,0,0,0,1,1,0,0,0,0,0,0,0,0,2,0,3,5,5,3,1,9
118614.0,Zatorski Pawel,L,Poland,32.0,184.0,2022,Iran,Poland,2022-07-05,False,0,0,0,0,0,0,5,5,0,0,0,0,0,0,0,0,4,3,18,25,6,3,0,9
118614.0,Zatorski Pawel,L,Poland,32.0,184.0,2022,Poland,China,2022-07-07,True,0,0,0,0,0,0,0,0,0,0,0,0,0,0,0,0,0,0,0,0,0,0,0,0
118614.0,Zatorski Pawel,L,Poland,32.0,184.0,2022,Poland,Netherlands,2022-07-09,True,0,0,0,0,0,0,5,5,0,0,0,0,0,0,0,0,4,2,9,15,3,1,1,5
118614.0,Zatorski Pawel,L,Poland,32.0,184.0,2022,Poland,Slovenia,2022-07-10,True,0,0,0,0,0,0,2,2,0,0,0,0,0,0,0,0,1,4,12,17,5,5,0,10
118614.0,Zatorski Pawel,L,Poland,32.0,184.0,2022,Poland,Iran,2022-07-21,True,0,0,0,0,0,0,2,2,0,0,0,0,0,0,0,0,9,3,12,24,14,5,1,20
118614.0,Zatorski Pawel,L,Poland,32.0,184.0,2022,Poland,USA,2022-07-23,False,0,0,0,0,0,0,1,1,0,0,0,0,0,0,0,0,3,2,3,8,2,2,0,4
118614.0,Zatorski Pawel,L,Poland,32.0,184.0,2022,Italy,Poland,2022-07-24,True,0,0,0,0,0,0,1,1,0,0,0,0,0,0,0,0,6,1,8,15,5,2,0,7
152873.0,Kwolek Bartosz,OH,Poland,25.0,192.0,2022,Poland,Argentina,2022-06-08,True,0,3,7,10,0,0,1,1,7,4,4,15,1,2,2,5,6,2,17,25,5,2,1,8
152873.0,Kwolek Bartosz,OH,Poland,25.0,192.0,2022,Poland,Italy,2022-06-09,False,0,0,3,3,0,0,0,0,0,1,0,1,0,1,0,1,0,0,2,2,0,0,0,0
152873.0,Kwolek Bartosz,OH,Poland,25.0,192.0,2022,Bulgaria,Poland,2022-06-11,True,2,1,12,15,0,1,2,3,10,2,8,20,0,3,1,4,7,1,14,22,3,1,2,6
152873.0,Kwolek Bartosz,OH,Poland,25.0,192.0,2022,France,Poland,2022-06-12,True,1,2,10,13,1,0,3,4,10,1,5,16,0,1,2,3,7,0,19,26,5,2,0,7
152873.0,Kwolek Bartosz,OH,Poland,25.0,192.0,2022,Brazil,Poland,2022-06-22,True,0,0,0,0,0,0,0,0,0,0,0,0,0,0,0,0,0,0,0,0,0,0,0,0
152873.0,Kwolek Bartosz,OH,Poland,25.0,192.0,2022,Poland,Canada,2022-06-23,True,0,0,2,2,0,0,0,0,2,1,2,5,0,0,1,1,0,0,2,2,1,0,0,1
152873.0,Kwolek Bartosz,OH,Poland,25.0,192.0,2022,Poland,Australia,2022-06-25,True,0,4,12,16,1,0,0,1,8,2,4,14,1,3,1,5,7,0,13,20,2,0,2,4
152873.0,Kwolek Bartosz,OH,Poland,25.0,192.0,2022,USA,Poland,2022-06-26,True,1,1,3,5,0,0,0,0,0,0,1,1,0,0,0,0,0,0,2,2,2,0,0,2
165942.0,Janusz Marcin,S,Poland,28.0,196.0,2022,Brazil,Poland,2022-06-22,True,0,1,8,9,13,0,75,88,1,0,0,1,0,1,1,2,0,0,0,0,4,3,1,8
165942.0,Janusz Marcin,S,Poland,28.0,196.0,2022,Poland,Canada,2022-06-23,True,2,1,6,9,12,0,33,45,0,0,1,1,1,4,2,7,0,0,0,0,0,2,0,2
165942.0,Janusz Marcin,S,Poland,28.0,196.0,2022,Poland,Australia,2022-06-25,True,0,0,0,0,3,0,2,5,0,0,0,0,0,0,0,0,0,0,0,0,0,1,0,1
165942.0,Janusz Marcin,S,Poland,28.0,196.0,2022,USA,Poland,2022-06-26,True,0,2,7,9,18,2,70,90,0,0,0,0,0,0,1,1,0,0,0,0,5,2,0,7
165942.0,Janusz Marcin,S,Poland,28.0,196.0,2022,Iran,Poland,2022-07-05,False,1,2,5,8,10,0,57,67,0,0,1,1,1,2,1,4,0,0,1,1,1,2,1,4
165942.0,Janusz Marcin,S,Poland,28.0,196.0,2022,Poland,China,2022-07-07,True,0,0,0,0,0,0,4,4,0,0,0,0,0,0,0,0,0,0,0,0,0,0,0,0
165942.0,Janusz Marcin,S,Poland,28.0,196.0,2022,Poland,Netherlands,2022-07-09,True,0,0,9,9,12,0,41,53,0,0,0,0,0,4,0,4,0,0,1,1,2,3,1,6
165942.0,Janusz Marcin,S,Poland,28.0,196.0,2022,Poland,Slovenia,2022-07-10,True,0,2,7,9,15,0,61,76,0,0,0,0,0,0,0,0,0,0,0,0,0,1,1,2
165942.0,Janusz Marcin,S,Poland,28.0,196.0,2022,Poland,Iran,2022-07-21,True,0,1,11,12,14,0,66,80,0,0,0,0,0,3,0,3,0,0,0,0,3,2,0,5
165942.0,Janusz Marcin,S,Poland,28.0,196.0,2022,Poland,USA,2022-07-23,False,0,0,5,5,11,0,50,61,0,0,0,0,1,0,1,2,0,1,0,1,1,0,2,3
165942.0,Janusz Marcin,S,Poland,28.0,196.0,2022,Italy,Poland,2022-07-24,True,0,2,5,7,13,1,51,65,0,0,0,0,1,2,5,8,0,0,0,0,4,1,0,5
150734.0,Bieniek Mateusz,MB,Poland,28.0,210.0,2022,Brazil,Poland,2022-06-22,True,7,5,16,28,1,0,0,1,2,1,5,8,0,5,6,11,0,0,0,0,2,0,0,2
150734.0,Bieniek Mateusz,MB,Poland,28.0,210.0,2022,Poland,Canada,2022-06-23,True,0,1,0,1,0,0,0,0,0,0,0,0,0,0,0,0,0,0,0,0,0,0,0,0
150734.0,Bieniek Mateusz,MB,Poland,28.0,210.0,2022,Poland,Australia,2022-06-25,True,1,2,4,7,0,0,0,0,6,1,1,8,0,2,2,4,0,0,0,0,1,0,0,1
150734.0,Bieniek Mateusz,MB,Poland,28.0,210.0,2022,USA,Poland,2022-06-26,True,0,4,15,19,0,0,0,0,8,2,3,13,0,1,4,5,0,0,1,1,1,0,0,1
150734.0,Bieniek Mateusz,MB,Poland,28.0,210.0,2022,Iran,Poland,2022-07-05,False,4,4,14,22,0,0,0,0,8,2,3,13,5,4,0,9,0,0,0,0,0,0,1,1
150734.0,Bieniek Mateusz,MB,Poland,28.0,210.0,2022,Poland,China,2022-07-07,True,2,0,1,3,0,0,0,0,0,0,0,0,0,0,0,0,0,0,0,0,0,1,0,1
150734.0,Bieniek Mateusz,MB,Poland,28.0,210.0,2022,Poland,Netherlands,2022-07-09,True,1,2,10,13,0,0,0,0,6,2,1,9,0,6,1,7,0,0,0,0,0,0,0,0
150734.0,Bieniek Mateusz,MB,Poland,28.0,210.0,2022,Poland,Slovenia,2022-07-10,True,1,4,15,20,0,0,0,0,7,0,2,9,1,5,0,6,0,0,1,1,0,0,0,0
150734.0,Bieniek Mateusz,MB,Poland,28.0,210.0,2022,Poland,Iran,2022-07-21,True,1,3,14,18,0,0,0,0,6,0,3,9,2,2,4,8,1,0,1,2,3,2,0,5
150734.0,Bieniek Mateusz,MB,Poland,28.0,210.0,2022,Poland,USA,2022-07-23,False,1,3,6,10,0,0,0,0,4,0,2,6,0,2,3,5,0,0,1,1,1,0,0,1
150734.0,Bieniek Mateusz,MB,Poland,28.0,210.0,2022,Italy,Poland,2022-07-24,True,3,1,8,12,0,0,3,3,6,2,2,10,1,6,5,12,0,0,0,0,1,0,0,1
152866.0,Fornal Tomasz,OH,Poland,25.0,198.0,2022,Poland,Argentina,2022-06-08,True,0,4,8,12,0,0,5,5,14,1,12,27,0,2,4,6,2,0,10,12,7,1,0,8
152866.0,Fornal Tomasz,OH,Poland,25.0,198.0,2022,Poland,Italy,2022-06-09,False,0,8,3,11,1,0,3,4,10,4,7,21,2,0,10,12,4,0,14,18,2,3,4,9
152866.0,Fornal Tomasz,OH,Poland,25.0,198.0,2022,Bulgaria,Poland,2022-06-11,True,0,0,0,0,0,0,0,0,0,0,0,0,0,0,0,0,0,0,0,0,0,0,0,0
152866.0,Fornal Tomasz,OH,Poland,25.0,198.0,2022,France,Poland,2022-06-12,True,2,4,8,14,0,0,1,1,12,6,12,30,2,4,4,10,2,3,13,18,6,1,1,8
152866.0,Fornal Tomasz,OH,Poland,25.0,198.0,2022,Brazil,Poland,2022-06-22,True,0,0,0,0,0,0,0,0,0,0,0,0,0,0,0,0,0,0,0,0,0,0,0,0
152866.0,Fornal Tomasz,OH,Poland,25.0,198.0,2022,Poland,Canada,2022-06-23,True,1,4,8,13,0,0,3,3,7,2,5,14,1,2,3,6,7,1,9,17,6,1,0,7
152866.0,Fornal Tomasz,OH,Poland,25.0,198.0,2022,Poland,Australia,2022-06-25,True,0,0,2,2,0,0,1,1,4,0,3,7,0,0,1,1,2,0,1,3,2,0,0,2
152866.0,Fornal Tomasz,OH,Poland,25.0,198.0,2022,USA,Poland,2022-06-26,True,0,0,0,0,0,0,0,0,0,0,0,0,0,0,0,0,0,0,0,0,0,0,0,0
152866.0,Fornal Tomasz,OH,Poland,25.0,198.0,2022,Iran,Poland,2022-07-05,False,2,0,3,5,0,0,0,0,1,0,0,1,0,0,0,0,0,1,2,3,2,0,0,2
152866.0,Fornal Tomasz,OH,Poland,25.0,198.0,2022,Poland,China,2022-07-07,True,5,1,10,16,0,0,1,1,14,1,2,17,1,3,0,4,3,1,8,12,1,0,0,1
152866.0,Fornal Tomasz,OH,Poland,25.0,198.0,2022,Poland,Netherlands,2022-07-09,True,0,2,4,6,0,0,0,0,2,1,2,5,0,0,0,0,0,0,8,8,2,0,0,2
152866.0,Fornal Tomasz,OH,Poland,25.0,198.0,2022,Poland,Slovenia,2022-07-10,True,1,1,2,4,0,0,0,0,5,1,2,8,1,0,0,1,2,0,4,6,3,0,0,3
152866.0,Fornal Tomasz,OH,Poland,25.0,198.0,2022,Poland,Iran,2022-07-21,True,0,2,0,2,0,0,0,0,0,0,3,3,0,1,0,1,1,1,2,4,0,2,0,2
152866.0,Fornal Tomasz,OH,Poland,25.0,198.0,2022,Poland,USA,2022-07-23,False,0,2,1,3,0,0,0,0,2,0,2,4,0,0,0,0,4,2,5,11,1,0,0,1
152866.0,Fornal Tomasz,OH,Poland,25.0,198.0,2022,Italy,Poland,2022-07-24,True,0,2,3,5,0,0,3,3,6,0,2,8,0,0,0,0,9,0,8,17,3,0,0,3
183851.0,Urbanowicz Karol,MB,Poland,22.0,201.0,2022,Poland,Argentina,2022-06-08,True,0,0,0,0,0,0,0,0,0,0,0,0,0,0,0,0,0,0,0,0,0,0,0,0
183851.0,Urbanowicz Karol,MB,Poland,22.0,201.0,2022,Poland,Italy,2022-06-09,False,0,0,0,0,0,0,0,0,0,0,0,0,0,0,0,0,0,0,0,0,0,0,0,0
183851.0,Urbanowicz Karol,MB,Poland,22.0,201.0,2022,Bulgaria,Poland,2022-06-11,True,1,1,4,6,0,0,2,2,3,2,3,8,0,3,4,7,0,0,2,2,1,0,1,2
183851.0,Urbanowicz Karol,MB,Poland,22.0,201.0,2022,France,Poland,2022-06-12,True,0,0,0,0,0,0,0,0,0,0,0,0,0,0,0,0,0,0,0,0,0,0,0,0
181100.0,Butryn Karol,O,Poland,29.0,194.0,2022,Poland,Argentina,2022-06-08,True,0,2,1,3,0,0,0,0,3,0,0,3,0,0,0,0,0,0,0,0,1,0,0,1
181100.0,Butryn Karol,O,Poland,29.0,194.0,2022,Poland,Italy,2022-06-09,False,2,3,12,17,0,0,0,0,16,5,5,26,1,4,4,9,0,0,2,2,1,2,3,6
181100.0,Butryn Karol,O,Poland,29.0,194.0,2022,Bulgaria,Poland,2022-06-11,True,0,0,0,0,0,0,0,0,0,0,0,0,0,0,0,0,0,0,0,0,0,0,0,0
181100.0,Butryn Karol,O,Poland,29.0,194.0,2022,France,Poland,2022-06-12,True,3,3,16,22,0,0,4,4,16,7,6,29,3,3,1,7,0,0,0,0,6,3,2,11
181100.0,Butryn Karol,O,Poland,29.0,194.0,2022,Iran,Poland,2022-07-05,False,0,1,0,1,0,0,0,0,0,0,0,0,0,0,0,0,0,0,0,0,0,0,0,0
181100.0,Butryn Karol,O,Poland,29.0,194.0,2022,Poland,China,2022-07-07,True,0,1,0,1,0,0,0,0,0,1,0,1,0,0,0,0,0,0,0,0,0,0,0,0
181100.0,Butryn Karol,O,Poland,29.0,194.0,2022,Poland,Netherlands,2022-07-09,True,0,2,9,11,0,0,0,0,9,4,1,14,0,3,0,3,0,0,0,0,1,1,0,2
181100.0,Butryn Karol,O,Poland,29.0,194.0,2022,Poland,Slovenia,2022-07-10,True,0,0,0,0,0,0,0,0,0,0,0,0,0,0,0,0,0,0,0,0,0,0,0,0
181100.0,Butryn Karol,O,Poland,29.0,194.0,2022,Poland,Iran,2022-07-21,True,0,2,6,8,0,0,0,0,0,0,0,0,0,0,0,0,0,0,0,0,1,0,0,1
181100.0,Butryn Karol,O,Poland,29.0,194.0,2022,Poland,USA,2022-07-23,False,0,0,1,1,0,0,1,1,0,0,0,0,0,0,0,0,0,0,0,0,0,1,0,1
181100.0,Butryn Karol,O,Poland,29.0,194.0,2022,Italy,Poland,2022-07-24,True,1,1,2,4,0,0,0,0,0,0,0,0,0,0,0,0,0,0,0,0,1,0,0,1
164127.0,Szymura Kamil,L,Poland,24.0,184.0,2022,Poland,Argentina,2022-06-08,True,0,0,0,0,0,0,0,0,0,0,0,0,0,0,0,0,0,0,0,0,0,0,0,0
164127.0,Szymura Kamil,L,Poland,24.0,184.0,2022,Poland,Italy,2022-06-09,False,0,0,0,0,0,0,0,0,0,0,0,0,0,0,0,0,0,0,0,0,0,0,0,0
164127.0,Szymura Kamil,L,Poland,24.0,184.0,2022,Bulgaria,Poland,2022-06-11,True,0,0,0,0,0,0,4,4,0,0,0,0,0,0,0,0,1,0,6,7,8,2,3,13
164127.0,Szymura Kamil,L,Poland,24.0,184.0,2022,France,Poland,2022-06-12,True,0,0,0,0,0,0,0,0,0,0,0,0,0,0,0,0,0,0,0,0,0,0,0,0
164124.0,Poreba Mateusz,MB,Poland,23.0,203.0,2022,Poland,Argentina,2022-06-08,True,0,0,0,0,0,0,0,0,0,0,0,0,0,0,0,0,0,0,0,0,0,0,0,0
164124.0,Poreba Mateusz,MB,Poland,23.0,203.0,2022,Poland,Italy,2022-06-09,False,2,3,14,19,0,0,1,1,4,3,2,9,2,6,3,11,0,0,1,1,5,0,2,7
164124.0,Poreba Mateusz,MB,Poland,23.0,203.0,2022,Bulgaria,Poland,2022-06-11,True,1,0,12,13,0,0,0,0,4,1,0,5,1,4,4,9,1,0,0,1,1,1,1,3
164124.0,Poreba Mateusz,MB,Poland,23.0,203.0,2022,France,Poland,2022-06-12,True,1,1,12,14,0,0,3,3,2,0,1,3,0,2,3,5,0,0,0,0,1,1,1,3
164124.0,Poreba Mateusz,MB,Poland,23.0,203.0,2022,Brazil,Poland,2022-06-22,True,0,0,0,0,0,0,0,0,0,0,0,0,0,0,0,0,0,0,0,0,0,0,0,0
164124.0,Poreba Mateusz,MB,Poland,23.0,203.0,2022,Poland,Canada,2022-06-23,True,1,0,4,5,1,0,0,1,4,0,0,4,0,0,0,0,0,0,0,0,0,0,0,0
164124.0,Poreba Mateusz,MB,Poland,23.0,203.0,2022,Poland,Australia,2022-06-25,True,1,0,4,5,0,0,0,0,2,0,1,3,1,2,1,4,0,0,0,0,0,0,0,0
164124.0,Poreba Mateusz,MB,Poland,23.0,203.0,2022,USA,Poland,2022-06-26,True,0,0,0,0,0,0,0,0,0,0,0,0,0,0,0,0,0,0,0,0,0,0,0,0
153387.0,Firlej Jan,S,Poland,26.0,187.0,2022,Poland,Argentina,2022-06-08,True,1,0,11,12,26,0,40,66,2,0,0,2,1,2,3,6,0,1,1,2,9,4,0,13
153387.0,Firlej Jan,S,Poland,26.0,187.0,2022,Poland,Italy,2022-06-09,False,0,4,8,12,43,1,36,80,0,0,2,2,0,5,1,6,0,0,0,0,6,1,1,8
153387.0,Firlej Jan,S,Poland,26.0,187.0,2022,Bulgaria,Poland,2022-06-11,True,0,0,0,0,0,0,0,0,0,0,0,0,0,0,0,0,0,0,0,0,0,0,0,0
153387.0,Firlej Jan,S,Poland,26.0,187.0,2022,France,Poland,2022-06-12,True,0,1,13,14,25,0,55,80,0,0,1,1,0,3,3,6,0,1,0,1,5,7,4,16
153387.0,Firlej Jan,S,Poland,26.0,187.0,2022,Iran,Poland,2022-07-05,False,0,0,2,2,3,1,26,30,0,0,0,0,0,0,0,0,0,0,0,0,1,2,0,3
153387.0,Firlej Jan,S,Poland,26.0,187.0,2022,Poland,China,2022-07-07,True,0,0,6,6,17,0,33,50,1,0,0,1,1,1,0,2,0,0,1,1,0,1,0,1
153387.0,Firlej Jan,S,Poland,26.0,187.0,2022,Poland,Netherlands,2022-07-09,True,0,0,0,0,1,0,0,1,0,0,0,0,0,0,0,0,0,0,0,0,0,0,0,0
153387.0,Firlej Jan,S,Poland,26.0,187.0,2022,Poland,Slovenia,2022-07-10,True,0,0,0,0,5,0,4,9,0,0,0,0,0,0,0,0,0,0,0,0,0,0,0,0
181313.0,Nikolic Uros,OH,Serbia,24.0,210.0,2022,Bulgaria,Serbia,2022-06-07,True,0,0,0,0,0,0,0,0,0,0,0,0,0,0,0,0,0,0,0,0,0,0,0,0
181313.0,Nikolic Uros,OH,Serbia,24.0,210.0,2022,Serbia,France,2022-06-09,False,0,2,11,13,2,0,0,2,2,0,1,3,1,2,3,6,0,0,3,3,1,2,1,4
181313.0,Nikolic Uros,OH,Serbia,24.0,210.0,2022,Serbia,Argentina,2022-06-10,True,0,0,0,0,0,0,0,0,0,0,1,1,0,1,0,1,0,0,0,0,0,0,0,0
181313.0,Nikolic Uros,OH,Serbia,24.0,210.0,2022,Germany,Serbia,2022-06-11,False,0,0,0,0,0,0,0,0,0,0,0,0,0,0,0,0,0,0,0,0,0,0,0,0
120250.0,Petric Nemanja,OH,Serbia,35.0,203.0,2022,Serbia,USA,2022-06-22,False,0,0,0,0,0,0,0,0,0,0,0,0,0,0,0,0,0,0,0,0,0,0,0,0
120250.0,Petric Nemanja,OH,Serbia,35.0,203.0,2022,Serbia,Brazil,2022-06-23,False,0,0,0,0,0,0,0,0,0,0,0,0,0,0,0,0,0,0,0,0,0,0,0,0
120250.0,Petric Nemanja,OH,Serbia,35.0,203.0,2022,Serbia,Canada,2022-06-24,True,0,0,0,0,0,0,0,0,0,0,0,0,0,0,0,0,0,0,0,0,0,1,0,1
120250.0,Petric Nemanja,OH,Serbia,35.0,203.0,2022,Serbia,Australia,2022-06-26,True,0,0,0,0,0,0,0,0,0,0,0,0,0,0,0,0,0,0,0,0,0,0,0,0
120250.0,Petric Nemanja,OH,Serbia,35.0,203.0,2022,Slovenia,Serbia,2022-07-06,False,0,0,0,0,0,0,0,0,0,0,0,0,0,0,0,0,0,0,0,0,0,0,0,0
120250.0,Petric Nemanja,OH,Serbia,35.0,203.0,2022,Italy,Serbia,2022-07-08,False,0,2,5,7,0,0,1,1,7,4,8,19,1,0,0,1,2,2,21,25,0,0,1,1
120250.0,Petric Nemanja,OH,Serbia,35.0,203.0,2022,Iran,Serbia,2022-07-09,False,0,0,0,0,0,0,0,0,0,0,0,0,0,0,0,0,0,0,0,0,0,0,0,0
120250.0,Petric Nemanja,OH,Serbia,35.0,203.0,2022,China,Serbia,2022-07-10,True,0,0,0,0,0,0,0,0,0,0,0,0,0,0,0,0,0,0,0,0,0,0,0,0
132458.0,Katic Milan,OH,Serbia,29.0,202.0,2022,Bulgaria,Serbia,2022-06-07,True,0,0,6,6,0,0,4,4,7,0,4,11,0,2,0,2,1,0,7,8,1,2,1,4
132458.0,Katic Milan,OH,Serbia,29.0,202.0,2022,Serbia,France,2022-06-09,False,0,0,0,0,0,0,1,1,0,0,1,1,0,0,2,2,1,0,2,3,0,0,0,0
132458.0,Katic Milan,OH,Serbia,29.0,202.0,2022,Serbia,Argentina,2022-06-10,True,1,0,4,5,0,0,3,3,0,0,2,2,0,0,1,1,1,0,4,5,0,1,0,1
132458.0,Katic Milan,OH,Serbia,29.0,202.0,2022,Germany,Serbia,2022-06-11,False,0,0,0,0,0,0,1,1,1,0,0,1,0,0,1,1,0,0,6,6,0,0,0,0
132458.0,Katic Milan,OH,Serbia,29.0,202.0,2022,Serbia,USA,2022-06-22,False,0,0,4,4,0,0,0,0,2,0,1,3,1,0,0,1,1,0,5,6,0,0,0,0
132458.0,Katic Milan,OH,Serbia,29.0,202.0,2022,Serbia,Brazil,2022-06-23,False,0,1,9,10,0,0,1,1,6,2,9,17,1,1,2,4,7,1,9,17,0,2,0,2
132458.0,Katic Milan,OH,Serbia,29.0,202.0,2022,Serbia,Canada,2022-06-24,True,0,2,10,12,0,0,0,0,6,2,4,12,0,1,1,2,2,2,6,10,2,2,0,4
132458.0,Katic Milan,OH,Serbia,29.0,202.0,2022,Serbia,Australia,2022-06-26,True,0,0,0,0,0,0,1,1,0,0,0,0,0,0,0,0,1,0,2,3,1,0,0,1
132458.0,Katic Milan,OH,Serbia,29.0,202.0,2022,Slovenia,Serbia,2022-07-06,False,0,1,1,2,0,0,1,1,1,1,3,5,0,1,0,1,1,1,0,2,0,0,0,0
132458.0,Katic Milan,OH,Serbia,29.0,202.0,2022,Italy,Serbia,2022-07-08,False,0,0,0,0,0,0,0,0,0,0,0,0,0,0,0,0,0,0,0,0,0,0,0,0
132458.0,Katic Milan,OH,Serbia,29.0,202.0,2022,Iran,Serbia,2022-07-09,False,0,0,0,0,0,0,0,0,0,0,0,0,0,0,0,0,0,1,0,1,0,0,0,0
132458.0,Katic Milan,OH,Serbia,29.0,202.0,2022,China,Serbia,2022-07-10,True,0,0,0,0,0,0,0,0,0,0,0,0,0,0,0,0,0,0,0,0,0,0,0,0
150383.0,Pekovic Nikola,L,Serbia,33.0,176.0,2022,Bulgaria,Serbia,2022-06-07,True,0,0,0,0,0,0,3,3,0,0,0,0,0,0,0,0,0,0,0,0,1,12,5,18
150383.0,Pekovic Nikola,L,Serbia,33.0,176.0,2022,Serbia,France,2022-06-09,False,0,0,0,0,1,0,9,10,0,0,0,0,0,0,0,0,1,4,16,21,14,4,4,22
150383.0,Pekovic Nikola,L,Serbia,33.0,176.0,2022,Serbia,Argentina,2022-06-10,True,0,0,0,0,0,0,5,5,0,0,0,0,0,0,0,0,5,2,13,20,6,3,4,13
150383.0,Pekovic Nikola,L,Serbia,33.0,176.0,2022,Germany,Serbia,2022-06-11,False,0,0,0,0,0,0,2,2,0,0,0,0,0,0,0,0,0,0,0,0,9,1,2,12
150383.0,Pekovic Nikola,L,Serbia,33.0,176.0,2022,Serbia,USA,2022-06-22,False,0,0,0,0,0,0,0,0,0,0,0,0,0,0,0,0,1,0,17,18,4,1,2,7
150383.0,Pekovic Nikola,L,Serbia,33.0,176.0,2022,Serbia,Brazil,2022-06-23,False,0,0,0,0,0,0,0,0,0,0,0,0,0,0,0,0,0,0,0,0,2,0,1,3
150383.0,Pekovic Nikola,L,Serbia,33.0,176.0,2022,Serbia,Canada,2022-06-24,True,0,0,0,0,0,1,2,3,0,0,0,0,0,0,0,0,5,0,15,20,8,3,0,11
150383.0,Pekovic Nikola,L,Serbia,33.0,176.0,2022,Serbia,Australia,2022-06-26,True,0,0,0,0,0,0,0,0,0,0,0,0,0,0,0,0,0,0,0,0,0,0,0,0
150383.0,Pekovic Nikola,L,Serbia,33.0,176.0,2022,Slovenia,Serbia,2022-07-06,False,0,0,0,0,0,0,1,1,0,0,0,0,0,0,0,0,2,1,13,16,4,2,0,6
150383.0,Pekovic Nikola,L,Serbia,33.0,176.0,2022,Italy,Serbia,2022-07-08,False,0,0,0,0,0,0,0,0,0,0,0,0,0,0,0,0,0,0,0,0,1,0,0,1
150383.0,Pekovic Nikola,L,Serbia,33.0,176.0,2022,Iran,Serbia,2022-07-09,False,0,0,0,0,0,0,0,0,0,0,0,0,0,0,0,0,0,0,0,0,1,0,0,1
150383.0,Pekovic Nikola,L,Serbia,33.0,176.0,2022,China,Serbia,2022-07-10,True,0,0,0,0,0,0,3,3,0,0,0,0,0,0,0,0,6,0,10,16,7,4,0,11
146579.0,Krsmanovic Petar,MB,Serbia,32.0,205.0,2022,Serbia,USA,2022-06-22,False,0,1,3,4,0,0,1,1,0,0,0,0,0,0,0,0,0,0,0,0,0,1,0,1
146579.0,Krsmanovic Petar,MB,Serbia,32.0,205.0,2022,Serbia,Brazil,2022-06-23,False,0,3,5,8,0,0,0,0,4,0,2,6,0,4,5,9,0,0,1,1,1,0,0,1
146579.0,Krsmanovic Petar,MB,Serbia,32.0,205.0,2022,Serbia,Canada,2022-06-24,True,0,0,2,2,0,0,0,0,0,0,0,0,0,0,0,0,0,0,0,0,0,0,0,0
146579.0,Krsmanovic Petar,MB,Serbia,32.0,205.0,2022,Serbia,Australia,2022-06-26,True,0,0,0,0,0,0,0,0,0,0,0,0,0,0,0,0,0,0,0,0,0,0,0,0
146579.0,Krsmanovic Petar,MB,Serbia,32.0,205.0,2022,Slovenia,Serbia,2022-07-06,False,0,0,1,1,0,0,0,0,0,0,0,0,0,0,0,0,0,0,0,0,0,1,0,1
146579.0,Krsmanovic Petar,MB,Serbia,32.0,205.0,2022,Italy,Serbia,2022-07-08,False,0,0,5,5,0,0,0,0,0,1,3,4,0,0,0,0,0,0,2,2,0,1,0,1
146579.0,Krsmanovic Petar,MB,Serbia,32.0,205.0,2022,Iran,Serbia,2022-07-09,False,0,0,1,1,0,0,0,0,0,0,0,0,0,0,0,0,0,0,0,0,0,0,0,0
146579.0,Krsmanovic Petar,MB,Serbia,32.0,205.0,2022,China,Serbia,2022-07-10,True,0,1,12,13,0,1,2,3,5,2,1,8,1,8,0,9,0,0,1,1,3,0,1,4
124911.0,Jovovic Nikola,S,Serbia,31.0,197.0,2022,Bulgaria,Serbia,2022-06-07,True,0,0,14,14,32,0,56,88,0,0,1,1,0,2,4,6,0,0,0,0,0,3,6,9
124911.0,Jovovic Nikola,S,Serbia,31.0,197.0,2022,Serbia,France,2022-06-09,False,0,0,0,0,0,0,0,0,0,0,0,0,0,0,0,0,0,0,0,0,0,0,0,0
124911.0,Jovovic Nikola,S,Serbia,31.0,197.0,2022,Serbia,Argentina,2022-06-10,True,1,0,13,14,36,0,35,71,0,0,1,1,2,3,7,12,0,0,0,0,3,3,3,9
124911.0,Jovovic Nikola,S,Serbia,31.0,197.0,2022,Germany,Serbia,2022-06-11,False,0,0,13,13,13,0,99,112,4,1,0,5,1,3,3,7,0,1,0,1,4,3,4,11
124911.0,Jovovic Nikola,S,Serbia,31.0,197.0,2022,Serbia,USA,2022-06-22,False,0,1,8,9,23,0,56,79,0,0,0,0,0,2,1,3,0,1,0,1,2,3,0,5
124911.0,Jovovic Nikola,S,Serbia,31.0,197.0,2022,Serbia,Brazil,2022-06-23,False,0,0,0,0,0,0,0,0,0,0,0,0,0,0,0,0,0,0,0,0,0,0,0,0
124911.0,Jovovic Nikola,S,Serbia,31.0,197.0,2022,Serbia,Canada,2022-06-24,True,0,1,11,12,31,0,56,87,1,0,0,1,0,2,1,3,0,0,0,0,2,3,0,5
124911.0,Jovovic Nikola,S,Serbia,31.0,197.0,2022,Serbia,Australia,2022-06-26,True,0,0,10,10,25,0,47,72,2,0,0,2,0,2,1,3,0,0,0,0,3,1,0,4
124911.0,Jovovic Nikola,S,Serbia,31.0,197.0,2022,Slovenia,Serbia,2022-07-06,False,0,1,7,8,15,2,59,76,0,0,1,1,0,1,0,1,0,0,0,0,2,0,0,2
124911.0,Jovovic Nikola,S,Serbia,31.0,197.0,2022,Italy,Serbia,2022-07-08,False,0,0,7,7,14,0,71,85,0,0,0,0,0,1,0,1,0,0,0,0,0,1,0,1
124911.0,Jovovic Nikola,S,Serbia,31.0,197.0,2022,Iran,Serbia,2022-07-09,False,0,0,10,10,14,0,64,78,0,0,0,0,0,0,1,1,0,0,1,1,2,1,1,4
124911.0,Jovovic Nikola,S,Serbia,31.0,197.0,2022,China,Serbia,2022-07-10,True,0,0,0,0,0,0,0,0,0,0,0,0,0,0,0,0,0,0,0,0,0,0,0,0
162122.0,Kujundžić Miran,OH,Serbia,25.0,196.0,2022,Bulgaria,Serbia,2022-06-07,True,6,2,17,25,0,0,1,1,13,6,6,25,1,1,2,4,2,2,21,25,6,5,5,16
162122.0,Kujundžić Miran,OH,Serbia,25.0,196.0,2022,Serbia,France,2022-06-09,False,0,0,0,0,0,0,0,0,0,0,0,0,0,0,0,0,0,0,0,0,0,0,0,0
162122.0,Kujundžić Miran,OH,Serbia,25.0,196.0,2022,Serbia,Argentina,2022-06-10,True,1,0,9,10,0,0,1,1,11,2,7,20,2,3,1,6,4,4,22,30,3,4,1,8
162122.0,Kujundžić Miran,OH,Serbia,25.0,196.0,2022,Germany,Serbia,2022-06-11,False,3,6,12,21,0,0,1,1,13,7,13,33,0,1,0,1,8,3,30,41,9,1,2,12
162122.0,Kujundžić Miran,OH,Serbia,25.0,196.0,2022,Serbia,USA,2022-06-22,False,1,5,11,17,0,0,0,0,11,0,7,18,0,3,0,3,9,2,21,32,2,1,2,5
162122.0,Kujundžić Miran,OH,Serbia,25.0,196.0,2022,Serbia,Brazil,2022-06-23,False,0,0,1,1,0,0,0,0,2,2,0,4,0,2,0,2,0,0,1,1,0,0,0,0
162122.0,Kujundžić Miran,OH,Serbia,25.0,196.0,2022,Serbia,Canada,2022-06-24,True,2,5,10,17,0,0,1,1,12,4,5,21,1,2,1,4,7,4,32,43,2,2,0,4
162122.0,Kujundžić Miran,OH,Serbia,25.0,196.0,2022,Serbia,Australia,2022-06-26,True,0,3,10,13,0,0,0,0,13,2,2,17,0,1,0,1,4,0,7,11,0,1,0,1
162122.0,Kujundžić Miran,OH,Serbia,25.0,196.0,2022,Slovenia,Serbia,2022-07-06,False,0,2,5,7,0,0,0,0,4,3,5,12,0,0,0,0,0,2,11,13,3,1,0,4
162122.0,Kujundžić Miran,OH,Serbia,25.0,196.0,2022,Italy,Serbia,2022-07-08,False,0,2,3,5,0,0,1,1,3,7,5,15,1,0,0,1,0,1,7,8,1,0,0,1
162122.0,Kujundžić Miran,OH,Serbia,25.0,196.0,2022,Iran,Serbia,2022-07-09,False,1,2,8,11,0,0,2,2,7,4,6,17,1,0,0,1,1,0,28,29,2,0,0,2
162122.0,Kujundžić Miran,OH,Serbia,25.0,196.0,2022,China,Serbia,2022-07-10,True,1,2,18,21,0,0,0,0,9,2,2,13,0,3,0,3,1,0,13,14,5,0,1,6
173251.0,Peric Pavle,OH,Serbia,24.0,207.0,2022,Bulgaria,Serbia,2022-06-07,True,0,0,1,1,0,0,0,0,1,1,0,2,0,0,0,0,0,0,2,2,0,0,0,0
173251.0,Peric Pavle,OH,Serbia,24.0,207.0,2022,Serbia,France,2022-06-09,False,1,3,13,17,0,1,2,3,19,3,14,36,1,2,5,8,2,2,14,18,10,3,1,14
173251.0,Peric Pavle,OH,Serbia,24.0,207.0,2022,Serbia,Argentina,2022-06-10,True,1,2,9,12,0,1,0,1,9,5,7,21,2,4,2,8,0,2,14,16,6,5,1,12
173251.0,Peric Pavle,OH,Serbia,24.0,207.0,2022,Germany,Serbia,2022-06-11,False,3,6,11,20,0,0,7,7,18,4,14,36,1,0,4,5,1,3,17,21,5,1,3,9
173251.0,Peric Pavle,OH,Serbia,24.0,207.0,2022,Serbia,USA,2022-06-22,False,1,5,5,11,0,0,1,1,14,3,6,23,1,1,0,2,1,2,18,21,0,1,1,2
173251.0,Peric Pavle,OH,Serbia,24.0,207.0,2022,Serbia,Brazil,2022-06-23,False,1,5,3,9,0,0,2,2,4,2,10,16,1,2,2,5,4,5,13,22,4,0,0,4
173251.0,Peric Pavle,OH,Serbia,24.0,207.0,2022,Serbia,Canada,2022-06-24,True,0,2,3,5,0,0,0,0,1,3,2,6,1,0,1,2,0,2,4,6,2,1,0,3
173251.0,Peric Pavle,OH,Serbia,24.0,207.0,2022,Serbia,Australia,2022-06-26,True,0,0,10,10,0,0,0,0,10,2,3,15,1,1,1,3,3,1,21,25,1,1,0,2
173251.0,Peric Pavle,OH,Serbia,24.0,207.0,2022,Slovenia,Serbia,2022-07-06,False,2,1,9,12,0,0,1,1,7,3,12,22,1,0,0,1,3,0,28,31,0,0,2,2
173251.0,Peric Pavle,OH,Serbia,24.0,207.0,2022,Italy,Serbia,2022-07-08,False,0,1,3,4,0,0,2,2,4,4,2,10,0,0,0,0,1,0,10,11,0,0,0,0
173251.0,Peric Pavle,OH,Serbia,24.0,207.0,2022,Iran,Serbia,2022-07-09,False,0,3,7,10,0,0,1,1,10,7,9,26,0,3,0,3,0,2,19,21,0,0,0,0
173251.0,Peric Pavle,OH,Serbia,24.0,207.0,2022,China,Serbia,2022-07-10,True,1,3,13,17,0,0,2,2,12,2,10,24,2,4,0,6,3,2,25,30,2,2,0,4
124915.0,Atanasijevic Aleksandar,O,Serbia,31.0,200.0,2022,Serbia,USA,2022-06-22,False,3,4,9,16,0,0,0,0,17,5,4,26,0,3,0,3,0,0,1,1,0,2,0,2
124915.0,Atanasijevic Aleksandar,O,Serbia,31.0,200.0,2022,Serbia,Brazil,2022-06-23,False,0,0,0,0,0,0,0,0,0,0,0,0,0,0,0,0,0,0,0,0,0,0,0,0
124915.0,Atanasijevic Aleksandar,O,Serbia,31.0,200.0,2022,Serbia,Canada,2022-06-24,True,1,6,15,22,0,0,3,3,21,6,9,36,0,2,3,5,0,0,0,0,1,4,2,7
124915.0,Atanasijevic Aleksandar,O,Serbia,31.0,200.0,2022,Serbia,Australia,2022-06-26,True,0,4,10,14,0,0,0,0,14,5,7,26,1,2,4,7,0,0,1,1,3,2,1,6
124915.0,Atanasijevic Aleksandar,O,Serbia,31.0,200.0,2022,Slovenia,Serbia,2022-07-06,False,0,5,6,11,0,0,0,0,11,4,9,24,0,2,0,2,0,0,0,0,0,2,0,2
124915.0,Atanasijevic Aleksandar,O,Serbia,31.0,200.0,2022,Italy,Serbia,2022-07-08,False,2,3,5,10,0,0,0,0,12,8,11,31,0,1,0,1,0,0,0,0,1,1,2,4
124915.0,Atanasijevic Aleksandar,O,Serbia,31.0,200.0,2022,Iran,Serbia,2022-07-09,False,0,2,11,13,0,0,1,1,14,5,7,26,0,0,0,0,0,0,0,0,2,1,0,3
124915.0,Atanasijevic Aleksandar,O,Serbia,31.0,200.0,2022,China,Serbia,2022-07-10,True,0,0,0,0,0,0,0,0,0,0,0,0,0,0,0,0,0,0,0,0,0,0,0,0
150382.0,Masulovic Nemanja,MB,Serbia,27.0,205.0,2022,Bulgaria,Serbia,2022-06-07,True,1,1,11,13,0,0,0,0,8,0,3,11,0,6,4,10,0,0,1,1,1,2,1,4
150382.0,Masulovic Nemanja,MB,Serbia,27.0,205.0,2022,Serbia,France,2022-06-09,False,0,0,10,10,0,0,2,2,9,1,2,12,2,4,8,14,0,0,0,0,3,1,1,5
150382.0,Masulovic Nemanja,MB,Serbia,27.0,205.0,2022,Serbia,Argentina,2022-06-10,True,0,1,21,22,0,0,2,2,9,0,3,12,2,4,10,16,0,0,1,1,0,0,1,1
150382.0,Masulovic Nemanja,MB,Serbia,27.0,205.0,2022,Germany,Serbia,2022-06-11,False,0,0,16,16,0,0,3,3,9,0,6,15,4,8,13,25,0,0,1,1,5,1,2,8
150382.0,Masulovic Nemanja,MB,Serbia,27.0,205.0,2022,Serbia,USA,2022-06-22,False,0,0,1,1,1,0,0,1,0,0,1,1,0,1,1,2,0,0,0,0,0,0,0,0
150382.0,Masulovic Nemanja,MB,Serbia,27.0,205.0,2022,Serbia,Brazil,2022-06-23,False,1,0,11,12,0,0,0,0,4,0,3,7,0,2,1,3,0,0,1,1,1,0,1,2
150382.0,Masulovic Nemanja,MB,Serbia,27.0,205.0,2022,Serbia,Canada,2022-06-24,True,0,1,7,8,0,0,0,0,3,2,2,7,0,4,1,5,0,0,1,1,0,0,1,1
150382.0,Masulovic Nemanja,MB,Serbia,27.0,205.0,2022,Serbia,Australia,2022-06-26,True,0,0,0,0,0,0,0,0,0,0,0,0,0,0,0,0,0,0,0,0,0,0,0,0
150382.0,Masulovic Nemanja,MB,Serbia,27.0,205.0,2022,Slovenia,Serbia,2022-07-06,False,0,0,0,0,0,0,0,0,0,0,0,0,0,0,0,0,0,0,0,0,0,0,0,0
150382.0,Masulovic Nemanja,MB,Serbia,27.0,205.0,2022,Italy,Serbia,2022-07-08,False,0,0,8,8,0,0,0,0,5,1,3,9,0,3,0,3,0,0,0,0,1,2,0,3
150382.0,Masulovic Nemanja,MB,Serbia,27.0,205.0,2022,Iran,Serbia,2022-07-09,False,0,0,0,0,0,0,1,1,0,0,0,0,0,0,0,0,0,0,0,0,0,0,0,0
150382.0,Masulovic Nemanja,MB,Serbia,27.0,205.0,2022,China,Serbia,2022-07-10,True,0,0,11,11,0,0,0,0,5,1,6,12,3,3,2,8,0,0,0,0,1,0,0,1
116525.0,Podrascanin Marko,MB,Serbia,35.0,204.0,2022,Serbia,USA,2022-06-22,False,1,2,11,14,0,0,1,1,4,2,5,11,0,4,1,5,0,0,1,1,2,0,0,2
116525.0,Podrascanin Marko,MB,Serbia,35.0,204.0,2022,Serbia,Brazil,2022-06-23,False,0,0,0,0,0,0,0,0,0,0,0,0,0,0,0,0,0,0,0,0,0,0,0,0
116525.0,Podrascanin Marko,MB,Serbia,35.0,204.0,2022,Serbia,Canada,2022-06-24,True,0,1,6,7,0,0,0,0,2,0,0,2,1,2,0,3,0,0,0,0,1,0,0,1
116525.0,Podrascanin Marko,MB,Serbia,35.0,204.0,2022,Serbia,Australia,2022-06-26,True,1,1,13,15,0,0,0,0,4,0,3,7,1,5,2,8,0,0,0,0,3,0,0,3
116525.0,Podrascanin Marko,MB,Serbia,35.0,204.0,2022,Slovenia,Serbia,2022-07-06,False,0,1,5,6,1,0,0,1,4,0,1,5,2,5,0,7,0,0,0,0,0,1,0,1
116525.0,Podrascanin Marko,MB,Serbia,35.0,204.0,2022,Italy,Serbia,2022-07-08,False,0,0,0,0,0,0,0,0,0,0,0,0,0,0,0,0,0,0,0,0,0,0,0,0
116525.0,Podrascanin Marko,MB,Serbia,35.0,204.0,2022,Iran,Serbia,2022-07-09,False,0,1,9,10,0,0,0,0,4,1,2,7,4,4,1,9,0,0,1,1,0,1,0,1
116525.0,Podrascanin Marko,MB,Serbia,35.0,204.0,2022,China,Serbia,2022-07-10,True,0,0,0,0,0,0,0,0,0,0,0,0,0,0,0,0,0,0,0,0,0,0,0,0
136362.0,Lisinac Srecko,MB,Serbia,30.0,205.0,2022,Serbia,USA,2022-06-22,False,0,2,7,9,0,0,0,0,4,0,3,7,1,6,4,11,0,0,1,1,0,0,0,0
136362.0,Lisinac Srecko,MB,Serbia,30.0,205.0,2022,Serbia,Brazil,2022-06-23,False,0,0,0,0,0,0,0,0,0,0,0,0,0,0,0,0,0,0,0,0,0,0,0,0
136362.0,Lisinac Srecko,MB,Serbia,30.0,205.0,2022,Serbia,Canada,2022-06-24,True,0,3,14,17,0,0,0,0,12,1,3,16,3,7,1,11,0,0,0,0,0,0,0,0
136362.0,Lisinac Srecko,MB,Serbia,30.0,205.0,2022,Serbia,Australia,2022-06-26,True,1,2,8,11,1,0,0,1,8,1,3,12,2,5,1,8,0,0,0,0,2,0,1,3
136362.0,Lisinac Srecko,MB,Serbia,30.0,205.0,2022,Slovenia,Serbia,2022-07-06,False,0,5,7,12,0,0,1,1,9,1,2,12,0,3,0,3,0,0,0,0,0,0,0,0
136362.0,Lisinac Srecko,MB,Serbia,30.0,205.0,2022,Italy,Serbia,2022-07-08,False,0,0,12,12,0,0,0,0,3,0,1,4,1,0,0,1,0,0,1,1,0,0,1,1
136362.0,Lisinac Srecko,MB,Serbia,30.0,205.0,2022,Iran,Serbia,2022-07-09,False,0,1,10,11,0,0,0,0,4,1,0,5,1,3,0,4,0,0,1,1,1,0,0,1
136362.0,Lisinac Srecko,MB,Serbia,30.0,205.0,2022,China,Serbia,2022-07-10,True,0,0,1,1,0,0,0,0,0,0,0,0,0,0,0,0,0,0,0,0,0,0,0,0
173250.0,Todorovic Vuk,S,Serbia,24.0,190.0,2022,Bulgaria,Serbia,2022-06-07,True,0,0,0,0,0,0,0,0,0,0,0,0,0,0,0,0,0,0,0,0,0,0,0,0
173250.0,Todorovic Vuk,S,Serbia,24.0,190.0,2022,Serbia,France,2022-06-09,False,0,1,13,14,22,0,64,86,0,0,0,0,0,1,3,4,0,1,3,4,5,2,4,11
173250.0,Todorovic Vuk,S,Serbia,24.0,190.0,2022,Serbia,Argentina,2022-06-10,True,0,0,1,1,5,0,4,9,0,0,0,0,0,0,1,1,0,0,0,0,2,0,0,2
173250.0,Todorovic Vuk,S,Serbia,24.0,190.0,2022,Germany,Serbia,2022-06-11,False,0,0,0,0,0,0,0,0,0,0,0,0,0,0,0,0,0,0,0,0,0,0,0,0
173250.0,Todorovic Vuk,S,Serbia,24.0,190.0,2022,Slovenia,Serbia,2022-07-06,False,0,0,0,0,0,0,4,4,0,0,0,0,0,0,0,0,0,0,0,0,0,0,0,0
173250.0,Todorovic Vuk,S,Serbia,24.0,190.0,2022,Italy,Serbia,2022-07-08,False,0,0,1,1,0,0,4,4,0,0,0,0,0,0,0,0,0,0,0,0,0,0,0,0
173250.0,Todorovic Vuk,S,Serbia,24.0,190.0,2022,Iran,Serbia,2022-07-09,False,0,0,0,0,0,0,0,0,0,0,0,0,0,0,0,0,0,0,0,0,0,0,0,0
173250.0,Todorovic Vuk,S,Serbia,24.0,190.0,2022,China,Serbia,2022-07-10,True,0,1,14,15,20,0,63,83,1,0,0,1,0,3,0,3,0,0,0,0,1,0,1,2
168276.0,Vucicevic Bozidar,O,Serbia,24.0,205.0,2022,Slovenia,Serbia,2022-07-06,False,0,0,0,0,0,0,0,0,0,2,1,3,0,0,0,0,0,0,0,0,0,0,0,0
168276.0,Vucicevic Bozidar,O,Serbia,24.0,205.0,2022,Italy,Serbia,2022-07-08,False,0,0,0,0,0,0,0,0,0,0,0,0,0,0,0,0,0,0,0,0,0,0,0,0
168276.0,Vucicevic Bozidar,O,Serbia,24.0,205.0,2022,Iran,Serbia,2022-07-09,False,0,0,1,1,0,0,0,0,1,3,1,5,0,1,0,1,0,1,0,1,0,0,0,0
168276.0,Vucicevic Bozidar,O,Serbia,24.0,205.0,2022,China,Serbia,2022-07-10,True,4,4,11,19,0,1,0,1,12,6,12,30,2,1,0,3,0,0,0,0,2,0,1,3
189274.0,Marinovic Lazar,OH,Serbia,24.0,197.0,2022,Bulgaria,Serbia,2022-06-07,True,0,3,2,5,0,0,2,2,3,4,3,10,0,2,3,5,1,0,9,10,1,1,0,2
189274.0,Marinovic Lazar,OH,Serbia,24.0,197.0,2022,Serbia,France,2022-06-09,False,0,4,10,14,1,0,3,4,8,7,6,21,1,1,6,8,5,3,19,27,6,1,1,8
189274.0,Marinovic Lazar,OH,Serbia,24.0,197.0,2022,Serbia,Argentina,2022-06-10,True,0,0,1,1,0,1,1,2,0,0,0,0,0,0,0,0,0,0,0,0,0,0,0,0
189274.0,Marinovic Lazar,OH,Serbia,24.0,197.0,2022,Germany,Serbia,2022-06-11,False,0,0,0,0,0,0,0,0,0,0,0,0,0,0,0,0,0,0,0,0,0,0,0,0
164985.0,Nedeljkovic Aleksandar,MB,Serbia,25.0,205.0,2022,Bulgaria,Serbia,2022-06-07,True,1,0,16,17,0,1,0,1,5,1,4,10,3,3,4,10,0,0,1,1,2,4,0,6
164985.0,Nedeljkovic Aleksandar,MB,Serbia,25.0,205.0,2022,Serbia,France,2022-06-09,False,0,0,2,2,0,0,0,0,1,0,0,1,0,1,0,1,0,0,0,0,0,2,0,2
164985.0,Nedeljkovic Aleksandar,MB,Serbia,25.0,205.0,2022,Serbia,Argentina,2022-06-10,True,2,1,14,17,0,0,0,0,6,3,2,11,2,5,8,15,0,0,0,0,0,0,0,0
164985.0,Nedeljkovic Aleksandar,MB,Serbia,25.0,205.0,2022,Germany,Serbia,2022-06-11,False,0,0,24,24,0,1,1,2,6,2,3,11,2,12,8,22,0,0,0,0,5,2,0,7
124920.0,Koprivica Lazar,L,Serbia,31.0,200.0,2022,Bulgaria,Serbia,2022-06-07,True,0,0,0,0,0,0,3,3,0,0,0,0,0,0,0,0,6,1,20,27,3,1,1,5
124920.0,Koprivica Lazar,L,Serbia,31.0,200.0,2022,Serbia,France,2022-06-09,False,0,0,0,0,0,0,0,0,0,0,0,0,0,0,0,0,0,0,0,0,0,0,0,0
124920.0,Koprivica Lazar,L,Serbia,31.0,200.0,2022,Serbia,Argentina,2022-06-10,True,0,0,0,0,0,0,0,0,0,0,0,0,0,0,0,0,0,0,0,0,0,0,0,0
124920.0,Koprivica Lazar,L,Serbia,31.0,200.0,2022,Germany,Serbia,2022-06-11,False,0,0,0,0,0,1,3,4,0,0,0,0,0,0,0,0,6,2,18,26,8,0,0,8
124920.0,Koprivica Lazar,L,Serbia,31.0,200.0,2022,Serbia,USA,2022-06-22,False,0,0,0,0,0,0,0,0,0,0,0,0,0,0,0,0,0,0,0,0,0,0,0,0
124920.0,Koprivica Lazar,L,Serbia,31.0,200.0,2022,Serbia,Brazil,2022-06-23,False,0,0,0,0,0,0,3,3,0,0,0,0,0,0,0,0,6,1,12,19,1,2,0,3
124920.0,Koprivica Lazar,L,Serbia,31.0,200.0,2022,Serbia,Canada,2022-06-24,True,0,0,0,0,0,0,0,0,0,0,0,0,0,0,0,0,0,0,0,0,0,0,0,0
124920.0,Koprivica Lazar,L,Serbia,31.0,200.0,2022,Serbia,Australia,2022-06-26,True,0,0,0,0,0,0,1,1,0,0,0,0,0,0,0,0,3,0,5,8,5,3,0,8
124920.0,Koprivica Lazar,L,Serbia,31.0,200.0,2022,Slovenia,Serbia,2022-07-06,False,0,0,0,0,0,0,0,0,0,0,0,0,0,0,0,0,0,0,0,0,0,0,0,0
124920.0,Koprivica Lazar,L,Serbia,31.0,200.0,2022,Italy,Serbia,2022-07-08,False,0,0,0,0,0,0,1,1,0,0,0,0,0,0,0,0,0,3,14,17,2,1,0,3
124920.0,Koprivica Lazar,L,Serbia,31.0,200.0,2022,Iran,Serbia,2022-07-09,False,0,0,0,0,0,0,4,4,0,0,0,0,0,0,0,0,1,3,13,17,4,3,0,7
124920.0,Koprivica Lazar,L,Serbia,31.0,200.0,2022,China,Serbia,2022-07-10,True,0,0,0,0,0,0,0,0,0,0,0,0,0,0,0,0,0,0,0,0,0,0,0,0
189272.0,Meljanac Nikola,O,Serbia,24.0,201.0,2022,Bulgaria,Serbia,2022-06-07,True,0,0,1,1,0,0,0,0,4,0,0,4,0,0,0,0,0,0,0,0,0,1,0,1
189272.0,Meljanac Nikola,O,Serbia,24.0,201.0,2022,Serbia,France,2022-06-09,False,1,6,9,16,0,0,3,3,18,6,14,38,1,4,2,7,0,0,0,0,1,3,4,8
189272.0,Meljanac Nikola,O,Serbia,24.0,201.0,2022,Serbia,Argentina,2022-06-10,True,0,1,1,2,0,0,0,0,3,1,0,4,0,0,0,0,0,0,0,0,0,1,0,1
189272.0,Meljanac Nikola,O,Serbia,24.0,201.0,2022,Germany,Serbia,2022-06-11,False,0,0,0,0,0,0,0,0,0,0,0,0,0,0,0,0,0,0,0,0,0,0,0,0
189272.0,Meljanac Nikola,O,Serbia,24.0,201.0,2022,Serbia,USA,2022-06-22,False,0,1,5,6,0,0,0,0,4,3,0,7,0,0,0,0,0,0,0,0,1,0,0,1
189272.0,Meljanac Nikola,O,Serbia,24.0,201.0,2022,Serbia,Brazil,2022-06-23,False,1,5,5,11,0,0,1,1,13,8,5,26,0,1,1,2,0,0,0,0,3,1,1,5
189272.0,Meljanac Nikola,O,Serbia,24.0,201.0,2022,Serbia,Canada,2022-06-24,True,0,0,0,0,0,0,0,0,0,0,0,0,0,0,0,0,0,0,0,0,0,0,0,0
189272.0,Meljanac Nikola,O,Serbia,24.0,201.0,2022,Serbia,Australia,2022-06-26,True,0,0,0,0,0,0,0,0,0,0,0,0,0,0,0,0,0,0,0,0,0,0,0,0
124912.0,Petkovic Dusan,O,Serbia,31.0,202.0,2022,Bulgaria,Serbia,2022-06-07,True,0,2,9,11,0,1,2,3,13,9,9,31,0,1,1,2,0,0,0,0,4,2,5,11
124912.0,Petkovic Dusan,O,Serbia,31.0,202.0,2022,Serbia,France,2022-06-09,False,1,1,3,5,0,0,0,0,0,0,0,0,0,0,0,0,0,0,0,0,0,1,0,1
124912.0,Petkovic Dusan,O,Serbia,31.0,202.0,2022,Serbia,Argentina,2022-06-10,True,0,3,6,9,0,0,0,0,9,5,10,24,1,0,4,5,0,0,0,0,4,2,1,7
124912.0,Petkovic Dusan,O,Serbia,31.0,202.0,2022,Germany,Serbia,2022-06-11,False,4,5,16,25,0,0,6,6,20,11,9,40,1,4,5,10,0,0,0,0,7,4,2,13
189276.0,Rudic Andrej,MB,Serbia,24.0,201.0,2022,Bulgaria,Serbia,2022-06-07,True,0,0,0,0,0,0,0,0,0,0,0,0,0,0,0,0,0,0,0,0,0,0,0,0
189276.0,Rudic Andrej,MB,Serbia,24.0,201.0,2022,Serbia,France,2022-06-09,False,0,0,3,3,0,0,0,0,0,0,0,0,0,0,0,0,0,0,0,0,0,2,0,2
189276.0,Rudic Andrej,MB,Serbia,24.0,201.0,2022,Serbia,Argentina,2022-06-10,True,0,0,0,0,0,0,0,0,0,0,0,0,0,0,0,0,0,0,0,0,0,0,0,0
189276.0,Rudic Andrej,MB,Serbia,24.0,201.0,2022,Germany,Serbia,2022-06-11,False,0,1,0,1,0,0,0,0,0,0,0,0,0,0,0,0,0,0,0,0,0,0,0,0
166724.0,Vulikic Andrija,S,Serbia,26.0,193.0,2022,Serbia,USA,2022-06-22,False,0,1,1,2,1,0,13,14,1,0,0,1,0,0,0,0,0,0,0,0,0,2,2,4
166724.0,Vulikic Andrija,S,Serbia,26.0,193.0,2022,Serbia,Brazil,2022-06-23,False,0,0,9,9,13,3,57,73,0,0,2,2,1,0,1,2,0,1,0,1,0,3,0,3
166724.0,Vulikic Andrija,S,Serbia,26.0,193.0,2022,Serbia,Canada,2022-06-24,True,0,0,2,2,0,0,6,6,0,0,0,0,0,0,0,0,0,0,0,0,1,0,0,1
166724.0,Vulikic Andrija,S,Serbia,26.0,193.0,2022,Serbia,Australia,2022-06-26,True,0,0,0,0,0,0,0,0,0,0,0,0,0,0,0,0,0,0,0,0,0,0,0,0
151390.0,Štern Tonček,O,Slovenia,27.0,200.0,2022,Slovenia,China,2022-06-11,True,0,0,2,2,0,0,0,0,4,1,3,8,0,1,2,3,0,0,0,0,1,0,0,1
151390.0,Štern Tonček,O,Slovenia,27.0,200.0,2022,Italy,Slovenia,2022-06-25,False,0,0,4,4,0,0,0,0,1,0,0,1,0,0,1,1,0,0,0,0,1,0,0,1
151390.0,Štern Tonček,O,Slovenia,27.0,200.0,2022,Japan,Slovenia,2022-06-26,False,1,4,10,15,0,0,2,2,14,9,3,26,1,6,3,10,0,0,0,0,3,2,0,5
151390.0,Štern Tonček,O,Slovenia,27.0,200.0,2022,Slovenia,Serbia,2022-07-06,True,1,2,12,15,0,0,1,1,8,4,6,18,1,0,0,1,0,0,0,0,1,0,0,1
151390.0,Štern Tonček,O,Slovenia,27.0,200.0,2022,Bulgaria,Slovenia,2022-07-07,True,3,3,16,22,0,0,0,0,14,10,8,32,1,0,0,1,0,0,0,0,2,0,1,3
151390.0,Štern Tonček,O,Slovenia,27.0,200.0,2022,Slovenia,Iran,2022-07-08,False,1,3,7,11,0,0,0,0,5,3,4,12,1,3,0,4,0,0,1,1,2,2,0,4
151390.0,Štern Tonček,O,Slovenia,27.0,200.0,2022,Poland,Slovenia,2022-07-10,False,3,5,7,15,0,0,2,2,15,5,4,24,2,6,0,8,0,0,1,1,3,0,2,5
114962.0,Pajenk Alen,MB,Slovenia,36.0,203.0,2022,Slovenia,China,2022-06-11,True,0,1,3,4,1,0,0,1,5,0,0,5,1,1,2,4,0,0,1,1,1,1,1,3
114962.0,Pajenk Alen,MB,Slovenia,36.0,203.0,2022,Slovenia,Netherlands,2022-06-21,False,1,2,8,11,0,0,1,1,5,1,5,11,0,3,5,8,0,0,1,1,2,0,0,2
114962.0,Pajenk Alen,MB,Slovenia,36.0,203.0,2022,Argentina,Slovenia,2022-06-23,True,0,2,11,13,1,0,1,2,6,2,5,13,0,2,6,8,0,0,0,0,2,1,0,3
114962.0,Pajenk Alen,MB,Slovenia,36.0,203.0,2022,Italy,Slovenia,2022-06-25,False,0,0,0,0,0,0,0,0,0,0,0,0,0,0,0,0,0,0,0,0,0,0,0,0
114962.0,Pajenk Alen,MB,Slovenia,36.0,203.0,2022,Japan,Slovenia,2022-06-26,False,0,6,4,10,1,0,0,1,6,1,3,10,2,3,6,11,0,0,0,0,2,0,0,2
114962.0,Pajenk Alen,MB,Slovenia,36.0,203.0,2022,Slovenia,Serbia,2022-07-06,True,0,3,9,12,0,0,0,0,6,1,1,8,1,3,0,4,0,0,0,0,1,0,0,1
114962.0,Pajenk Alen,MB,Slovenia,36.0,203.0,2022,Bulgaria,Slovenia,2022-07-07,True,0,3,12,15,0,0,0,0,6,0,2,8,3,0,1,4,0,0,1,1,1,2,0,3
114962.0,Pajenk Alen,MB,Slovenia,36.0,203.0,2022,Slovenia,Iran,2022-07-08,False,0,2,2,4,0,0,0,0,1,1,1,3,0,1,0,1,0,0,0,0,0,0,0,0
114962.0,Pajenk Alen,MB,Slovenia,36.0,203.0,2022,Poland,Slovenia,2022-07-10,False,1,3,10,14,0,0,0,0,6,1,3,10,2,2,0,4,0,0,1,1,1,0,1,2
168715.0,Planinšič Uroš,S,Slovenia,24.0,186.0,2022,Slovenia,China,2022-06-11,True,0,0,1,1,5,1,15,21,0,0,0,0,0,0,2,2,0,0,0,0,0,0,0,0
151391.0,Kozamernik Jan,MB,Slovenia,27.0,204.0,2022,Slovenia,China,2022-06-11,True,0,1,3,4,0,0,0,0,2,0,0,2,1,2,0,3,0,0,0,0,0,0,0,0
151391.0,Kozamernik Jan,MB,Slovenia,27.0,204.0,2022,Slovenia,Netherlands,2022-06-21,False,0,2,7,9,0,0,1,1,2,2,3,7,4,4,4,12,0,0,1,1,2,0,1,3
151391.0,Kozamernik Jan,MB,Slovenia,27.0,204.0,2022,Argentina,Slovenia,2022-06-23,True,1,2,14,17,0,0,0,0,5,1,2,8,3,7,8,18,0,0,0,0,4,1,2,7
151391.0,Kozamernik Jan,MB,Slovenia,27.0,204.0,2022,Italy,Slovenia,2022-06-25,False,0,2,7,9,0,0,1,1,3,2,3,8,0,3,3,6,0,0,2,2,0,1,0,1
151391.0,Kozamernik Jan,MB,Slovenia,27.0,204.0,2022,Japan,Slovenia,2022-06-26,False,0,1,20,21,0,0,1,1,5,0,4,9,3,5,3,11,0,0,0,0,6,1,0,7
151391.0,Kozamernik Jan,MB,Slovenia,27.0,204.0,2022,Slovenia,Serbia,2022-07-06,True,0,1,9,10,0,0,0,0,2,0,3,5,2,2,0,4,0,0,1,1,0,1,0,1
151391.0,Kozamernik Jan,MB,Slovenia,27.0,204.0,2022,Bulgaria,Slovenia,2022-07-07,True,0,0,19,19,0,0,0,0,5,0,0,5,3,2,0,5,0,0,1,1,1,0,0,1
151391.0,Kozamernik Jan,MB,Slovenia,27.0,204.0,2022,Slovenia,Iran,2022-07-08,False,0,1,10,11,0,0,1,1,5,0,2,7,2,1,2,5,0,0,0,0,1,0,0,1
151391.0,Kozamernik Jan,MB,Slovenia,27.0,204.0,2022,Poland,Slovenia,2022-07-10,False,1,3,8,12,0,0,0,0,4,0,1,5,1,2,0,3,0,0,1,1,2,0,0,2
114952.0,Gasparini Mitja,O,Slovenia,38.0,202.0,2022,Slovenia,China,2022-06-11,True,0,3,13,16,0,1,0,1,12,4,4,20,1,2,2,5,0,0,0,0,3,3,1,7
114952.0,Gasparini Mitja,O,Slovenia,38.0,202.0,2022,Slovenia,Serbia,2022-07-06,True,0,0,0,0,0,0,0,0,0,0,0,0,0,0,0,0,0,0,0,0,0,0,0,0
114952.0,Gasparini Mitja,O,Slovenia,38.0,202.0,2022,Bulgaria,Slovenia,2022-07-07,True,0,0,0,0,0,0,0,0,0,0,0,0,0,0,0,0,0,0,0,0,0,0,0,0
114952.0,Gasparini Mitja,O,Slovenia,38.0,202.0,2022,Slovenia,Iran,2022-07-08,False,0,0,0,0,0,0,0,0,1,0,0,1,0,0,0,0,0,0,0,0,0,0,0,0
114952.0,Gasparini Mitja,O,Slovenia,38.0,202.0,2022,Poland,Slovenia,2022-07-10,False,0,1,0,1,0,0,0,0,0,0,0,0,0,0,0,0,0,0,0,0,0,0,0,0
153301.0,Košenina Alan,L,Slovenia,26.0,189.0,2022,Slovenia,China,2022-06-11,True,0,0,0,0,0,0,0,0,0,0,0,0,0,0,0,0,0,0,0,0,0,0,0,0
153301.0,Košenina Alan,L,Slovenia,26.0,189.0,2022,Slovenia,Netherlands,2022-06-21,False,0,0,0,0,0,0,2,2,0,0,0,0,0,0,0,0,2,3,12,17,10,4,0,14
153301.0,Košenina Alan,L,Slovenia,26.0,189.0,2022,Argentina,Slovenia,2022-06-23,True,0,0,0,0,1,0,4,5,0,0,0,0,0,0,0,0,9,3,22,34,9,3,3,15
153301.0,Košenina Alan,L,Slovenia,26.0,189.0,2022,Italy,Slovenia,2022-06-25,False,0,0,0,0,0,0,1,1,0,0,0,0,0,0,0,0,3,1,14,18,2,9,0,11
153301.0,Košenina Alan,L,Slovenia,26.0,189.0,2022,Japan,Slovenia,2022-06-26,False,0,0,0,0,0,0,0,0,0,0,0,0,0,0,0,0,0,0,0,0,0,0,0,0
153301.0,Košenina Alan,L,Slovenia,26.0,189.0,2022,Slovenia,Serbia,2022-07-06,True,0,0,0,0,0,0,0,0,0,0,0,0,0,0,0,0,0,0,0,0,0,0,0,0
153301.0,Košenina Alan,L,Slovenia,26.0,189.0,2022,Bulgaria,Slovenia,2022-07-07,True,0,0,0,0,0,0,0,0,0,0,0,0,0,0,0,0,0,0,0,0,0,0,0,0
153301.0,Košenina Alan,L,Slovenia,26.0,189.0,2022,Slovenia,Iran,2022-07-08,False,0,0,0,0,0,0,0,0,0,0,0,0,0,0,0,0,0,0,0,0,0,0,0,0
153301.0,Košenina Alan,L,Slovenia,26.0,189.0,2022,Poland,Slovenia,2022-07-10,False,0,0,0,0,0,0,0,0,0,0,0,0,0,0,0,0,0,0,0,0,0,0,0,0
154046.0,Bošnjak Crtomir,OH,Slovenia,22.0,196.0,2022,Slovenia,China,2022-06-11,True,0,0,0,0,0,0,0,0,0,0,0,0,0,0,0,0,0,0,0,0,0,0,0,0
154046.0,Bošnjak Crtomir,OH,Slovenia,22.0,196.0,2022,Slovenia,Netherlands,2022-06-21,False,0,0,0,0,0,0,0,0,0,0,0,0,0,0,0,0,0,0,0,0,0,0,0,0
154046.0,Bošnjak Crtomir,OH,Slovenia,22.0,196.0,2022,Argentina,Slovenia,2022-06-23,True,0,0,0,0,0,0,0,0,0,0,0,0,0,0,0,0,0,0,0,0,0,0,0,0
154046.0,Bošnjak Crtomir,OH,Slovenia,22.0,196.0,2022,Italy,Slovenia,2022-06-25,False,0,1,1,2,0,0,0,0,2,1,0,3,0,0,0,0,0,0,2,2,1,0,0,1
154046.0,Bošnjak Crtomir,OH,Slovenia,22.0,196.0,2022,Japan,Slovenia,2022-06-26,False,0,0,0,0,0,0,0,0,0,0,0,0,0,0,0,0,0,0,0,0,0,0,0,0
114956.0,Vincic Dejan,S,Slovenia,36.0,200.0,2022,Slovenia,Netherlands,2022-06-21,False,0,0,1,1,1,0,0,1,0,0,0,0,0,0,0,0,0,0,1,1,0,0,0,0
114956.0,Vincic Dejan,S,Slovenia,36.0,200.0,2022,Argentina,Slovenia,2022-06-23,True,0,0,1,1,0,0,0,0,0,0,0,0,0,0,0,0,0,0,0,0,0,0,0,0
114956.0,Vincic Dejan,S,Slovenia,36.0,200.0,2022,Italy,Slovenia,2022-06-25,False,0,0,7,7,12,0,49,61,1,0,1,2,0,0,2,2,0,0,0,0,6,1,1,8
114956.0,Vincic Dejan,S,Slovenia,36.0,200.0,2022,Japan,Slovenia,2022-06-26,False,0,0,1,1,0,0,0,0,0,0,0,0,0,0,0,0,0,0,0,0,0,0,0,0
114956.0,Vincic Dejan,S,Slovenia,36.0,200.0,2022,Slovenia,Serbia,2022-07-06,True,0,1,9,10,12,0,48,60,2,0,1,3,0,3,0,3,0,0,0,0,0,0,0,0
114956.0,Vincic Dejan,S,Slovenia,36.0,200.0,2022,Bulgaria,Slovenia,2022-07-07,True,0,0,0,0,0,0,0,0,0,0,0,0,0,0,0,0,0,0,0,0,0,0,0,0
114956.0,Vincic Dejan,S,Slovenia,36.0,200.0,2022,Slovenia,Iran,2022-07-08,False,1,0,8,9,15,1,42,58,0,0,1,1,1,1,0,2,0,0,1,1,0,2,0,2
114956.0,Vincic Dejan,S,Slovenia,36.0,200.0,2022,Poland,Slovenia,2022-07-10,False,1,0,2,3,1,0,22,23,0,0,1,1,0,1,0,1,0,0,0,0,0,0,0,0
151404.0,Štalekar Sašo,MB,Slovenia,26.0,214.0,2022,Slovenia,Netherlands,2022-06-21,False,0,0,0,0,0,0,0,0,0,0,0,0,0,0,0,0,0,0,0,0,0,0,0,0
151404.0,Štalekar Sašo,MB,Slovenia,26.0,214.0,2022,Argentina,Slovenia,2022-06-23,True,0,0,0,0,0,0,0,0,0,0,0,0,0,0,0,0,0,0,0,0,0,0,0,0
151404.0,Štalekar Sašo,MB,Slovenia,26.0,214.0,2022,Italy,Slovenia,2022-06-25,False,0,0,9,9,0,0,1,1,1,0,4,5,1,4,5,10,0,0,3,3,2,0,0,2
151404.0,Štalekar Sašo,MB,Slovenia,26.0,214.0,2022,Japan,Slovenia,2022-06-26,False,0,0,0,0,0,0,0,0,0,0,0,0,0,1,0,1,0,0,0,0,0,0,0,0
144483.0,Koncilja Danijel,MB,Slovenia,32.0,201.0,2022,Slovenia,China,2022-06-11,True,0,2,9,11,1,0,0,1,9,1,2,12,1,2,3,6,1,0,0,1,3,0,0,3
144483.0,Koncilja Danijel,MB,Slovenia,32.0,201.0,2022,Slovenia,Netherlands,2022-06-21,False,0,4,4,8,0,0,1,1,8,3,9,20,0,3,2,5,0,1,0,1,0,2,1,3
144483.0,Koncilja Danijel,MB,Slovenia,32.0,201.0,2022,Argentina,Slovenia,2022-06-23,True,0,0,0,0,0,0,0,0,0,0,0,0,0,0,0,0,0,0,0,0,0,0,0,0
144483.0,Koncilja Danijel,MB,Slovenia,32.0,201.0,2022,Italy,Slovenia,2022-06-25,False,0,2,1,3,0,0,0,0,1,0,1,2,1,1,0,2,0,0,0,0,0,0,0,0
144483.0,Koncilja Danijel,MB,Slovenia,32.0,201.0,2022,Japan,Slovenia,2022-06-26,False,0,0,0,0,0,0,0,0,0,0,0,0,0,0,1,1,0,0,0,0,0,0,1,1
144483.0,Koncilja Danijel,MB,Slovenia,32.0,201.0,2022,Slovenia,Serbia,2022-07-06,True,0,0,0,0,0,0,0,0,0,0,0,0,0,0,0,0,0,0,0,0,0,0,0,0
144483.0,Koncilja Danijel,MB,Slovenia,32.0,201.0,2022,Bulgaria,Slovenia,2022-07-07,True,0,0,0,0,0,0,0,0,0,0,0,0,0,0,0,0,0,0,0,0,0,0,0,0
144483.0,Koncilja Danijel,MB,Slovenia,32.0,201.0,2022,Slovenia,Iran,2022-07-08,False,0,1,3,4,0,0,0,0,1,0,3,4,0,3,0,3,0,0,0,0,0,0,1,1
144483.0,Koncilja Danijel,MB,Slovenia,32.0,201.0,2022,Poland,Slovenia,2022-07-10,False,0,0,0,0,0,0,0,0,0,0,0,0,0,0,0,0,0,0,0,0,0,0,0,0
154546.0,Klobucar Jan,L,Slovenia,30.0,196.0,2022,Slovenia,China,2022-06-11,True,0,0,1,1,0,0,0,0,0,0,0,0,0,0,0,0,1,0,0,1,0,0,0,0
154546.0,Klobucar Jan,L,Slovenia,30.0,196.0,2022,Slovenia,Netherlands,2022-06-21,False,0,0,0,0,0,0,0,0,0,0,0,0,0,0,0,0,0,0,3,3,0,0,0,0
154546.0,Klobucar Jan,L,Slovenia,30.0,196.0,2022,Argentina,Slovenia,2022-06-23,True,0,0,0,0,0,0,0,0,0,0,0,0,0,0,0,0,0,0,0,0,0,0,0,0
154546.0,Klobucar Jan,L,Slovenia,30.0,196.0,2022,Italy,Slovenia,2022-06-25,False,0,0,6,6,0,0,2,2,3,1,5,9,0,1,1,2,4,1,8,13,6,3,0,9
154546.0,Klobucar Jan,L,Slovenia,30.0,196.0,2022,Japan,Slovenia,2022-06-26,False,0,0,0,0,0,0,0,0,0,0,0,0,0,0,0,0,0,0,0,0,0,0,0,0
144415.0,Kovačič Jani,L,Slovenia,30.0,186.0,2022,Slovenia,China,2022-06-11,True,0,0,0,0,3,0,1,4,0,0,0,0,0,0,0,0,9,1,18,28,12,4,0,16
144415.0,Kovačič Jani,L,Slovenia,30.0,186.0,2022,Italy,Slovenia,2022-06-25,False,0,0,0,0,0,0,0,0,0,0,0,0,0,0,0,0,0,0,0,0,0,0,0,0
144415.0,Kovačič Jani,L,Slovenia,30.0,186.0,2022,Japan,Slovenia,2022-06-26,False,0,0,0,0,0,0,4,4,0,0,0,0,0,0,0,0,11,1,11,23,6,8,2,16
144415.0,Kovačič Jani,L,Slovenia,30.0,186.0,2022,Slovenia,Serbia,2022-07-06,True,0,0,0,0,0,0,1,1,0,0,0,0,0,0,0,0,2,0,8,10,4,1,0,5
144415.0,Kovačič Jani,L,Slovenia,30.0,186.0,2022,Bulgaria,Slovenia,2022-07-07,True,0,0,0,0,0,0,0,0,0,0,0,0,0,0,0,0,1,0,18,19,8,2,1,11
144415.0,Kovačič Jani,L,Slovenia,30.0,186.0,2022,Slovenia,Iran,2022-07-08,False,0,0,0,0,0,0,3,3,0,0,0,0,0,0,0,0,2,4,21,27,1,2,1,4
144415.0,Kovačič Jani,L,Slovenia,30.0,186.0,2022,Poland,Slovenia,2022-07-10,False,0,0,0,0,0,0,0,0,0,0,0,0,0,0,0,0,2,5,15,22,1,4,0,5
155920.0,Štern Žiga,OH,Slovenia,29.0,193.0,2022,Slovenia,China,2022-06-11,True,0,2,13,15,1,0,3,4,9,7,7,23,0,2,0,2,10,1,15,26,5,0,2,7
155920.0,Štern Žiga,OH,Slovenia,29.0,193.0,2022,Slovenia,Netherlands,2022-06-21,False,0,3,9,12,0,0,0,0,11,3,9,23,0,1,3,4,5,2,6,13,6,1,1,8
155920.0,Štern Žiga,OH,Slovenia,29.0,193.0,2022,Argentina,Slovenia,2022-06-23,True,0,3,14,17,0,0,3,3,8,4,5,17,1,0,3,4,3,0,6,9,5,2,1,8
155920.0,Štern Žiga,OH,Slovenia,29.0,193.0,2022,Italy,Slovenia,2022-06-25,False,0,2,5,7,0,0,3,3,11,1,6,18,1,0,1,2,2,3,4,9,2,2,1,5
155920.0,Štern Žiga,OH,Slovenia,29.0,193.0,2022,Japan,Slovenia,2022-06-26,False,0,1,1,2,0,0,2,2,0,0,0,0,0,0,0,0,1,0,1,2,2,0,0,2
155920.0,Štern Žiga,OH,Slovenia,29.0,193.0,2022,Slovenia,Serbia,2022-07-06,True,0,0,0,0,0,0,0,0,0,0,0,0,0,0,0,0,0,0,0,0,0,0,0,0
155920.0,Štern Žiga,OH,Slovenia,29.0,193.0,2022,Bulgaria,Slovenia,2022-07-07,True,0,0,0,0,0,0,0,0,2,0,2,4,0,1,0,1,0,1,1,2,0,0,0,0
155920.0,Štern Žiga,OH,Slovenia,29.0,193.0,2022,Slovenia,Iran,2022-07-08,False,0,0,0,0,0,0,0,0,0,0,0,0,0,0,0,0,0,0,0,0,0,0,0,0
155920.0,Štern Žiga,OH,Slovenia,29.0,193.0,2022,Poland,Slovenia,2022-07-10,False,0,0,0,0,0,0,0,0,0,0,0,0,0,0,0,0,0,0,0,0,0,0,0,0
161754.0,Videčnik Matic,MB,Slovenia,29.0,203.0,2022,Slovenia,China,2022-06-11,True,0,0,5,5,0,0,1,1,1,2,1,4,1,1,2,4,3,0,0,3,1,0,0,1
161754.0,Videčnik Matic,MB,Slovenia,29.0,203.0,2022,Slovenia,Serbia,2022-07-06,True,0,0,0,0,0,0,0,0,0,0,0,0,0,0,0,0,0,0,0,0,0,0,0,0
161754.0,Videčnik Matic,MB,Slovenia,29.0,203.0,2022,Bulgaria,Slovenia,2022-07-07,True,0,0,0,0,0,0,0,0,0,0,0,0,0,0,0,0,0,0,0,0,0,0,0,0
161754.0,Videčnik Matic,MB,Slovenia,29.0,203.0,2022,Slovenia,Iran,2022-07-08,False,0,0,1,1,0,0,0,0,0,0,0,0,0,0,0,0,0,0,1,1,0,0,0,0
161754.0,Videčnik Matic,MB,Slovenia,29.0,203.0,2022,Poland,Slovenia,2022-07-10,False,0,0,0,0,0,0,0,0,0,0,0,0,0,0,0,0,0,0,0,0,0,0,0,0
119018.0,Ropret Gregor,S,Slovenia,34.0,192.0,2022,Slovenia,China,2022-06-11,True,2,3,18,23,37,0,36,73,0,0,1,1,1,0,1,2,0,0,2,2,6,0,1,7
119018.0,Ropret Gregor,S,Slovenia,34.0,192.0,2022,Slovenia,Netherlands,2022-06-21,False,0,2,11,13,16,1,53,70,1,0,0,1,1,2,0,3,0,0,0,0,4,0,1,5
119018.0,Ropret Gregor,S,Slovenia,34.0,192.0,2022,Argentina,Slovenia,2022-06-23,True,2,2,16,20,15,0,76,91,1,0,1,2,1,1,3,5,0,0,1,1,14,3,0,17
119018.0,Ropret Gregor,S,Slovenia,34.0,192.0,2022,Italy,Slovenia,2022-06-25,False,0,0,1,1,0,0,4,4,0,0,0,0,0,0,0,0,0,0,1,1,0,1,0,1
119018.0,Ropret Gregor,S,Slovenia,34.0,192.0,2022,Japan,Slovenia,2022-06-26,False,0,1,10,11,24,0,64,88,0,0,0,0,0,2,1,3,0,0,0,0,8,1,1,10
119018.0,Ropret Gregor,S,Slovenia,34.0,192.0,2022,Slovenia,Serbia,2022-07-06,True,0,0,0,0,0,0,0,0,0,0,0,0,0,0,0,0,0,0,0,0,0,0,0,0
119018.0,Ropret Gregor,S,Slovenia,34.0,192.0,2022,Bulgaria,Slovenia,2022-07-07,True,0,2,10,12,24,2,64,90,0,0,1,1,1,2,0,3,0,1,0,1,1,0,1,2
119018.0,Ropret Gregor,S,Slovenia,34.0,192.0,2022,Slovenia,Iran,2022-07-08,False,0,0,0,0,0,0,0,0,0,0,0,0,0,0,0,0,0,0,0,0,0,0,0,0
119018.0,Ropret Gregor,S,Slovenia,34.0,192.0,2022,Poland,Slovenia,2022-07-10,False,0,2,5,7,11,1,60,72,0,0,0,0,0,1,0,1,0,0,1,1,0,0,1,1
114957.0,Urnaut Tine,OH,Slovenia,34.0,200.0,2022,Slovenia,Netherlands,2022-06-21,False,0,0,0,0,0,0,1,1,0,0,0,0,0,0,0,0,0,0,5,5,0,0,1,1
114957.0,Urnaut Tine,OH,Slovenia,34.0,200.0,2022,Argentina,Slovenia,2022-06-23,True,2,3,15,20,0,0,5,5,17,3,14,34,0,4,3,7,9,0,10,19,9,4,0,13
114957.0,Urnaut Tine,OH,Slovenia,34.0,200.0,2022,Italy,Slovenia,2022-06-25,False,0,0,0,0,0,0,0,0,0,0,0,0,0,0,0,0,0,0,0,0,0,0,0,0
114957.0,Urnaut Tine,OH,Slovenia,34.0,200.0,2022,Japan,Slovenia,2022-06-26,False,1,2,11,14,0,0,2,2,9,3,11,23,1,2,1,4,6,3,22,31,4,4,1,9
114957.0,Urnaut Tine,OH,Slovenia,34.0,200.0,2022,Slovenia,Serbia,2022-07-06,True,0,1,7,8,0,0,1,1,11,0,4,15,1,3,1,5,0,0,14,14,0,1,0,1
114957.0,Urnaut Tine,OH,Slovenia,34.0,200.0,2022,Bulgaria,Slovenia,2022-07-07,True,0,0,0,0,0,0,0,0,0,0,0,0,0,0,0,0,0,0,0,0,0,0,0,0
114957.0,Urnaut Tine,OH,Slovenia,34.0,200.0,2022,Slovenia,Iran,2022-07-08,False,2,1,2,5,0,0,2,2,2,4,2,8,0,0,0,0,0,0,7,7,0,1,0,1
114957.0,Urnaut Tine,OH,Slovenia,34.0,200.0,2022,Poland,Slovenia,2022-07-10,False,1,3,9,13,0,0,0,0,7,2,16,25,1,0,0,1,1,2,18,21,3,1,0,4
136918.0,Čebulj Klemen,OH,Slovenia,31.0,202.0,2022,Slovenia,Serbia,2022-07-06,True,3,3,12,18,0,0,0,0,7,1,7,15,1,3,0,4,4,2,12,18,5,0,0,5
136918.0,Čebulj Klemen,OH,Slovenia,31.0,202.0,2022,Bulgaria,Slovenia,2022-07-07,True,0,2,9,11,0,0,0,0,13,2,9,24,1,1,1,3,3,2,26,31,2,0,1,3
136918.0,Čebulj Klemen,OH,Slovenia,31.0,202.0,2022,Slovenia,Iran,2022-07-08,False,0,3,8,11,0,0,0,0,10,6,6,22,1,3,0,4,2,0,10,12,1,0,0,1
136918.0,Čebulj Klemen,OH,Slovenia,31.0,202.0,2022,Poland,Slovenia,2022-07-10,False,0,4,9,13,0,0,0,0,9,7,12,28,0,3,0,3,0,2,29,31,2,0,1,3
168747.0,Možič Rok,OH,Slovenia,21.0,200.0,2022,Slovenia,China,2022-06-11,True,0,3,9,12,1,0,0,1,14,1,13,28,3,3,1,7,6,1,6,13,6,0,0,6
168747.0,Možič Rok,OH,Slovenia,21.0,200.0,2022,Slovenia,Netherlands,2022-06-21,False,1,4,5,10,0,0,4,4,8,2,9,19,3,1,2,6,3,3,16,22,7,0,1,8
168747.0,Možič Rok,OH,Slovenia,21.0,200.0,2022,Argentina,Slovenia,2022-06-23,True,1,2,9,12,0,0,5,5,13,6,19,38,3,4,6,13,0,1,1,2,5,0,0,5
168747.0,Možič Rok,OH,Slovenia,21.0,200.0,2022,Italy,Slovenia,2022-06-25,False,0,3,7,10,0,0,0,0,10,5,9,24,1,1,2,4,3,1,8,12,4,2,1,7
168747.0,Možič Rok,OH,Slovenia,21.0,200.0,2022,Japan,Slovenia,2022-06-26,False,0,4,6,10,0,0,3,3,18,4,15,37,2,6,3,11,6,1,16,23,0,0,2,2
168747.0,Možič Rok,OH,Slovenia,21.0,200.0,2022,Slovenia,Serbia,2022-07-06,True,0,0,0,0,0,0,0,0,0,0,0,0,0,0,0,0,0,0,0,0,0,0,0,0
168747.0,Možič Rok,OH,Slovenia,21.0,200.0,2022,Bulgaria,Slovenia,2022-07-07,True,0,3,14,17,0,0,4,4,13,3,1,17,1,2,0,3,0,0,9,9,1,1,2,4
168747.0,Možič Rok,OH,Slovenia,21.0,200.0,2022,Slovenia,Iran,2022-07-08,False,0,3,2,5,0,0,0,0,2,2,1,5,0,0,0,0,0,2,6,8,1,0,0,1
168747.0,Možič Rok,OH,Slovenia,21.0,200.0,2022,Poland,Slovenia,2022-07-10,False,0,0,1,1,0,0,1,1,0,3,2,5,0,0,0,0,0,0,0,0,0,0,0,0
132624.0,Russell Aaron,OH,USA,29.0,205.0,2022,Netherlands,USA,2022-06-09,False,2,1,11,14,5,0,5,10,11,2,4,17,1,3,2,6,4,0,3,7,3,3,4,10
132624.0,Russell Aaron,OH,USA,29.0,205.0,2022,Japan,USA,2022-06-10,False,3,4,13,20,2,0,1,3,16,3,14,33,1,2,7,10,8,0,26,34,7,1,1,9
132624.0,Russell Aaron,OH,USA,29.0,205.0,2022,USA,Brazil,2022-06-11,False,1,5,9,15,2,0,0,2,9,6,9,24,0,5,1,6,14,0,20,34,7,2,2,11
132624.0,Russell Aaron,OH,USA,29.0,205.0,2022,Serbia,USA,2022-06-22,False,1,2,11,14,1,0,1,2,10,3,3,16,1,2,0,3,3,2,12,17,2,4,0,6
132624.0,Russell Aaron,OH,USA,29.0,205.0,2022,USA,Iran,2022-06-23,False,0,0,0,0,0,0,0,0,0,0,0,0,0,0,0,0,0,0,0,0,0,0,0,0
132624.0,Russell Aaron,OH,USA,29.0,205.0,2022,USA,Bulgaria,2022-06-25,False,4,5,8,17,0,0,0,0,10,5,8,23,2,3,1,6,5,1,17,23,1,2,0,3
132624.0,Russell Aaron,OH,USA,29.0,205.0,2022,USA,Poland,2022-06-26,False,3,4,10,17,0,0,1,1,13,6,10,29,0,4,0,4,6,0,15,21,1,1,1,3
132624.0,Russell Aaron,OH,USA,29.0,205.0,2022,USA,Germany,2022-07-05,False,3,1,12,16,0,0,4,4,19,3,12,34,1,4,2,7,5,0,6,11,4,1,1,6
132624.0,Russell Aaron,OH,USA,29.0,205.0,2022,France,USA,2022-07-07,False,2,3,15,20,0,0,1,1,13,2,15,30,3,5,3,11,7,2,16,25,6,1,1,8
132624.0,Russell Aaron,OH,USA,29.0,205.0,2022,Canada,USA,2022-07-09,False,0,4,4,8,1,0,2,3,10,1,12,23,1,3,4,8,4,1,7,12,7,2,1,10
132624.0,Russell Aaron,OH,USA,29.0,205.0,2022,USA,Argentina,2022-07-10,False,0,0,0,0,0,0,0,0,0,0,0,0,0,0,0,0,0,0,0,0,0,0,0,0
132624.0,Russell Aaron,OH,USA,29.0,205.0,2022,USA,Brazil,2022-07-20,False,0,2,12,14,0,0,1,1,14,2,10,26,0,0,1,1,9,1,17,27,12,3,1,16
132624.0,Russell Aaron,OH,USA,29.0,205.0,2022,Poland,USA,2022-07-23,False,0,3,7,10,0,0,0,0,9,4,5,18,0,1,1,2,6,1,12,19,5,4,0,9
132624.0,Russell Aaron,OH,USA,29.0,205.0,2022,France,USA,2022-07-24,False,0,3,13,16,1,0,2,3,20,4,7,31,0,4,1,5,5,2,17,24,8,4,1,13
136078.0,Shaw James,S,USA,29.0,203.0,2022,Netherlands,USA,2022-06-09,False,0,1,1,2,6,0,6,12,1,0,1,2,1,0,0,1,0,0,0,0,0,0,0,0
136078.0,Shaw James,S,USA,29.0,203.0,2022,Japan,USA,2022-06-10,False,0,0,0,0,5,0,6,11,0,0,0,0,0,0,0,0,0,0,0,0,2,0,0,2
136078.0,Shaw James,S,USA,29.0,203.0,2022,USA,Brazil,2022-06-11,False,0,0,2,2,3,0,7,10,0,1,0,1,0,0,0,0,0,0,0,0,0,0,0,0
136078.0,Shaw James,S,USA,29.0,203.0,2022,Serbia,USA,2022-06-22,False,0,0,0,0,0,0,0,0,0,0,0,0,0,0,0,0,0,0,0,0,0,0,0,0
136078.0,Shaw James,S,USA,29.0,203.0,2022,USA,Iran,2022-06-23,False,0,0,2,2,5,0,16,21,0,0,1,1,0,1,0,1,0,0,0,0,0,0,0,0
136078.0,Shaw James,S,USA,29.0,203.0,2022,USA,Bulgaria,2022-06-25,False,0,1,3,4,2,0,6,8,0,0,0,0,0,0,0,0,0,0,0,0,0,1,0,1
136078.0,Shaw James,S,USA,29.0,203.0,2022,USA,Poland,2022-06-26,False,0,0,1,1,1,0,3,4,0,0,0,0,0,1,0,1,0,0,0,0,0,0,0,0
147721.0,Jendryk II Jeffrey,MB,USA,27.0,208.0,2022,Netherlands,USA,2022-06-09,False,1,1,13,15,0,0,0,0,3,0,0,3,1,4,1,6,0,0,0,0,4,1,0,5
147721.0,Jendryk II Jeffrey,MB,USA,27.0,208.0,2022,Japan,USA,2022-06-10,False,1,3,15,19,0,0,0,0,11,1,5,17,4,8,10,22,0,0,0,0,2,3,1,6
147721.0,Jendryk II Jeffrey,MB,USA,27.0,208.0,2022,USA,Brazil,2022-06-11,False,1,3,11,15,0,0,1,1,9,1,0,10,2,4,3,9,0,0,2,2,1,1,0,2
147721.0,Jendryk II Jeffrey,MB,USA,27.0,208.0,2022,Serbia,USA,2022-06-22,False,0,1,14,15,0,0,0,0,5,1,6,12,0,9,3,12,0,0,4,4,0,0,0,0
147721.0,Jendryk II Jeffrey,MB,USA,27.0,208.0,2022,USA,Iran,2022-06-23,False,2,2,7,11,0,0,1,1,5,1,3,9,2,4,2,8,0,0,2,2,0,0,0,0
147721.0,Jendryk II Jeffrey,MB,USA,27.0,208.0,2022,USA,Bulgaria,2022-06-25,False,0,1,14,15,1,0,0,1,7,0,3,10,1,2,4,7,0,0,0,0,2,1,0,3
147721.0,Jendryk II Jeffrey,MB,USA,27.0,208.0,2022,USA,Poland,2022-06-26,False,0,0,8,8,0,0,0,0,3,1,1,5,0,2,0,2,0,1,1,2,0,1,0,1
147721.0,Jendryk II Jeffrey,MB,USA,27.0,208.0,2022,USA,Germany,2022-07-05,False,0,1,9,10,0,0,1,1,5,0,2,7,0,6,9,15,2,0,2,4,2,0,0,2
147721.0,Jendryk II Jeffrey,MB,USA,27.0,208.0,2022,France,USA,2022-07-07,False,0,3,9,12,0,0,0,0,5,2,1,8,1,4,9,14,0,1,0,1,4,1,2,7
147721.0,Jendryk II Jeffrey,MB,USA,27.0,208.0,2022,Canada,USA,2022-07-09,False,1,0,13,14,0,0,1,1,4,0,0,4,1,4,4,9,1,0,1,2,1,2,0,3
147721.0,Jendryk II Jeffrey,MB,USA,27.0,208.0,2022,USA,Argentina,2022-07-10,False,0,0,0,0,0,0,0,0,0,0,0,0,0,0,0,0,0,0,0,0,0,0,0,0
147721.0,Jendryk II Jeffrey,MB,USA,27.0,208.0,2022,USA,Brazil,2022-07-20,False,0,0,8,8,0,0,0,0,6,0,4,10,2,6,4,12,0,0,0,0,2,1,0,3
147721.0,Jendryk II Jeffrey,MB,USA,27.0,208.0,2022,Poland,USA,2022-07-23,False,1,1,8,10,0,0,0,0,6,0,2,8,1,4,6,11,0,0,0,0,0,1,0,1
147721.0,Jendryk II Jeffrey,MB,USA,27.0,208.0,2022,France,USA,2022-07-24,False,0,3,7,10,0,0,1,1,6,0,3,9,3,11,3,17,1,0,1,2,3,1,0,4
147417.0,Ensing Kyle,O,USA,26.0,201.0,2022,Netherlands,USA,2022-06-09,False,1,3,9,13,0,0,0,0,11,3,2,16,2,1,0,3,0,0,0,0,6,0,0,6
147417.0,Ensing Kyle,O,USA,26.0,201.0,2022,Japan,USA,2022-06-10,False,0,4,13,17,0,0,0,0,19,2,15,36,1,4,8,13,0,0,0,0,5,2,3,10
147417.0,Ensing Kyle,O,USA,26.0,201.0,2022,USA,Brazil,2022-06-11,False,0,0,0,0,0,0,0,0,0,0,0,0,0,0,0,0,0,0,0,0,0,0,0,0
147417.0,Ensing Kyle,O,USA,26.0,201.0,2022,Serbia,USA,2022-06-22,False,0,3,11,14,0,0,0,0,13,4,6,23,0,5,3,8,0,0,0,0,2,1,1,4
147417.0,Ensing Kyle,O,USA,26.0,201.0,2022,USA,Iran,2022-06-23,False,0,1,8,9,0,0,0,0,11,6,5,22,0,3,0,3,0,0,0,0,1,1,0,2
147417.0,Ensing Kyle,O,USA,26.0,201.0,2022,USA,Bulgaria,2022-06-25,False,1,5,4,10,0,0,1,1,17,2,3,22,2,0,3,5,0,0,0,0,1,3,0,4
147417.0,Ensing Kyle,O,USA,26.0,201.0,2022,USA,Poland,2022-06-26,False,0,3,7,10,0,0,2,2,8,4,6,18,0,2,0,2,0,0,0,0,0,1,1,2
147417.0,Ensing Kyle,O,USA,26.0,201.0,2022,USA,Germany,2022-07-05,False,1,3,6,10,0,0,1,1,12,5,8,25,0,1,7,8,0,0,0,0,4,0,2,6
147417.0,Ensing Kyle,O,USA,26.0,201.0,2022,France,USA,2022-07-07,False,2,2,11,15,0,0,3,3,10,3,12,25,0,8,4,12,0,0,0,0,6,4,2,12
147417.0,Ensing Kyle,O,USA,26.0,201.0,2022,Canada,USA,2022-07-09,False,2,1,10,13,0,0,1,1,10,0,6,16,1,3,1,5,0,0,1,1,5,2,3,10
147417.0,Ensing Kyle,O,USA,26.0,201.0,2022,USA,Argentina,2022-07-10,False,0,2,11,13,1,0,1,2,7,1,5,13,1,3,4,8,0,0,0,0,6,1,1,8
147417.0,Ensing Kyle,O,USA,26.0,201.0,2022,USA,Brazil,2022-07-20,False,1,2,3,6,0,0,0,0,4,3,7,14,1,5,2,8,0,0,0,0,3,0,1,4
147417.0,Ensing Kyle,O,USA,26.0,201.0,2022,Poland,USA,2022-07-23,False,0,2,8,10,0,0,2,2,8,1,6,15,0,2,2,4,0,0,2,2,3,0,0,3
147417.0,Ensing Kyle,O,USA,26.0,201.0,2022,France,USA,2022-07-24,False,0,0,1,1,0,0,0,0,1,0,4,5,0,0,0,0,0,0,0,0,2,0,0,2
140185.0,Stahl Mitchell,MB,USA,28.0,203.0,2022,Serbia,USA,2022-06-22,False,0,0,0,0,0,0,0,0,0,0,0,0,0,0,0,0,0,0,0,0,0,0,0,0
140185.0,Stahl Mitchell,MB,USA,28.0,203.0,2022,USA,Iran,2022-06-23,False,0,1,5,6,0,0,0,0,3,1,3,7,1,2,2,5,0,0,1,1,0,0,0,0
140185.0,Stahl Mitchell,MB,USA,28.0,203.0,2022,USA,Bulgaria,2022-06-25,False,0,0,1,1,0,0,0,0,0,0,1,1,0,0,0,0,0,0,0,0,0,0,0,0
140185.0,Stahl Mitchell,MB,USA,28.0,203.0,2022,USA,Poland,2022-06-26,False,2,3,5,10,0,0,1,1,5,0,2,7,1,4,2,7,0,0,2,2,0,2,0,2
140185.0,Stahl Mitchell,MB,USA,28.0,203.0,2022,USA,Germany,2022-07-05,False,0,0,0,0,0,0,0,0,0,0,0,0,0,0,0,0,0,0,0,0,0,0,0,0
140185.0,Stahl Mitchell,MB,USA,28.0,203.0,2022,France,USA,2022-07-07,False,0,0,0,0,0,0,0,0,0,0,0,0,0,0,0,0,0,0,0,0,0,0,0,0
140185.0,Stahl Mitchell,MB,USA,28.0,203.0,2022,Canada,USA,2022-07-09,False,0,0,0,0,0,0,0,0,0,0,0,0,0,0,0,0,0,0,0,0,0,0,0,0
140185.0,Stahl Mitchell,MB,USA,28.0,203.0,2022,USA,Argentina,2022-07-10,False,1,8,9,18,0,0,0,0,7,1,4,12,3,7,7,17,0,0,2,2,2,0,0,2
140185.0,Stahl Mitchell,MB,USA,28.0,203.0,2022,USA,Brazil,2022-07-20,False,0,0,0,0,0,0,0,0,0,0,0,0,0,0,0,0,0,0,0,0,0,0,0,0
140185.0,Stahl Mitchell,MB,USA,28.0,203.0,2022,Poland,USA,2022-07-23,False,0,0,0,0,0,0,0,0,0,0,0,0,0,0,0,0,0,0,0,0,0,0,0,0
140185.0,Stahl Mitchell,MB,USA,28.0,203.0,2022,France,USA,2022-07-24,False,0,0,0,0,0,0,0,0,0,0,0,0,0,0,0,0,0,0,0,0,0,0,0,0
183140.0,Pasteur Jacob,OH,USA,20.0,193.0,2022,Netherlands,USA,2022-06-09,False,0,0,0,0,0,0,0,0,0,0,0,0,0,0,0,0,0,0,0,0,0,0,0,0
183140.0,Pasteur Jacob,OH,USA,20.0,193.0,2022,Japan,USA,2022-06-10,False,0,0,0,0,0,0,0,0,0,0,0,0,0,0,0,0,0,0,0,0,0,0,0,0
183140.0,Pasteur Jacob,OH,USA,20.0,193.0,2022,USA,Brazil,2022-06-11,False,0,0,0,0,0,0,0,0,0,0,0,0,0,0,0,0,0,0,0,0,0,0,0,0
139254.0,Defalco Torey,OH,USA,25.0,198.0,2022,Serbia,USA,2022-06-22,False,0,6,12,18,0,0,0,0,23,3,6,32,2,3,1,6,5,3,16,24,0,4,0,4
139254.0,Defalco Torey,OH,USA,25.0,198.0,2022,USA,Iran,2022-06-23,False,0,3,8,11,1,0,0,1,13,4,7,24,0,2,0,2,4,2,23,29,0,1,1,2
139254.0,Defalco Torey,OH,USA,25.0,198.0,2022,USA,Bulgaria,2022-06-25,False,2,3,17,22,0,0,1,1,10,4,11,25,0,1,1,2,6,1,17,24,1,2,1,4
139254.0,Defalco Torey,OH,USA,25.0,198.0,2022,USA,Poland,2022-06-26,False,2,0,17,19,0,0,0,0,11,3,12,26,1,2,1,4,9,3,24,36,1,1,1,3
139254.0,Defalco Torey,OH,USA,25.0,198.0,2022,USA,Germany,2022-07-05,False,1,4,16,21,0,0,4,4,11,2,6,19,0,3,7,10,14,1,18,33,4,1,1,6
139254.0,Defalco Torey,OH,USA,25.0,198.0,2022,France,USA,2022-07-07,False,1,3,13,17,0,0,7,7,12,5,8,25,2,2,8,12,2,2,16,20,6,2,2,10
139254.0,Defalco Torey,OH,USA,25.0,198.0,2022,Canada,USA,2022-07-09,False,1,2,8,11,0,0,5,5,17,1,5,23,0,2,4,6,5,0,9,14,2,1,0,3
139254.0,Defalco Torey,OH,USA,25.0,198.0,2022,USA,Argentina,2022-07-10,False,0,3,13,16,0,0,7,7,25,6,12,43,3,7,1,11,5,1,24,30,5,3,1,9
139254.0,Defalco Torey,OH,USA,25.0,198.0,2022,USA,Brazil,2022-07-20,False,1,6,11,18,0,0,0,0,16,4,9,29,0,5,2,7,11,1,10,22,2,6,0,8
139254.0,Defalco Torey,OH,USA,25.0,198.0,2022,Poland,USA,2022-07-23,False,6,1,11,18,0,0,2,2,6,2,6,14,1,2,0,3,2,0,5,7,4,1,1,6
139254.0,Defalco Torey,OH,USA,25.0,198.0,2022,France,USA,2022-07-24,False,0,2,16,18,0,1,0,1,13,6,6,25,0,2,4,6,2,1,9,12,2,3,1,6
170104.0,Hanes Jake,O,USA,24.0,210.0,2022,Netherlands,USA,2022-06-09,False,0,0,2,2,0,0,0,0,3,0,1,4,0,0,0,0,0,0,0,0,0,0,0,0
170104.0,Hanes Jake,O,USA,24.0,210.0,2022,Japan,USA,2022-06-10,False,0,1,0,1,0,0,1,1,2,0,1,3,0,0,0,0,0,0,0,0,0,0,0,0
170104.0,Hanes Jake,O,USA,24.0,210.0,2022,USA,Brazil,2022-06-11,False,1,2,18,21,0,0,0,0,17,4,16,37,2,3,1,6,0,0,0,0,7,3,2,12
170104.0,Hanes Jake,O,USA,24.0,210.0,2022,USA,Germany,2022-07-05,False,0,2,4,6,0,0,0,0,4,3,3,10,0,1,2,3,0,0,0,0,0,0,0,0
170104.0,Hanes Jake,O,USA,24.0,210.0,2022,France,USA,2022-07-07,False,0,2,0,2,0,0,0,0,0,0,1,1,0,2,2,4,0,0,0,0,0,0,1,1
170104.0,Hanes Jake,O,USA,24.0,210.0,2022,Canada,USA,2022-07-09,False,0,0,0,0,0,0,0,0,0,0,0,0,0,0,0,0,0,0,0,0,0,0,0,0
170104.0,Hanes Jake,O,USA,24.0,210.0,2022,USA,Argentina,2022-07-10,False,0,2,4,6,0,0,1,1,7,1,6,14,0,1,2,3,0,0,0,0,2,0,0,2
142445.0,Dagostino Kyle,L,USA,27.0,175.0,2022,Netherlands,USA,2022-06-09,False,0,0,0,0,3,0,0,3,0,0,0,0,0,0,0,0,6,0,7,13,9,0,0,9
142445.0,Dagostino Kyle,L,USA,27.0,175.0,2022,Japan,USA,2022-06-10,False,0,0,0,0,10,0,3,13,0,0,0,0,0,0,0,0,5,0,7,12,14,4,3,21
142445.0,Dagostino Kyle,L,USA,27.0,175.0,2022,USA,Brazil,2022-06-11,False,0,0,0,0,7,0,1,8,0,0,0,0,0,0,0,0,11,1,6,18,12,1,0,13
142445.0,Dagostino Kyle,L,USA,27.0,175.0,2022,Serbia,USA,2022-06-22,False,0,0,0,0,0,0,0,0,0,0,0,0,0,0,0,0,0,0,0,0,0,0,0,0
142445.0,Dagostino Kyle,L,USA,27.0,175.0,2022,USA,Iran,2022-06-23,False,0,0,0,0,1,0,1,2,0,0,0,0,0,0,0,0,5,1,16,22,3,3,2,8
142445.0,Dagostino Kyle,L,USA,27.0,175.0,2022,USA,Bulgaria,2022-06-25,False,0,0,0,0,0,0,0,0,0,0,0,0,0,0,0,0,0,0,0,0,0,0,0,0
142445.0,Dagostino Kyle,L,USA,27.0,175.0,2022,USA,Poland,2022-06-26,False,0,0,0,0,0,0,0,0,0,0,0,0,0,0,0,0,0,0,0,0,0,0,0,0
142445.0,Dagostino Kyle,L,USA,27.0,175.0,2022,USA,Germany,2022-07-05,False,0,0,0,0,0,0,0,0,0,0,0,0,0,0,0,0,0,0,0,0,0,0,0,0
142445.0,Dagostino Kyle,L,USA,27.0,175.0,2022,France,USA,2022-07-07,False,0,0,0,0,0,0,0,0,0,0,0,0,0,0,0,0,0,0,0,0,0,0,0,0
142445.0,Dagostino Kyle,L,USA,27.0,175.0,2022,Canada,USA,2022-07-09,False,0,0,0,0,0,0,0,0,0,0,0,0,0,0,0,0,0,0,0,0,0,0,0,0
142445.0,Dagostino Kyle,L,USA,27.0,175.0,2022,USA,Argentina,2022-07-10,False,0,0,0,0,0,0,5,5,0,0,0,0,0,0,0,0,10,0,12,22,10,6,5,21
142445.0,Dagostino Kyle,L,USA,27.0,175.0,2022,USA,Brazil,2022-07-20,False,0,0,0,0,0,0,0,0,0,0,0,0,0,0,0,0,0,0,0,0,0,0,0,0
142445.0,Dagostino Kyle,L,USA,27.0,175.0,2022,Poland,USA,2022-07-23,False,0,0,0,0,0,0,0,0,0,0,0,0,0,0,0,0,0,0,1,1,0,0,0,0
142445.0,Dagostino Kyle,L,USA,27.0,175.0,2022,France,USA,2022-07-24,False,0,0,0,0,0,0,0,0,0,0,0,0,0,0,0,0,0,0,0,0,0,0,0,0
124879.0,Christenson Micah,S,USA,29.0,198.0,2022,USA,Germany,2022-07-05,False,1,3,11,15,33,1,53,87,3,0,1,4,1,1,4,6,0,0,0,0,10,4,1,15
124879.0,Christenson Micah,S,USA,29.0,198.0,2022,France,USA,2022-07-07,False,0,3,11,14,23,1,53,77,1,0,3,4,2,4,5,11,0,1,1,2,5,2,1,8
124879.0,Christenson Micah,S,USA,29.0,198.0,2022,Canada,USA,2022-07-09,False,1,3,11,15,33,1,22,56,1,0,0,1,1,1,2,4,0,0,0,0,4,1,1,6
124879.0,Christenson Micah,S,USA,29.0,198.0,2022,USA,Argentina,2022-07-10,False,0,2,7,9,28,0,32,60,0,0,1,1,3,3,3,9,0,0,1,1,6,3,1,10
124879.0,Christenson Micah,S,USA,29.0,198.0,2022,USA,Brazil,2022-07-20,False,2,1,24,27,34,0,66,100,0,0,1,1,1,0,0,1,0,0,0,0,4,2,0,6
124879.0,Christenson Micah,S,USA,29.0,198.0,2022,Poland,USA,2022-07-23,False,0,1,12,13,12,0,43,55,3,0,1,4,1,1,0,2,0,0,0,0,2,0,0,2
124879.0,Christenson Micah,S,USA,29.0,198.0,2022,France,USA,2022-07-24,False,1,3,15,19,26,1,69,96,1,0,0,1,2,5,4,11,0,0,0,0,4,1,1,6
147542.0,Gasman Patrick,MB,USA,26.0,208.0,2022,Netherlands,USA,2022-06-09,False,0,0,0,0,0,0,0,0,0,0,0,0,0,0,0,0,0,0,0,0,0,0,0,0
147542.0,Gasman Patrick,MB,USA,26.0,208.0,2022,Japan,USA,2022-06-10,False,0,0,0,0,0,0,0,0,0,0,0,0,0,0,0,0,0,0,0,0,0,0,0,0
147542.0,Gasman Patrick,MB,USA,26.0,208.0,2022,USA,Brazil,2022-06-11,False,0,0,0,0,0,0,0,0,0,0,0,0,0,0,0,0,0,0,0,0,0,0,0,0
136077.0,Russell Kyle,O,USA,29.0,206.0,2022,Serbia,USA,2022-06-22,False,0,0,0,0,0,0,0,0,0,0,0,0,0,0,0,0,0,0,0,0,0,0,0,0
136077.0,Russell Kyle,O,USA,29.0,206.0,2022,USA,Iran,2022-06-23,False,1,2,2,5,0,0,0,0,2,0,2,4,0,0,0,0,0,0,0,0,1,0,0,1
136077.0,Russell Kyle,O,USA,29.0,206.0,2022,USA,Bulgaria,2022-06-25,False,0,1,1,2,0,0,0,0,3,0,0,3,0,1,1,2,0,0,0,0,0,0,0,0
136077.0,Russell Kyle,O,USA,29.0,206.0,2022,USA,Poland,2022-06-26,False,0,1,5,6,0,0,0,0,3,0,2,5,0,1,0,1,0,0,0,0,0,1,0,1
136077.0,Russell Kyle,O,USA,29.0,206.0,2022,USA,Brazil,2022-07-20,False,0,0,7,7,0,0,0,0,8,2,6,16,0,1,2,3,0,0,0,0,4,1,1,6
136077.0,Russell Kyle,O,USA,29.0,206.0,2022,Poland,USA,2022-07-23,False,1,2,4,7,0,0,0,0,0,0,0,0,0,0,0,0,0,0,0,0,0,0,0,0
136077.0,Russell Kyle,O,USA,29.0,206.0,2022,France,USA,2022-07-24,False,0,2,5,7,0,0,0,0,4,2,5,11,0,1,2,3,0,0,0,0,1,0,0,1
147543.0,Tuaniga Joshua,S,USA,26.0,191.0,2022,Netherlands,USA,2022-06-09,False,0,1,6,7,17,0,20,37,2,1,0,3,0,2,2,4,0,0,0,0,3,0,0,3
147543.0,Tuaniga Joshua,S,USA,26.0,191.0,2022,Japan,USA,2022-06-10,False,0,5,15,20,52,0,43,95,2,1,1,4,1,2,6,9,0,0,0,0,7,0,1,8
147543.0,Tuaniga Joshua,S,USA,26.0,191.0,2022,USA,Brazil,2022-06-11,False,0,3,10,13,43,0,42,85,3,0,1,4,2,3,4,9,0,0,1,1,4,2,0,6
147543.0,Tuaniga Joshua,S,USA,26.0,191.0,2022,Serbia,USA,2022-06-22,False,2,3,14,19,37,0,52,89,0,0,2,2,0,1,2,3,0,0,0,0,2,4,0,6
147543.0,Tuaniga Joshua,S,USA,26.0,191.0,2022,USA,Iran,2022-06-23,False,0,1,8,9,21,0,41,62,0,1,2,3,0,1,2,3,0,0,0,0,0,2,0,2
147543.0,Tuaniga Joshua,S,USA,26.0,191.0,2022,USA,Bulgaria,2022-06-25,False,0,1,12,13,24,1,50,75,1,0,1,2,0,5,0,5,0,0,0,0,5,4,3,12
147543.0,Tuaniga Joshua,S,USA,26.0,191.0,2022,USA,Poland,2022-06-26,False,0,3,12,15,21,0,64,85,1,0,0,1,0,2,3,5,0,0,0,0,2,1,0,3
147543.0,Tuaniga Joshua,S,USA,26.0,191.0,2022,USA,Germany,2022-07-05,False,0,0,0,0,0,0,0,0,0,0,0,0,0,0,0,0,0,0,0,0,0,0,0,0
147543.0,Tuaniga Joshua,S,USA,26.0,191.0,2022,France,USA,2022-07-07,False,0,0,0,0,5,0,3,8,0,0,0,0,0,0,0,0,0,0,0,0,1,0,0,1
147543.0,Tuaniga Joshua,S,USA,26.0,191.0,2022,Canada,USA,2022-07-09,False,0,0,0,0,0,0,0,0,0,0,0,0,0,0,0,0,0,0,0,0,0,0,0,0
147543.0,Tuaniga Joshua,S,USA,26.0,191.0,2022,USA,Argentina,2022-07-10,False,0,0,7,7,20,0,18,38,0,0,1,1,0,1,2,3,0,0,0,0,1,1,2,4
147543.0,Tuaniga Joshua,S,USA,26.0,191.0,2022,USA,Brazil,2022-07-20,False,0,0,0,0,0,0,0,0,0,0,0,0,0,0,0,0,0,0,0,0,0,0,0,0
147543.0,Tuaniga Joshua,S,USA,26.0,191.0,2022,Poland,USA,2022-07-23,False,0,0,0,0,0,0,0,0,0,0,0,0,0,0,0,0,0,0,0,0,0,0,0,0
147543.0,Tuaniga Joshua,S,USA,26.0,191.0,2022,France,USA,2022-07-24,False,0,0,0,0,0,0,0,0,0,0,0,0,0,0,0,0,0,0,0,0,0,0,0,0
143682.0,Jaeschke Thomas,OH,USA,29.0,198.0,2022,Netherlands,USA,2022-06-09,False,1,2,6,9,1,0,0,1,7,4,5,16,1,2,2,5,3,0,15,18,5,1,0,6
143682.0,Jaeschke Thomas,OH,USA,29.0,198.0,2022,Japan,USA,2022-06-10,False,0,5,11,16,3,0,0,3,9,2,16,27,2,2,1,5,13,1,20,34,10,1,0,11
143682.0,Jaeschke Thomas,OH,USA,29.0,198.0,2022,USA,Brazil,2022-06-11,False,0,0,0,0,0,0,0,0,0,0,0,0,0,0,0,0,0,0,0,0,0,0,0,0
143682.0,Jaeschke Thomas,OH,USA,29.0,198.0,2022,Serbia,USA,2022-06-22,False,0,0,0,0,0,0,0,0,0,0,0,0,0,0,0,0,0,0,0,0,0,0,0,0
143682.0,Jaeschke Thomas,OH,USA,29.0,198.0,2022,USA,Iran,2022-06-23,False,0,1,5,6,0,0,1,1,3,2,6,11,1,0,0,1,3,1,4,8,3,1,1,5
143682.0,Jaeschke Thomas,OH,USA,29.0,198.0,2022,USA,Bulgaria,2022-06-25,False,0,0,0,0,0,0,0,0,0,0,0,0,0,0,0,0,0,0,0,0,0,0,0,0
143682.0,Jaeschke Thomas,OH,USA,29.0,198.0,2022,USA,Poland,2022-06-26,False,0,0,0,0,0,0,0,0,0,0,0,0,0,0,0,0,0,0,0,0,0,0,0,0
133463.0,Muagututia Garrett,OH,USA,35.0,205.0,2022,Serbia,USA,2022-06-22,False,0,0,0,0,0,0,0,0,0,0,0,0,0,0,0,0,0,0,0,0,0,0,0,0
133463.0,Muagututia Garrett,OH,USA,35.0,205.0,2022,USA,Iran,2022-06-23,False,0,0,7,7,0,1,0,1,3,1,3,7,0,0,0,0,0,1,3,4,0,0,0,0
133463.0,Muagututia Garrett,OH,USA,35.0,205.0,2022,USA,Bulgaria,2022-06-25,False,0,0,1,1,0,0,0,0,3,0,0,3,0,0,0,0,0,2,2,4,2,1,0,3
133463.0,Muagututia Garrett,OH,USA,35.0,205.0,2022,USA,Poland,2022-06-26,False,0,0,0,0,0,0,0,0,0,1,0,1,0,1,0,1,0,0,1,1,0,0,0,0
133463.0,Muagututia Garrett,OH,USA,35.0,205.0,2022,USA,Germany,2022-07-05,False,0,2,2,4,0,0,0,0,0,0,0,0,0,0,0,0,0,0,0,0,1,0,0,1
133463.0,Muagututia Garrett,OH,USA,35.0,205.0,2022,France,USA,2022-07-07,False,0,2,0,2,0,0,0,0,0,0,0,0,0,0,0,0,0,0,0,0,0,0,0,0
133463.0,Muagututia Garrett,OH,USA,35.0,205.0,2022,Canada,USA,2022-07-09,False,0,0,0,0,0,0,0,0,0,0,0,0,0,0,0,0,0,0,0,0,0,0,0,0
133463.0,Muagututia Garrett,OH,USA,35.0,205.0,2022,USA,Argentina,2022-07-10,False,0,1,21,22,1,0,1,2,10,5,7,22,0,3,1,4,11,1,14,26,5,1,3,9
133463.0,Muagututia Garrett,OH,USA,35.0,205.0,2022,USA,Brazil,2022-07-20,False,0,1,2,3,0,0,0,0,0,0,0,0,0,0,0,0,0,0,0,0,0,1,0,1
133463.0,Muagututia Garrett,OH,USA,35.0,205.0,2022,Poland,USA,2022-07-23,False,0,0,0,0,0,0,0,0,0,0,0,0,0,0,0,0,0,0,0,0,0,0,0,0
133463.0,Muagututia Garrett,OH,USA,35.0,205.0,2022,France,USA,2022-07-24,False,0,1,9,10,0,0,1,1,11,0,4,15,0,4,3,7,10,2,6,18,6,1,0,7
116069.0,Smith David,MB,USA,37.0,201.0,2022,Netherlands,USA,2022-06-09,False,0,0,12,12,2,0,0,2,3,1,1,5,2,1,4,7,0,0,0,0,1,0,0,1
116069.0,Smith David,MB,USA,37.0,201.0,2022,Japan,USA,2022-06-10,False,0,3,9,12,1,0,1,2,5,2,4,11,1,6,10,17,0,0,1,1,3,0,2,5
116069.0,Smith David,MB,USA,37.0,201.0,2022,USA,Brazil,2022-06-11,False,0,0,0,0,0,0,0,0,0,0,0,0,0,0,0,0,0,0,0,0,0,0,0,0
116069.0,Smith David,MB,USA,37.0,201.0,2022,Serbia,USA,2022-06-22,False,2,2,14,18,0,0,0,0,5,1,2,8,4,3,1,8,0,0,2,2,2,1,1,4
116069.0,Smith David,MB,USA,37.0,201.0,2022,USA,Iran,2022-06-23,False,0,0,0,0,0,0,0,0,0,0,0,0,0,0,0,0,0,0,0,0,0,0,0,0
116069.0,Smith David,MB,USA,37.0,201.0,2022,USA,Bulgaria,2022-06-25,False,1,1,8,10,0,0,1,1,4,0,1,5,2,3,3,8,0,0,0,0,0,0,1,1
116069.0,Smith David,MB,USA,37.0,201.0,2022,USA,Poland,2022-06-26,False,1,3,5,9,0,1,0,1,5,1,3,9,3,7,2,12,1,0,0,1,0,1,0,1
116069.0,Smith David,MB,USA,37.0,201.0,2022,USA,Germany,2022-07-05,False,1,2,11,14,0,0,1,1,5,0,4,9,2,7,5,14,2,0,3,5,3,0,1,4
116069.0,Smith David,MB,USA,37.0,201.0,2022,France,USA,2022-07-07,False,1,2,17,20,0,0,3,3,5,0,1,6,1,0,5,6,0,0,2,2,3,1,0,4
116069.0,Smith David,MB,USA,37.0,201.0,2022,Canada,USA,2022-07-09,False,0,3,10,13,1,0,2,3,5,0,3,8,1,2,5,8,0,0,0,0,1,1,0,2
116069.0,Smith David,MB,USA,37.0,201.0,2022,USA,Argentina,2022-07-10,False,2,3,17,22,0,0,0,0,9,1,2,12,3,2,7,12,0,0,0,0,1,0,0,1
116069.0,Smith David,MB,USA,37.0,201.0,2022,USA,Brazil,2022-07-20,False,0,1,10,11,0,0,0,0,8,0,3,11,3,6,9,18,1,0,1,2,5,2,0,7
116069.0,Smith David,MB,USA,37.0,201.0,2022,Poland,USA,2022-07-23,False,1,1,4,6,0,0,1,1,6,1,1,8,3,4,4,11,0,0,0,0,3,0,0,3
116069.0,Smith David,MB,USA,37.0,201.0,2022,France,USA,2022-07-24,False,0,0,15,15,1,0,1,2,4,4,2,10,2,6,6,14,0,0,0,0,1,1,0,2
168461.0,Briggs Mason,L,USA,22.0,182.0,2022,Netherlands,USA,2022-06-09,False,0,0,0,0,0,0,0,0,0,0,0,0,0,0,0,0,0,0,0,0,0,0,0,0
168461.0,Briggs Mason,L,USA,22.0,182.0,2022,Japan,USA,2022-06-10,False,0,0,0,0,0,0,0,0,0,0,0,0,0,0,0,0,0,0,0,0,0,0,0,0
168461.0,Briggs Mason,L,USA,22.0,182.0,2022,USA,Brazil,2022-06-11,False,0,0,0,0,0,0,0,0,0,0,0,0,0,0,0,0,0,0,0,0,0,0,0,0
119732.0,Shoji Erik,L,USA,33.0,184.0,2022,Serbia,USA,2022-06-22,False,0,0,0,0,0,0,1,1,0,0,0,0,0,0,0,0,9,1,14,24,4,0,2,6
119732.0,Shoji Erik,L,USA,33.0,184.0,2022,USA,Iran,2022-06-23,False,0,0,0,0,0,0,0,0,0,0,0,0,0,0,0,0,0,0,0,0,0,0,0,0
119732.0,Shoji Erik,L,USA,33.0,184.0,2022,USA,Bulgaria,2022-06-25,False,0,0,0,0,1,0,2,3,0,0,0,0,0,0,0,0,7,2,9,18,8,3,2,13
119732.0,Shoji Erik,L,USA,33.0,184.0,2022,USA,Poland,2022-06-26,False,0,0,0,0,1,0,1,2,0,0,0,0,0,0,0,0,4,0,12,16,7,4,0,11
119732.0,Shoji Erik,L,USA,33.0,184.0,2022,USA,Germany,2022-07-05,False,0,0,0,0,1,0,7,8,0,0,0,0,0,0,0,0,10,1,3,14,11,2,2,15
119732.0,Shoji Erik,L,USA,33.0,184.0,2022,France,USA,2022-07-07,False,0,0,0,0,0,1,4,5,0,0,0,0,0,0,0,0,5,1,12,18,7,3,0,10
119732.0,Shoji Erik,L,USA,33.0,184.0,2022,Canada,USA,2022-07-09,False,0,0,0,0,0,1,2,3,0,0,0,0,0,0,0,0,7,1,8,16,8,3,2,13
119732.0,Shoji Erik,L,USA,33.0,184.0,2022,USA,Argentina,2022-07-10,False,0,0,0,0,0,0,0,0,0,0,0,0,0,0,0,0,0,0,0,0,0,0,0,0
119732.0,Shoji Erik,L,USA,33.0,184.0,2022,USA,Brazil,2022-07-20,False,0,0,0,0,0,0,3,3,0,0,0,0,0,0,0,0,9,0,9,18,5,5,0,10
119732.0,Shoji Erik,L,USA,33.0,184.0,2022,Poland,USA,2022-07-23,False,0,0,0,0,0,0,3,3,0,0,0,0,0,0,0,0,5,3,6,14,9,2,0,11
119732.0,Shoji Erik,L,USA,33.0,184.0,2022,France,USA,2022-07-24,False,0,0,0,0,0,0,2,2,0,0,0,0,0,0,0,0,9,1,14,24,9,2,2,13
153472.0,Kessel Cody,OH,USA,31.0,196.0,2022,Netherlands,USA,2022-06-09,False,0,0,0,0,0,0,0,0,0,0,0,0,0,0,0,0,0,0,0,0,0,0,0,0
153472.0,Kessel Cody,OH,USA,31.0,196.0,2022,Japan,USA,2022-06-10,False,0,0,2,2,0,0,0,0,0,0,0,0,0,0,0,0,0,0,0,0,0,0,0,0
153472.0,Kessel Cody,OH,USA,31.0,196.0,2022,USA,Brazil,2022-06-11,False,0,1,14,15,0,0,1,1,8,3,9,20,0,4,3,7,6,2,6,14,7,1,1,9
153472.0,Kessel Cody,OH,USA,31.0,196.0,2022,USA,Germany,2022-07-05,False,0,0,0,0,0,0,0,0,0,0,0,0,0,0,0,0,0,0,0,0,0,0,0,0
153472.0,Kessel Cody,OH,USA,31.0,196.0,2022,France,USA,2022-07-07,False,0,0,0,0,0,0,0,0,0,0,0,0,0,0,0,0,0,0,0,0,0,0,0,0
153472.0,Kessel Cody,OH,USA,31.0,196.0,2022,Canada,USA,2022-07-09,False,0,0,0,0,0,0,0,0,0,0,0,0,0,0,0,0,0,0,0,0,0,0,0,0
153472.0,Kessel Cody,OH,USA,31.0,196.0,2022,USA,Argentina,2022-07-10,False,0,0,0,0,0,0,0,0,0,0,0,0,0,0,0,0,0,0,0,0,0,0,0,0
153472.0,Kessel Cody,OH,USA,31.0,196.0,2022,USA,Brazil,2022-07-20,False,0,0,0,0,0,0,0,0,0,0,0,0,0,0,0,0,0,0,0,0,0,0,0,0
153472.0,Kessel Cody,OH,USA,31.0,196.0,2022,Poland,USA,2022-07-23,False,0,0,0,0,0,0,0,0,0,0,0,0,0,0,0,0,0,0,0,0,0,0,0,0
153472.0,Kessel Cody,OH,USA,31.0,196.0,2022,France,USA,2022-07-24,False,0,0,0,0,0,0,0,0,0,0,0,0,0,0,0,0,0,0,0,0,0,0,0,0
162551.0,Mitchem Tyler,MB,USA,24.0,208.0,2022,Netherlands,USA,2022-06-09,False,0,0,0,0,0,0,0,0,1,0,1,2,0,0,0,0,0,0,0,0,0,0,0,0
162551.0,Mitchem Tyler,MB,USA,24.0,208.0,2022,Japan,USA,2022-06-10,False,0,0,1,1,0,0,0,0,0,0,0,0,0,0,0,0,0,0,1,1,0,0,0,0
162551.0,Mitchem Tyler,MB,USA,24.0,208.0,2022,USA,Brazil,2022-06-11,False,2,2,12,16,0,0,0,0,9,0,2,11,2,7,4,13,0,0,0,0,5,0,0,5
162551.0,Mitchem Tyler,MB,USA,24.0,208.0,2022,Serbia,USA,2022-06-22,False,0,0,0,0,0,0,0,0,0,0,0,0,0,0,0,0,0,0,0,0,0,0,0,0
162551.0,Mitchem Tyler,MB,USA,24.0,208.0,2022,USA,Iran,2022-06-23,False,0,1,5,6,0,0,0,0,2,1,2,5,0,3,0,3,0,0,0,0,0,0,0,0
162551.0,Mitchem Tyler,MB,USA,24.0,208.0,2022,USA,Bulgaria,2022-06-25,False,0,0,0,0,0,0,0,0,0,0,0,0,0,0,0,0,0,0,0,0,0,0,0,0
162551.0,Mitchem Tyler,MB,USA,24.0,208.0,2022,USA,Poland,2022-06-26,False,0,0,0,0,0,0,0,0,0,0,0,0,0,0,0,0,0,0,0,0,0,0,0,0
162551.0,Mitchem Tyler,MB,USA,24.0,208.0,2022,USA,Germany,2022-07-05,False,0,0,0,0,0,0,0,0,0,0,0,0,0,0,0,0,0,0,0,0,0,0,0,0
162551.0,Mitchem Tyler,MB,USA,24.0,208.0,2022,France,USA,2022-07-07,False,0,0,0,0,0,0,0,0,0,0,0,0,0,0,0,0,0,0,0,0,0,0,0,0
162551.0,Mitchem Tyler,MB,USA,24.0,208.0,2022,Canada,USA,2022-07-09,False,0,0,0,0,0,0,0,0,0,0,0,0,0,0,0,0,0,0,0,0,0,0,0,0
162551.0,Mitchem Tyler,MB,USA,24.0,208.0,2022,USA,Argentina,2022-07-10,False,0,0,0,0,0,0,0,0,0,0,0,0,0,0,0,0,0,0,0,0,0,0,0,0
162551.0,Mitchem Tyler,MB,USA,24.0,208.0,2022,USA,Brazil,2022-07-20,False,0,0,0,0,0,0,0,0,0,0,0,0,0,0,0,0,0,0,0,0,0,0,0,0
162551.0,Mitchem Tyler,MB,USA,24.0,208.0,2022,Poland,USA,2022-07-23,False,0,0,0,0,0,0,0,0,0,0,0,0,0,0,0,0,0,0,0,0,0,0,0,0
162551.0,Mitchem Tyler,MB,USA,24.0,208.0,2022,France,USA,2022-07-24,False,0,0,0,0,0,0,0,0,0,0,0,0,0,0,0,0,0,0,0,0,0,0,0,0
142412.0,Sanchez Matias,S,Argentina,27.0,175.0,2023,Italy,Argentina,2023-06-06,True,0,0,0,0,1,0,2,3,0,0,0,0,0,0,0,0,0,0,0,0,0,0,0,0
142412.0,Sanchez Matias,S,Argentina,27.0,175.0,2023,Argentina,Netherlands,2023-06-11,True,0,0,0,0,1,0,4,5,0,0,0,0,0,0,0,0,0,0,0,0,1,1,1,3
142412.0,Sanchez Matias,S,Argentina,27.0,175.0,2023,Argentina,Slovenia,2023-06-20,False,0,1,12,13,28,2,52,82,0,0,1,1,0,0,0,0,0,0,0,0,2,1,2,5
142412.0,Sanchez Matias,S,Argentina,27.0,175.0,2023,Argentina,France,2023-06-21,True,0,2,13,15,38,0,53,91,0,0,0,0,0,2,0,2,0,0,0,0,5,2,0,7
142412.0,Sanchez Matias,S,Argentina,27.0,175.0,2023,Argentina,Bulgaria,2023-06-23,True,0,0,10,10,20,0,27,47,0,0,0,0,0,0,1,1,0,0,0,0,5,0,3,8
142412.0,Sanchez Matias,S,Argentina,27.0,175.0,2023,Japan,Argentina,2023-06-24,False,0,1,14,15,29,0,65,94,0,0,0,0,0,7,0,7,0,0,1,1,1,6,0,7
142412.0,Sanchez Matias,S,Argentina,27.0,175.0,2023,Argentina,Serbia,2023-07-04,True,0,0,0,0,1,0,3,4,0,0,0,0,0,1,0,1,0,0,0,0,0,0,0,0
142412.0,Sanchez Matias,S,Argentina,27.0,175.0,2023,Argentina,Germany,2023-07-06,True,0,0,0,0,2,1,10,13,0,0,0,0,0,0,0,0,0,0,0,0,0,0,0,0
142412.0,Sanchez Matias,S,Argentina,27.0,175.0,2023,Italy,Argentina,2023-07-19,False,0,0,1,1,5,0,9,14,0,0,0,0,0,0,0,0,0,0,0,0,1,0,0,1
142410.0,Martinez Franchi Jan,U,Argentina,26.0,190.0,2023,Italy,Argentina,2023-06-06,True,0,0,0,0,0,0,0,0,0,0,0,0,0,0,0,0,0,0,0,0,0,0,0,0
142410.0,Martinez Franchi Jan,U,Argentina,26.0,190.0,2023,Argentina,Netherlands,2023-06-11,True,0,0,1,1,0,0,0,0,2,1,2,5,0,1,1,2,0,0,9,9,2,3,1,6
142410.0,Martinez Franchi Jan,U,Argentina,26.0,190.0,2023,Argentina,Slovenia,2023-06-20,False,0,2,1,3,0,0,0,0,0,0,2,2,0,1,0,1,5,1,4,10,3,0,0,3
142410.0,Martinez Franchi Jan,U,Argentina,26.0,190.0,2023,Argentina,France,2023-06-21,True,0,0,0,0,0,0,0,0,0,0,0,0,0,0,0,0,0,0,0,0,0,0,0,0
142410.0,Martinez Franchi Jan,U,Argentina,26.0,190.0,2023,Argentina,Bulgaria,2023-06-23,True,0,0,0,0,0,0,0,0,0,0,0,0,0,0,0,0,0,0,0,0,0,0,0,0
142410.0,Martinez Franchi Jan,U,Argentina,26.0,190.0,2023,Japan,Argentina,2023-06-24,False,0,0,0,0,0,0,0,0,0,0,0,0,0,0,0,0,0,0,2,2,0,0,0,0
142410.0,Martinez Franchi Jan,U,Argentina,26.0,190.0,2023,Argentina,Serbia,2023-07-04,True,0,0,0,0,0,0,0,0,0,0,0,0,0,0,0,0,0,0,0,0,0,0,0,0
142410.0,Martinez Franchi Jan,U,Argentina,26.0,190.0,2023,Argentina,Germany,2023-07-06,True,0,0,1,1,0,0,0,0,2,0,2,4,0,0,2,2,1,0,2,3,3,0,0,3
142410.0,Martinez Franchi Jan,U,Argentina,26.0,190.0,2023,Italy,Argentina,2023-07-19,False,0,1,1,2,0,0,2,2,2,0,4,6,0,0,0,0,2,0,4,6,0,0,0,0
142411.0,Gallego Joaquin,MB,Argentina,27.0,204.0,2023,Italy,Argentina,2023-06-06,True,0,0,4,4,0,0,0,0,1,0,2,3,2,1,1,4,0,0,0,0,0,0,0,0
142411.0,Gallego Joaquin,MB,Argentina,27.0,204.0,2023,Argentina,Netherlands,2023-06-11,True,0,0,0,0,0,0,0,0,0,0,0,0,0,0,0,0,0,0,0,0,0,0,0,0
142411.0,Gallego Joaquin,MB,Argentina,27.0,204.0,2023,Argentina,Slovenia,2023-06-20,False,0,0,0,0,0,0,0,0,0,0,0,0,0,0,0,0,0,0,0,0,0,0,0,0
142411.0,Gallego Joaquin,MB,Argentina,27.0,204.0,2023,Argentina,France,2023-06-21,True,0,0,0,0,0,0,0,0,0,0,0,0,0,0,0,0,0,0,0,0,0,0,0,0
142411.0,Gallego Joaquin,MB,Argentina,27.0,204.0,2023,Argentina,Bulgaria,2023-06-23,True,0,0,0,0,0,0,0,0,0,0,0,0,0,0,0,0,0,0,0,0,0,0,0,0
142411.0,Gallego Joaquin,MB,Argentina,27.0,204.0,2023,Japan,Argentina,2023-06-24,False,0,0,0,0,0,0,0,0,0,0,0,0,0,0,0,0,0,0,0,0,0,0,0,0
142411.0,Gallego Joaquin,MB,Argentina,27.0,204.0,2023,Argentina,Serbia,2023-07-04,True,0,0,0,0,0,0,0,0,0,0,0,0,0,0,0,0,0,0,0,0,0,0,0,0
142411.0,Gallego Joaquin,MB,Argentina,27.0,204.0,2023,Argentina,Germany,2023-07-06,True,0,0,0,0,0,0,0,0,0,0,0,0,0,0,0,0,0,0,0,0,0,0,0,0
142411.0,Gallego Joaquin,MB,Argentina,27.0,204.0,2023,Italy,Argentina,2023-07-19,False,0,0,0,0,0,0,0,0,0,0,0,0,0,0,0,0,0,0,0,0,0,0,0,0
162546.0,Palonsky Luciano,OH,Argentina,24.0,198.0,2023,Italy,Argentina,2023-06-06,True,2,3,9,14,0,0,0,0,8,3,5,16,1,0,2,3,6,1,8,15,4,0,1,5
162546.0,Palonsky Luciano,OH,Argentina,24.0,198.0,2023,Argentina,Netherlands,2023-06-11,True,3,5,11,19,0,0,6,6,9,4,3,16,2,2,0,4,1,2,9,12,8,0,0,8
162546.0,Palonsky Luciano,OH,Argentina,24.0,198.0,2023,Argentina,Slovenia,2023-06-20,False,0,3,11,14,0,0,0,0,16,4,7,27,2,0,3,5,10,1,13,24,10,2,1,13
162546.0,Palonsky Luciano,OH,Argentina,24.0,198.0,2023,Argentina,France,2023-06-21,True,3,3,16,22,0,1,2,3,13,4,11,28,0,4,1,5,4,0,8,12,6,3,0,9
162546.0,Palonsky Luciano,OH,Argentina,24.0,198.0,2023,Argentina,Bulgaria,2023-06-23,True,4,2,9,15,0,0,2,2,12,2,7,21,1,3,1,5,4,1,21,26,5,3,0,8
162546.0,Palonsky Luciano,OH,Argentina,24.0,198.0,2023,Japan,Argentina,2023-06-24,False,1,3,12,16,0,0,2,2,21,2,10,33,0,5,1,6,9,1,17,27,3,3,3,9
162546.0,Palonsky Luciano,OH,Argentina,24.0,198.0,2023,Argentina,Serbia,2023-07-04,True,1,6,9,16,0,0,3,3,12,2,13,27,1,2,1,4,5,1,13,19,8,4,1,13
162546.0,Palonsky Luciano,OH,Argentina,24.0,198.0,2023,Argentina,Germany,2023-07-06,True,2,5,7,14,0,0,4,4,9,4,10,23,3,2,0,5,2,1,13,16,1,2,0,3
162546.0,Palonsky Luciano,OH,Argentina,24.0,198.0,2023,Italy,Argentina,2023-07-19,False,0,4,4,8,0,0,2,2,5,2,8,15,0,2,0,2,0,1,19,20,3,1,2,6
152692.0,Loser Agustin,MB,Argentina,26.0,198.0,2023,Italy,Argentina,2023-06-06,True,2,3,9,14,0,0,0,0,3,1,4,8,2,1,5,8,0,0,2,2,0,0,0,0
152692.0,Loser Agustin,MB,Argentina,26.0,198.0,2023,Argentina,Netherlands,2023-06-11,True,1,2,19,22,0,0,1,1,7,1,0,8,1,4,4,9,1,0,3,4,5,1,1,7
152692.0,Loser Agustin,MB,Argentina,26.0,198.0,2023,Argentina,Slovenia,2023-06-20,False,0,5,11,16,0,0,0,0,10,1,4,15,0,7,4,11,1,0,1,2,2,1,0,3
152692.0,Loser Agustin,MB,Argentina,26.0,198.0,2023,Argentina,France,2023-06-21,True,0,2,14,16,0,0,0,0,11,0,4,15,5,9,1,15,0,0,0,0,5,1,0,6
152692.0,Loser Agustin,MB,Argentina,26.0,198.0,2023,Argentina,Bulgaria,2023-06-23,True,2,0,11,13,0,0,1,1,8,2,1,11,6,4,2,12,0,0,0,0,1,1,0,2
152692.0,Loser Agustin,MB,Argentina,26.0,198.0,2023,Japan,Argentina,2023-06-24,False,2,2,17,21,0,0,0,0,6,0,5,11,3,8,4,15,3,0,1,4,2,3,0,5
152692.0,Loser Agustin,MB,Argentina,26.0,198.0,2023,Argentina,Serbia,2023-07-04,True,1,1,15,17,0,0,0,0,7,0,3,10,8,4,2,14,0,0,0,0,3,0,0,3
152692.0,Loser Agustin,MB,Argentina,26.0,198.0,2023,Argentina,Germany,2023-07-06,True,1,2,7,10,0,0,5,5,6,0,0,6,6,3,0,9,0,1,3,4,2,1,0,3
152692.0,Loser Agustin,MB,Argentina,26.0,198.0,2023,Italy,Argentina,2023-07-19,False,1,0,10,11,0,0,0,0,7,2,5,14,2,1,4,7,0,0,2,2,1,0,0,1
153053.0,Danani Santiago,L,Argentina,28.0,176.0,2023,Italy,Argentina,2023-06-06,True,0,0,0,0,0,0,4,4,0,0,0,0,0,0,0,0,6,1,10,17,6,5,2,13
153053.0,Danani Santiago,L,Argentina,28.0,176.0,2023,Argentina,Netherlands,2023-06-11,True,0,0,0,0,0,0,10,10,0,0,0,0,0,0,0,0,3,2,24,29,9,7,0,16
153053.0,Danani Santiago,L,Argentina,28.0,176.0,2023,Argentina,Slovenia,2023-06-20,False,0,0,0,0,0,0,2,2,0,0,0,0,0,0,0,0,10,1,9,20,11,3,0,14
153053.0,Danani Santiago,L,Argentina,28.0,176.0,2023,Argentina,France,2023-06-21,True,0,0,0,0,0,0,7,7,0,0,0,0,0,0,0,0,8,0,10,18,11,1,0,12
153053.0,Danani Santiago,L,Argentina,28.0,176.0,2023,Argentina,Bulgaria,2023-06-23,True,0,0,0,0,0,0,6,6,0,0,0,0,0,0,0,0,2,1,7,10,13,3,1,17
153053.0,Danani Santiago,L,Argentina,28.0,176.0,2023,Japan,Argentina,2023-06-24,False,0,0,0,0,0,0,6,6,0,0,0,0,0,0,0,0,5,0,17,22,8,6,3,17
153053.0,Danani Santiago,L,Argentina,28.0,176.0,2023,Argentina,Serbia,2023-07-04,True,0,0,0,0,0,0,6,6,0,0,0,0,0,0,0,0,9,1,14,24,7,4,2,13
153053.0,Danani Santiago,L,Argentina,28.0,176.0,2023,Argentina,Germany,2023-07-06,True,0,0,0,0,0,0,0,0,0,0,0,0,0,0,0,0,3,0,10,13,7,4,1,12
153053.0,Danani Santiago,L,Argentina,28.0,176.0,2023,Italy,Argentina,2023-07-19,False,0,0,0,0,0,0,4,4,0,0,0,0,0,0,0,0,4,1,9,14,5,5,0,10
160816.0,Zelayeta Mauro,OH,Argentina,24.0,190.0,2023,Italy,Argentina,2023-06-06,True,0,0,0,0,0,0,0,0,0,0,0,0,0,0,0,0,0,0,0,0,0,0,0,0
160816.0,Zelayeta Mauro,OH,Argentina,24.0,190.0,2023,Argentina,Netherlands,2023-06-11,True,0,0,0,0,0,0,0,0,0,0,0,0,0,0,0,0,0,0,0,0,0,0,0,0
160816.0,Zelayeta Mauro,OH,Argentina,24.0,190.0,2023,Argentina,Slovenia,2023-06-20,False,0,0,0,0,0,0,0,0,0,0,0,0,0,0,0,0,0,0,0,0,0,0,0,0
160816.0,Zelayeta Mauro,OH,Argentina,24.0,190.0,2023,Argentina,France,2023-06-21,True,0,0,0,0,0,0,0,0,0,0,0,0,0,0,0,0,0,0,0,0,0,0,0,0
160816.0,Zelayeta Mauro,OH,Argentina,24.0,190.0,2023,Argentina,Bulgaria,2023-06-23,True,0,0,0,0,0,0,0,0,0,0,0,0,0,0,0,0,0,0,0,0,0,0,0,0
160816.0,Zelayeta Mauro,OH,Argentina,24.0,190.0,2023,Japan,Argentina,2023-06-24,False,0,0,0,0,0,0,0,0,0,0,0,0,0,0,0,0,0,0,0,0,0,0,0,0
160816.0,Zelayeta Mauro,OH,Argentina,24.0,190.0,2023,Argentina,Serbia,2023-07-04,True,0,0,0,0,0,0,0,0,0,0,0,0,0,0,0,0,0,0,0,0,0,0,0,0
160816.0,Zelayeta Mauro,OH,Argentina,24.0,190.0,2023,Argentina,Germany,2023-07-06,True,0,0,0,0,0,0,0,0,0,0,0,0,0,0,0,0,0,0,0,0,0,0,0,0
160816.0,Zelayeta Mauro,OH,Argentina,24.0,190.0,2023,Italy,Argentina,2023-07-19,False,0,1,0,1,0,0,0,0,1,0,0,1,0,0,0,0,0,0,0,0,0,0,0,0
174853.0,Armoa Manuel,OH,Argentina,21.0,195.0,2023,Italy,Argentina,2023-06-06,True,0,0,0,0,0,0,0,0,0,0,0,0,0,0,0,0,0,0,0,0,0,0,0,0
174853.0,Armoa Manuel,OH,Argentina,21.0,195.0,2023,Argentina,Netherlands,2023-06-11,True,0,0,1,1,0,0,1,1,1,1,0,2,0,0,0,0,0,0,0,0,0,0,0,0
174853.0,Armoa Manuel,OH,Argentina,21.0,195.0,2023,Argentina,Slovenia,2023-06-20,False,0,0,0,0,0,0,0,0,0,0,0,0,0,0,0,0,0,0,0,0,0,0,0,0
174853.0,Armoa Manuel,OH,Argentina,21.0,195.0,2023,Argentina,France,2023-06-21,True,0,1,2,3,0,0,0,0,0,0,0,0,0,0,0,0,0,0,0,0,0,0,0,0
174853.0,Armoa Manuel,OH,Argentina,21.0,195.0,2023,Argentina,Bulgaria,2023-06-23,True,0,0,0,0,0,0,0,0,0,0,0,0,0,0,0,0,0,0,0,0,0,0,0,0
174853.0,Armoa Manuel,OH,Argentina,21.0,195.0,2023,Japan,Argentina,2023-06-24,False,0,0,0,0,0,0,0,0,0,0,0,0,0,0,0,0,0,0,0,0,0,0,0,0
174853.0,Armoa Manuel,OH,Argentina,21.0,195.0,2023,Argentina,Serbia,2023-07-04,True,0,0,3,3,0,0,3,3,4,0,2,6,1,0,0,1,1,0,3,4,0,0,0,0
174853.0,Armoa Manuel,OH,Argentina,21.0,195.0,2023,Argentina,Germany,2023-07-06,True,0,0,0,0,0,0,0,0,0,0,0,0,0,0,0,0,0,0,0,0,0,0,0,0
174853.0,Armoa Manuel,OH,Argentina,21.0,195.0,2023,Italy,Argentina,2023-07-19,False,1,0,2,3,0,0,0,0,1,3,3,7,0,1,0,1,1,0,6,7,0,0,1,1
142415.0,Lima Bruno,O,Argentina,28.0,198.0,2023,Italy,Argentina,2023-06-06,True,0,2,11,13,0,0,0,0,17,0,5,22,0,0,0,0,0,0,1,1,3,0,0,3
142415.0,Lima Bruno,O,Argentina,28.0,198.0,2023,Argentina,Netherlands,2023-06-11,True,0,2,1,3,0,0,0,0,2,2,4,8,2,1,2,5,0,0,0,0,0,2,1,3
142415.0,Lima Bruno,O,Argentina,28.0,198.0,2023,Argentina,Slovenia,2023-06-20,False,2,4,10,16,0,0,1,1,14,6,11,31,0,3,2,5,0,0,0,0,3,1,0,4
142415.0,Lima Bruno,O,Argentina,28.0,198.0,2023,Argentina,France,2023-06-21,True,0,3,2,5,0,0,0,0,6,3,6,15,0,1,1,2,0,0,0,0,1,1,1,3
142415.0,Lima Bruno,O,Argentina,28.0,198.0,2023,Argentina,Bulgaria,2023-06-23,True,1,3,8,12,0,2,0,2,7,2,6,15,0,3,4,7,0,0,0,0,4,1,1,6
142415.0,Lima Bruno,O,Argentina,28.0,198.0,2023,Japan,Argentina,2023-06-24,False,0,0,6,6,0,0,2,2,11,2,7,20,1,3,0,4,0,0,3,3,1,1,0,2
142415.0,Lima Bruno,O,Argentina,28.0,198.0,2023,Argentina,Serbia,2023-07-04,True,1,3,14,18,0,0,1,1,16,3,5,24,1,6,6,13,0,0,1,1,3,1,0,4
142415.0,Lima Bruno,O,Argentina,28.0,198.0,2023,Argentina,Germany,2023-07-06,True,2,2,11,15,0,0,2,2,8,3,5,16,0,3,4,7,0,0,0,0,4,1,0,5
142415.0,Lima Bruno,O,Argentina,28.0,198.0,2023,Italy,Argentina,2023-07-19,False,0,0,0,0,0,0,0,0,0,0,0,0,0,0,0,0,0,0,0,0,0,0,0,0
117457.0,De Cecco Luciano,S,Argentina,35.0,191.0,2023,Italy,Argentina,2023-06-06,True,0,2,12,14,19,0,46,65,0,0,1,1,1,1,1,3,0,0,1,1,3,0,2,5
117457.0,De Cecco Luciano,S,Argentina,35.0,191.0,2023,Argentina,Netherlands,2023-06-11,True,1,0,10,11,24,3,78,105,1,1,1,3,1,4,4,9,0,0,0,0,7,3,1,11
117457.0,De Cecco Luciano,S,Argentina,35.0,191.0,2023,Argentina,Serbia,2023-07-04,True,0,1,14,15,39,0,41,80,0,0,1,1,0,2,2,4,0,1,0,1,8,2,0,10
117457.0,De Cecco Luciano,S,Argentina,35.0,191.0,2023,Argentina,Germany,2023-07-06,True,1,0,15,16,23,0,27,50,1,0,0,1,1,1,0,2,0,0,0,0,4,2,2,8
117457.0,De Cecco Luciano,S,Argentina,35.0,191.0,2023,Italy,Argentina,2023-07-19,False,0,0,6,6,19,0,36,55,0,0,0,0,0,0,0,0,0,0,0,0,3,5,0,8
141282.0,Koukartsev Pablo Sergio,O,Argentina,31.0,203.0,2023,Italy,Argentina,2023-06-06,True,0,0,0,0,0,0,0,0,1,0,0,1,0,0,0,0,0,0,0,0,0,0,0,0
141282.0,Koukartsev Pablo Sergio,O,Argentina,31.0,203.0,2023,Argentina,Netherlands,2023-06-11,True,1,3,17,21,0,0,1,1,24,1,12,37,0,4,2,6,0,0,0,0,7,1,1,9
141282.0,Koukartsev Pablo Sergio,O,Argentina,31.0,203.0,2023,Argentina,Slovenia,2023-06-20,False,0,0,3,3,0,0,0,0,2,2,2,6,0,0,0,0,0,0,0,0,1,0,0,1
141282.0,Koukartsev Pablo Sergio,O,Argentina,31.0,203.0,2023,Argentina,France,2023-06-21,True,0,2,5,7,0,0,0,0,8,2,11,21,1,1,3,5,1,0,0,1,2,0,0,2
141282.0,Koukartsev Pablo Sergio,O,Argentina,31.0,203.0,2023,Argentina,Bulgaria,2023-06-23,True,0,1,4,5,0,0,0,0,2,1,1,4,0,1,0,1,0,0,0,0,0,0,0,0
141282.0,Koukartsev Pablo Sergio,O,Argentina,31.0,203.0,2023,Japan,Argentina,2023-06-24,False,0,2,6,8,0,0,0,0,7,0,6,13,0,0,2,2,2,1,1,4,2,2,0,4
141282.0,Koukartsev Pablo Sergio,O,Argentina,31.0,203.0,2023,Argentina,Serbia,2023-07-04,True,0,0,1,1,0,0,0,0,0,0,1,1,0,0,0,0,0,0,0,0,0,0,0,0
141282.0,Koukartsev Pablo Sergio,O,Argentina,31.0,203.0,2023,Argentina,Germany,2023-07-06,True,1,0,3,4,0,0,0,0,2,2,3,7,0,1,0,1,0,0,0,0,0,0,0,0
141282.0,Koukartsev Pablo Sergio,O,Argentina,31.0,203.0,2023,Italy,Argentina,2023-07-19,False,0,1,5,6,0,0,1,1,5,6,12,23,1,2,1,4,0,0,0,0,0,0,0,0
163555.0,Vicentin Luciano,OH,Argentina,23.0,197.0,2023,Italy,Argentina,2023-06-06,True,0,5,6,11,0,0,0,0,9,3,11,23,2,0,2,4,3,0,12,15,6,1,0,7
163555.0,Vicentin Luciano,OH,Argentina,23.0,197.0,2023,Argentina,Netherlands,2023-06-11,True,2,5,16,23,0,0,1,1,10,8,16,34,4,3,2,9,7,3,22,32,9,4,3,16
163555.0,Vicentin Luciano,OH,Argentina,23.0,197.0,2023,Argentina,Slovenia,2023-06-20,False,0,5,2,7,0,0,1,1,5,2,10,17,0,0,3,3,6,2,10,18,5,1,1,7
163555.0,Vicentin Luciano,OH,Argentina,23.0,197.0,2023,Argentina,France,2023-06-21,True,1,4,13,18,0,0,2,2,7,3,7,17,1,2,2,5,7,2,29,38,6,1,0,7
163555.0,Vicentin Luciano,OH,Argentina,23.0,197.0,2023,Argentina,Bulgaria,2023-06-23,True,0,2,9,11,0,0,0,0,9,2,9,20,0,3,4,7,2,0,9,11,5,3,1,9
163555.0,Vicentin Luciano,OH,Argentina,23.0,197.0,2023,Japan,Argentina,2023-06-24,False,0,9,15,24,0,0,2,2,15,3,11,29,0,1,1,2,8,1,23,32,2,6,1,9
163555.0,Vicentin Luciano,OH,Argentina,23.0,197.0,2023,Argentina,Serbia,2023-07-04,True,2,2,5,9,0,0,1,1,5,6,7,18,1,3,2,6,5,2,7,14,4,3,0,7
163555.0,Vicentin Luciano,OH,Argentina,23.0,197.0,2023,Argentina,Germany,2023-07-06,True,0,3,2,5,0,0,2,2,7,4,5,16,0,1,1,2,4,0,7,11,5,0,0,5
163555.0,Vicentin Luciano,OH,Argentina,23.0,197.0,2023,Italy,Argentina,2023-07-19,False,0,1,2,3,0,0,2,2,3,3,7,13,0,3,1,4,2,2,10,14,3,0,0,3
125047.0,Ramos Martin,MB,Argentina,32.0,197.0,2023,Italy,Argentina,2023-06-06,True,0,0,0,0,0,0,0,0,0,0,0,0,0,0,0,0,0,0,0,0,0,0,0,0
125047.0,Ramos Martin,MB,Argentina,32.0,197.0,2023,Argentina,Netherlands,2023-06-11,True,0,2,16,18,0,0,2,2,7,0,10,17,5,4,3,12,0,0,2,2,3,1,2,6
125047.0,Ramos Martin,MB,Argentina,32.0,197.0,2023,Argentina,Slovenia,2023-06-20,False,0,0,3,3,0,0,0,0,0,0,0,0,0,0,0,0,0,0,0,0,0,1,0,1
125047.0,Ramos Martin,MB,Argentina,32.0,197.0,2023,Argentina,France,2023-06-21,True,0,0,0,0,0,0,0,0,0,0,0,0,0,0,0,0,0,0,0,0,0,0,0,0
125047.0,Ramos Martin,MB,Argentina,32.0,197.0,2023,Argentina,Bulgaria,2023-06-23,True,0,0,0,0,0,0,0,0,0,0,0,0,0,0,0,0,0,0,0,0,0,0,0,0
125047.0,Ramos Martin,MB,Argentina,32.0,197.0,2023,Japan,Argentina,2023-06-24,False,0,1,11,12,0,0,1,1,6,0,0,6,2,4,3,9,0,0,0,0,1,0,0,1
125047.0,Ramos Martin,MB,Argentina,32.0,197.0,2023,Argentina,Serbia,2023-07-04,True,0,0,0,0,0,0,0,0,0,0,0,0,0,0,0,0,0,0,0,0,0,0,0,0
125047.0,Ramos Martin,MB,Argentina,32.0,197.0,2023,Argentina,Germany,2023-07-06,True,0,0,0,0,0,0,0,0,0,0,0,0,0,0,0,0,0,0,0,0,0,0,0,0
125047.0,Ramos Martin,MB,Argentina,32.0,197.0,2023,Italy,Argentina,2023-07-19,False,0,1,4,5,0,0,1,1,2,0,2,4,1,4,3,8,0,1,1,2,0,2,0,2
162543.0,Zerba Nicolas,MB,Argentina,24.0,203.0,2023,Italy,Argentina,2023-06-06,True,0,2,2,4,0,0,0,0,1,0,2,3,0,1,5,6,0,0,0,0,1,0,0,1
162543.0,Zerba Nicolas,MB,Argentina,24.0,203.0,2023,Argentina,Netherlands,2023-06-11,True,0,0,0,0,0,0,0,0,0,0,0,0,0,0,0,0,0,0,0,0,0,0,0,0
162543.0,Zerba Nicolas,MB,Argentina,24.0,203.0,2023,Argentina,Slovenia,2023-06-20,False,0,1,12,13,0,0,0,0,7,1,2,10,1,2,3,6,0,0,2,2,6,2,0,8
162543.0,Zerba Nicolas,MB,Argentina,24.0,203.0,2023,Argentina,France,2023-06-21,True,0,1,10,11,0,0,1,1,6,1,4,11,0,10,4,14,1,0,0,1,2,1,1,4
162543.0,Zerba Nicolas,MB,Argentina,24.0,203.0,2023,Argentina,Bulgaria,2023-06-23,True,0,0,7,7,0,0,1,1,4,1,2,7,0,2,7,9,0,0,0,0,1,1,0,2
162543.0,Zerba Nicolas,MB,Argentina,24.0,203.0,2023,Japan,Argentina,2023-06-24,False,1,1,5,7,0,0,1,1,1,0,2,3,1,3,4,8,1,0,1,2,0,1,0,1
162543.0,Zerba Nicolas,MB,Argentina,24.0,203.0,2023,Argentina,Serbia,2023-07-04,True,0,2,12,14,0,0,2,2,3,1,7,11,4,5,3,12,0,0,2,2,1,1,0,2
162543.0,Zerba Nicolas,MB,Argentina,24.0,203.0,2023,Argentina,Germany,2023-07-06,True,0,1,7,8,0,0,2,2,3,0,4,7,1,1,5,7,0,0,0,0,2,0,0,2
162543.0,Zerba Nicolas,MB,Argentina,24.0,203.0,2023,Italy,Argentina,2023-07-19,False,0,0,0,0,0,0,0,0,0,0,0,0,0,0,0,0,0,0,0,0,0,0,0,0
116099.0,Rezende Bruno Mossa,S,Brazil,37.0,190.0,2023,Brazil,Cuba,2023-06-10,False,0,2,14,16,33,1,57,91,0,0,0,0,0,2,3,5,0,0,0,0,4,3,0,7
116099.0,Rezende Bruno Mossa,S,Brazil,37.0,190.0,2023,USA,Brazil,2023-06-11,True,2,2,20,24,22,0,62,84,0,0,0,0,1,3,5,9,0,0,0,0,2,3,1,6
116099.0,Rezende Bruno Mossa,S,Brazil,37.0,190.0,2023,Brazil,Bulgaria,2023-06-20,True,0,1,6,7,17,0,36,53,0,0,0,0,2,1,3,6,0,0,0,0,3,1,0,4
116099.0,Rezende Bruno Mossa,S,Brazil,37.0,190.0,2023,Japan,Brazil,2023-06-22,False,0,1,2,3,8,0,16,24,0,0,0,0,1,2,0,3,0,0,0,0,1,2,0,3
116099.0,Rezende Bruno Mossa,S,Brazil,37.0,190.0,2023,Brazil,Slovenia,2023-06-24,True,1,2,13,16,30,0,69,99,1,0,1,2,1,2,3,6,0,0,0,0,7,3,2,12
116099.0,Rezende Bruno Mossa,S,Brazil,37.0,190.0,2023,Brazil,France,2023-06-25,True,0,3,14,17,28,1,60,89,0,0,0,0,1,0,2,3,0,0,1,1,3,6,2,11
116099.0,Rezende Bruno Mossa,S,Brazil,37.0,190.0,2023,Brazil,Italy,2023-07-04,False,0,0,8,8,22,0,64,86,1,0,2,3,0,1,6,7,0,0,1,1,3,3,2,8
116099.0,Rezende Bruno Mossa,S,Brazil,37.0,190.0,2023,Brazil,Netherlands,2023-07-06,True,0,0,12,12,11,1,40,52,1,0,1,2,0,2,2,4,0,0,0,0,4,1,0,5
116099.0,Rezende Bruno Mossa,S,Brazil,37.0,190.0,2023,Poland,Brazil,2023-07-07,False,0,0,11,11,17,0,51,68,2,0,0,2,0,4,1,5,0,0,0,0,7,2,2,11
116099.0,Rezende Bruno Mossa,S,Brazil,37.0,190.0,2023,Brazil,China,2023-07-08,True,0,0,13,13,12,1,42,55,0,0,0,0,0,3,5,8,0,0,0,0,4,2,2,8
116099.0,Rezende Bruno Mossa,S,Brazil,37.0,190.0,2023,Poland,Brazil,2023-07-20,False,0,0,5,5,9,0,25,34,0,0,0,0,0,1,0,1,0,0,0,0,1,2,0,3
125010.0,Rodrigues Pinto Otávio Henrique,MB,Brazil,33.0,200.0,2023,Brazil,Cuba,2023-06-10,False,0,5,11,16,0,0,0,0,8,2,3,13,3,3,5,11,0,0,1,1,1,1,0,2
125010.0,Rodrigues Pinto Otávio Henrique,MB,Brazil,33.0,200.0,2023,USA,Brazil,2023-06-11,True,0,1,5,6,0,0,0,0,2,1,3,6,0,3,1,4,0,0,1,1,0,0,0,0
125010.0,Rodrigues Pinto Otávio Henrique,MB,Brazil,33.0,200.0,2023,Brazil,Bulgaria,2023-06-20,True,0,1,4,5,0,0,1,1,1,0,0,1,0,1,0,1,0,0,0,0,1,0,0,1
125010.0,Rodrigues Pinto Otávio Henrique,MB,Brazil,33.0,200.0,2023,Japan,Brazil,2023-06-22,False,0,2,5,7,0,0,1,1,3,0,2,5,2,3,2,7,0,0,0,0,0,0,0,0
125010.0,Rodrigues Pinto Otávio Henrique,MB,Brazil,33.0,200.0,2023,Brazil,Slovenia,2023-06-24,True,1,4,12,17,0,0,0,0,8,0,1,9,1,4,2,7,0,0,1,1,2,2,0,4
125010.0,Rodrigues Pinto Otávio Henrique,MB,Brazil,33.0,200.0,2023,Brazil,France,2023-06-25,True,1,4,12,17,0,0,0,0,4,1,0,5,0,5,5,10,0,0,0,0,2,0,0,2
125010.0,Rodrigues Pinto Otávio Henrique,MB,Brazil,33.0,200.0,2023,Brazil,Italy,2023-07-04,False,0,2,2,4,0,0,0,0,1,0,2,3,0,0,1,1,0,0,0,0,2,0,0,2
125010.0,Rodrigues Pinto Otávio Henrique,MB,Brazil,33.0,200.0,2023,Brazil,Netherlands,2023-07-06,True,0,0,0,0,0,0,0,0,0,0,0,0,0,0,0,0,0,0,0,0,0,0,0,0
125010.0,Rodrigues Pinto Otávio Henrique,MB,Brazil,33.0,200.0,2023,Poland,Brazil,2023-07-07,False,0,1,0,1,0,0,0,0,0,0,0,0,0,0,0,0,0,0,0,0,0,0,0,0
125010.0,Rodrigues Pinto Otávio Henrique,MB,Brazil,33.0,200.0,2023,Brazil,China,2023-07-08,True,2,2,11,15,0,0,1,1,8,0,0,8,2,1,3,6,0,0,0,0,1,0,0,1
125010.0,Rodrigues Pinto Otávio Henrique,MB,Brazil,33.0,200.0,2023,Poland,Brazil,2023-07-20,False,0,2,0,2,0,0,0,0,0,0,0,0,0,1,1,2,0,0,0,0,0,0,0,0
174908.0,Fernandes P.X.Cavalcante Adriano,OH,Brazil,22.0,201.0,2023,Brazil,Cuba,2023-06-10,False,0,0,1,1,0,0,0,0,1,0,2,3,0,0,1,1,2,0,4,6,0,0,1,1
174908.0,Fernandes P.X.Cavalcante Adriano,OH,Brazil,22.0,201.0,2023,USA,Brazil,2023-06-11,True,0,0,0,0,0,0,0,0,0,0,0,0,0,0,0,0,0,0,0,0,0,0,0,0
174908.0,Fernandes P.X.Cavalcante Adriano,OH,Brazil,22.0,201.0,2023,Brazil,Bulgaria,2023-06-20,True,0,0,0,0,0,0,0,0,0,0,0,0,0,0,0,0,0,0,0,0,1,0,0,1
174908.0,Fernandes P.X.Cavalcante Adriano,OH,Brazil,22.0,201.0,2023,Japan,Brazil,2023-06-22,False,0,1,0,1,0,0,0,0,0,1,2,3,0,1,0,1,0,0,1,1,0,0,0,0
174908.0,Fernandes P.X.Cavalcante Adriano,OH,Brazil,22.0,201.0,2023,Brazil,Slovenia,2023-06-24,True,0,0,1,1,0,0,1,1,1,1,2,4,0,1,0,1,1,0,3,4,0,0,0,0
174908.0,Fernandes P.X.Cavalcante Adriano,OH,Brazil,22.0,201.0,2023,Brazil,France,2023-06-25,True,0,0,11,11,0,0,2,2,11,1,4,16,0,2,1,3,2,2,19,23,3,2,0,5
174908.0,Fernandes P.X.Cavalcante Adriano,OH,Brazil,22.0,201.0,2023,Brazil,Italy,2023-07-04,False,0,0,1,1,0,0,0,0,0,0,1,1,0,0,0,0,1,1,3,5,0,0,0,0
174908.0,Fernandes P.X.Cavalcante Adriano,OH,Brazil,22.0,201.0,2023,Brazil,Netherlands,2023-07-06,True,0,1,0,1,0,0,0,0,1,0,1,2,0,2,0,2,0,0,2,2,1,0,0,1
174908.0,Fernandes P.X.Cavalcante Adriano,OH,Brazil,22.0,201.0,2023,Poland,Brazil,2023-07-07,False,0,0,1,1,0,0,0,0,0,1,0,1,1,1,0,2,1,0,1,2,0,0,0,0
174908.0,Fernandes P.X.Cavalcante Adriano,OH,Brazil,22.0,201.0,2023,Brazil,China,2023-07-08,True,0,0,15,15,0,0,1,1,7,2,4,13,0,2,5,7,1,2,14,17,3,0,2,5
174908.0,Fernandes P.X.Cavalcante Adriano,OH,Brazil,22.0,201.0,2023,Poland,Brazil,2023-07-20,False,0,0,0,0,0,0,0,0,0,0,0,0,0,0,0,0,0,0,0,0,0,0,0,0
161930.0,Honorato Henrique Dantas Nóbrega,OH,Brazil,27.0,190.0,2023,Brazil,Cuba,2023-06-10,False,0,5,11,16,0,0,4,4,8,5,3,16,0,4,2,6,10,0,18,28,7,3,2,12
161930.0,Honorato Henrique Dantas Nóbrega,OH,Brazil,27.0,190.0,2023,USA,Brazil,2023-06-11,True,1,2,12,15,0,0,2,2,4,5,7,16,2,5,0,7,3,1,10,14,4,0,0,4
161930.0,Honorato Henrique Dantas Nóbrega,OH,Brazil,27.0,190.0,2023,Brazil,Bulgaria,2023-06-20,True,0,2,8,10,0,0,1,1,5,2,5,12,0,1,3,4,3,0,3,6,3,1,0,4
161930.0,Honorato Henrique Dantas Nóbrega,OH,Brazil,27.0,190.0,2023,Japan,Brazil,2023-06-22,False,1,3,16,20,0,0,4,4,11,2,8,21,4,3,3,10,8,3,13,24,3,2,0,5
161930.0,Honorato Henrique Dantas Nóbrega,OH,Brazil,27.0,190.0,2023,Brazil,Slovenia,2023-06-24,True,0,6,9,15,0,0,5,5,6,1,10,17,2,4,1,7,2,0,18,20,4,0,0,4
161930.0,Honorato Henrique Dantas Nóbrega,OH,Brazil,27.0,190.0,2023,Brazil,France,2023-06-25,True,0,1,3,4,0,0,2,2,0,0,2,2,1,1,0,2,0,0,2,2,1,0,0,1
161930.0,Honorato Henrique Dantas Nóbrega,OH,Brazil,27.0,190.0,2023,Brazil,Italy,2023-07-04,False,1,4,8,13,0,0,4,4,14,7,15,36,0,5,4,9,2,3,8,13,1,4,1,6
161930.0,Honorato Henrique Dantas Nóbrega,OH,Brazil,27.0,190.0,2023,Brazil,Netherlands,2023-07-06,True,1,3,7,11,0,0,1,1,7,1,5,13,2,4,0,6,2,0,13,15,3,3,0,6
161930.0,Honorato Henrique Dantas Nóbrega,OH,Brazil,27.0,190.0,2023,Poland,Brazil,2023-07-07,False,0,3,14,17,0,1,3,4,8,2,9,19,1,4,2,7,1,1,13,15,5,4,0,9
161930.0,Honorato Henrique Dantas Nóbrega,OH,Brazil,27.0,190.0,2023,Brazil,China,2023-07-08,True,0,0,0,0,0,0,2,2,0,0,0,0,1,0,0,1,0,0,0,0,1,0,0,1
161930.0,Honorato Henrique Dantas Nóbrega,OH,Brazil,27.0,190.0,2023,Poland,Brazil,2023-07-20,False,0,0,6,6,0,0,2,2,4,4,5,13,2,1,1,4,4,3,10,17,4,1,1,6
118928.0,Leal Hidalgo Yoandy,OH,Brazil,35.0,202.0,2023,Poland,Brazil,2023-07-20,False,0,2,1,3,0,0,0,0,2,0,2,4,0,1,0,1,0,1,9,10,0,0,0,0
142744.0,Gil Kreling Fernando,S,Brazil,28.0,186.0,2023,Brazil,Cuba,2023-06-10,False,0,1,1,2,14,0,10,24,0,0,0,0,0,0,1,1,0,0,0,0,0,0,0,0
142744.0,Gil Kreling Fernando,S,Brazil,28.0,186.0,2023,USA,Brazil,2023-06-11,True,0,0,0,0,0,0,3,3,0,0,0,0,0,0,0,0,0,0,0,0,0,0,0,0
142744.0,Gil Kreling Fernando,S,Brazil,28.0,186.0,2023,Brazil,Bulgaria,2023-06-20,True,0,0,0,0,0,0,0,0,0,0,0,0,0,0,0,0,0,0,0,0,2,1,0,3
142744.0,Gil Kreling Fernando,S,Brazil,28.0,186.0,2023,Japan,Brazil,2023-06-22,False,0,0,12,12,24,1,55,80,1,0,0,1,0,1,4,5,0,0,0,0,2,1,0,3
142744.0,Gil Kreling Fernando,S,Brazil,28.0,186.0,2023,Brazil,Slovenia,2023-06-24,True,0,0,0,0,2,0,4,6,0,0,0,0,0,0,0,0,0,0,0,0,0,0,0,0
142744.0,Gil Kreling Fernando,S,Brazil,28.0,186.0,2023,Brazil,France,2023-06-25,True,0,0,0,0,1,0,1,2,0,0,0,0,0,0,0,0,0,0,0,0,0,2,0,2
142744.0,Gil Kreling Fernando,S,Brazil,28.0,186.0,2023,Brazil,Italy,2023-07-04,False,0,0,4,4,5,0,13,18,0,0,0,0,0,0,0,0,0,0,0,0,1,1,0,2
142744.0,Gil Kreling Fernando,S,Brazil,28.0,186.0,2023,Brazil,Netherlands,2023-07-06,True,0,0,3,3,5,0,7,12,0,0,0,0,0,1,1,2,0,0,0,0,0,0,0,0
142744.0,Gil Kreling Fernando,S,Brazil,28.0,186.0,2023,Poland,Brazil,2023-07-07,False,0,1,3,4,5,0,10,15,0,0,0,0,0,1,0,1,0,0,0,0,1,0,0,1
142744.0,Gil Kreling Fernando,S,Brazil,28.0,186.0,2023,Brazil,China,2023-07-08,True,0,0,0,0,1,0,0,1,0,0,0,0,0,0,0,0,0,0,0,0,0,0,0,0
142744.0,Gil Kreling Fernando,S,Brazil,28.0,186.0,2023,Poland,Brazil,2023-07-20,False,0,0,3,3,9,0,29,38,0,0,0,0,0,0,2,2,0,0,0,0,3,2,2,7
161939.0,Nascimento Maique Reis,L,Brazil,26.0,187.0,2023,Brazil,Cuba,2023-06-10,False,0,0,0,0,0,0,3,3,0,0,0,0,0,0,0,0,6,2,23,31,11,7,1,19
161939.0,Nascimento Maique Reis,L,Brazil,26.0,187.0,2023,USA,Brazil,2023-06-11,True,0,0,0,0,0,0,0,0,0,0,0,0,0,0,0,0,0,0,0,0,0,0,0,0
161939.0,Nascimento Maique Reis,L,Brazil,26.0,187.0,2023,Brazil,Bulgaria,2023-06-20,True,0,0,0,0,0,0,0,0,0,0,0,0,0,0,0,0,0,0,0,0,0,0,0,0
161939.0,Nascimento Maique Reis,L,Brazil,26.0,187.0,2023,Japan,Brazil,2023-06-22,False,0,0,0,0,0,0,1,1,0,0,0,0,0,0,0,0,2,1,5,8,4,3,1,8
161939.0,Nascimento Maique Reis,L,Brazil,26.0,187.0,2023,Brazil,Slovenia,2023-06-24,True,0,0,0,0,0,0,2,2,0,0,0,0,0,0,0,0,5,1,16,22,10,5,0,15
161939.0,Nascimento Maique Reis,L,Brazil,26.0,187.0,2023,Brazil,France,2023-06-25,True,0,0,0,0,0,0,2,2,0,0,0,0,0,0,0,0,5,2,16,23,7,5,2,14
161939.0,Nascimento Maique Reis,L,Brazil,26.0,187.0,2023,Brazil,Italy,2023-07-04,False,0,0,0,0,0,0,0,0,0,0,0,0,0,0,0,0,0,1,2,3,4,3,0,7
161939.0,Nascimento Maique Reis,L,Brazil,26.0,187.0,2023,Brazil,Netherlands,2023-07-06,True,0,0,0,0,0,0,2,2,0,0,0,0,0,0,0,0,4,0,8,12,9,2,3,14
161939.0,Nascimento Maique Reis,L,Brazil,26.0,187.0,2023,Poland,Brazil,2023-07-07,False,0,0,0,0,0,0,2,2,0,0,0,0,0,0,0,0,6,1,19,26,8,5,1,14
161939.0,Nascimento Maique Reis,L,Brazil,26.0,187.0,2023,Brazil,China,2023-07-08,True,0,0,0,0,0,0,0,0,0,0,0,0,0,0,0,0,0,0,0,0,0,0,0,0
161939.0,Nascimento Maique Reis,L,Brazil,26.0,187.0,2023,Poland,Brazil,2023-07-20,False,0,0,0,0,0,0,0,0,0,0,0,0,0,0,0,0,0,0,0,0,0,0,0,0
116081.0,Saatkamp Lucas,MB,Brazil,38.0,209.0,2023,Brazil,Bulgaria,2023-06-20,True,1,4,3,8,0,0,0,0,4,0,2,6,0,3,4,7,0,0,0,0,1,0,0,1
116081.0,Saatkamp Lucas,MB,Brazil,38.0,209.0,2023,Japan,Brazil,2023-06-22,False,0,2,4,6,0,0,0,0,5,0,4,9,0,4,3,7,0,0,0,0,1,1,1,3
116081.0,Saatkamp Lucas,MB,Brazil,38.0,209.0,2023,Brazil,Slovenia,2023-06-24,True,0,0,0,0,0,0,0,0,0,0,0,0,0,0,0,0,0,0,0,0,0,0,0,0
116081.0,Saatkamp Lucas,MB,Brazil,38.0,209.0,2023,Brazil,France,2023-06-25,True,0,2,12,14,0,0,0,0,5,3,1,9,1,2,6,9,0,0,1,1,3,1,1,5
116081.0,Saatkamp Lucas,MB,Brazil,38.0,209.0,2023,Brazil,Italy,2023-07-04,False,0,3,7,10,0,0,0,0,5,1,4,10,0,3,1,4,0,0,1,1,3,0,0,3
116081.0,Saatkamp Lucas,MB,Brazil,38.0,209.0,2023,Brazil,Netherlands,2023-07-06,True,0,1,5,6,0,0,0,0,4,2,8,14,6,3,10,19,0,0,1,1,1,0,0,1
116081.0,Saatkamp Lucas,MB,Brazil,38.0,209.0,2023,Poland,Brazil,2023-07-07,False,2,3,11,16,0,0,0,0,6,0,2,8,1,5,6,12,0,0,0,0,0,1,0,1
116081.0,Saatkamp Lucas,MB,Brazil,38.0,209.0,2023,Brazil,China,2023-07-08,True,0,0,0,0,0,0,0,0,0,0,0,0,0,0,0,0,0,0,0,0,0,0,0,0
116081.0,Saatkamp Lucas,MB,Brazil,38.0,209.0,2023,Poland,Brazil,2023-07-20,False,2,4,9,15,0,0,0,0,3,1,5,9,1,3,2,6,0,0,1,1,1,0,0,1
118916.0,Hoss Thales,L,Brazil,34.0,190.0,2023,Brazil,Cuba,2023-06-10,False,0,0,0,0,0,0,0,0,0,0,0,0,0,0,0,0,0,0,0,0,0,0,0,0
118916.0,Hoss Thales,L,Brazil,34.0,190.0,2023,USA,Brazil,2023-06-11,True,0,0,0,0,0,0,1,1,0,0,0,0,0,0,0,0,4,1,13,18,13,3,1,17
118916.0,Hoss Thales,L,Brazil,34.0,190.0,2023,Brazil,Bulgaria,2023-06-20,True,0,0,0,0,0,0,2,2,0,0,0,0,0,0,0,0,1,1,10,12,3,4,2,9
118916.0,Hoss Thales,L,Brazil,34.0,190.0,2023,Japan,Brazil,2023-06-22,False,0,0,0,0,0,0,1,1,0,0,0,0,0,0,0,0,4,0,4,8,7,2,0,9
118916.0,Hoss Thales,L,Brazil,34.0,190.0,2023,Brazil,Slovenia,2023-06-24,True,0,0,0,0,0,0,0,0,0,0,0,0,0,0,0,0,0,0,0,0,0,0,0,0
118916.0,Hoss Thales,L,Brazil,34.0,190.0,2023,Brazil,France,2023-06-25,True,0,0,0,0,0,0,0,0,0,0,0,0,0,0,0,0,0,0,0,0,0,0,0,0
118916.0,Hoss Thales,L,Brazil,34.0,190.0,2023,Brazil,Italy,2023-07-04,False,0,0,0,0,0,0,3,3,0,0,0,0,0,0,0,0,3,0,13,16,9,3,0,12
118916.0,Hoss Thales,L,Brazil,34.0,190.0,2023,Brazil,Netherlands,2023-07-06,True,0,0,0,0,0,0,0,0,0,0,0,0,0,0,0,0,0,0,0,0,0,0,0,0
118916.0,Hoss Thales,L,Brazil,34.0,190.0,2023,Poland,Brazil,2023-07-07,False,0,0,0,0,0,0,0,0,0,0,0,0,0,0,0,0,0,0,0,0,0,0,0,0
118916.0,Hoss Thales,L,Brazil,34.0,190.0,2023,Brazil,China,2023-07-08,True,0,0,0,0,0,0,3,3,0,0,0,0,0,0,0,0,2,0,7,9,9,2,0,11
118916.0,Hoss Thales,L,Brazil,34.0,190.0,2023,Poland,Brazil,2023-07-20,False,0,0,0,0,0,0,3,3,0,0,0,0,0,0,0,0,2,2,7,11,6,3,0,9
136468.0,Souza Ricardo Lucarelli,OH,Brazil,32.0,196.0,2023,Brazil,Cuba,2023-06-10,False,1,2,15,18,0,1,4,5,19,7,12,38,0,4,3,7,2,2,18,22,6,8,1,15
136468.0,Souza Ricardo Lucarelli,OH,Brazil,32.0,196.0,2023,USA,Brazil,2023-06-11,True,1,4,11,16,0,0,2,2,14,3,9,26,3,3,1,7,3,2,23,28,3,0,2,5
136468.0,Souza Ricardo Lucarelli,OH,Brazil,32.0,196.0,2023,Brazil,Bulgaria,2023-06-20,True,2,2,7,11,0,0,5,5,10,1,3,14,0,1,0,1,7,0,14,21,1,1,2,4
136468.0,Souza Ricardo Lucarelli,OH,Brazil,32.0,196.0,2023,Japan,Brazil,2023-06-22,False,1,2,20,23,0,0,4,4,11,3,10,24,0,4,1,5,6,3,31,40,8,4,0,12
136468.0,Souza Ricardo Lucarelli,OH,Brazil,32.0,196.0,2023,Brazil,Slovenia,2023-06-24,True,1,3,11,15,0,0,8,8,18,2,17,37,0,6,2,8,4,0,22,26,5,2,0,7
136468.0,Souza Ricardo Lucarelli,OH,Brazil,32.0,196.0,2023,Brazil,France,2023-06-25,True,3,4,12,19,0,0,3,3,11,6,12,29,1,4,1,6,2,1,20,23,10,1,1,12
136468.0,Souza Ricardo Lucarelli,OH,Brazil,32.0,196.0,2023,Brazil,Italy,2023-07-04,False,2,1,12,15,0,0,9,9,9,1,9,19,0,2,2,4,6,8,26,40,4,0,1,5
136468.0,Souza Ricardo Lucarelli,OH,Brazil,32.0,196.0,2023,Brazil,Netherlands,2023-07-06,True,2,2,12,16,0,0,4,4,6,4,4,14,1,2,1,4,2,1,8,11,5,1,1,7
136468.0,Souza Ricardo Lucarelli,OH,Brazil,32.0,196.0,2023,Poland,Brazil,2023-07-07,False,2,5,11,18,1,1,3,5,12,7,5,24,0,0,3,3,5,1,20,26,3,0,0,3
136468.0,Souza Ricardo Lucarelli,OH,Brazil,32.0,196.0,2023,Brazil,China,2023-07-08,True,0,2,7,9,0,0,2,2,6,2,6,14,2,1,3,6,2,1,6,9,4,0,0,4
136468.0,Souza Ricardo Lucarelli,OH,Brazil,32.0,196.0,2023,Poland,Brazil,2023-07-20,False,2,1,7,10,0,0,5,5,7,4,9,20,1,2,3,6,2,3,16,21,3,3,0,6
161921.0,Moreira Roque Felipe,O,Brazil,26.0,212.0,2023,Brazil,Bulgaria,2023-06-20,True,0,0,0,0,0,0,1,1,1,0,0,1,1,0,2,3,0,0,0,0,0,0,0,0
161921.0,Moreira Roque Felipe,O,Brazil,26.0,212.0,2023,Japan,Brazil,2023-06-22,False,0,0,2,2,0,0,0,0,3,0,2,5,0,0,0,0,0,0,0,0,0,0,0,0
161921.0,Moreira Roque Felipe,O,Brazil,26.0,212.0,2023,Brazil,Slovenia,2023-06-24,True,0,0,0,0,0,0,0,0,1,0,0,1,0,1,0,1,0,0,0,0,0,0,0,0
161921.0,Moreira Roque Felipe,O,Brazil,26.0,212.0,2023,Brazil,France,2023-06-25,True,0,0,0,0,0,0,1,1,1,0,0,1,0,0,0,0,0,0,0,0,0,0,0,0
161921.0,Moreira Roque Felipe,O,Brazil,26.0,212.0,2023,Brazil,Italy,2023-07-04,False,0,1,6,7,0,0,1,1,7,1,4,12,1,1,2,4,0,0,0,0,4,0,1,5
161921.0,Moreira Roque Felipe,O,Brazil,26.0,212.0,2023,Brazil,Netherlands,2023-07-06,True,0,1,1,2,0,0,0,0,2,1,1,4,0,0,0,0,0,0,0,0,0,0,0,0
161921.0,Moreira Roque Felipe,O,Brazil,26.0,212.0,2023,Poland,Brazil,2023-07-07,False,0,0,2,2,0,0,0,0,4,1,0,5,0,0,1,1,0,0,0,0,0,1,0,1
161921.0,Moreira Roque Felipe,O,Brazil,26.0,212.0,2023,Brazil,China,2023-07-08,True,1,1,9,11,0,0,3,3,12,2,8,22,4,2,0,6,0,0,1,1,1,1,0,2
161921.0,Moreira Roque Felipe,O,Brazil,26.0,212.0,2023,Poland,Brazil,2023-07-20,False,0,0,1,1,0,0,0,0,1,0,2,3,0,1,1,2,0,0,0,0,0,0,0,0
136947.0,Souza Alan,O,Brazil,30.0,202.0,2023,Brazil,Cuba,2023-06-10,False,0,0,0,0,0,0,1,1,0,0,1,1,1,0,0,1,0,0,0,0,0,0,0,0
136947.0,Souza Alan,O,Brazil,30.0,202.0,2023,USA,Brazil,2023-06-11,True,1,3,12,16,0,0,2,2,15,2,13,30,1,2,1,4,0,0,0,0,5,2,0,7
136947.0,Souza Alan,O,Brazil,30.0,202.0,2023,Brazil,Bulgaria,2023-06-20,True,2,3,11,16,0,0,0,0,12,3,8,23,0,4,0,4,0,0,0,0,6,2,0,8
136947.0,Souza Alan,O,Brazil,30.0,202.0,2023,Japan,Brazil,2023-06-22,False,0,4,14,18,0,0,2,2,20,2,10,32,0,5,2,7,0,0,2,2,9,5,0,14
136947.0,Souza Alan,O,Brazil,30.0,202.0,2023,Brazil,Slovenia,2023-06-24,True,1,3,10,14,0,0,1,1,18,7,12,37,0,4,3,7,0,0,0,0,7,5,1,13
136947.0,Souza Alan,O,Brazil,30.0,202.0,2023,Brazil,France,2023-06-25,True,0,2,9,11,0,0,1,1,23,6,10,39,1,5,6,12,0,0,1,1,5,2,1,8
136947.0,Souza Alan,O,Brazil,30.0,202.0,2023,Brazil,Italy,2023-07-04,False,0,4,3,7,0,0,1,1,9,5,8,22,0,2,5,7,0,0,0,0,4,2,0,6
136947.0,Souza Alan,O,Brazil,30.0,202.0,2023,Brazil,Netherlands,2023-07-06,True,0,0,7,7,0,0,1,1,8,3,5,16,1,1,4,6,0,0,0,0,7,2,0,9
136947.0,Souza Alan,O,Brazil,30.0,202.0,2023,Poland,Brazil,2023-07-07,False,0,4,3,7,0,0,2,2,15,3,11,29,2,4,2,8,0,0,0,0,3,1,1,5
136947.0,Souza Alan,O,Brazil,30.0,202.0,2023,Brazil,China,2023-07-08,True,0,0,0,0,0,0,0,0,0,0,0,0,0,0,0,0,0,0,0,0,0,0,0,0
136947.0,Souza Alan,O,Brazil,30.0,202.0,2023,Poland,Brazil,2023-07-20,False,1,2,6,9,0,0,2,2,14,5,10,29,0,2,3,5,0,0,1,1,3,2,0,5
136956.0,Resende Gualberto Flavio,MB,Brazil,30.0,199.0,2023,Brazil,Cuba,2023-06-10,False,0,0,14,14,0,0,0,0,7,0,8,15,3,4,2,9,0,0,0,0,0,2,0,2
136956.0,Resende Gualberto Flavio,MB,Brazil,30.0,199.0,2023,USA,Brazil,2023-06-11,True,0,1,5,6,0,0,0,0,3,0,2,5,1,3,2,6,0,0,0,0,0,1,0,1
136956.0,Resende Gualberto Flavio,MB,Brazil,30.0,199.0,2023,Brazil,Bulgaria,2023-06-20,True,1,1,15,17,0,0,0,0,5,1,2,8,3,3,5,11,0,0,0,0,1,1,0,2
136956.0,Resende Gualberto Flavio,MB,Brazil,30.0,199.0,2023,Japan,Brazil,2023-06-22,False,0,0,10,10,0,0,0,0,5,0,4,9,3,3,5,11,0,0,0,0,0,1,1,2
136956.0,Resende Gualberto Flavio,MB,Brazil,30.0,199.0,2023,Brazil,Slovenia,2023-06-24,True,0,3,14,17,0,0,1,1,10,0,1,11,2,4,2,8,1,0,2,3,1,1,0,2
136956.0,Resende Gualberto Flavio,MB,Brazil,30.0,199.0,2023,Brazil,France,2023-06-25,True,0,0,1,1,0,0,1,1,1,0,0,1,2,0,0,2,0,0,0,0,0,0,0,0
136956.0,Resende Gualberto Flavio,MB,Brazil,30.0,199.0,2023,Brazil,Italy,2023-07-04,False,0,1,6,7,0,1,1,2,8,1,2,11,2,3,7,12,1,0,4,5,1,2,0,3
136956.0,Resende Gualberto Flavio,MB,Brazil,30.0,199.0,2023,Brazil,Netherlands,2023-07-06,True,0,0,0,0,0,0,0,0,0,0,0,0,0,0,0,0,0,0,0,0,0,0,0,0
136956.0,Resende Gualberto Flavio,MB,Brazil,30.0,199.0,2023,Poland,Brazil,2023-07-07,False,0,0,1,1,0,0,1,1,0,1,0,1,0,1,0,1,0,0,0,0,0,0,0,0
136956.0,Resende Gualberto Flavio,MB,Brazil,30.0,199.0,2023,Brazil,China,2023-07-08,True,0,2,8,10,0,0,1,1,5,1,2,8,1,8,8,17,0,0,4,4,2,0,0,2
136956.0,Resende Gualberto Flavio,MB,Brazil,30.0,199.0,2023,Poland,Brazil,2023-07-20,False,0,2,10,12,0,0,0,0,4,1,2,7,1,1,4,6,0,0,2,2,1,0,1,2
187493.0,Nunes da Cunha Jr Judson Amabel,MB,Brazil,25.0,204.0,2023,Brazil,Cuba,2023-06-10,False,0,0,4,4,0,0,0,0,0,1,0,1,0,1,0,1,0,0,0,0,0,0,0,0
187493.0,Nunes da Cunha Jr Judson Amabel,MB,Brazil,25.0,204.0,2023,USA,Brazil,2023-06-11,True,0,1,11,12,0,0,0,0,12,0,0,12,1,3,6,10,0,0,0,0,3,0,0,3
187493.0,Nunes da Cunha Jr Judson Amabel,MB,Brazil,25.0,204.0,2023,Brazil,Bulgaria,2023-06-20,True,0,0,0,0,0,0,0,0,0,0,0,0,0,0,0,0,0,0,0,0,0,0,0,0
187493.0,Nunes da Cunha Jr Judson Amabel,MB,Brazil,25.0,204.0,2023,Japan,Brazil,2023-06-22,False,0,3,7,10,0,0,0,0,8,0,4,12,1,5,5,11,1,0,1,2,1,0,0,1
187493.0,Nunes da Cunha Jr Judson Amabel,MB,Brazil,25.0,204.0,2023,Brazil,Slovenia,2023-06-24,True,0,2,1,3,0,0,0,0,3,0,2,5,0,2,2,4,0,0,0,0,2,0,0,2
187493.0,Nunes da Cunha Jr Judson Amabel,MB,Brazil,25.0,204.0,2023,Brazil,France,2023-06-25,True,0,0,0,0,0,0,0,0,0,0,0,0,0,0,0,0,0,0,0,0,0,0,0,0
187493.0,Nunes da Cunha Jr Judson Amabel,MB,Brazil,25.0,204.0,2023,Brazil,Italy,2023-07-04,False,0,1,5,6,0,0,0,0,5,0,1,6,1,1,0,2,2,0,0,2,1,1,0,2
187493.0,Nunes da Cunha Jr Judson Amabel,MB,Brazil,25.0,204.0,2023,Brazil,Netherlands,2023-07-06,True,0,2,9,11,0,0,1,1,5,0,0,5,1,4,3,8,0,0,0,0,2,1,0,3
187493.0,Nunes da Cunha Jr Judson Amabel,MB,Brazil,25.0,204.0,2023,Poland,Brazil,2023-07-07,False,0,4,8,12,0,0,1,1,5,2,4,11,2,5,3,10,2,0,2,4,0,2,0,2
187493.0,Nunes da Cunha Jr Judson Amabel,MB,Brazil,25.0,204.0,2023,Brazil,China,2023-07-08,True,0,0,0,0,0,0,0,0,0,0,0,0,0,0,0,0,0,0,0,0,0,0,0,0
187493.0,Nunes da Cunha Jr Judson Amabel,MB,Brazil,25.0,204.0,2023,Poland,Brazil,2023-07-20,False,0,0,0,0,0,0,0,0,0,0,0,0,0,0,0,0,0,0,0,0,0,0,0,0
173067.0,Kolev Nikolay,MB,Bulgaria,26.0,204.0,2023,Bulgaria,China,2023-06-06,False,0,0,5,5,0,0,0,0,0,1,0,1,1,0,0,1,0,0,0,0,0,0,0,0
173067.0,Kolev Nikolay,MB,Bulgaria,26.0,204.0,2023,Slovenia,Bulgaria,2023-06-08,True,3,1,9,13,0,0,0,0,3,1,2,6,0,1,5,6,0,0,0,0,3,0,0,3
173067.0,Kolev Nikolay,MB,Bulgaria,26.0,204.0,2023,Poland,Bulgaria,2023-06-09,False,0,2,2,4,0,0,0,0,1,1,2,4,0,3,3,6,0,0,0,0,0,0,0,0
173067.0,Kolev Nikolay,MB,Bulgaria,26.0,204.0,2023,Japan,Bulgaria,2023-06-10,False,0,2,5,7,0,0,1,1,4,0,5,9,0,4,3,7,0,0,0,0,2,0,0,2
173067.0,Kolev Nikolay,MB,Bulgaria,26.0,204.0,2023,Brazil,Bulgaria,2023-06-20,False,0,0,0,0,0,0,0,0,0,0,0,0,0,0,0,0,0,0,0,0,0,0,0,0
173067.0,Kolev Nikolay,MB,Bulgaria,26.0,204.0,2023,Canada,Bulgaria,2023-06-22,False,1,2,4,7,0,0,0,0,4,0,2,6,1,2,0,3,0,0,0,0,0,0,0,0
173067.0,Kolev Nikolay,MB,Bulgaria,26.0,204.0,2023,Argentina,Bulgaria,2023-06-23,False,0,0,0,0,0,0,0,0,0,0,0,0,0,0,0,0,0,0,0,0,0,0,0,0
173067.0,Kolev Nikolay,MB,Bulgaria,26.0,204.0,2023,Bulgaria,Cuba,2023-06-25,False,0,0,18,18,0,0,2,2,8,1,2,11,2,5,2,9,0,0,0,0,1,2,0,3
173067.0,Kolev Nikolay,MB,Bulgaria,26.0,204.0,2023,Bulgaria,Serbia,2023-07-08,False,0,0,7,7,0,0,1,1,6,0,1,7,2,1,5,8,0,0,0,0,0,0,0,0
156676.0,Atanasov Martin,OH,Bulgaria,27.0,197.0,2023,Bulgaria,China,2023-06-06,False,2,4,7,13,0,0,2,2,10,5,4,19,1,1,1,3,7,3,10,20,1,0,2,3
156676.0,Atanasov Martin,OH,Bulgaria,27.0,197.0,2023,Slovenia,Bulgaria,2023-06-08,True,0,4,5,9,0,0,3,3,11,2,10,23,2,2,2,6,7,1,8,16,4,0,0,4
156676.0,Atanasov Martin,OH,Bulgaria,27.0,197.0,2023,Poland,Bulgaria,2023-06-09,False,1,5,6,12,0,0,4,4,14,5,12,31,0,1,1,2,10,2,5,17,6,0,0,6
156676.0,Atanasov Martin,OH,Bulgaria,27.0,197.0,2023,Japan,Bulgaria,2023-06-10,False,1,3,6,10,0,0,1,1,4,3,2,9,2,0,1,3,4,2,11,17,4,0,1,5
156676.0,Atanasov Martin,OH,Bulgaria,27.0,197.0,2023,Brazil,Bulgaria,2023-06-20,False,0,2,4,6,0,0,0,0,4,2,6,12,1,2,0,3,3,4,6,13,2,1,1,4
156676.0,Atanasov Martin,OH,Bulgaria,27.0,197.0,2023,Canada,Bulgaria,2023-06-22,False,1,7,6,14,0,0,3,3,12,5,9,26,0,6,0,6,5,0,11,16,5,4,0,9
156676.0,Atanasov Martin,OH,Bulgaria,27.0,197.0,2023,Argentina,Bulgaria,2023-06-23,False,0,0,0,0,0,0,0,0,0,0,0,0,0,0,0,0,0,0,1,1,0,1,0,1
156676.0,Atanasov Martin,OH,Bulgaria,27.0,197.0,2023,Bulgaria,Cuba,2023-06-25,False,1,7,14,22,0,0,6,6,8,1,7,16,3,7,3,13,10,1,20,31,4,4,0,8
156676.0,Atanasov Martin,OH,Bulgaria,27.0,197.0,2023,Bulgaria,Serbia,2023-07-08,False,0,1,5,6,0,0,2,2,4,1,4,9,0,4,0,4,1,1,8,10,2,2,0,4
132035.0,Gotsev Svetoslav,MB,Bulgaria,33.0,205.0,2023,Bulgaria,China,2023-06-06,False,0,1,9,10,0,0,0,0,4,1,2,7,2,5,1,8,0,0,0,0,3,0,0,3
132035.0,Gotsev Svetoslav,MB,Bulgaria,33.0,205.0,2023,Slovenia,Bulgaria,2023-06-08,True,0,0,0,0,0,0,0,0,0,0,0,0,0,0,0,0,0,0,0,0,0,0,0,0
132035.0,Gotsev Svetoslav,MB,Bulgaria,33.0,205.0,2023,Poland,Bulgaria,2023-06-09,False,0,0,0,0,0,0,0,0,0,0,0,0,0,0,0,0,0,0,0,0,0,0,0,0
132035.0,Gotsev Svetoslav,MB,Bulgaria,33.0,205.0,2023,Japan,Bulgaria,2023-06-10,False,0,0,0,0,0,0,0,0,0,0,0,0,0,0,0,0,0,0,0,0,0,0,0,0
132035.0,Gotsev Svetoslav,MB,Bulgaria,33.0,205.0,2023,Brazil,Bulgaria,2023-06-20,False,0,1,4,5,0,0,0,0,2,0,1,3,1,4,1,6,0,0,0,0,0,0,0,0
132035.0,Gotsev Svetoslav,MB,Bulgaria,33.0,205.0,2023,Canada,Bulgaria,2023-06-22,False,0,0,9,9,0,0,3,3,4,2,4,10,3,3,3,9,0,0,0,0,1,0,0,1
132035.0,Gotsev Svetoslav,MB,Bulgaria,33.0,205.0,2023,Argentina,Bulgaria,2023-06-23,False,0,0,4,4,0,0,1,1,1,1,2,4,0,0,1,1,0,0,0,0,0,0,0,0
132035.0,Gotsev Svetoslav,MB,Bulgaria,33.0,205.0,2023,Bulgaria,Cuba,2023-06-25,False,0,0,0,0,0,0,0,0,0,0,0,0,0,0,0,0,0,0,0,0,0,0,0,0
132035.0,Gotsev Svetoslav,MB,Bulgaria,33.0,205.0,2023,Bulgaria,Serbia,2023-07-08,False,0,0,0,0,0,0,0,0,0,0,0,0,0,0,0,0,0,0,0,0,0,0,0,0
168269.0,Asparuhov Asparuh,OH,Bulgaria,23.0,201.0,2023,Bulgaria,China,2023-06-06,False,0,1,0,1,0,0,0,0,0,1,1,2,0,0,0,0,0,0,0,0,1,0,0,1
168269.0,Asparuhov Asparuh,OH,Bulgaria,23.0,201.0,2023,Slovenia,Bulgaria,2023-06-08,True,0,0,0,0,0,0,0,0,0,0,0,0,0,0,0,0,0,0,0,0,0,0,0,0
168269.0,Asparuhov Asparuh,OH,Bulgaria,23.0,201.0,2023,Poland,Bulgaria,2023-06-09,False,0,3,3,6,0,0,0,0,8,1,4,13,0,0,1,1,0,0,0,0,3,0,0,3
168269.0,Asparuhov Asparuh,OH,Bulgaria,23.0,201.0,2023,Japan,Bulgaria,2023-06-10,False,1,1,9,11,0,0,0,0,7,2,8,17,1,1,5,7,0,0,0,0,1,1,0,2
168269.0,Asparuhov Asparuh,OH,Bulgaria,23.0,201.0,2023,Brazil,Bulgaria,2023-06-20,False,0,1,0,1,0,0,0,0,0,0,1,1,0,1,0,1,0,0,0,0,0,0,0,0
168269.0,Asparuhov Asparuh,OH,Bulgaria,23.0,201.0,2023,Canada,Bulgaria,2023-06-22,False,0,1,2,3,0,0,1,1,6,0,0,6,0,0,1,1,0,1,2,3,2,0,0,2
168269.0,Asparuhov Asparuh,OH,Bulgaria,23.0,201.0,2023,Argentina,Bulgaria,2023-06-23,False,0,2,4,6,0,0,3,3,2,2,5,9,0,2,0,2,1,2,11,14,5,4,0,9
168269.0,Asparuhov Asparuh,OH,Bulgaria,23.0,201.0,2023,Bulgaria,Cuba,2023-06-25,False,0,3,4,7,0,0,1,1,7,2,4,13,0,6,3,9,0,0,0,0,1,1,0,2
168269.0,Asparuhov Asparuh,OH,Bulgaria,23.0,201.0,2023,Bulgaria,Serbia,2023-07-08,False,1,5,3,9,0,0,2,2,8,4,9,21,3,1,3,7,0,0,0,0,3,1,0,4
137012.0,Seganov Georgi,S,Bulgaria,30.0,197.0,2023,Bulgaria,China,2023-06-06,False,0,0,7,7,8,0,20,28,0,0,0,0,0,0,1,1,0,0,0,0,1,0,0,1
137012.0,Seganov Georgi,S,Bulgaria,30.0,197.0,2023,Slovenia,Bulgaria,2023-06-08,True,0,1,10,11,19,0,52,71,0,0,1,1,0,3,3,6,0,0,0,0,1,0,0,1
137012.0,Seganov Georgi,S,Bulgaria,30.0,197.0,2023,Poland,Bulgaria,2023-06-09,False,0,1,14,15,25,1,80,106,1,0,1,2,2,2,0,4,0,0,0,0,2,0,0,2
137012.0,Seganov Georgi,S,Bulgaria,30.0,197.0,2023,Japan,Bulgaria,2023-06-10,False,0,0,10,10,15,1,55,71,0,1,0,1,0,1,1,2,0,0,0,0,2,0,0,2
137012.0,Seganov Georgi,S,Bulgaria,30.0,197.0,2023,Brazil,Bulgaria,2023-06-20,False,0,1,8,9,16,0,48,64,0,0,2,2,0,3,2,5,0,1,0,1,2,1,0,3
137012.0,Seganov Georgi,S,Bulgaria,30.0,197.0,2023,Canada,Bulgaria,2023-06-22,False,0,1,11,12,24,0,58,82,1,1,1,3,1,2,1,4,0,0,0,0,5,0,1,6
137012.0,Seganov Georgi,S,Bulgaria,30.0,197.0,2023,Argentina,Bulgaria,2023-06-23,False,0,0,7,7,11,1,50,62,0,0,2,2,0,0,0,0,0,0,0,0,5,5,1,11
137012.0,Seganov Georgi,S,Bulgaria,30.0,197.0,2023,Bulgaria,Cuba,2023-06-25,False,0,0,9,9,13,0,26,39,0,0,0,0,0,1,1,2,0,0,0,0,1,5,0,6
137012.0,Seganov Georgi,S,Bulgaria,30.0,197.0,2023,Bulgaria,Serbia,2023-07-08,False,1,1,6,8,21,1,47,69,0,0,0,0,0,1,2,3,0,0,1,1,4,4,1,9
174445.0,Karyagin Denis,OH,Bulgaria,21.0,206.0,2023,Bulgaria,China,2023-06-06,False,0,0,0,0,0,0,0,0,0,0,0,0,0,0,0,0,0,0,0,0,0,0,0,0
174445.0,Karyagin Denis,OH,Bulgaria,21.0,206.0,2023,Slovenia,Bulgaria,2023-06-08,True,0,0,0,0,0,0,0,0,0,0,0,0,0,0,0,0,0,0,0,0,0,0,0,0
174445.0,Karyagin Denis,OH,Bulgaria,21.0,206.0,2023,Poland,Bulgaria,2023-06-09,False,1,2,10,13,0,0,2,2,6,3,6,15,1,1,0,2,2,0,15,17,6,0,0,6
174445.0,Karyagin Denis,OH,Bulgaria,21.0,206.0,2023,Japan,Bulgaria,2023-06-10,False,0,0,2,2,0,0,0,0,3,0,1,4,0,1,0,1,3,0,2,5,1,0,1,2
174445.0,Karyagin Denis,OH,Bulgaria,21.0,206.0,2023,Brazil,Bulgaria,2023-06-20,False,0,5,2,7,0,0,2,2,5,3,7,15,0,5,3,8,2,1,26,29,6,2,1,9
174445.0,Karyagin Denis,OH,Bulgaria,21.0,206.0,2023,Canada,Bulgaria,2023-06-22,False,0,0,0,0,0,0,0,0,0,0,0,0,0,0,0,0,0,0,0,0,0,0,0,0
174445.0,Karyagin Denis,OH,Bulgaria,21.0,206.0,2023,Argentina,Bulgaria,2023-06-23,False,0,1,1,2,0,0,0,0,1,0,4,5,1,1,0,2,0,0,1,1,0,0,0,0
174445.0,Karyagin Denis,OH,Bulgaria,21.0,206.0,2023,Bulgaria,Cuba,2023-06-25,False,0,0,0,0,0,0,0,0,0,0,0,0,0,0,0,0,0,0,0,0,0,0,0,0
174445.0,Karyagin Denis,OH,Bulgaria,21.0,206.0,2023,Bulgaria,Serbia,2023-07-08,False,0,5,5,10,0,0,1,1,10,2,13,25,0,2,1,3,5,2,21,28,2,2,1,5
152619.0,Grozdanov Aleks,MB,Bulgaria,25.0,208.0,2023,Bulgaria,China,2023-06-06,False,0,1,17,18,0,0,1,1,5,1,1,7,0,4,4,8,0,0,0,0,2,0,0,2
152619.0,Grozdanov Aleks,MB,Bulgaria,25.0,208.0,2023,Slovenia,Bulgaria,2023-06-08,True,0,1,12,13,0,0,0,0,5,0,3,8,4,3,4,11,0,0,1,1,1,0,0,1
152619.0,Grozdanov Aleks,MB,Bulgaria,25.0,208.0,2023,Poland,Bulgaria,2023-06-09,False,0,3,11,14,0,0,2,2,7,0,2,9,1,3,4,8,0,0,0,0,4,0,0,4
152619.0,Grozdanov Aleks,MB,Bulgaria,25.0,208.0,2023,Japan,Bulgaria,2023-06-10,False,0,1,10,11,0,0,1,1,3,0,3,6,2,3,1,6,0,0,1,1,1,0,0,1
152619.0,Grozdanov Aleks,MB,Bulgaria,25.0,208.0,2023,Brazil,Bulgaria,2023-06-20,False,0,1,8,9,0,0,3,3,3,2,3,8,0,0,1,1,0,0,0,0,0,0,0,0
152619.0,Grozdanov Aleks,MB,Bulgaria,25.0,208.0,2023,Canada,Bulgaria,2023-06-22,False,0,0,11,11,0,0,0,0,7,0,1,8,5,7,8,20,0,0,1,1,2,1,0,3
152619.0,Grozdanov Aleks,MB,Bulgaria,25.0,208.0,2023,Argentina,Bulgaria,2023-06-23,False,0,1,10,11,0,0,1,1,2,2,3,7,1,3,4,8,0,0,0,0,1,0,0,1
152619.0,Grozdanov Aleks,MB,Bulgaria,25.0,208.0,2023,Bulgaria,Cuba,2023-06-25,False,1,2,11,14,0,0,0,0,5,2,4,11,6,4,3,13,0,0,0,0,1,1,0,2
152619.0,Grozdanov Aleks,MB,Bulgaria,25.0,208.0,2023,Bulgaria,Serbia,2023-07-08,False,0,0,13,13,0,0,3,3,7,3,3,13,2,2,3,7,0,0,1,1,2,1,0,3
180587.0,Dimitrov Dimitar,O,Bulgaria,23.0,208.0,2023,Bulgaria,China,2023-06-06,False,1,4,11,16,0,0,3,3,12,7,10,29,2,4,1,7,0,0,0,0,6,1,1,8
180587.0,Dimitrov Dimitar,O,Bulgaria,23.0,208.0,2023,Slovenia,Bulgaria,2023-06-08,True,1,2,13,16,0,0,0,0,7,4,8,19,1,0,0,1,0,0,0,0,8,0,0,8
180587.0,Dimitrov Dimitar,O,Bulgaria,23.0,208.0,2023,Poland,Bulgaria,2023-06-09,False,1,6,6,13,0,0,0,0,9,1,10,20,1,2,2,5,0,0,0,0,5,0,0,5
180587.0,Dimitrov Dimitar,O,Bulgaria,23.0,208.0,2023,Japan,Bulgaria,2023-06-10,False,0,1,1,2,0,0,0,0,1,2,4,7,1,1,1,3,0,0,0,0,3,0,0,3
180587.0,Dimitrov Dimitar,O,Bulgaria,23.0,208.0,2023,Brazil,Bulgaria,2023-06-20,False,0,0,0,0,0,0,0,0,0,0,0,0,0,0,0,0,0,0,0,0,0,0,0,0
180587.0,Dimitrov Dimitar,O,Bulgaria,23.0,208.0,2023,Canada,Bulgaria,2023-06-22,False,0,5,8,13,0,0,3,3,5,5,10,20,0,1,1,2,0,0,0,0,4,2,0,6
180587.0,Dimitrov Dimitar,O,Bulgaria,23.0,208.0,2023,Argentina,Bulgaria,2023-06-23,False,0,4,5,9,0,0,1,1,13,2,14,29,0,0,2,2,0,0,0,0,3,1,0,4
180587.0,Dimitrov Dimitar,O,Bulgaria,23.0,208.0,2023,Bulgaria,Cuba,2023-06-25,False,0,1,7,8,0,0,1,1,5,3,9,17,1,0,4,5,1,0,0,1,2,1,0,3
180587.0,Dimitrov Dimitar,O,Bulgaria,23.0,208.0,2023,Bulgaria,Serbia,2023-07-08,False,0,2,0,2,0,0,0,0,2,1,0,3,1,0,0,1,0,0,0,0,0,2,0,2
113691.0,Salparov Teodor,L,Bulgaria,41.0,187.0,2023,Brazil,Bulgaria,2023-06-20,False,0,0,0,0,0,1,8,9,0,0,0,0,0,0,0,0,1,0,8,9,5,4,2,11
113691.0,Salparov Teodor,L,Bulgaria,41.0,187.0,2023,Canada,Bulgaria,2023-06-22,False,0,0,0,0,0,0,7,7,0,0,0,0,0,0,0,0,6,1,29,36,7,2,1,10
113691.0,Salparov Teodor,L,Bulgaria,41.0,187.0,2023,Argentina,Bulgaria,2023-06-23,False,0,0,0,0,0,0,6,6,0,0,0,0,0,0,0,0,4,0,8,12,5,0,0,5
113691.0,Salparov Teodor,L,Bulgaria,41.0,187.0,2023,Bulgaria,Cuba,2023-06-25,False,0,0,0,0,0,1,4,5,0,0,0,0,0,0,0,0,6,5,15,26,9,4,0,13
113691.0,Salparov Teodor,L,Bulgaria,41.0,187.0,2023,Bulgaria,Serbia,2023-07-08,False,0,0,0,0,0,0,6,6,0,0,0,0,0,0,0,0,3,1,7,11,4,2,0,6
135372.0,Bozhilov Martin,L,Bulgaria,35.0,190.0,2023,Bulgaria,China,2023-06-06,False,0,0,0,0,0,0,3,3,0,0,0,0,0,0,0,0,9,1,14,24,9,1,1,11
135372.0,Bozhilov Martin,L,Bulgaria,35.0,190.0,2023,Slovenia,Bulgaria,2023-06-08,True,0,0,0,0,0,0,1,1,0,0,0,0,0,0,0,0,8,0,7,15,3,0,1,4
135372.0,Bozhilov Martin,L,Bulgaria,35.0,190.0,2023,Poland,Bulgaria,2023-06-09,False,0,0,0,0,0,0,4,4,0,0,0,0,0,0,0,0,3,2,22,27,8,0,1,9
135372.0,Bozhilov Martin,L,Bulgaria,35.0,190.0,2023,Japan,Bulgaria,2023-06-10,False,0,0,0,0,0,0,3,3,0,0,0,0,0,0,0,0,4,0,9,13,5,1,2,8
135372.0,Bozhilov Martin,L,Bulgaria,35.0,190.0,2023,Bulgaria,Serbia,2023-07-08,False,0,0,0,0,0,0,1,1,0,0,0,0,0,0,0,0,0,0,0,0,1,1,0,2
124986.0,Raev Delcho,S,Bulgaria,33.0,185.0,2023,Brazil,Bulgaria,2023-06-20,False,0,0,0,0,0,0,1,1,0,0,0,0,0,0,0,0,0,0,0,0,0,0,0,0
124986.0,Raev Delcho,S,Bulgaria,33.0,185.0,2023,Canada,Bulgaria,2023-06-22,False,0,0,0,0,1,0,1,2,0,0,0,0,0,0,0,0,0,0,0,0,0,0,0,0
124986.0,Raev Delcho,S,Bulgaria,33.0,185.0,2023,Argentina,Bulgaria,2023-06-23,False,0,0,2,2,6,0,6,12,0,0,0,0,0,1,0,1,0,0,0,0,1,1,0,2
124986.0,Raev Delcho,S,Bulgaria,33.0,185.0,2023,Bulgaria,Cuba,2023-06-25,False,0,0,10,10,21,0,26,47,0,0,0,0,0,2,1,3,0,0,0,0,3,2,0,5
124986.0,Raev Delcho,S,Bulgaria,33.0,185.0,2023,Bulgaria,Serbia,2023-07-08,False,0,0,0,0,0,0,0,0,0,0,0,0,0,0,0,0,0,0,0,0,0,0,0,0
132033.0,Penchev Nikolay,OH,Bulgaria,31.0,197.0,2023,Bulgaria,China,2023-06-06,False,0,1,3,4,0,0,2,2,2,3,1,6,1,2,2,5,2,1,2,5,3,0,0,3
132033.0,Penchev Nikolay,OH,Bulgaria,31.0,197.0,2023,Slovenia,Bulgaria,2023-06-08,True,0,0,0,0,0,0,0,0,0,0,0,0,0,0,0,0,1,0,2,3,1,0,0,1
132033.0,Penchev Nikolay,OH,Bulgaria,31.0,197.0,2023,Poland,Bulgaria,2023-06-09,False,0,0,3,3,0,0,1,1,1,0,0,1,0,0,0,0,4,0,2,6,1,0,0,1
132033.0,Penchev Nikolay,OH,Bulgaria,31.0,197.0,2023,Japan,Bulgaria,2023-06-10,False,0,0,0,0,0,0,0,0,0,0,0,0,0,0,0,0,0,0,3,3,0,0,0,0
132033.0,Penchev Nikolay,OH,Bulgaria,31.0,197.0,2023,Bulgaria,Serbia,2023-07-08,False,0,0,1,1,0,0,1,1,1,0,3,4,0,0,0,0,1,0,3,4,0,1,0,1
118486.0,Bratoev Valentin,OH,Bulgaria,36.0,203.0,2023,Bulgaria,Serbia,2023-07-08,False,1,0,5,6,0,0,3,3,1,1,1,3,0,1,0,1,2,1,6,9,2,0,0,2
168268.0,Petkov Iliya,MB,Bulgaria,27.0,200.0,2023,Bulgaria,China,2023-06-06,False,0,0,1,1,0,0,0,0,0,0,0,0,0,0,0,0,0,0,0,0,1,0,0,1
168268.0,Petkov Iliya,MB,Bulgaria,27.0,200.0,2023,Slovenia,Bulgaria,2023-06-08,True,0,1,0,1,0,0,0,0,0,0,0,0,0,0,0,0,0,0,0,0,0,0,0,0
168268.0,Petkov Iliya,MB,Bulgaria,27.0,200.0,2023,Poland,Bulgaria,2023-06-09,False,0,4,7,11,0,0,1,1,3,1,4,8,1,2,4,7,0,0,1,1,3,0,0,3
168268.0,Petkov Iliya,MB,Bulgaria,27.0,200.0,2023,Japan,Bulgaria,2023-06-10,False,2,2,0,4,0,0,0,0,0,0,0,0,0,0,0,0,0,0,0,0,0,0,0,0
168268.0,Petkov Iliya,MB,Bulgaria,27.0,200.0,2023,Brazil,Bulgaria,2023-06-20,False,0,0,5,5,0,0,0,0,2,0,0,2,0,0,0,0,0,0,0,0,0,1,0,1
168268.0,Petkov Iliya,MB,Bulgaria,27.0,200.0,2023,Canada,Bulgaria,2023-06-22,False,0,1,4,5,0,0,0,0,0,0,0,0,0,0,0,0,0,0,0,0,0,0,0,0
168268.0,Petkov Iliya,MB,Bulgaria,27.0,200.0,2023,Argentina,Bulgaria,2023-06-23,False,1,2,5,8,0,0,0,0,5,0,3,8,1,2,4,7,0,0,0,0,2,0,0,2
168268.0,Petkov Iliya,MB,Bulgaria,27.0,200.0,2023,Bulgaria,Cuba,2023-06-25,False,0,2,0,2,0,0,0,0,0,0,0,0,0,0,0,0,0,0,0,0,0,0,0,0
168268.0,Petkov Iliya,MB,Bulgaria,27.0,200.0,2023,Bulgaria,Serbia,2023-07-08,False,0,2,1,3,0,0,0,0,0,0,0,0,0,0,0,0,0,0,0,0,1,0,0,1
157324.0,Eshenko Pearson,MB,Canada,26.0,204.0,2023,Canada,Germany,2023-06-11,False,0,1,5,6,0,0,0,0,3,0,0,3,2,4,2,8,0,1,0,1,2,0,0,2
157324.0,Eshenko Pearson,MB,Canada,26.0,204.0,2023,Japan,Canada,2023-06-20,False,1,1,4,6,0,0,1,1,0,1,2,3,0,3,1,4,1,0,2,3,1,0,0,1
157324.0,Eshenko Pearson,MB,Canada,26.0,204.0,2023,Slovenia,Canada,2023-06-21,False,0,0,12,12,0,0,1,1,4,0,1,5,0,1,5,6,0,0,4,4,3,0,2,5
157324.0,Eshenko Pearson,MB,Canada,26.0,204.0,2023,Canada,Bulgaria,2023-06-22,True,1,2,13,16,0,0,1,1,6,1,3,10,0,2,4,6,0,0,1,1,1,0,0,1
157324.0,Eshenko Pearson,MB,Canada,26.0,204.0,2023,Canada,France,2023-06-24,False,0,1,5,6,0,0,0,0,3,0,1,4,0,3,3,6,0,0,2,2,2,0,0,2
157324.0,Eshenko Pearson,MB,Canada,26.0,204.0,2023,Canada,Netherlands,2023-07-05,False,0,2,9,11,0,0,0,0,7,0,4,11,1,7,6,14,0,0,3,3,3,1,1,5
157324.0,Eshenko Pearson,MB,Canada,26.0,204.0,2023,Canada,Italy,2023-07-06,False,0,0,0,0,0,0,0,0,0,0,0,0,0,0,0,0,0,0,0,0,0,0,0,0
157324.0,Eshenko Pearson,MB,Canada,26.0,204.0,2023,Poland,Canada,2023-07-08,False,0,1,7,8,0,0,0,0,1,1,2,4,0,2,3,5,2,0,1,3,0,1,0,1
157324.0,Eshenko Pearson,MB,Canada,26.0,204.0,2023,China,Canada,2023-07-09,True,0,0,0,0,0,0,0,0,0,0,0,0,0,0,0,0,0,0,0,0,0,0,0,0
165212.0,Herr Luke,S,Canada,29.0,192.0,2023,Canada,Germany,2023-06-11,False,0,2,3,5,16,0,50,66,0,0,0,0,1,1,1,3,0,0,1,1,1,2,1,4
165212.0,Herr Luke,S,Canada,29.0,192.0,2023,Japan,Canada,2023-06-20,False,1,0,5,6,8,0,38,46,0,0,0,0,1,1,1,3,0,0,0,0,0,1,0,1
165212.0,Herr Luke,S,Canada,29.0,192.0,2023,Slovenia,Canada,2023-06-21,False,0,1,4,5,11,0,34,45,0,0,0,0,0,2,2,4,0,0,0,0,1,0,0,1
165212.0,Herr Luke,S,Canada,29.0,192.0,2023,Canada,Bulgaria,2023-06-22,True,0,0,14,14,23,1,60,84,0,0,0,0,2,1,1,4,0,0,0,0,5,1,0,6
165212.0,Herr Luke,S,Canada,29.0,192.0,2023,Canada,France,2023-06-24,False,0,0,8,8,16,1,40,57,0,0,0,0,0,2,0,2,0,0,0,0,4,2,0,6
165212.0,Herr Luke,S,Canada,29.0,192.0,2023,Canada,Netherlands,2023-07-05,False,1,1,11,13,24,0,48,72,0,0,0,0,2,2,3,7,0,0,0,0,6,5,0,11
165212.0,Herr Luke,S,Canada,29.0,192.0,2023,Canada,Italy,2023-07-06,False,1,3,10,14,23,1,79,103,0,0,0,0,1,0,4,5,0,0,0,0,6,2,0,8
165212.0,Herr Luke,S,Canada,29.0,192.0,2023,Poland,Canada,2023-07-08,False,0,0,0,0,0,0,0,0,0,0,0,0,0,0,0,0,0,0,0,0,0,0,0,0
165212.0,Herr Luke,S,Canada,29.0,192.0,2023,China,Canada,2023-07-09,True,0,0,12,12,18,1,59,78,0,0,0,0,1,3,3,7,0,0,0,0,5,2,0,7
136291.0,Hoag Nicholas,OH,Canada,31.0,200.0,2023,Canada,Germany,2023-06-11,False,1,6,16,23,0,0,4,4,8,4,7,19,0,2,1,3,7,0,19,26,7,1,4,12
136291.0,Hoag Nicholas,OH,Canada,31.0,200.0,2023,Japan,Canada,2023-06-20,False,1,2,12,15,0,0,3,3,7,3,8,18,1,5,1,7,8,2,25,35,7,4,2,13
136291.0,Hoag Nicholas,OH,Canada,31.0,200.0,2023,Slovenia,Canada,2023-06-21,False,0,0,1,1,0,0,0,0,0,0,0,0,0,0,0,0,0,0,0,0,0,0,0,0
136291.0,Hoag Nicholas,OH,Canada,31.0,200.0,2023,Canada,Bulgaria,2023-06-22,True,1,3,13,17,0,0,3,3,8,4,10,22,1,1,0,2,1,0,11,12,7,3,1,11
136291.0,Hoag Nicholas,OH,Canada,31.0,200.0,2023,Canada,France,2023-06-24,False,1,1,9,11,0,0,4,4,7,2,5,14,0,1,2,3,2,2,12,16,2,2,1,5
136291.0,Hoag Nicholas,OH,Canada,31.0,200.0,2023,Canada,Netherlands,2023-07-05,False,1,1,17,19,0,0,4,4,9,2,12,23,1,5,3,9,1,0,16,17,3,1,1,5
136291.0,Hoag Nicholas,OH,Canada,31.0,200.0,2023,Canada,Italy,2023-07-06,False,2,3,16,21,0,0,4,4,12,3,12,27,0,1,3,4,6,2,20,28,6,3,0,9
136291.0,Hoag Nicholas,OH,Canada,31.0,200.0,2023,Poland,Canada,2023-07-08,False,0,0,4,4,0,0,0,0,0,0,0,0,0,0,0,0,0,0,0,0,1,0,0,1
136291.0,Hoag Nicholas,OH,Canada,31.0,200.0,2023,China,Canada,2023-07-09,True,3,2,18,23,0,0,3,3,9,2,7,18,0,3,2,5,1,3,20,24,2,0,0,2
168914.0,Hofer Brodie,OH,Canada,23.0,200.0,2023,Canada,Germany,2023-06-11,False,0,0,2,2,0,0,0,0,0,0,0,0,0,0,0,0,0,0,0,0,0,0,0,0
168914.0,Hofer Brodie,OH,Canada,23.0,200.0,2023,Japan,Canada,2023-06-20,False,0,0,2,2,0,0,0,0,0,0,0,0,0,0,0,0,0,0,0,0,0,0,0,0
168914.0,Hofer Brodie,OH,Canada,23.0,200.0,2023,Slovenia,Canada,2023-06-21,False,0,2,5,7,0,0,1,1,9,4,15,28,0,1,1,2,3,2,12,17,3,1,0,4
168914.0,Hofer Brodie,OH,Canada,23.0,200.0,2023,Canada,Bulgaria,2023-06-22,True,0,0,0,0,0,0,0,0,0,0,0,0,0,0,0,0,0,0,0,0,0,0,0,0
168914.0,Hofer Brodie,OH,Canada,23.0,200.0,2023,Canada,France,2023-06-24,False,0,0,3,3,0,0,0,0,0,0,0,0,0,0,0,0,0,0,0,0,0,0,0,0
168914.0,Hofer Brodie,OH,Canada,23.0,200.0,2023,Canada,Netherlands,2023-07-05,False,0,0,0,0,0,0,0,0,0,0,0,0,0,0,0,0,0,0,0,0,0,0,0,0
168914.0,Hofer Brodie,OH,Canada,23.0,200.0,2023,Canada,Italy,2023-07-06,False,0,0,2,2,0,0,0,0,0,0,0,0,0,0,0,0,0,0,0,0,0,0,0,0
168914.0,Hofer Brodie,OH,Canada,23.0,200.0,2023,Poland,Canada,2023-07-08,False,1,1,10,12,0,1,8,9,8,4,8,20,0,3,0,3,4,0,7,11,4,4,0,8
168914.0,Hofer Brodie,OH,Canada,23.0,200.0,2023,China,Canada,2023-07-09,True,0,0,0,0,0,0,0,0,0,0,0,0,0,0,0,0,0,0,0,0,0,0,0,0
140042.0,Demyanenko Danny,MB,Canada,29.0,196.0,2023,Canada,Germany,2023-06-11,False,0,1,6,7,0,0,0,0,1,1,1,3,2,0,0,2,1,0,0,1,0,1,0,1
140042.0,Demyanenko Danny,MB,Canada,29.0,196.0,2023,Japan,Canada,2023-06-20,False,0,4,9,13,0,0,1,1,6,0,2,8,1,5,4,10,2,0,3,5,5,0,0,5
140042.0,Demyanenko Danny,MB,Canada,29.0,196.0,2023,Slovenia,Canada,2023-06-21,False,0,0,0,0,0,0,0,0,0,0,0,0,0,0,0,0,0,0,0,0,0,0,0,0
140042.0,Demyanenko Danny,MB,Canada,29.0,196.0,2023,Canada,Bulgaria,2023-06-22,True,3,2,7,12,0,0,2,2,10,1,3,14,2,5,10,17,0,0,2,2,4,1,0,5
140042.0,Demyanenko Danny,MB,Canada,29.0,196.0,2023,Canada,France,2023-06-24,False,0,3,6,9,0,0,0,0,4,0,2,6,0,6,5,11,0,0,0,0,0,2,0,2
140042.0,Demyanenko Danny,MB,Canada,29.0,196.0,2023,Canada,Netherlands,2023-07-05,False,1,2,13,16,0,0,2,2,6,4,1,11,0,8,5,13,0,0,2,2,1,0,1,2
140042.0,Demyanenko Danny,MB,Canada,29.0,196.0,2023,Canada,Italy,2023-07-06,False,1,4,13,18,0,0,1,1,6,2,3,11,0,6,4,10,0,1,1,2,1,2,2,5
140042.0,Demyanenko Danny,MB,Canada,29.0,196.0,2023,Poland,Canada,2023-07-08,False,0,0,0,0,0,0,0,0,0,0,0,0,0,0,0,0,0,0,0,0,0,0,0,0
140042.0,Demyanenko Danny,MB,Canada,29.0,196.0,2023,China,Canada,2023-07-09,True,2,3,12,17,0,0,0,0,8,0,1,9,4,3,4,11,0,0,0,0,0,2,0,2
140061.0,Maar Stephen Timothy,OH,Canada,29.0,201.0,2023,Canada,Germany,2023-06-11,False,0,0,13,13,0,0,4,4,10,3,13,26,2,2,2,6,5,2,12,19,6,2,0,8
140061.0,Maar Stephen Timothy,OH,Canada,29.0,201.0,2023,Japan,Canada,2023-06-20,False,1,3,8,12,0,0,3,3,16,4,15,35,0,4,2,6,3,2,12,17,4,5,2,11
140061.0,Maar Stephen Timothy,OH,Canada,29.0,201.0,2023,Slovenia,Canada,2023-06-21,False,0,0,0,0,0,0,0,0,0,0,0,0,0,0,0,0,0,0,0,0,0,0,0,0
140061.0,Maar Stephen Timothy,OH,Canada,29.0,201.0,2023,Canada,Bulgaria,2023-06-22,True,1,3,10,14,1,0,5,6,14,4,10,28,1,1,2,4,10,2,24,36,6,3,3,12
140061.0,Maar Stephen Timothy,OH,Canada,29.0,201.0,2023,Canada,France,2023-06-24,False,1,2,8,11,0,0,3,3,13,3,12,28,0,6,3,9,6,0,14,20,5,2,1,8
140061.0,Maar Stephen Timothy,OH,Canada,29.0,201.0,2023,Canada,Netherlands,2023-07-05,False,0,2,0,2,0,0,0,0,1,0,1,2,0,2,1,3,2,0,5,7,0,0,0,0
140061.0,Maar Stephen Timothy,OH,Canada,29.0,201.0,2023,Canada,Italy,2023-07-06,False,1,1,9,11,0,0,7,7,15,6,22,43,2,2,5,9,2,4,22,28,7,3,0,10
140061.0,Maar Stephen Timothy,OH,Canada,29.0,201.0,2023,Poland,Canada,2023-07-08,False,0,0,0,0,0,0,0,0,0,0,0,0,0,0,0,0,0,0,0,0,0,0,0,0
140061.0,Maar Stephen Timothy,OH,Canada,29.0,201.0,2023,China,Canada,2023-07-09,True,0,4,10,14,0,0,4,4,14,3,5,22,4,3,4,11,7,2,28,37,9,3,1,13
143745.0,Walsh Brett James,S,Canada,30.0,196.0,2023,Japan,Canada,2023-06-20,False,0,1,5,6,21,0,30,51,0,0,0,0,1,2,3,6,0,0,0,0,1,2,1,4
143745.0,Walsh Brett James,S,Canada,30.0,196.0,2023,Slovenia,Canada,2023-06-21,False,0,1,2,3,10,0,24,34,0,0,0,0,0,0,2,2,0,0,0,0,2,3,0,5
143745.0,Walsh Brett James,S,Canada,30.0,196.0,2023,Canada,Bulgaria,2023-06-22,True,0,0,1,1,0,0,2,2,0,0,0,0,0,0,0,0,0,0,0,0,0,0,0,0
143745.0,Walsh Brett James,S,Canada,30.0,196.0,2023,Canada,France,2023-06-24,False,0,0,0,0,1,0,6,7,0,0,0,0,0,0,1,1,0,0,0,0,0,0,0,0
143745.0,Walsh Brett James,S,Canada,30.0,196.0,2023,Canada,Netherlands,2023-07-05,False,0,0,1,1,1,0,5,6,0,0,0,0,0,0,0,0,0,0,0,0,1,0,0,1
143745.0,Walsh Brett James,S,Canada,30.0,196.0,2023,Canada,Italy,2023-07-06,False,0,0,0,0,0,0,6,6,0,0,0,0,0,0,0,0,0,0,0,0,0,0,0,0
143745.0,Walsh Brett James,S,Canada,30.0,196.0,2023,Poland,Canada,2023-07-08,False,2,3,7,12,16,0,53,69,0,0,0,0,0,3,1,4,0,0,0,0,3,3,2,8
143745.0,Walsh Brett James,S,Canada,30.0,196.0,2023,China,Canada,2023-07-09,True,0,0,0,0,0,0,0,0,0,0,0,0,0,0,0,0,0,0,0,0,0,0,0,0
140428.0,Sclater Ryan Joseph,O,Canada,30.0,200.0,2023,Canada,Germany,2023-06-11,False,0,1,10,11,0,0,0,0,15,4,12,31,1,1,0,2,0,0,1,1,3,1,1,5
140428.0,Sclater Ryan Joseph,O,Canada,30.0,200.0,2023,Japan,Canada,2023-06-20,False,0,0,4,4,0,0,2,2,3,3,4,10,0,1,0,1,0,0,0,0,2,0,1,3
140428.0,Sclater Ryan Joseph,O,Canada,30.0,200.0,2023,Slovenia,Canada,2023-06-21,False,0,0,3,3,0,0,1,1,3,0,4,7,1,2,0,3,0,0,0,0,5,3,1,9
140428.0,Sclater Ryan Joseph,O,Canada,30.0,200.0,2023,Canada,Bulgaria,2023-06-22,True,1,2,1,4,0,0,0,0,2,4,3,9,0,0,2,2,0,0,0,0,2,1,0,3
140428.0,Sclater Ryan Joseph,O,Canada,30.0,200.0,2023,Canada,France,2023-06-24,False,0,0,0,0,0,0,0,0,0,0,0,0,0,0,0,0,0,0,0,0,0,0,0,0
140428.0,Sclater Ryan Joseph,O,Canada,30.0,200.0,2023,Canada,Netherlands,2023-07-05,False,2,3,11,16,0,0,4,4,18,2,13,33,0,2,2,4,0,0,0,0,5,2,0,7
140428.0,Sclater Ryan Joseph,O,Canada,30.0,200.0,2023,Canada,Italy,2023-07-06,False,1,3,10,14,0,0,5,5,16,7,15,38,5,4,3,12,0,1,5,6,10,3,1,14
140428.0,Sclater Ryan Joseph,O,Canada,30.0,200.0,2023,Poland,Canada,2023-07-08,False,0,0,0,0,0,0,0,0,0,0,0,0,0,0,0,0,0,0,0,0,0,0,0,0
140428.0,Sclater Ryan Joseph,O,Canada,30.0,200.0,2023,China,Canada,2023-07-09,True,0,2,11,13,0,0,2,2,20,3,13,36,0,4,2,6,0,0,2,2,5,0,1,6
136296.0,Van Berkel Lucas,MB,Canada,32.0,210.0,2023,Canada,Germany,2023-06-11,False,0,0,11,11,0,0,0,0,7,2,2,11,0,8,2,10,0,0,1,1,1,0,0,1
136296.0,Van Berkel Lucas,MB,Canada,32.0,210.0,2023,Japan,Canada,2023-06-20,False,0,0,5,5,0,1,1,2,2,1,2,5,2,2,1,5,1,0,2,3,2,0,1,3
136296.0,Van Berkel Lucas,MB,Canada,32.0,210.0,2023,Slovenia,Canada,2023-06-21,False,0,0,11,11,0,0,1,1,4,0,2,6,1,6,3,10,0,0,1,1,4,0,0,4
136296.0,Van Berkel Lucas,MB,Canada,32.0,210.0,2023,Canada,Bulgaria,2023-06-22,True,0,0,0,0,0,0,0,0,0,0,0,0,0,0,0,0,0,0,0,0,0,0,0,0
136296.0,Van Berkel Lucas,MB,Canada,32.0,210.0,2023,Canada,France,2023-06-24,False,0,0,0,0,0,0,0,0,0,0,0,0,0,0,0,0,0,0,0,0,0,0,0,0
136296.0,Van Berkel Lucas,MB,Canada,32.0,210.0,2023,Canada,Netherlands,2023-07-05,False,0,0,1,1,0,0,0,0,0,0,0,0,1,0,0,1,0,0,0,0,0,0,0,0
136296.0,Van Berkel Lucas,MB,Canada,32.0,210.0,2023,Canada,Italy,2023-07-06,False,0,0,9,9,0,0,6,6,6,0,4,10,1,5,6,12,0,0,1,1,1,2,0,3
136296.0,Van Berkel Lucas,MB,Canada,32.0,210.0,2023,Poland,Canada,2023-07-08,False,0,1,5,6,0,0,3,3,3,0,3,6,0,5,6,11,0,0,0,0,1,2,0,3
136296.0,Van Berkel Lucas,MB,Canada,32.0,210.0,2023,China,Canada,2023-07-09,True,0,1,15,16,0,0,1,1,4,0,2,6,0,2,8,10,0,0,0,0,0,1,1,2
182679.0,Cooper Samuel,OH,Canada,22.0,200.0,2023,Japan,Canada,2023-06-20,False,0,0,0,0,0,0,0,0,0,0,1,1,0,0,0,0,0,0,0,0,0,0,0,0
182679.0,Cooper Samuel,OH,Canada,22.0,200.0,2023,Slovenia,Canada,2023-06-21,False,1,2,1,4,0,0,3,3,5,5,5,15,1,0,1,2,2,0,7,9,2,1,1,4
182679.0,Cooper Samuel,OH,Canada,22.0,200.0,2023,Canada,Bulgaria,2023-06-22,True,0,0,0,0,0,0,0,0,0,0,0,0,0,0,0,0,0,0,0,0,0,0,0,0
182679.0,Cooper Samuel,OH,Canada,22.0,200.0,2023,Canada,France,2023-06-24,False,0,0,0,0,0,0,0,0,0,0,0,0,0,0,0,0,0,0,0,0,0,0,0,0
182679.0,Cooper Samuel,OH,Canada,22.0,200.0,2023,Canada,Netherlands,2023-07-05,False,0,0,0,0,0,0,1,1,1,0,1,2,0,0,0,0,0,0,3,3,0,0,0,0
182679.0,Cooper Samuel,OH,Canada,22.0,200.0,2023,Canada,Italy,2023-07-06,False,0,0,0,0,0,0,0,0,0,0,0,0,0,0,0,0,0,0,0,0,0,0,0,0
182679.0,Cooper Samuel,OH,Canada,22.0,200.0,2023,Poland,Canada,2023-07-08,False,3,3,6,12,0,0,3,3,15,4,12,31,1,1,0,2,4,1,24,29,3,4,0,7
182679.0,Cooper Samuel,OH,Canada,22.0,200.0,2023,China,Canada,2023-07-09,True,0,0,0,0,0,0,0,0,0,0,0,0,0,0,0,0,0,0,0,0,0,0,0,0
151871.0,Szwarc Arthur,O,Canada,28.0,209.0,2023,Canada,Germany,2023-06-11,False,0,1,3,4,0,0,0,0,3,2,6,11,1,1,0,2,0,0,0,0,0,2,1,3
151871.0,Szwarc Arthur,O,Canada,28.0,209.0,2023,Japan,Canada,2023-06-20,False,4,0,7,11,0,0,0,0,12,5,8,25,1,2,0,3,0,0,1,1,3,1,0,4
151871.0,Szwarc Arthur,O,Canada,28.0,209.0,2023,Slovenia,Canada,2023-06-21,False,1,0,7,8,0,0,1,1,10,2,5,17,0,3,0,3,0,0,0,0,1,1,1,3
151871.0,Szwarc Arthur,O,Canada,28.0,209.0,2023,Canada,Bulgaria,2023-06-22,True,2,4,7,13,0,0,1,1,12,4,3,19,1,3,1,5,0,0,0,0,3,1,0,4
151871.0,Szwarc Arthur,O,Canada,28.0,209.0,2023,Canada,France,2023-06-24,False,2,2,9,13,0,0,1,1,11,4,8,23,0,2,1,3,0,0,0,0,3,6,0,9
151871.0,Szwarc Arthur,O,Canada,28.0,209.0,2023,Canada,Netherlands,2023-07-05,False,0,0,0,0,0,0,0,0,0,0,0,0,0,0,0,0,0,0,0,0,0,0,0,0
151871.0,Szwarc Arthur,O,Canada,28.0,209.0,2023,Canada,Italy,2023-07-06,False,0,0,1,1,0,0,0,0,0,2,0,2,0,0,1,1,0,0,0,0,0,1,0,1
151871.0,Szwarc Arthur,O,Canada,28.0,209.0,2023,Poland,Canada,2023-07-08,False,0,5,8,13,0,0,3,3,14,7,6,27,2,1,1,4,1,0,0,1,3,3,2,8
151871.0,Szwarc Arthur,O,Canada,28.0,209.0,2023,China,Canada,2023-07-09,True,0,0,0,0,0,0,0,0,0,0,0,0,0,0,0,0,0,0,0,0,0,0,0,0
168925.0,Lui Justin,L,Canada,23.0,178.0,2023,Canada,Germany,2023-06-11,False,0,0,0,0,0,0,0,0,0,0,0,0,0,0,0,0,0,0,0,0,0,0,0,0
168925.0,Lui Justin,L,Canada,23.0,178.0,2023,Japan,Canada,2023-06-20,False,0,0,0,0,0,0,0,0,0,0,0,0,0,0,0,0,0,0,1,1,0,0,0,0
168925.0,Lui Justin,L,Canada,23.0,178.0,2023,Slovenia,Canada,2023-06-21,False,0,0,0,0,0,0,1,1,0,0,0,0,0,0,0,0,0,1,4,5,2,0,0,2
168925.0,Lui Justin,L,Canada,23.0,178.0,2023,Canada,Bulgaria,2023-06-22,True,0,0,0,0,0,0,0,0,0,0,0,0,0,0,0,0,0,0,0,0,0,0,0,0
168925.0,Lui Justin,L,Canada,23.0,178.0,2023,Canada,France,2023-06-24,False,0,0,0,0,0,0,0,0,0,0,0,0,0,0,0,0,2,0,5,7,3,0,0,3
168925.0,Lui Justin,L,Canada,23.0,178.0,2023,Canada,Netherlands,2023-07-05,False,0,0,0,0,0,0,0,0,0,0,0,0,0,0,0,0,0,0,0,0,0,0,0,0
168925.0,Lui Justin,L,Canada,23.0,178.0,2023,Canada,Italy,2023-07-06,False,0,0,0,0,0,0,2,2,0,0,0,0,0,0,0,0,5,0,13,18,13,6,0,19
168925.0,Lui Justin,L,Canada,23.0,178.0,2023,Poland,Canada,2023-07-08,False,0,0,0,0,0,0,2,2,0,0,0,0,0,0,0,0,3,2,13,18,7,1,1,9
168925.0,Lui Justin,L,Canada,23.0,178.0,2023,China,Canada,2023-07-09,True,0,0,0,0,0,0,2,2,0,0,0,0,0,0,0,0,0,1,6,7,4,7,0,11
168923.0,Currie Landon,L,Canada,24.0,174.0,2023,Canada,Germany,2023-06-11,False,0,0,0,0,0,0,0,0,0,0,0,0,0,0,0,0,4,1,19,24,14,6,3,23
168923.0,Currie Landon,L,Canada,24.0,174.0,2023,Japan,Canada,2023-06-20,False,0,0,0,0,0,0,1,1,0,0,0,0,0,0,0,0,2,2,15,19,5,12,0,17
168923.0,Currie Landon,L,Canada,24.0,174.0,2023,Slovenia,Canada,2023-06-21,False,0,0,0,0,0,0,1,1,0,0,0,0,0,0,0,0,2,1,4,7,6,4,1,11
168923.0,Currie Landon,L,Canada,24.0,174.0,2023,Canada,Bulgaria,2023-06-22,True,0,0,0,0,0,0,4,4,0,0,0,0,0,0,0,0,2,2,16,20,7,4,1,12
168923.0,Currie Landon,L,Canada,24.0,174.0,2023,Canada,France,2023-06-24,False,0,0,0,0,0,0,2,2,0,0,0,0,0,0,0,0,0,2,13,15,4,3,0,7
168923.0,Currie Landon,L,Canada,24.0,174.0,2023,Canada,Netherlands,2023-07-05,False,0,0,0,0,0,0,3,3,0,0,0,0,0,0,0,0,2,5,21,28,5,4,1,10
168923.0,Currie Landon,L,Canada,24.0,174.0,2023,Canada,Italy,2023-07-06,False,0,0,0,0,0,0,0,0,0,0,0,0,0,0,0,0,0,0,0,0,0,0,0,0
168923.0,Currie Landon,L,Canada,24.0,174.0,2023,Poland,Canada,2023-07-08,False,0,0,0,0,0,0,0,0,0,0,0,0,0,0,0,0,0,0,0,0,0,0,0,0
168923.0,Currie Landon,L,Canada,24.0,174.0,2023,China,Canada,2023-07-09,True,0,0,0,0,0,0,0,0,0,0,0,0,0,0,0,0,0,0,0,0,0,0,0,0
168908.0,Elser Mathias,OH,Canada,22.0,198.0,2023,Canada,Germany,2023-06-11,False,0,0,0,0,0,0,0,0,0,0,0,0,0,0,0,0,1,0,4,5,0,0,0,0
168908.0,Elser Mathias,OH,Canada,22.0,198.0,2023,Japan,Canada,2023-06-20,False,0,1,0,1,0,0,0,0,2,0,3,5,0,0,0,0,0,2,2,4,1,1,0,2
168908.0,Elser Mathias,OH,Canada,22.0,198.0,2023,Slovenia,Canada,2023-06-21,False,0,1,5,6,0,0,1,1,6,2,4,12,1,1,1,3,6,3,12,21,5,1,0,6
168908.0,Elser Mathias,OH,Canada,22.0,198.0,2023,Canada,Bulgaria,2023-06-22,True,0,0,5,5,0,0,0,0,0,0,0,0,0,0,0,0,0,0,0,0,0,1,0,1
168908.0,Elser Mathias,OH,Canada,22.0,198.0,2023,Canada,France,2023-06-24,False,0,0,0,0,0,0,0,0,0,0,0,0,0,0,0,0,0,0,0,0,0,0,0,0
168908.0,Elser Mathias,OH,Canada,22.0,198.0,2023,Canada,Netherlands,2023-07-05,False,0,0,9,9,0,0,1,1,5,4,5,14,1,2,2,5,3,1,7,11,3,0,0,3
168908.0,Elser Mathias,OH,Canada,22.0,198.0,2023,Canada,Italy,2023-07-06,False,0,2,1,3,0,0,0,0,1,0,3,4,0,0,0,0,2,0,7,9,1,0,0,1
168908.0,Elser Mathias,OH,Canada,22.0,198.0,2023,Poland,Canada,2023-07-08,False,0,0,4,4,0,0,0,0,0,0,0,0,0,0,0,0,0,0,0,0,0,1,0,1
168908.0,Elser Mathias,OH,Canada,22.0,198.0,2023,China,Canada,2023-07-09,True,0,0,2,2,0,0,1,1,0,0,0,0,0,0,0,0,0,0,0,0,1,0,0,1
173184.0,Wang Dongchen,MB,China,23.0,200.0,2023,Bulgaria,China,2023-06-06,True,1,0,6,7,0,0,0,0,1,1,1,3,2,0,1,3,0,0,1,1,0,0,0,0
173184.0,Wang Dongchen,MB,China,23.0,200.0,2023,Serbia,China,2023-06-08,False,0,0,10,10,0,1,2,3,4,0,4,8,1,4,2,7,0,0,1,1,1,0,1,2
173184.0,Wang Dongchen,MB,China,23.0,200.0,2023,China,France,2023-06-09,False,0,0,0,0,0,0,0,0,0,0,0,0,0,0,0,0,0,0,0,0,0,0,0,0
173184.0,Wang Dongchen,MB,China,23.0,200.0,2023,Iran,China,2023-06-10,False,0,0,0,0,0,0,0,0,0,0,0,0,0,0,0,0,0,0,0,0,0,0,0,0
173184.0,Wang Dongchen,MB,China,23.0,200.0,2023,Netherlands,China,2023-06-20,False,0,0,0,0,0,0,0,0,0,0,0,0,0,0,0,0,0,0,0,0,0,0,0,0
173184.0,Wang Dongchen,MB,China,23.0,200.0,2023,USA,China,2023-06-21,False,0,1,11,12,0,0,0,0,3,2,2,7,0,1,2,3,0,0,0,0,0,1,0,1
173184.0,Wang Dongchen,MB,China,23.0,200.0,2023,China,Italy,2023-06-22,False,0,1,9,10,0,0,1,1,3,1,3,7,1,5,3,9,1,0,0,1,0,2,0,2
173184.0,Wang Dongchen,MB,China,23.0,200.0,2023,China,Germany,2023-06-24,True,0,1,11,12,0,0,0,0,3,1,5,9,0,0,2,2,0,0,0,0,1,1,0,2
173184.0,Wang Dongchen,MB,China,23.0,200.0,2023,Japan,China,2023-07-04,False,0,0,0,0,0,0,0,0,0,0,0,0,0,0,0,0,0,0,0,0,0,0,0,0
173184.0,Wang Dongchen,MB,China,23.0,200.0,2023,China,Slovenia,2023-07-06,False,2,3,6,11,0,0,1,1,3,0,2,5,2,3,2,7,0,1,2,3,1,0,0,1
173184.0,Wang Dongchen,MB,China,23.0,200.0,2023,Brazil,China,2023-07-08,False,0,1,6,7,0,0,1,1,4,1,2,7,2,3,0,5,0,0,1,1,2,0,2,4
173184.0,Wang Dongchen,MB,China,23.0,200.0,2023,China,Canada,2023-07-09,False,0,0,0,0,0,0,0,0,0,0,0,0,0,0,0,0,0,0,0,0,0,0,0,0
142855.0,Jiang Chuan,O,China,29.0,205.0,2023,Bulgaria,China,2023-06-06,True,0,5,9,14,0,1,0,1,10,7,6,23,0,5,3,8,0,0,0,0,6,0,1,7
142855.0,Jiang Chuan,O,China,29.0,205.0,2023,Serbia,China,2023-06-08,False,0,2,12,14,0,0,0,0,13,8,9,30,0,0,2,2,0,0,0,0,3,0,2,5
142855.0,Jiang Chuan,O,China,29.0,205.0,2023,China,France,2023-06-09,False,0,3,11,14,0,0,1,1,14,5,7,26,1,2,3,6,0,0,0,0,2,1,0,3
142855.0,Jiang Chuan,O,China,29.0,205.0,2023,Iran,China,2023-06-10,False,1,2,3,6,0,0,0,0,8,1,6,15,0,1,0,1,0,0,0,0,3,0,0,3
142855.0,Jiang Chuan,O,China,29.0,205.0,2023,Netherlands,China,2023-06-20,False,0,1,7,8,0,0,0,0,6,5,7,18,0,1,4,5,0,0,0,0,4,0,1,5
142855.0,Jiang Chuan,O,China,29.0,205.0,2023,USA,China,2023-06-21,False,0,0,0,0,0,0,0,0,0,0,0,0,0,0,0,0,0,0,0,0,0,0,0,0
142855.0,Jiang Chuan,O,China,29.0,205.0,2023,China,Italy,2023-06-22,False,0,3,4,7,0,0,1,1,9,5,9,23,0,1,3,4,0,0,1,1,3,3,0,6
142855.0,Jiang Chuan,O,China,29.0,205.0,2023,China,Germany,2023-06-24,True,0,3,7,10,0,0,0,0,16,3,5,24,2,1,2,5,0,0,0,0,2,6,0,8
142855.0,Jiang Chuan,O,China,29.0,205.0,2023,Japan,China,2023-07-04,False,0,2,2,4,0,1,2,3,2,3,7,12,2,0,1,3,0,0,0,0,2,0,0,2
142855.0,Jiang Chuan,O,China,29.0,205.0,2023,China,Slovenia,2023-07-06,False,1,3,3,7,0,0,0,0,7,2,5,14,1,1,4,6,0,0,0,0,3,2,1,6
142855.0,Jiang Chuan,O,China,29.0,205.0,2023,Brazil,China,2023-07-08,False,0,1,1,2,0,0,1,1,2,3,2,7,0,0,0,0,0,0,0,0,0,0,0,0
142855.0,Jiang Chuan,O,China,29.0,205.0,2023,China,Canada,2023-07-09,False,2,1,6,9,0,0,0,0,7,8,4,19,0,3,0,3,0,0,0,0,5,0,2,7
174297.0,Wang Hebin,S,China,24.0,188.0,2023,Bulgaria,China,2023-06-06,True,1,1,11,13,8,1,62,71,1,0,2,3,0,0,2,2,0,0,0,0,2,0,1,3
174297.0,Wang Hebin,S,China,24.0,188.0,2023,Serbia,China,2023-06-08,False,0,2,8,10,12,2,72,86,1,1,0,2,0,0,1,1,0,0,0,0,5,0,0,5
174297.0,Wang Hebin,S,China,24.0,188.0,2023,China,France,2023-06-09,False,0,0,10,10,10,2,67,79,1,1,0,2,0,2,1,3,0,0,0,0,4,0,1,5
174297.0,Wang Hebin,S,China,24.0,188.0,2023,Iran,China,2023-06-10,False,0,0,8,8,5,0,45,50,0,0,0,0,0,4,0,4,0,0,0,0,1,0,0,1
174297.0,Wang Hebin,S,China,24.0,188.0,2023,Netherlands,China,2023-06-20,False,0,1,9,10,21,0,54,75,0,0,1,1,2,0,2,4,0,0,0,0,3,2,0,5
174297.0,Wang Hebin,S,China,24.0,188.0,2023,USA,China,2023-06-21,False,0,1,11,12,18,0,47,65,1,0,2,3,0,1,1,2,0,0,0,0,1,9,0,10
174297.0,Wang Hebin,S,China,24.0,188.0,2023,China,Italy,2023-06-22,False,0,0,2,2,8,0,11,19,0,0,0,0,1,0,0,1,0,0,1,1,0,0,0,0
174297.0,Wang Hebin,S,China,24.0,188.0,2023,China,Germany,2023-06-24,True,1,0,15,16,14,0,66,80,0,0,0,0,2,3,2,7,0,0,1,1,3,1,0,4
174297.0,Wang Hebin,S,China,24.0,188.0,2023,Japan,China,2023-07-04,False,0,0,21,21,23,1,67,91,0,0,0,0,3,4,5,12,0,1,0,1,3,2,3,8
174297.0,Wang Hebin,S,China,24.0,188.0,2023,China,Slovenia,2023-07-06,False,0,0,4,4,9,0,36,45,1,0,0,1,0,2,4,6,0,0,0,0,3,2,0,5
174297.0,Wang Hebin,S,China,24.0,188.0,2023,Brazil,China,2023-07-08,False,0,1,5,6,6,0,27,33,0,0,0,0,0,0,1,1,0,0,0,0,1,0,0,1
174297.0,Wang Hebin,S,China,24.0,188.0,2023,China,Canada,2023-07-09,False,1,0,13,14,16,0,53,69,0,0,2,2,0,3,1,4,0,0,0,0,4,0,0,4
174295.0,Yang Yiming,L,China,24.0,186.0,2023,Netherlands,China,2023-06-20,False,0,0,0,0,0,0,0,0,0,0,0,0,0,0,0,0,0,0,0,0,0,0,0,0
174295.0,Yang Yiming,L,China,24.0,186.0,2023,USA,China,2023-06-21,False,0,0,0,0,0,0,0,0,0,0,0,0,0,0,0,0,0,0,0,0,0,0,0,0
174295.0,Yang Yiming,L,China,24.0,186.0,2023,China,Italy,2023-06-22,False,0,0,0,0,0,0,6,6,0,0,0,0,0,0,0,0,2,3,11,16,4,3,1,8
174295.0,Yang Yiming,L,China,24.0,186.0,2023,China,Germany,2023-06-24,True,0,0,0,0,0,0,1,1,0,0,0,0,0,0,0,0,0,0,0,0,0,0,0,0
174295.0,Yang Yiming,L,China,24.0,186.0,2023,Japan,China,2023-07-04,False,0,0,0,0,0,0,0,0,0,0,0,0,0,0,0,0,0,0,0,0,0,0,0,0
174295.0,Yang Yiming,L,China,24.0,186.0,2023,China,Slovenia,2023-07-06,False,0,0,0,0,0,0,0,0,0,0,0,0,0,0,0,0,0,0,2,2,0,0,0,0
174295.0,Yang Yiming,L,China,24.0,186.0,2023,Brazil,China,2023-07-08,False,0,0,0,0,0,0,0,0,0,0,0,0,0,0,0,0,0,0,0,0,0,0,0,0
174295.0,Yang Yiming,L,China,24.0,186.0,2023,China,Canada,2023-07-09,False,0,0,0,0,0,0,0,0,0,0,0,0,0,0,0,0,0,0,0,0,0,0,0,0
152518.0,Yu Yuantai,OH,China,26.0,186.0,2023,Bulgaria,China,2023-06-06,True,2,5,12,19,0,0,3,3,11,2,5,18,2,0,2,4,16,1,37,54,3,0,1,4
152518.0,Yu Yuantai,OH,China,26.0,186.0,2023,Serbia,China,2023-06-08,False,0,3,6,9,0,0,0,0,8,3,6,17,1,0,1,2,7,3,21,31,5,0,1,6
152518.0,Yu Yuantai,OH,China,26.0,186.0,2023,China,France,2023-06-09,False,0,0,1,1,0,0,0,0,1,1,2,4,0,0,0,0,1,2,6,9,0,0,1,1
152518.0,Yu Yuantai,OH,China,26.0,186.0,2023,Iran,China,2023-06-10,False,0,1,2,3,0,0,1,1,2,1,0,3,0,0,1,1,2,1,2,5,0,0,1,1
152518.0,Yu Yuantai,OH,China,26.0,186.0,2023,Netherlands,China,2023-06-20,False,0,0,1,1,0,0,0,0,0,0,1,1,0,1,0,1,1,0,0,1,2,0,0,2
152518.0,Yu Yuantai,OH,China,26.0,186.0,2023,USA,China,2023-06-21,False,0,0,0,0,0,0,0,0,0,0,0,0,0,0,0,0,0,0,0,0,0,0,0,0
152518.0,Yu Yuantai,OH,China,26.0,186.0,2023,China,Italy,2023-06-22,False,0,4,3,7,0,1,1,2,7,3,3,13,0,1,0,1,5,0,10,15,4,1,0,5
152518.0,Yu Yuantai,OH,China,26.0,186.0,2023,China,Germany,2023-06-24,True,1,6,12,19,0,0,3,3,13,1,5,19,0,0,1,1,8,1,16,25,4,6,1,11
152518.0,Yu Yuantai,OH,China,26.0,186.0,2023,Japan,China,2023-07-04,False,2,5,9,16,0,0,4,4,15,2,9,26,0,1,1,2,4,1,16,21,5,3,2,10
152518.0,Yu Yuantai,OH,China,26.0,186.0,2023,China,Slovenia,2023-07-06,False,0,3,13,16,0,0,3,3,15,2,15,32,0,5,3,8,7,2,14,23,9,6,1,16
152518.0,Yu Yuantai,OH,China,26.0,186.0,2023,Brazil,China,2023-07-08,False,0,0,5,5,0,0,1,1,6,2,4,12,0,1,1,2,0,1,10,11,2,0,0,2
152518.0,Yu Yuantai,OH,China,26.0,186.0,2023,China,Canada,2023-07-09,False,0,2,9,11,0,0,3,3,5,6,7,18,1,3,0,4,4,2,21,27,3,5,0,8
164632.0,Guo Cheng,S,China,28.0,200.0,2023,Bulgaria,China,2023-06-06,True,0,0,0,0,0,0,0,0,0,0,0,0,0,0,0,0,0,0,0,0,0,0,0,0
164632.0,Guo Cheng,S,China,28.0,200.0,2023,Serbia,China,2023-06-08,False,0,0,0,0,0,0,0,0,0,0,0,0,1,1,0,2,0,0,0,0,1,0,0,1
164632.0,Guo Cheng,S,China,28.0,200.0,2023,China,France,2023-06-09,False,0,1,0,1,0,0,0,0,0,0,0,0,0,0,0,0,0,0,0,0,0,0,0,0
164632.0,Guo Cheng,S,China,28.0,200.0,2023,Iran,China,2023-06-10,False,0,1,3,4,5,0,21,26,0,0,1,1,1,2,2,5,0,0,0,0,1,0,1,2
164632.0,Guo Cheng,S,China,28.0,200.0,2023,Netherlands,China,2023-06-20,False,0,0,0,0,0,0,0,0,0,0,0,0,0,0,0,0,0,0,0,0,0,0,0,0
164632.0,Guo Cheng,S,China,28.0,200.0,2023,USA,China,2023-06-21,False,0,0,0,0,0,0,0,0,0,0,0,0,0,0,0,0,0,0,0,0,0,0,0,0
164632.0,Guo Cheng,S,China,28.0,200.0,2023,China,Italy,2023-06-22,False,0,0,0,0,0,0,0,0,0,0,0,0,0,0,0,0,0,0,0,0,0,0,0,0
164632.0,Guo Cheng,S,China,28.0,200.0,2023,China,Germany,2023-06-24,True,0,0,0,0,0,0,0,0,0,0,0,0,0,0,0,0,0,0,0,0,0,0,0,0
164632.0,Guo Cheng,S,China,28.0,200.0,2023,Japan,China,2023-07-04,False,0,0,0,0,0,0,0,0,0,0,0,0,0,0,0,0,0,0,0,0,0,0,0,0
164632.0,Guo Cheng,S,China,28.0,200.0,2023,China,Slovenia,2023-07-06,False,0,0,0,0,0,0,0,0,0,0,0,0,0,0,0,0,0,0,0,0,0,0,0,0
164632.0,Guo Cheng,S,China,28.0,200.0,2023,Brazil,China,2023-07-08,False,0,0,0,0,0,0,0,0,0,0,0,0,0,0,0,0,0,0,0,0,0,0,0,0
164632.0,Guo Cheng,S,China,28.0,200.0,2023,China,Canada,2023-07-09,False,0,0,0,0,0,0,0,0,0,0,0,0,0,0,0,0,0,0,0,0,0,0,0,0
181103.0,Li Yongzhen,MB,China,25.0,198.0,2023,Bulgaria,China,2023-06-06,True,1,4,13,18,0,0,0,0,7,1,2,10,1,3,2,6,0,0,0,0,0,0,0,0
181103.0,Li Yongzhen,MB,China,25.0,198.0,2023,Serbia,China,2023-06-08,False,0,2,7,9,0,0,0,0,3,0,1,4,0,0,3,3,1,0,0,1,1,0,0,1
181103.0,Li Yongzhen,MB,China,25.0,198.0,2023,China,France,2023-06-09,False,0,3,6,9,0,0,0,0,8,0,3,11,0,4,7,11,1,0,1,2,0,0,0,0
181103.0,Li Yongzhen,MB,China,25.0,198.0,2023,Iran,China,2023-06-10,False,0,3,7,10,0,0,0,0,4,1,3,8,4,6,6,16,0,0,1,1,1,0,0,1
181103.0,Li Yongzhen,MB,China,25.0,198.0,2023,Netherlands,China,2023-06-20,False,1,3,6,10,0,0,1,1,6,2,2,10,4,3,1,8,0,0,3,3,0,0,0,0
181103.0,Li Yongzhen,MB,China,25.0,198.0,2023,USA,China,2023-06-21,False,0,1,7,8,1,0,1,2,2,2,3,7,0,6,5,11,0,0,2,2,0,1,0,1
181103.0,Li Yongzhen,MB,China,25.0,198.0,2023,China,Italy,2023-06-22,False,0,0,0,0,0,0,0,0,0,0,0,0,0,0,0,0,0,0,0,0,0,0,0,0
181103.0,Li Yongzhen,MB,China,25.0,198.0,2023,China,Germany,2023-06-24,True,0,1,2,3,0,0,0,0,2,0,0,2,1,1,0,2,0,0,0,0,1,1,0,2
181103.0,Li Yongzhen,MB,China,25.0,198.0,2023,Japan,China,2023-07-04,False,0,7,6,13,0,0,1,1,8,2,4,14,8,5,9,22,0,0,1,1,3,0,0,3
181103.0,Li Yongzhen,MB,China,25.0,198.0,2023,China,Slovenia,2023-07-06,False,0,0,4,4,0,0,0,0,1,0,1,2,0,0,0,0,0,0,1,1,0,0,0,0
181103.0,Li Yongzhen,MB,China,25.0,198.0,2023,Brazil,China,2023-07-08,False,0,1,2,3,0,0,1,1,0,0,1,1,0,0,3,3,0,0,1,1,0,0,0,0
181103.0,Li Yongzhen,MB,China,25.0,198.0,2023,China,Canada,2023-07-09,False,2,4,5,11,0,0,4,4,8,1,3,12,0,7,4,11,0,0,1,1,1,0,0,1
174159.0,Zhai Dejun,OH,China,24.0,195.0,2023,Bulgaria,China,2023-06-06,True,0,0,0,0,0,0,0,0,0,0,0,0,0,0,0,0,0,0,0,0,0,0,0,0
174159.0,Zhai Dejun,OH,China,24.0,195.0,2023,Serbia,China,2023-06-08,False,0,0,2,2,0,0,0,0,1,0,0,1,0,0,0,0,1,0,5,6,1,0,0,1
174159.0,Zhai Dejun,OH,China,24.0,195.0,2023,China,France,2023-06-09,False,0,3,13,16,0,0,1,1,7,2,12,21,2,2,0,4,4,0,13,17,6,1,2,9
174159.0,Zhai Dejun,OH,China,24.0,195.0,2023,Iran,China,2023-06-10,False,0,2,5,7,0,0,1,1,3,5,8,16,0,1,0,1,6,2,15,23,3,0,1,4
174159.0,Zhai Dejun,OH,China,24.0,195.0,2023,Netherlands,China,2023-06-20,False,0,1,1,2,0,0,0,0,0,2,1,3,0,0,2,2,2,0,0,2,0,0,0,0
174159.0,Zhai Dejun,OH,China,24.0,195.0,2023,USA,China,2023-06-21,False,1,2,6,9,0,0,1,1,12,2,9,23,0,1,2,3,0,1,6,7,7,4,0,11
174159.0,Zhai Dejun,OH,China,24.0,195.0,2023,China,Italy,2023-06-22,False,0,4,3,7,0,0,0,0,12,9,4,25,0,2,2,4,3,0,17,20,2,1,0,3
174159.0,Zhai Dejun,OH,China,24.0,195.0,2023,China,Germany,2023-06-24,True,0,0,1,1,0,0,0,0,0,0,0,0,0,0,0,0,0,0,0,0,0,0,0,0
174159.0,Zhai Dejun,OH,China,24.0,195.0,2023,Japan,China,2023-07-04,False,1,1,10,12,0,0,1,1,6,0,6,12,1,1,2,4,1,0,7,8,1,0,0,1
174159.0,Zhai Dejun,OH,China,24.0,195.0,2023,China,Slovenia,2023-07-06,False,2,1,4,7,0,0,1,1,6,2,8,16,0,3,2,5,0,0,2,2,1,1,0,2
174159.0,Zhai Dejun,OH,China,24.0,195.0,2023,Brazil,China,2023-07-08,False,1,2,4,7,0,0,4,4,2,6,10,18,0,0,0,0,0,0,1,1,3,0,0,3
174159.0,Zhai Dejun,OH,China,24.0,195.0,2023,China,Canada,2023-07-09,False,0,2,1,3,0,0,1,1,1,0,3,4,0,4,0,4,0,0,5,5,0,1,0,1
168175.0,Peng Shikun,MB,China,23.0,208.0,2023,Bulgaria,China,2023-06-06,True,1,1,11,13,0,0,0,0,5,0,2,7,1,3,2,6,0,0,1,1,1,0,0,1
168175.0,Peng Shikun,MB,China,23.0,208.0,2023,Serbia,China,2023-06-08,False,0,0,5,5,0,0,0,0,1,0,1,2,1,0,3,4,1,0,0,1,2,0,0,2
168175.0,Peng Shikun,MB,China,23.0,208.0,2023,China,France,2023-06-09,False,0,2,11,13,0,0,0,0,4,0,4,8,2,4,1,7,0,0,1,1,5,1,0,6
168175.0,Peng Shikun,MB,China,23.0,208.0,2023,Iran,China,2023-06-10,False,2,0,17,19,0,0,1,1,3,0,3,6,3,6,2,11,0,0,0,0,2,0,1,3
168175.0,Peng Shikun,MB,China,23.0,208.0,2023,Netherlands,China,2023-06-20,False,0,1,10,11,0,0,1,1,8,1,4,13,1,2,3,6,0,0,0,0,0,0,0,0
168175.0,Peng Shikun,MB,China,23.0,208.0,2023,USA,China,2023-06-21,False,0,0,0,0,0,0,0,0,0,0,0,0,0,0,0,0,0,0,0,0,0,0,0,0
168175.0,Peng Shikun,MB,China,23.0,208.0,2023,China,Italy,2023-06-22,False,0,0,11,11,0,0,0,0,3,2,2,7,1,2,4,7,0,0,0,0,0,1,0,1
168175.0,Peng Shikun,MB,China,23.0,208.0,2023,China,Germany,2023-06-24,True,1,1,18,20,0,0,0,0,4,0,3,7,0,6,4,10,0,0,1,1,1,0,0,1
168175.0,Peng Shikun,MB,China,23.0,208.0,2023,Japan,China,2023-07-04,False,0,4,17,21,0,0,0,0,6,0,0,6,1,2,4,7,0,0,0,0,1,0,0,1
168175.0,Peng Shikun,MB,China,23.0,208.0,2023,China,Slovenia,2023-07-06,False,0,2,18,20,0,0,1,1,6,3,6,15,2,1,3,6,0,0,0,0,1,1,2,4
168175.0,Peng Shikun,MB,China,23.0,208.0,2023,Brazil,China,2023-07-08,False,0,1,6,7,0,0,0,0,1,1,3,5,0,4,2,6,0,0,0,0,0,0,0,0
168175.0,Peng Shikun,MB,China,23.0,208.0,2023,China,Canada,2023-07-09,False,0,1,12,13,0,0,1,1,5,4,1,10,3,4,2,9,0,0,0,0,1,0,0,1
174158.0,Qu Zongshuai,L,China,25.0,186.0,2023,Bulgaria,China,2023-06-06,True,0,0,0,0,0,0,5,5,0,0,0,0,0,0,0,0,2,2,8,12,8,1,2,11
174158.0,Qu Zongshuai,L,China,25.0,186.0,2023,Serbia,China,2023-06-08,False,0,0,0,0,0,0,4,4,0,0,0,0,0,0,0,0,4,3,8,15,8,0,0,8
174158.0,Qu Zongshuai,L,China,25.0,186.0,2023,China,France,2023-06-09,False,0,0,0,0,0,0,6,6,0,0,0,0,0,0,0,0,3,2,7,12,11,1,4,16
174158.0,Qu Zongshuai,L,China,25.0,186.0,2023,Iran,China,2023-06-10,False,0,0,0,0,0,0,1,1,0,0,0,0,0,0,0,0,6,3,17,26,2,2,1,5
174158.0,Qu Zongshuai,L,China,25.0,186.0,2023,Netherlands,China,2023-06-20,False,0,0,0,0,0,0,4,4,0,0,0,0,0,0,0,0,6,2,18,26,6,3,0,9
174158.0,Qu Zongshuai,L,China,25.0,186.0,2023,USA,China,2023-06-21,False,0,0,0,0,0,0,5,5,0,0,0,0,0,0,0,0,4,1,19,24,4,4,0,8
174158.0,Qu Zongshuai,L,China,25.0,186.0,2023,China,Italy,2023-06-22,False,0,0,0,0,0,0,0,0,0,0,0,0,0,0,0,0,0,0,0,0,0,0,0,0
174158.0,Qu Zongshuai,L,China,25.0,186.0,2023,China,Germany,2023-06-24,True,0,0,0,0,0,0,4,4,0,0,0,0,0,0,0,0,8,0,12,20,12,10,2,24
174158.0,Qu Zongshuai,L,China,25.0,186.0,2023,Japan,China,2023-07-04,False,0,0,0,0,0,0,5,5,0,0,0,0,0,0,0,0,5,1,14,20,11,6,3,20
174158.0,Qu Zongshuai,L,China,25.0,186.0,2023,China,Slovenia,2023-07-06,False,0,0,0,0,0,0,5,5,0,0,0,0,0,0,0,0,3,2,12,17,9,3,2,14
174158.0,Qu Zongshuai,L,China,25.0,186.0,2023,Brazil,China,2023-07-08,False,0,0,0,0,0,0,6,6,0,0,0,0,0,0,0,0,3,1,5,9,3,2,0,5
174158.0,Qu Zongshuai,L,China,25.0,186.0,2023,China,Canada,2023-07-09,False,0,0,0,0,0,0,5,5,0,0,0,0,0,0,0,0,3,0,21,24,5,2,0,7
152511.0,Chen Leiyang,S,China,25.0,198.0,2023,Netherlands,China,2023-06-20,False,0,0,0,0,0,0,3,3,0,0,0,0,0,0,0,0,0,0,0,0,0,0,0,0
152511.0,Chen Leiyang,S,China,25.0,198.0,2023,USA,China,2023-06-21,False,0,0,0,0,0,0,0,0,0,0,0,0,0,0,0,0,0,0,0,0,0,0,0,0
152511.0,Chen Leiyang,S,China,25.0,198.0,2023,China,Italy,2023-06-22,False,1,1,8,10,7,0,42,49,0,0,0,0,0,1,0,1,0,0,0,0,1,2,0,3
152511.0,Chen Leiyang,S,China,25.0,198.0,2023,China,Germany,2023-06-24,True,0,0,0,0,0,0,1,1,0,0,0,0,0,1,0,1,0,0,0,0,1,1,0,2
152511.0,Chen Leiyang,S,China,25.0,198.0,2023,Japan,China,2023-07-04,False,0,0,0,0,0,0,0,0,0,0,0,0,0,0,0,0,0,0,0,0,0,0,0,0
152511.0,Chen Leiyang,S,China,25.0,198.0,2023,China,Slovenia,2023-07-06,False,0,1,8,9,11,1,45,57,0,0,0,0,0,1,2,3,0,0,0,0,2,0,1,3
152511.0,Chen Leiyang,S,China,25.0,198.0,2023,Brazil,China,2023-07-08,False,0,1,4,5,4,0,37,41,0,0,0,0,0,0,1,1,0,1,0,1,4,2,1,7
152511.0,Chen Leiyang,S,China,25.0,198.0,2023,China,Canada,2023-07-09,False,0,0,4,4,2,1,20,23,0,0,0,0,0,0,0,0,0,0,0,0,0,0,0,0
142598.0,Rao Shuhan,MB,China,27.0,205.0,2023,Japan,China,2023-07-04,False,0,0,0,0,0,0,0,0,0,0,0,0,0,0,0,0,0,0,0,0,0,0,0,0
142598.0,Rao Shuhan,MB,China,27.0,205.0,2023,China,Slovenia,2023-07-06,False,0,0,0,0,0,0,0,0,0,0,0,0,0,0,0,0,0,0,0,0,0,0,0,0
142598.0,Rao Shuhan,MB,China,27.0,205.0,2023,Brazil,China,2023-07-08,False,0,0,0,0,0,0,0,0,0,0,0,0,0,0,0,0,0,0,0,0,0,0,0,0
142598.0,Rao Shuhan,MB,China,27.0,205.0,2023,China,Canada,2023-07-09,False,0,0,0,0,0,0,0,0,0,0,0,0,0,0,0,0,0,0,0,0,0,0,0,0
168271.0,Zhang Jingyin,OH,China,24.0,207.0,2023,Bulgaria,China,2023-06-06,True,2,6,8,16,0,0,3,3,21,6,9,36,6,3,2,11,1,1,14,16,5,0,1,6
168271.0,Zhang Jingyin,OH,China,24.0,207.0,2023,Serbia,China,2023-06-08,False,1,2,7,10,0,0,0,0,14,6,7,27,2,4,2,8,2,2,15,19,3,0,0,3
168271.0,Zhang Jingyin,OH,China,24.0,207.0,2023,China,France,2023-06-09,False,1,2,11,14,0,0,2,2,7,6,11,24,1,2,4,7,7,5,24,36,6,1,1,8
168271.0,Zhang Jingyin,OH,China,24.0,207.0,2023,Iran,China,2023-06-10,False,1,2,9,12,0,0,5,5,15,4,7,26,4,2,1,7,8,1,19,28,3,0,2,5
168271.0,Zhang Jingyin,OH,China,24.0,207.0,2023,Netherlands,China,2023-06-20,False,4,2,7,13,0,0,2,2,10,10,9,29,1,0,1,2,4,0,17,21,6,3,0,9
168271.0,Zhang Jingyin,OH,China,24.0,207.0,2023,USA,China,2023-06-21,False,3,1,11,15,0,0,2,2,12,5,7,24,0,1,3,4,3,2,8,13,3,2,0,5
168271.0,Zhang Jingyin,OH,China,24.0,207.0,2023,China,Italy,2023-06-22,False,0,0,0,0,0,0,0,0,0,0,0,0,0,0,0,0,0,0,0,0,0,0,0,0
168271.0,Zhang Jingyin,OH,China,24.0,207.0,2023,China,Germany,2023-06-24,True,2,3,10,15,0,0,2,2,20,4,6,30,3,1,2,6,3,2,15,20,0,5,1,6
168271.0,Zhang Jingyin,OH,China,24.0,207.0,2023,Japan,China,2023-07-04,False,2,3,14,19,0,0,4,4,17,5,14,36,2,4,0,6,4,5,27,36,3,0,1,4
168271.0,Zhang Jingyin,OH,China,24.0,207.0,2023,China,Slovenia,2023-07-06,False,0,1,11,12,0,1,4,5,14,5,17,36,2,2,4,8,9,1,26,36,7,3,0,10
168271.0,Zhang Jingyin,OH,China,24.0,207.0,2023,Brazil,China,2023-07-08,False,0,4,3,7,0,0,4,4,8,5,12,25,1,2,2,5,6,0,27,33,3,0,1,4
168271.0,Zhang Jingyin,OH,China,24.0,207.0,2023,China,Canada,2023-07-09,False,1,2,13,16,0,0,2,2,24,4,13,41,0,3,2,5,1,3,22,26,2,1,2,5
169310.0,Wang Bin,OH,China,22.0,195.0,2023,Bulgaria,China,2023-06-06,True,0,1,2,3,0,0,0,0,0,0,0,0,0,0,0,0,0,0,0,0,0,0,0,0
169310.0,Wang Bin,OH,China,22.0,195.0,2023,Serbia,China,2023-06-08,False,0,0,0,0,0,0,0,0,0,0,0,0,0,0,0,0,0,0,1,1,0,0,0,0
169310.0,Wang Bin,OH,China,22.0,195.0,2023,China,France,2023-06-09,False,0,0,0,0,0,0,0,0,0,0,0,0,0,0,0,0,0,0,0,0,0,0,0,0
169310.0,Wang Bin,OH,China,22.0,195.0,2023,Iran,China,2023-06-10,False,0,0,0,0,0,0,0,0,0,0,0,0,0,0,0,0,0,0,0,0,0,0,0,0
169310.0,Wang Bin,OH,China,22.0,195.0,2023,Netherlands,China,2023-06-20,False,1,2,6,9,0,0,2,2,4,7,3,14,0,2,0,2,0,0,11,11,2,2,2,6
169310.0,Wang Bin,OH,China,22.0,195.0,2023,USA,China,2023-06-21,False,1,4,6,11,0,0,0,0,10,0,4,14,0,1,0,1,1,2,12,15,5,3,0,8
169310.0,Wang Bin,OH,China,22.0,195.0,2023,China,Italy,2023-06-22,False,0,0,3,3,0,0,0,0,1,0,0,1,0,1,1,2,1,1,8,10,1,1,0,2
169310.0,Wang Bin,OH,China,22.0,195.0,2023,China,Germany,2023-06-24,True,0,1,0,1,0,0,0,0,0,0,0,0,0,0,0,0,0,0,0,0,0,0,0,0
169310.0,Wang Bin,OH,China,22.0,195.0,2023,Japan,China,2023-07-04,False,0,1,3,4,0,0,0,0,0,0,0,0,0,0,0,0,0,0,0,0,0,0,0,0
169310.0,Wang Bin,OH,China,22.0,195.0,2023,China,Slovenia,2023-07-06,False,0,0,1,1,0,0,0,0,0,0,0,0,0,0,0,0,0,0,0,0,0,1,0,1
169310.0,Wang Bin,OH,China,22.0,195.0,2023,Brazil,China,2023-07-08,False,2,2,1,5,0,0,0,0,9,2,6,17,0,0,0,0,0,0,9,9,0,0,0,0
169310.0,Wang Bin,OH,China,22.0,195.0,2023,China,Canada,2023-07-09,False,0,0,1,1,0,0,0,0,1,0,0,1,0,0,0,0,0,0,1,1,0,0,0,0
147273.0,Masso Alvarez Jose Israel,MB,Cuba,26.0,2.0,2023,Netherlands,Cuba,2023-06-08,False,2,1,8,11,0,0,2,2,6,2,0,8,2,3,2,7,0,0,0,0,0,0,0,0
147273.0,Masso Alvarez Jose Israel,MB,Cuba,26.0,2.0,2023,Italy,Cuba,2023-06-09,False,0,4,3,7,0,0,0,0,5,2,3,10,0,5,5,10,0,1,1,2,1,2,0,3
147273.0,Masso Alvarez Jose Israel,MB,Cuba,26.0,2.0,2023,Brazil,Cuba,2023-06-10,True,0,0,0,0,0,0,0,0,0,0,0,0,0,0,0,0,0,0,0,0,0,0,0,0
147273.0,Masso Alvarez Jose Israel,MB,Cuba,26.0,2.0,2023,Japan,Cuba,2023-06-21,False,0,2,5,7,0,0,3,3,6,0,1,7,1,3,2,6,0,0,0,0,0,0,0,0
147273.0,Masso Alvarez Jose Israel,MB,Cuba,26.0,2.0,2023,Slovenia,Cuba,2023-06-22,False,0,2,5,7,0,0,0,0,6,1,2,9,0,4,3,7,0,0,1,1,1,0,0,1
147273.0,Masso Alvarez Jose Israel,MB,Cuba,26.0,2.0,2023,France,Cuba,2023-06-23,False,0,1,4,5,0,0,1,1,1,2,2,5,1,3,4,8,0,0,1,1,1,0,0,1
147273.0,Masso Alvarez Jose Israel,MB,Cuba,26.0,2.0,2023,Bulgaria,Cuba,2023-06-25,True,0,1,16,17,0,0,0,0,6,4,1,11,0,6,5,11,1,0,2,3,1,2,0,3
147273.0,Masso Alvarez Jose Israel,MB,Cuba,26.0,2.0,2023,Cuba,Iran,2023-07-09,True,0,1,2,3,0,0,0,0,1,0,1,2,0,1,2,3,0,0,1,1,3,0,0,3
151814.0,Mergarejo Hernandez Osniel Lazaro,OH,Cuba,26.0,195.0,2023,Netherlands,Cuba,2023-06-08,False,0,4,6,10,0,0,0,0,6,1,13,20,0,0,2,2,1,0,10,11,5,2,2,9
151814.0,Mergarejo Hernandez Osniel Lazaro,OH,Cuba,26.0,195.0,2023,Italy,Cuba,2023-06-09,False,0,0,0,0,0,0,0,0,0,0,0,0,0,0,0,0,0,0,0,0,0,0,0,0
151814.0,Mergarejo Hernandez Osniel Lazaro,OH,Cuba,26.0,195.0,2023,Brazil,Cuba,2023-06-10,True,0,0,2,2,0,0,0,0,0,0,0,0,0,0,0,0,0,0,0,0,0,0,0,0
151814.0,Mergarejo Hernandez Osniel Lazaro,OH,Cuba,26.0,195.0,2023,Japan,Cuba,2023-06-21,False,0,1,2,3,0,0,0,0,0,0,0,0,0,0,0,0,0,0,2,2,0,1,0,1
151814.0,Mergarejo Hernandez Osniel Lazaro,OH,Cuba,26.0,195.0,2023,Slovenia,Cuba,2023-06-22,False,1,1,5,7,0,0,0,0,0,0,1,1,0,0,1,1,0,0,0,0,2,0,0,2
151814.0,Mergarejo Hernandez Osniel Lazaro,OH,Cuba,26.0,195.0,2023,France,Cuba,2023-06-23,False,0,1,2,3,0,0,0,0,0,0,1,1,0,0,0,0,0,0,1,1,0,0,0,0
151814.0,Mergarejo Hernandez Osniel Lazaro,OH,Cuba,26.0,195.0,2023,Bulgaria,Cuba,2023-06-25,True,0,1,7,8,0,0,1,1,10,3,3,16,2,1,0,3,0,0,7,7,3,0,0,3
151814.0,Mergarejo Hernandez Osniel Lazaro,OH,Cuba,26.0,195.0,2023,Cuba,Iran,2023-07-09,True,0,4,5,9,0,0,2,2,4,2,4,10,0,1,0,1,3,1,9,13,1,4,0,5
147263.0,Concepcion Rojas Javier Octavio,MB,Cuba,26.0,200.0,2023,Netherlands,Cuba,2023-06-08,False,0,1,8,9,0,0,0,0,3,0,6,9,0,6,6,12,0,1,3,4,1,2,0,3
147263.0,Concepcion Rojas Javier Octavio,MB,Cuba,26.0,200.0,2023,Italy,Cuba,2023-06-09,False,1,4,10,15,0,0,0,0,4,1,2,7,5,6,1,12,0,0,4,4,3,0,0,3
147263.0,Concepcion Rojas Javier Octavio,MB,Cuba,26.0,200.0,2023,Brazil,Cuba,2023-06-10,True,1,5,13,19,0,0,0,0,8,1,2,11,4,6,5,15,0,0,2,2,2,1,0,3
147263.0,Concepcion Rojas Javier Octavio,MB,Cuba,26.0,200.0,2023,Japan,Cuba,2023-06-21,False,0,2,4,6,0,0,1,1,5,3,0,8,1,6,2,9,2,0,0,2,0,0,0,0
147263.0,Concepcion Rojas Javier Octavio,MB,Cuba,26.0,200.0,2023,Slovenia,Cuba,2023-06-22,False,0,3,5,8,0,0,2,2,7,1,1,9,0,3,2,5,0,0,2,2,1,0,0,1
147263.0,Concepcion Rojas Javier Octavio,MB,Cuba,26.0,200.0,2023,France,Cuba,2023-06-23,False,0,2,5,7,0,0,0,0,6,0,2,8,2,4,4,10,0,0,1,1,3,0,0,3
147263.0,Concepcion Rojas Javier Octavio,MB,Cuba,26.0,200.0,2023,Bulgaria,Cuba,2023-06-25,True,1,4,9,14,0,0,1,1,5,1,1,7,3,4,1,8,3,0,4,7,0,0,0,0
147263.0,Concepcion Rojas Javier Octavio,MB,Cuba,26.0,200.0,2023,Cuba,Iran,2023-07-09,True,0,2,11,13,0,0,1,1,7,2,5,14,4,8,5,17,0,0,2,2,3,1,1,5
168412.0,Thondike Mejias Christian Manuel,S,Cuba,22.0,195.0,2023,Netherlands,Cuba,2023-06-08,False,0,1,0,1,1,0,9,10,0,0,0,0,0,0,0,0,0,0,0,0,1,1,0,2
168412.0,Thondike Mejias Christian Manuel,S,Cuba,22.0,195.0,2023,Italy,Cuba,2023-06-09,False,0,2,4,6,4,0,25,29,1,0,0,1,0,2,2,4,0,0,0,0,1,0,0,1
168412.0,Thondike Mejias Christian Manuel,S,Cuba,22.0,195.0,2023,Brazil,Cuba,2023-06-10,True,0,0,0,0,0,0,0,0,0,0,0,0,0,0,0,0,0,0,0,0,0,0,0,0
168412.0,Thondike Mejias Christian Manuel,S,Cuba,22.0,195.0,2023,Japan,Cuba,2023-06-21,False,0,1,2,3,6,0,9,15,0,0,0,0,1,0,0,1,0,0,0,0,0,1,0,1
168412.0,Thondike Mejias Christian Manuel,S,Cuba,22.0,195.0,2023,Slovenia,Cuba,2023-06-22,False,0,1,6,7,13,0,34,47,0,2,0,2,1,4,1,6,0,0,0,0,2,1,0,3
168412.0,Thondike Mejias Christian Manuel,S,Cuba,22.0,195.0,2023,France,Cuba,2023-06-23,False,1,2,5,8,15,1,58,74,0,0,4,4,0,3,1,4,0,0,0,0,2,0,0,2
168412.0,Thondike Mejias Christian Manuel,S,Cuba,22.0,195.0,2023,Bulgaria,Cuba,2023-06-25,True,0,1,0,1,2,0,5,7,0,0,0,0,0,0,0,0,0,0,0,0,0,0,0,0
168412.0,Thondike Mejias Christian Manuel,S,Cuba,22.0,195.0,2023,Cuba,Iran,2023-07-09,True,0,1,3,4,6,0,16,22,0,0,2,2,0,3,0,3,0,0,0,0,1,1,0,2
132361.0,Garcia Alvarez Yonder Roman,L,Cuba,31.0,183.0,2023,Netherlands,Cuba,2023-06-08,False,0,0,0,0,0,0,6,6,0,0,0,0,0,0,0,0,2,0,13,15,4,2,1,7
132361.0,Garcia Alvarez Yonder Roman,L,Cuba,31.0,183.0,2023,Italy,Cuba,2023-06-09,False,0,0,0,0,0,0,6,6,0,0,0,0,0,0,0,0,3,1,7,11,4,0,1,5
132361.0,Garcia Alvarez Yonder Roman,L,Cuba,31.0,183.0,2023,Brazil,Cuba,2023-06-10,True,0,0,0,0,0,0,1,1,0,0,0,0,0,0,0,0,3,0,12,15,8,4,3,15
132361.0,Garcia Alvarez Yonder Roman,L,Cuba,31.0,183.0,2023,Japan,Cuba,2023-06-21,False,0,0,0,0,0,0,4,4,0,0,0,0,0,0,0,0,1,0,6,7,1,4,1,6
132361.0,Garcia Alvarez Yonder Roman,L,Cuba,31.0,183.0,2023,Slovenia,Cuba,2023-06-22,False,0,0,0,0,0,0,1,1,0,0,0,0,0,0,0,0,2,0,11,13,3,5,1,9
132361.0,Garcia Alvarez Yonder Roman,L,Cuba,31.0,183.0,2023,France,Cuba,2023-06-23,False,0,0,0,0,0,0,0,0,0,0,0,0,0,0,0,0,0,0,0,0,0,0,0,0
132361.0,Garcia Alvarez Yonder Roman,L,Cuba,31.0,183.0,2023,Bulgaria,Cuba,2023-06-25,True,0,0,0,0,0,0,0,0,0,0,0,0,0,0,0,0,0,0,0,0,0,0,0,0
132361.0,Garcia Alvarez Yonder Roman,L,Cuba,31.0,183.0,2023,Cuba,Iran,2023-07-09,True,0,0,0,0,0,1,6,7,0,0,0,0,0,0,0,0,2,2,8,12,8,2,0,10
147268.0,Gutierrez Suarez Miguel David,O,Cuba,27.0,197.0,2023,Netherlands,Cuba,2023-06-08,False,0,0,0,0,0,0,0,0,0,0,0,0,0,0,0,0,0,0,0,0,0,0,0,0
147268.0,Gutierrez Suarez Miguel David,O,Cuba,27.0,197.0,2023,Italy,Cuba,2023-06-09,False,0,1,1,2,0,0,1,1,2,0,3,5,1,2,0,3,0,0,0,0,1,0,0,1
147268.0,Gutierrez Suarez Miguel David,O,Cuba,27.0,197.0,2023,Brazil,Cuba,2023-06-10,True,0,0,0,0,0,0,0,0,0,0,0,0,0,0,0,0,0,0,0,0,0,0,0,0
147268.0,Gutierrez Suarez Miguel David,O,Cuba,27.0,197.0,2023,Japan,Cuba,2023-06-21,False,0,0,0,0,0,0,0,0,1,0,0,1,0,0,0,0,0,0,0,0,0,0,0,0
147268.0,Gutierrez Suarez Miguel David,O,Cuba,27.0,197.0,2023,Slovenia,Cuba,2023-06-22,False,0,1,0,1,0,0,0,0,0,0,1,1,0,1,0,1,0,0,0,0,0,1,0,1
147268.0,Gutierrez Suarez Miguel David,O,Cuba,27.0,197.0,2023,France,Cuba,2023-06-23,False,0,2,1,3,0,0,1,1,5,0,3,8,0,1,0,1,0,0,0,0,2,1,1,4
147268.0,Gutierrez Suarez Miguel David,O,Cuba,27.0,197.0,2023,Bulgaria,Cuba,2023-06-25,True,0,0,1,1,0,0,0,0,1,0,1,2,0,0,0,0,0,0,0,0,0,0,0,0
147268.0,Gutierrez Suarez Miguel David,O,Cuba,27.0,197.0,2023,Cuba,Iran,2023-07-09,True,0,0,0,0,0,0,0,0,0,0,0,0,0,0,0,0,0,0,0,0,0,0,0,0
157477.0,Taboada Diaz Lyvan,S,Cuba,25.0,191.0,2023,Netherlands,Cuba,2023-06-08,False,0,2,9,11,9,1,45,55,1,0,1,2,0,2,1,3,0,0,1,1,3,1,1,5
157477.0,Taboada Diaz Lyvan,S,Cuba,25.0,191.0,2023,Italy,Cuba,2023-06-09,False,0,0,11,11,10,0,38,48,1,1,0,2,1,0,0,1,0,1,3,4,3,1,0,4
157477.0,Taboada Diaz Lyvan,S,Cuba,25.0,191.0,2023,Brazil,Cuba,2023-06-10,True,0,1,19,20,24,0,82,106,1,0,0,1,2,1,5,8,0,0,0,0,5,4,1,10
157477.0,Taboada Diaz Lyvan,S,Cuba,25.0,191.0,2023,Japan,Cuba,2023-06-21,False,0,0,4,4,12,0,28,40,0,2,0,2,0,2,1,3,0,0,0,0,0,3,0,3
157477.0,Taboada Diaz Lyvan,S,Cuba,25.0,191.0,2023,Slovenia,Cuba,2023-06-22,False,0,0,4,4,6,0,25,31,1,0,0,1,0,3,2,5,0,0,0,0,2,2,0,4
157477.0,Taboada Diaz Lyvan,S,Cuba,25.0,191.0,2023,France,Cuba,2023-06-23,False,0,0,0,0,0,0,0,0,0,0,0,0,0,0,0,0,0,0,0,0,0,0,0,0
157477.0,Taboada Diaz Lyvan,S,Cuba,25.0,191.0,2023,Bulgaria,Cuba,2023-06-25,True,0,0,12,12,27,0,70,97,1,0,1,2,1,5,3,9,0,0,0,0,4,6,0,10
157477.0,Taboada Diaz Lyvan,S,Cuba,25.0,191.0,2023,Cuba,Iran,2023-07-09,True,0,2,10,12,27,1,59,87,0,0,0,0,3,1,3,7,0,0,0,0,4,4,1,9
169940.0,Herrera Jaime Jesus,O,Cuba,28.0,194.0,2023,Netherlands,Cuba,2023-06-08,False,1,4,10,15,0,0,1,1,9,8,5,22,2,5,3,10,0,0,0,0,2,7,0,9
169940.0,Herrera Jaime Jesus,O,Cuba,28.0,194.0,2023,Italy,Cuba,2023-06-09,False,0,2,9,11,0,0,2,2,6,7,10,23,1,5,2,8,0,0,0,0,4,5,1,10
169940.0,Herrera Jaime Jesus,O,Cuba,28.0,194.0,2023,Brazil,Cuba,2023-06-10,True,2,4,18,24,0,0,4,4,26,6,6,38,2,2,2,6,0,0,2,2,5,3,0,8
169940.0,Herrera Jaime Jesus,O,Cuba,28.0,194.0,2023,Japan,Cuba,2023-06-21,False,1,5,7,13,0,0,0,0,4,3,6,13,1,0,1,2,0,0,0,0,5,2,0,7
169940.0,Herrera Jaime Jesus,O,Cuba,28.0,194.0,2023,Slovenia,Cuba,2023-06-22,False,1,2,10,13,0,0,0,0,12,10,9,31,0,2,4,6,0,1,0,1,1,2,1,4
169940.0,Herrera Jaime Jesus,O,Cuba,28.0,194.0,2023,France,Cuba,2023-06-23,False,0,2,6,8,0,0,0,0,4,7,2,13,0,0,3,3,0,0,0,0,0,3,0,3
169940.0,Herrera Jaime Jesus,O,Cuba,28.0,194.0,2023,Bulgaria,Cuba,2023-06-25,True,6,6,13,25,0,0,1,1,21,6,9,36,0,2,1,3,1,0,1,2,7,3,1,11
169940.0,Herrera Jaime Jesus,O,Cuba,28.0,194.0,2023,Cuba,Iran,2023-07-09,True,2,7,12,21,0,0,3,3,25,6,5,36,1,2,1,4,0,0,0,0,1,4,1,6
147272.0,Goide Arredondo Adrian Eduardo,S,Cuba,25.0,191.0,2023,Netherlands,Cuba,2023-06-08,False,0,0,0,0,0,0,0,0,0,0,0,0,0,0,0,0,0,0,0,0,0,0,0,0
147272.0,Goide Arredondo Adrian Eduardo,S,Cuba,25.0,191.0,2023,Italy,Cuba,2023-06-09,False,0,0,0,0,0,0,0,0,0,0,0,0,0,0,0,0,0,0,0,0,0,0,0,0
147272.0,Goide Arredondo Adrian Eduardo,S,Cuba,25.0,191.0,2023,Brazil,Cuba,2023-06-10,True,0,0,0,0,0,0,0,0,0,0,0,0,0,0,0,0,0,0,0,0,0,0,0,0
147272.0,Goide Arredondo Adrian Eduardo,S,Cuba,25.0,191.0,2023,Japan,Cuba,2023-06-21,False,0,0,0,0,0,0,0,0,0,0,0,0,0,0,0,0,0,0,0,0,0,0,0,0
147272.0,Goide Arredondo Adrian Eduardo,S,Cuba,25.0,191.0,2023,Slovenia,Cuba,2023-06-22,False,0,0,0,0,0,0,0,0,0,0,0,0,0,0,0,0,0,0,0,0,0,0,0,0
147272.0,Goide Arredondo Adrian Eduardo,S,Cuba,25.0,191.0,2023,France,Cuba,2023-06-23,False,0,0,0,0,0,0,0,0,0,0,0,0,0,0,0,0,0,0,0,0,0,0,0,0
147272.0,Goide Arredondo Adrian Eduardo,S,Cuba,25.0,191.0,2023,Bulgaria,Cuba,2023-06-25,True,0,0,0,0,0,0,0,0,0,0,0,0,0,0,0,0,0,0,0,0,0,0,0,0
147272.0,Goide Arredondo Adrian Eduardo,S,Cuba,25.0,191.0,2023,Cuba,Iran,2023-07-09,True,0,0,0,0,0,0,0,0,0,0,0,0,0,0,0,0,0,0,0,0,0,0,0,0
151817.0,Lopez Castro Miguel Angel,OH,Cuba,27.0,189.0,2023,Netherlands,Cuba,2023-06-08,False,0,2,8,10,0,0,6,6,9,5,5,19,1,0,3,4,4,0,21,25,2,1,0,3
151817.0,Lopez Castro Miguel Angel,OH,Cuba,27.0,189.0,2023,Italy,Cuba,2023-06-09,False,2,4,7,13,0,1,6,7,11,3,9,23,1,2,1,4,1,0,21,22,2,0,1,3
151817.0,Lopez Castro Miguel Angel,OH,Cuba,27.0,189.0,2023,Brazil,Cuba,2023-06-10,True,2,6,12,20,0,0,5,5,14,4,17,35,0,5,4,9,6,1,27,34,4,5,2,11
151817.0,Lopez Castro Miguel Angel,OH,Cuba,27.0,189.0,2023,Japan,Cuba,2023-06-21,False,1,4,6,11,0,0,1,1,8,2,5,15,1,2,3,6,4,0,14,18,0,3,0,3
151817.0,Lopez Castro Miguel Angel,OH,Cuba,27.0,189.0,2023,Slovenia,Cuba,2023-06-22,False,0,4,9,13,0,0,5,5,9,5,6,20,0,6,2,8,6,2,20,28,2,3,0,5
151817.0,Lopez Castro Miguel Angel,OH,Cuba,27.0,189.0,2023,France,Cuba,2023-06-23,False,3,2,8,13,0,0,2,2,9,5,7,21,0,5,2,7,4,0,9,13,7,1,2,10
151817.0,Lopez Castro Miguel Angel,OH,Cuba,27.0,189.0,2023,Bulgaria,Cuba,2023-06-25,True,1,4,10,15,0,0,7,7,17,6,9,32,1,4,1,6,4,1,15,20,11,2,2,15
151817.0,Lopez Castro Miguel Angel,OH,Cuba,27.0,189.0,2023,Cuba,Iran,2023-07-09,True,3,5,15,23,0,0,2,2,22,3,8,33,2,3,4,9,9,0,32,41,1,5,1,7
182877.0,Pedroso Garriga Endriel Alberto,MB,Cuba,21.0,212.0,2023,Netherlands,Cuba,2023-06-08,False,0,0,0,0,0,0,0,0,0,0,0,0,0,0,0,0,0,0,0,0,0,0,0,0
182877.0,Pedroso Garriga Endriel Alberto,MB,Cuba,21.0,212.0,2023,Italy,Cuba,2023-06-09,False,0,0,0,0,0,0,0,0,0,0,0,0,0,0,0,0,0,0,0,0,0,0,0,0
182877.0,Pedroso Garriga Endriel Alberto,MB,Cuba,21.0,212.0,2023,Brazil,Cuba,2023-06-10,True,0,2,7,9,0,0,0,0,4,1,1,6,4,6,4,14,0,0,1,1,0,1,0,1
182877.0,Pedroso Garriga Endriel Alberto,MB,Cuba,21.0,212.0,2023,Japan,Cuba,2023-06-21,False,0,0,0,0,0,0,0,0,0,0,0,0,0,0,0,0,0,0,0,0,0,0,0,0
182877.0,Pedroso Garriga Endriel Alberto,MB,Cuba,21.0,212.0,2023,Slovenia,Cuba,2023-06-22,False,0,0,0,0,0,0,0,0,0,0,0,0,0,0,0,0,0,0,0,0,0,0,0,0
182877.0,Pedroso Garriga Endriel Alberto,MB,Cuba,21.0,212.0,2023,France,Cuba,2023-06-23,False,0,1,1,2,0,0,0,0,0,1,2,3,2,3,0,5,0,0,0,0,0,0,0,0
182877.0,Pedroso Garriga Endriel Alberto,MB,Cuba,21.0,212.0,2023,Bulgaria,Cuba,2023-06-25,True,0,0,2,2,0,0,0,0,0,0,0,0,0,1,0,1,0,0,0,0,0,0,0,0
182877.0,Pedroso Garriga Endriel Alberto,MB,Cuba,21.0,212.0,2023,Cuba,Iran,2023-07-09,True,0,1,15,16,0,0,0,0,4,2,3,9,0,6,3,9,0,0,0,0,1,1,0,2
168417.0,Gutierrez Suarez Jose Miguel,OH,Cuba,22.0,192.0,2023,Netherlands,Cuba,2023-06-08,False,0,1,0,1,0,0,0,0,0,0,0,0,0,0,0,0,0,0,0,0,0,0,0,0
168417.0,Gutierrez Suarez Jose Miguel,OH,Cuba,22.0,192.0,2023,Italy,Cuba,2023-06-09,False,0,1,2,3,0,0,0,0,0,0,0,0,0,0,0,0,0,0,0,0,0,0,0,0
168417.0,Gutierrez Suarez Jose Miguel,OH,Cuba,22.0,192.0,2023,Brazil,Cuba,2023-06-10,True,0,3,3,6,0,0,0,0,0,0,0,0,0,0,0,0,0,0,0,0,0,0,0,0
168417.0,Gutierrez Suarez Jose Miguel,OH,Cuba,22.0,192.0,2023,Japan,Cuba,2023-06-21,False,0,1,3,4,0,0,0,0,0,0,0,0,0,0,0,0,0,0,0,0,0,1,0,1
168417.0,Gutierrez Suarez Jose Miguel,OH,Cuba,22.0,192.0,2023,Slovenia,Cuba,2023-06-22,False,0,1,3,4,0,0,0,0,0,0,0,0,0,0,0,0,0,0,0,0,0,0,0,0
168417.0,Gutierrez Suarez Jose Miguel,OH,Cuba,22.0,192.0,2023,France,Cuba,2023-06-23,False,0,2,0,2,0,0,0,0,0,0,0,0,0,0,0,0,0,0,0,0,0,0,0,0
168417.0,Gutierrez Suarez Jose Miguel,OH,Cuba,22.0,192.0,2023,Bulgaria,Cuba,2023-06-25,True,0,3,1,4,0,0,1,1,0,1,1,2,1,0,0,1,0,0,0,0,0,0,0,0
168417.0,Gutierrez Suarez Jose Miguel,OH,Cuba,22.0,192.0,2023,Cuba,Iran,2023-07-09,True,1,2,3,6,0,0,0,0,0,0,0,0,0,0,0,0,0,0,0,0,1,0,0,1
157318.0,Yant Herrera Marlon,OH,Cuba,22.0,202.0,2023,Netherlands,Cuba,2023-06-08,False,0,1,0,1,0,0,1,1,0,1,0,1,0,0,0,0,1,0,2,3,0,0,0,0
157318.0,Yant Herrera Marlon,OH,Cuba,22.0,202.0,2023,Italy,Cuba,2023-06-09,False,0,2,13,15,0,0,1,1,11,3,9,23,0,3,1,4,4,2,23,29,4,1,0,5
157318.0,Yant Herrera Marlon,OH,Cuba,22.0,202.0,2023,Brazil,Cuba,2023-06-10,True,0,6,13,19,0,0,2,2,17,2,13,32,2,5,3,10,3,1,32,36,3,1,1,5
157318.0,Yant Herrera Marlon,OH,Cuba,22.0,202.0,2023,Japan,Cuba,2023-06-21,False,1,5,4,10,0,0,1,1,6,2,6,14,3,0,0,3,9,0,23,32,1,0,0,1
157318.0,Yant Herrera Marlon,OH,Cuba,22.0,202.0,2023,Slovenia,Cuba,2023-06-22,False,2,4,6,12,0,0,2,2,10,1,5,16,1,2,1,4,5,2,22,29,6,3,0,9
157318.0,Yant Herrera Marlon,OH,Cuba,22.0,202.0,2023,France,Cuba,2023-06-23,False,0,5,4,9,0,0,1,1,7,2,10,19,3,1,5,9,3,0,19,22,2,0,0,2
157318.0,Yant Herrera Marlon,OH,Cuba,22.0,202.0,2023,Bulgaria,Cuba,2023-06-25,True,0,2,5,7,0,0,1,1,1,3,2,6,0,0,2,2,2,1,12,15,0,1,0,1
157318.0,Yant Herrera Marlon,OH,Cuba,22.0,202.0,2023,Cuba,Iran,2023-07-09,True,1,5,7,13,0,0,0,0,13,4,2,19,1,0,3,4,6,0,23,29,4,4,0,8
190322.0,Gorguet Salas Alain,OH,Cuba,30.0,189.0,2023,Netherlands,Cuba,2023-06-08,False,0,0,0,0,0,0,0,0,0,0,0,0,0,0,0,0,0,0,0,0,6,2,0,8
190322.0,Gorguet Salas Alain,OH,Cuba,30.0,189.0,2023,Italy,Cuba,2023-06-09,False,0,0,0,0,0,0,1,1,0,0,0,0,0,0,0,0,0,0,0,0,0,0,0,0
190322.0,Gorguet Salas Alain,OH,Cuba,30.0,189.0,2023,Brazil,Cuba,2023-06-10,True,0,0,0,0,0,0,0,0,0,0,0,0,0,0,0,0,0,0,0,0,0,0,0,0
190322.0,Gorguet Salas Alain,OH,Cuba,30.0,189.0,2023,Japan,Cuba,2023-06-21,False,0,0,0,0,0,0,0,0,0,0,0,0,0,0,0,0,0,0,0,0,0,1,0,1
190322.0,Gorguet Salas Alain,OH,Cuba,30.0,189.0,2023,Slovenia,Cuba,2023-06-22,False,0,0,0,0,0,0,0,0,0,0,0,0,0,0,0,0,1,0,1,2,0,0,0,0
190322.0,Gorguet Salas Alain,OH,Cuba,30.0,189.0,2023,France,Cuba,2023-06-23,False,0,0,0,0,0,0,2,2,0,0,0,0,0,0,0,0,4,4,13,21,6,5,1,12
190322.0,Gorguet Salas Alain,OH,Cuba,30.0,189.0,2023,Bulgaria,Cuba,2023-06-25,True,0,0,0,0,0,0,2,2,0,0,0,0,0,0,0,0,9,1,23,33,3,7,1,11
190322.0,Gorguet Salas Alain,OH,Cuba,30.0,189.0,2023,Cuba,Iran,2023-07-09,True,0,0,0,0,0,0,0,0,0,0,0,0,0,0,0,0,0,0,0,0,0,0,0,0
152494.0,Chinenyeze Barthélémy,MB,France,26.0,204.0,2023,Argentina,France,2023-06-21,False,0,3,9,12,0,0,0,0,7,3,5,15,3,3,2,8,0,0,0,0,3,1,0,4
152494.0,Chinenyeze Barthélémy,MB,France,26.0,204.0,2023,France,Cuba,2023-06-23,True,0,2,8,10,0,0,0,0,5,0,3,8,0,3,3,6,0,0,0,0,3,0,0,3
152494.0,Chinenyeze Barthélémy,MB,France,26.0,204.0,2023,Canada,France,2023-06-24,True,0,4,5,9,0,0,0,0,7,0,3,10,0,2,3,5,0,0,0,0,4,1,0,5
152494.0,Chinenyeze Barthélémy,MB,France,26.0,204.0,2023,Brazil,France,2023-06-25,False,1,0,10,11,0,1,3,4,8,1,5,14,1,5,3,9,0,0,0,0,2,1,0,3
152494.0,Chinenyeze Barthélémy,MB,France,26.0,204.0,2023,Iran,France,2023-07-04,True,0,2,9,11,0,0,2,2,6,1,2,9,1,4,3,8,0,0,0,0,2,0,1,3
152494.0,Chinenyeze Barthélémy,MB,France,26.0,204.0,2023,Serbia,France,2023-07-07,True,0,2,10,12,0,0,1,1,7,3,3,13,3,4,2,9,0,0,1,1,1,0,0,1
152494.0,Chinenyeze Barthélémy,MB,France,26.0,204.0,2023,USA,France,2023-07-19,False,1,4,13,18,0,0,1,1,10,1,6,17,5,4,3,12,0,0,0,0,0,1,1,2
119792.0,Grebennikov Jenia,L,France,33.0,188.0,2023,Argentina,France,2023-06-21,False,0,0,0,0,0,0,7,7,0,0,0,0,0,0,0,0,9,2,13,24,19,5,1,25
119792.0,Grebennikov Jenia,L,France,33.0,188.0,2023,France,Cuba,2023-06-23,True,0,0,0,0,0,0,4,4,0,0,0,0,0,0,0,0,2,1,10,13,12,5,2,19
119792.0,Grebennikov Jenia,L,France,33.0,188.0,2023,Canada,France,2023-06-24,True,0,0,0,0,0,0,4,4,0,0,0,0,0,0,0,0,4,0,11,15,10,4,0,14
119792.0,Grebennikov Jenia,L,France,33.0,188.0,2023,Brazil,France,2023-06-25,False,0,0,0,0,0,0,5,5,0,0,0,0,0,0,0,0,3,1,19,23,15,8,0,23
119792.0,Grebennikov Jenia,L,France,33.0,188.0,2023,Iran,France,2023-07-04,True,0,0,0,0,0,0,8,8,0,0,0,0,0,0,0,0,2,0,16,18,7,3,3,13
119792.0,Grebennikov Jenia,L,France,33.0,188.0,2023,Serbia,France,2023-07-07,True,0,0,0,0,0,0,11,11,0,0,0,0,0,0,0,0,5,0,11,16,10,2,2,14
119792.0,Grebennikov Jenia,L,France,33.0,188.0,2023,USA,France,2023-07-19,False,0,0,0,0,0,0,9,9,0,0,0,0,0,0,0,0,6,1,14,21,10,5,2,17
142694.0,Patry Jean,O,France,27.0,207.0,2023,Argentina,France,2023-06-21,False,0,1,0,1,0,0,0,0,3,0,2,5,2,1,0,3,0,0,0,0,0,0,0,0
142694.0,Patry Jean,O,France,27.0,207.0,2023,France,Cuba,2023-06-23,True,1,3,8,12,0,0,2,2,13,3,11,27,0,0,3,3,0,0,0,0,3,0,2,5
142694.0,Patry Jean,O,France,27.0,207.0,2023,Canada,France,2023-06-24,True,3,2,13,18,0,0,0,0,11,0,10,21,2,3,2,7,0,0,0,0,3,1,0,4
142694.0,Patry Jean,O,France,27.0,207.0,2023,Brazil,France,2023-06-25,False,0,0,0,0,0,0,0,0,0,0,0,0,0,0,0,0,0,0,0,0,0,0,0,0
142694.0,Patry Jean,O,France,27.0,207.0,2023,Iran,France,2023-07-04,True,0,1,0,1,0,0,0,0,2,0,0,2,0,0,0,0,0,0,0,0,0,0,0,0
142694.0,Patry Jean,O,France,27.0,207.0,2023,Serbia,France,2023-07-07,True,0,3,13,16,0,0,0,0,16,8,15,39,2,1,1,4,0,0,0,0,4,3,0,7
142694.0,Patry Jean,O,France,27.0,207.0,2023,USA,France,2023-07-19,False,2,4,5,11,0,0,0,0,13,6,10,29,2,1,3,6,0,0,0,0,3,0,0,3
119804.0,Toniutti Benjamin,S,France,34.0,183.0,2023,Iran,France,2023-07-04,True,0,1,12,13,17,0,40,57,1,0,0,1,0,0,2,2,0,0,1,1,3,1,0,4
119804.0,Toniutti Benjamin,S,France,34.0,183.0,2023,Serbia,France,2023-07-07,True,0,0,0,0,0,0,0,0,0,0,0,0,0,0,0,0,0,0,0,0,0,0,0,0
119804.0,Toniutti Benjamin,S,France,34.0,183.0,2023,USA,France,2023-07-19,False,0,0,6,6,12,0,34,46,1,0,0,1,0,0,1,1,0,0,0,0,0,3,1,4
124518.0,Tillie Kevin,OH,France,33.0,200.0,2023,Poland,France,2023-06-07,False,1,3,12,16,0,0,3,3,10,4,11,25,1,4,5,10,7,2,10,19,6,1,0,7
124518.0,Tillie Kevin,OH,France,33.0,200.0,2023,China,France,2023-06-09,True,1,2,17,20,0,0,3,3,16,5,8,29,0,1,2,3,7,0,10,17,11,1,1,13
124518.0,Tillie Kevin,OH,France,33.0,200.0,2023,France,Slovenia,2023-06-10,False,0,3,12,15,0,0,2,2,8,5,12,25,1,4,1,6,7,2,19,28,10,1,0,11
124518.0,Tillie Kevin,OH,France,33.0,200.0,2023,Japan,France,2023-06-11,False,0,3,10,13,0,0,3,3,14,2,5,21,0,1,4,5,12,1,15,28,7,2,0,9
124518.0,Tillie Kevin,OH,France,33.0,200.0,2023,Argentina,France,2023-06-21,False,0,2,15,17,0,0,4,4,13,6,9,28,0,3,5,8,8,0,11,19,3,3,0,6
124518.0,Tillie Kevin,OH,France,33.0,200.0,2023,France,Cuba,2023-06-23,True,0,1,6,7,0,0,4,4,5,3,7,15,2,1,2,5,3,0,6,9,5,2,0,7
124518.0,Tillie Kevin,OH,France,33.0,200.0,2023,Canada,France,2023-06-24,True,0,0,1,1,0,0,0,0,0,0,0,0,0,0,0,0,0,0,0,0,0,0,0,0
124518.0,Tillie Kevin,OH,France,33.0,200.0,2023,Brazil,France,2023-06-25,False,0,3,17,20,0,0,3,3,9,4,9,22,0,4,2,6,8,1,19,28,2,1,4,7
124518.0,Tillie Kevin,OH,France,33.0,200.0,2023,USA,France,2023-07-19,False,0,2,20,22,0,0,3,3,11,6,6,23,0,3,3,6,7,3,27,37,13,3,0,16
136851.0,Brizard Antoine,S,France,29.0,196.0,2023,Argentina,France,2023-06-21,False,0,5,13,18,21,2,71,94,0,0,3,3,1,1,1,3,0,0,0,0,4,1,2,7
136851.0,Brizard Antoine,S,France,29.0,196.0,2023,France,Cuba,2023-06-23,True,1,4,8,13,13,0,46,59,2,0,0,2,2,2,3,7,0,0,0,0,3,3,0,6
136851.0,Brizard Antoine,S,France,29.0,196.0,2023,Canada,France,2023-06-24,True,0,1,8,9,16,1,52,69,1,1,0,2,1,4,4,9,0,0,0,0,4,1,1,6
136851.0,Brizard Antoine,S,France,29.0,196.0,2023,Brazil,France,2023-06-25,False,3,3,16,22,30,0,60,90,3,0,2,5,1,3,1,5,0,1,0,1,4,4,0,8
136851.0,Brizard Antoine,S,France,29.0,196.0,2023,Iran,France,2023-07-04,True,0,0,0,0,1,0,4,5,0,0,0,0,0,0,0,0,0,0,0,0,0,1,0,1
136851.0,Brizard Antoine,S,France,29.0,196.0,2023,Serbia,France,2023-07-07,True,1,6,11,18,29,0,64,93,2,0,1,3,0,3,4,7,0,0,1,1,4,3,1,8
136851.0,Brizard Antoine,S,France,29.0,196.0,2023,USA,France,2023-07-19,False,2,4,11,17,25,0,46,71,0,0,2,2,1,4,2,7,0,0,0,0,8,3,0,11
142710.0,Boyer Stephen,O,France,27.0,196.0,2023,Argentina,France,2023-06-21,False,0,3,7,10,0,0,2,2,14,6,8,28,0,3,1,4,0,0,0,0,4,2,0,6
142710.0,Boyer Stephen,O,France,27.0,196.0,2023,France,Cuba,2023-06-23,True,0,0,0,0,0,0,0,0,0,0,0,0,0,0,0,0,0,0,0,0,0,0,0,0
142710.0,Boyer Stephen,O,France,27.0,196.0,2023,Canada,France,2023-06-24,True,0,0,0,0,0,0,0,0,0,0,0,0,0,0,0,0,0,0,0,0,0,0,0,0
142710.0,Boyer Stephen,O,France,27.0,196.0,2023,Brazil,France,2023-06-25,False,0,5,7,12,0,0,3,3,16,5,15,36,1,2,3,6,1,0,0,1,4,3,0,7
142710.0,Boyer Stephen,O,France,27.0,196.0,2023,Iran,France,2023-07-04,True,1,3,6,10,0,0,1,1,10,1,8,19,0,3,0,3,0,0,0,0,4,2,1,7
142710.0,Boyer Stephen,O,France,27.0,196.0,2023,Serbia,France,2023-07-07,True,0,0,0,0,0,0,0,0,0,0,0,0,0,0,0,0,0,0,0,0,0,0,0,0
142710.0,Boyer Stephen,O,France,27.0,196.0,2023,USA,France,2023-07-19,False,0,1,3,4,0,0,1,1,4,1,10,15,0,1,1,2,0,0,1,1,3,0,1,4
125073.0,Le Goff Nicolas,MB,France,32.0,206.0,2023,Iran,France,2023-07-04,True,0,1,6,7,0,0,0,0,1,1,2,4,3,2,3,8,0,0,0,0,2,0,0,2
125073.0,Le Goff Nicolas,MB,France,32.0,206.0,2023,Serbia,France,2023-07-07,True,0,2,1,3,0,0,0,0,0,0,1,1,0,1,1,2,0,0,0,0,0,0,0,0
125073.0,Le Goff Nicolas,MB,France,32.0,206.0,2023,USA,France,2023-07-19,False,1,1,6,8,0,0,0,0,11,2,5,18,2,5,0,7,0,0,0,0,1,1,0,2
142677.0,Bultor Daryl,MB,France,28.0,197.0,2023,Poland,France,2023-06-07,False,0,3,8,11,0,0,0,0,6,1,2,9,2,2,0,4,0,0,0,0,5,0,0,5
142677.0,Bultor Daryl,MB,France,28.0,197.0,2023,China,France,2023-06-09,True,1,4,6,11,0,0,0,0,10,0,4,14,1,3,6,10,0,0,2,2,5,0,1,6
142677.0,Bultor Daryl,MB,France,28.0,197.0,2023,France,Slovenia,2023-06-10,False,0,2,6,8,0,0,2,2,6,0,3,9,0,3,0,3,0,0,2,2,1,0,0,1
142677.0,Bultor Daryl,MB,France,28.0,197.0,2023,Japan,France,2023-06-11,False,1,3,6,10,0,0,1,1,5,0,2,7,0,1,3,4,0,0,1,1,1,0,0,1
142677.0,Bultor Daryl,MB,France,28.0,197.0,2023,Argentina,France,2023-06-21,False,0,0,7,7,0,0,0,0,4,1,0,5,0,1,3,4,0,0,0,0,0,0,0,0
142677.0,Bultor Daryl,MB,France,28.0,197.0,2023,France,Cuba,2023-06-23,True,2,1,7,10,0,0,0,0,3,0,2,5,1,4,3,8,0,0,0,0,0,0,0,0
142677.0,Bultor Daryl,MB,France,28.0,197.0,2023,Canada,France,2023-06-24,True,0,3,9,12,0,0,0,0,7,1,2,10,0,2,2,4,0,0,0,0,1,1,0,2
142677.0,Bultor Daryl,MB,France,28.0,197.0,2023,Brazil,France,2023-06-25,False,0,3,5,8,0,0,0,0,7,1,1,9,1,3,3,7,0,0,0,0,0,0,2,2
142677.0,Bultor Daryl,MB,France,28.0,197.0,2023,Iran,France,2023-07-04,True,0,0,0,0,0,0,0,0,0,0,0,0,0,0,0,0,0,0,0,0,0,0,0,0
142677.0,Bultor Daryl,MB,France,28.0,197.0,2023,Serbia,France,2023-07-07,True,0,3,2,5,0,0,0,0,9,1,3,13,4,2,6,12,0,0,1,1,0,0,0,0
142677.0,Bultor Daryl,MB,France,28.0,197.0,2023,USA,France,2023-07-19,False,0,0,0,0,0,0,0,0,0,0,0,0,0,0,0,0,0,0,0,0,0,0,0,0
132948.0,Clevenot Trevor,OH,France,29.0,199.0,2023,Argentina,France,2023-06-21,False,1,0,6,7,0,0,1,1,4,1,4,9,1,0,1,2,6,1,4,11,3,1,0,4
132948.0,Clevenot Trevor,OH,France,29.0,199.0,2023,France,Cuba,2023-06-23,True,0,1,15,16,0,0,5,5,2,2,9,13,0,2,0,2,1,2,14,17,4,2,0,6
132948.0,Clevenot Trevor,OH,France,29.0,199.0,2023,Canada,France,2023-06-24,True,0,2,8,10,0,0,3,3,16,0,3,19,1,2,2,5,3,1,12,16,3,1,2,6
132948.0,Clevenot Trevor,OH,France,29.0,199.0,2023,Brazil,France,2023-06-25,False,1,3,10,14,0,0,2,2,10,4,10,24,2,8,2,12,2,1,22,25,1,3,1,5
132948.0,Clevenot Trevor,OH,France,29.0,199.0,2023,Iran,France,2023-07-04,True,0,4,9,13,0,0,1,1,7,5,11,23,0,1,0,1,2,0,11,13,5,2,1,8
132948.0,Clevenot Trevor,OH,France,29.0,199.0,2023,Serbia,France,2023-07-07,True,0,3,13,16,0,0,7,7,17,4,11,32,0,3,2,5,9,0,19,28,5,2,2,9
132948.0,Clevenot Trevor,OH,France,29.0,199.0,2023,USA,France,2023-07-19,False,0,4,6,10,0,0,1,1,6,0,20,26,1,5,6,12,2,1,24,27,5,5,1,11
120735.0,Louati Yacine,OH,France,32.0,198.0,2023,Argentina,France,2023-06-21,False,0,2,7,9,0,0,1,1,7,2,7,16,0,3,1,4,9,1,15,25,3,0,0,3
120735.0,Louati Yacine,OH,France,32.0,198.0,2023,France,Cuba,2023-06-23,True,0,0,1,1,0,0,0,0,0,0,0,0,0,0,0,0,0,0,0,0,0,0,0,0
120735.0,Louati Yacine,OH,France,32.0,198.0,2023,Canada,France,2023-06-24,True,1,1,10,12,0,0,2,2,9,1,9,19,1,3,0,4,6,3,12,21,2,2,1,5
120735.0,Louati Yacine,OH,France,32.0,198.0,2023,Brazil,France,2023-06-25,False,0,1,2,3,0,0,0,0,0,0,0,0,0,0,0,0,0,0,0,0,0,0,0,0
120735.0,Louati Yacine,OH,France,32.0,198.0,2023,Iran,France,2023-07-04,True,0,0,0,0,0,0,0,0,0,0,0,0,0,0,0,0,0,0,0,0,0,0,0,0
120735.0,Louati Yacine,OH,France,32.0,198.0,2023,Serbia,France,2023-07-07,True,1,0,15,16,0,0,2,2,3,4,7,14,1,4,3,8,7,1,14,22,2,2,0,4
120735.0,Louati Yacine,OH,France,32.0,198.0,2023,USA,France,2023-07-19,False,0,0,0,0,0,0,0,0,0,0,0,0,0,0,0,0,0,0,0,0,0,0,0,0
152506.0,Diez Benjamin,L,France,25.0,183.0,2023,Poland,France,2023-06-07,False,0,0,0,0,0,1,5,6,0,0,0,0,0,0,0,0,7,3,12,22,4,0,1,5
152506.0,Diez Benjamin,L,France,25.0,183.0,2023,China,France,2023-06-09,True,0,0,0,0,0,0,3,3,0,0,0,0,0,0,0,0,6,1,6,13,13,0,5,18
152506.0,Diez Benjamin,L,France,25.0,183.0,2023,France,Slovenia,2023-06-10,False,0,0,0,0,0,0,8,8,0,0,0,0,0,0,0,0,4,1,10,15,6,0,5,11
152506.0,Diez Benjamin,L,France,25.0,183.0,2023,Japan,France,2023-06-11,False,0,0,0,0,0,0,5,5,0,0,0,0,0,0,0,0,6,4,15,25,7,1,0,8
152506.0,Diez Benjamin,L,France,25.0,183.0,2023,Argentina,France,2023-06-21,False,0,0,0,0,0,0,0,0,0,0,0,0,0,0,0,0,0,0,0,0,0,0,0,0
152506.0,Diez Benjamin,L,France,25.0,183.0,2023,France,Cuba,2023-06-23,True,0,0,0,0,0,0,0,0,0,0,0,0,0,0,0,0,0,0,0,0,0,0,0,0
152506.0,Diez Benjamin,L,France,25.0,183.0,2023,Canada,France,2023-06-24,True,0,0,0,0,0,0,0,0,0,0,0,0,0,0,0,0,0,0,0,0,0,0,0,0
152506.0,Diez Benjamin,L,France,25.0,183.0,2023,Brazil,France,2023-06-25,False,0,0,0,0,0,0,0,0,0,0,0,0,0,0,0,0,0,0,0,0,0,0,0,0
152506.0,Diez Benjamin,L,France,25.0,183.0,2023,Iran,France,2023-07-04,True,0,0,0,0,0,0,0,0,0,0,0,0,0,0,0,0,0,0,0,0,0,0,0,0
152506.0,Diez Benjamin,L,France,25.0,183.0,2023,Serbia,France,2023-07-07,True,0,0,0,0,0,0,0,0,0,0,0,0,0,0,0,0,0,0,0,0,0,0,0,0
152506.0,Diez Benjamin,L,France,25.0,183.0,2023,USA,France,2023-07-19,False,0,0,0,0,0,0,0,0,0,0,0,0,0,0,0,0,0,0,0,0,0,0,0,0
142686.0,Carle Timothée,OH,France,28.0,195.0,2023,Poland,France,2023-06-07,False,0,4,13,17,1,0,4,5,8,4,8,20,0,3,1,4,5,3,27,35,4,0,0,4
142686.0,Carle Timothée,OH,France,28.0,195.0,2023,China,France,2023-06-09,True,2,1,7,10,0,0,2,2,14,1,10,25,2,2,1,5,13,0,16,29,11,3,2,16
142686.0,Carle Timothée,OH,France,28.0,195.0,2023,France,Slovenia,2023-06-10,False,1,3,12,16,0,0,4,4,15,8,16,39,0,1,4,5,4,0,17,21,6,0,2,8
142686.0,Carle Timothée,OH,France,28.0,195.0,2023,Japan,France,2023-06-11,False,1,5,10,16,0,0,3,3,12,4,7,23,0,1,2,3,6,2,15,23,6,2,2,10
142686.0,Carle Timothée,OH,France,28.0,195.0,2023,Argentina,France,2023-06-21,False,0,1,0,1,0,0,0,0,0,0,0,0,0,0,0,0,0,0,0,0,0,0,0,0
142686.0,Carle Timothée,OH,France,28.0,195.0,2023,France,Cuba,2023-06-23,True,0,0,0,0,0,0,0,0,2,0,2,4,0,0,0,0,0,1,0,1,0,0,0,0
142686.0,Carle Timothée,OH,France,28.0,195.0,2023,Canada,France,2023-06-24,True,0,0,0,0,0,0,0,0,0,0,0,0,0,0,0,0,0,0,0,0,0,0,0,0
142686.0,Carle Timothée,OH,France,28.0,195.0,2023,Brazil,France,2023-06-25,False,0,0,1,1,0,0,1,1,0,0,0,0,0,0,0,0,0,0,0,0,0,0,0,0
142686.0,Carle Timothée,OH,France,28.0,195.0,2023,Iran,France,2023-07-04,True,3,3,6,12,0,0,3,3,12,4,4,20,2,2,2,6,2,1,9,12,3,3,1,7
142686.0,Carle Timothée,OH,France,28.0,195.0,2023,Serbia,France,2023-07-07,True,0,1,4,5,0,0,0,0,2,0,1,3,0,0,1,1,1,1,6,8,1,2,0,3
142686.0,Carle Timothée,OH,France,28.0,195.0,2023,USA,France,2023-07-19,False,0,0,0,0,0,0,1,1,2,0,3,5,0,0,0,0,1,0,0,1,0,1,0,1
136856.0,Jouffroy Quentin,MB,France,30.0,202.0,2023,Poland,France,2023-06-07,False,0,5,9,14,0,0,0,0,3,2,0,5,1,3,7,11,2,0,1,3,2,0,1,3
136856.0,Jouffroy Quentin,MB,France,30.0,202.0,2023,China,France,2023-06-09,True,2,5,14,21,0,0,1,1,2,3,7,12,0,1,2,3,0,0,0,0,2,0,0,2
136856.0,Jouffroy Quentin,MB,France,30.0,202.0,2023,France,Slovenia,2023-06-10,False,0,7,8,15,0,0,0,0,8,1,3,12,2,4,4,10,2,0,2,4,7,0,3,10
136856.0,Jouffroy Quentin,MB,France,30.0,202.0,2023,Japan,France,2023-06-11,False,1,4,12,17,0,0,0,0,6,1,2,9,2,3,3,8,1,0,1,2,1,0,1,2
136856.0,Jouffroy Quentin,MB,France,30.0,202.0,2023,Argentina,France,2023-06-21,False,1,4,4,9,0,0,1,1,1,0,0,1,0,0,0,0,0,0,0,0,1,0,0,1
136856.0,Jouffroy Quentin,MB,France,30.0,202.0,2023,France,Cuba,2023-06-23,True,0,1,2,3,0,0,0,0,0,0,0,0,0,0,0,0,0,0,0,0,0,0,0,0
136856.0,Jouffroy Quentin,MB,France,30.0,202.0,2023,Canada,France,2023-06-24,True,0,0,2,2,0,0,0,0,0,0,0,0,0,0,0,0,0,0,0,0,0,0,0,0
136856.0,Jouffroy Quentin,MB,France,30.0,202.0,2023,Brazil,France,2023-06-25,False,0,1,1,2,0,0,0,0,0,0,0,0,0,0,0,0,0,0,0,0,0,0,0,0
136856.0,Jouffroy Quentin,MB,France,30.0,202.0,2023,Iran,France,2023-07-04,True,2,1,4,7,0,0,0,0,0,0,0,0,0,0,0,0,0,0,0,0,1,0,0,1
136856.0,Jouffroy Quentin,MB,France,30.0,202.0,2023,Serbia,France,2023-07-07,True,0,3,3,6,0,0,0,0,0,0,0,0,0,0,0,0,0,0,0,0,1,0,0,1
136856.0,Jouffroy Quentin,MB,France,30.0,202.0,2023,USA,France,2023-07-19,False,0,4,2,6,0,0,0,0,0,0,0,0,0,0,0,0,0,0,0,0,0,0,0,0
119779.0,Fromm Christian,OH,Germany,33.0,204.0,2023,Argentina,Germany,2023-07-06,False,0,1,3,4,0,0,1,1,3,1,9,13,0,1,0,1,3,0,8,11,1,0,0,1
152469.0,Tille Johannes,S,Germany,26.0,186.0,2023,Netherlands,Germany,2023-06-09,False,0,0,4,4,6,0,8,14,0,0,0,0,0,1,1,2,0,0,0,0,0,0,1,1
152469.0,Tille Johannes,S,Germany,26.0,186.0,2023,Germany,Italy,2023-06-10,False,1,0,13,14,10,1,36,47,0,1,0,1,1,4,1,6,0,0,1,1,3,5,0,8
152469.0,Tille Johannes,S,Germany,26.0,186.0,2023,Canada,Germany,2023-06-11,True,1,2,16,19,13,1,82,96,0,0,0,0,2,0,1,3,0,0,0,0,4,0,0,4
152469.0,Tille Johannes,S,Germany,26.0,186.0,2023,Iran,Germany,2023-06-20,False,0,3,10,13,14,1,52,67,0,0,0,0,1,2,0,3,0,0,1,1,1,1,1,3
152469.0,Tille Johannes,S,Germany,26.0,186.0,2023,Germany,Poland,2023-06-21,False,0,2,17,19,16,0,60,76,0,0,0,0,1,1,1,3,0,0,0,0,5,0,1,6
152469.0,Tille Johannes,S,Germany,26.0,186.0,2023,Serbia,Germany,2023-06-22,False,4,1,11,16,32,0,70,102,0,0,0,0,0,2,2,4,0,0,1,1,4,3,0,7
152469.0,Tille Johannes,S,Germany,26.0,186.0,2023,China,Germany,2023-06-24,False,1,3,11,15,25,0,52,77,0,0,1,1,1,0,1,2,0,0,0,0,2,4,0,6
152469.0,Tille Johannes,S,Germany,26.0,186.0,2023,Argentina,Germany,2023-07-06,False,0,0,3,3,1,0,7,8,0,0,0,0,0,0,0,0,0,0,0,0,4,1,0,5
119775.0,Kaliberda Denys,OH,Germany,33.0,193.0,2023,Netherlands,Germany,2023-06-09,False,0,2,1,3,0,0,1,1,1,1,0,2,0,0,0,0,1,0,2,3,2,0,0,2
119775.0,Kaliberda Denys,OH,Germany,33.0,193.0,2023,Germany,Italy,2023-06-10,False,2,3,10,15,0,0,1,1,8,4,8,20,1,2,1,4,1,2,23,26,7,5,0,12
119775.0,Kaliberda Denys,OH,Germany,33.0,193.0,2023,Canada,Germany,2023-06-11,True,0,0,0,0,0,0,0,0,0,0,0,0,0,0,0,0,0,0,0,0,0,0,0,0
119775.0,Kaliberda Denys,OH,Germany,33.0,193.0,2023,Iran,Germany,2023-06-20,False,0,0,0,0,0,0,0,0,0,0,0,0,0,0,0,0,0,0,0,0,0,0,0,0
119775.0,Kaliberda Denys,OH,Germany,33.0,193.0,2023,Germany,Poland,2023-06-21,False,0,0,0,0,0,0,1,1,0,0,0,0,0,0,0,0,0,1,9,10,4,1,1,6
119775.0,Kaliberda Denys,OH,Germany,33.0,193.0,2023,Serbia,Germany,2023-06-22,False,0,0,0,0,0,0,0,0,0,0,0,0,0,0,0,0,0,1,10,11,6,3,0,9
119775.0,Kaliberda Denys,OH,Germany,33.0,193.0,2023,China,Germany,2023-06-24,False,0,2,1,3,0,0,1,1,0,2,0,2,0,1,0,1,5,0,4,9,0,2,0,2
119775.0,Kaliberda Denys,OH,Germany,33.0,193.0,2023,Argentina,Germany,2023-07-06,False,0,0,0,0,0,0,0,0,0,0,0,0,0,0,0,0,0,0,0,0,0,0,0,0
139386.0,Reichert Moritz,OH,Germany,29.0,194.0,2023,Netherlands,Germany,2023-06-09,False,0,3,11,14,0,0,3,3,10,4,7,21,2,0,0,2,2,5,16,23,5,2,1,8
139386.0,Reichert Moritz,OH,Germany,29.0,194.0,2023,Germany,Italy,2023-06-10,False,1,3,6,10,0,0,5,5,4,5,6,15,0,1,2,3,7,0,18,25,4,3,0,7
139386.0,Reichert Moritz,OH,Germany,29.0,194.0,2023,Canada,Germany,2023-06-11,True,1,4,13,18,0,0,0,0,8,6,13,27,1,0,0,1,10,1,18,29,4,1,3,8
139386.0,Reichert Moritz,OH,Germany,29.0,194.0,2023,Iran,Germany,2023-06-20,False,0,3,5,8,0,0,0,0,10,3,9,22,1,4,2,7,5,3,18,26,2,2,0,4
139386.0,Reichert Moritz,OH,Germany,29.0,194.0,2023,Germany,Poland,2023-06-21,False,0,2,12,14,0,0,1,1,3,4,3,10,0,1,0,1,2,0,9,11,2,2,1,5
139386.0,Reichert Moritz,OH,Germany,29.0,194.0,2023,Serbia,Germany,2023-06-22,False,1,3,11,15,0,0,3,3,12,3,16,31,1,3,1,5,9,1,22,32,6,3,3,12
139386.0,Reichert Moritz,OH,Germany,29.0,194.0,2023,China,Germany,2023-06-24,False,1,2,12,15,0,0,7,7,10,3,6,19,1,2,2,5,9,1,8,18,3,5,0,8
139386.0,Reichert Moritz,OH,Germany,29.0,194.0,2023,Argentina,Germany,2023-07-06,False,0,1,4,5,0,0,1,1,4,4,3,11,1,1,0,2,3,1,9,13,0,3,0,3
182291.0,Graven Leonard,L,Germany,19.0,180.0,2023,Netherlands,Germany,2023-06-09,False,0,0,0,0,0,0,1,1,0,0,0,0,0,0,0,0,0,0,0,0,1,1,0,2
182291.0,Graven Leonard,L,Germany,19.0,180.0,2023,Germany,Italy,2023-06-10,False,0,0,0,0,0,0,1,1,0,0,0,0,0,0,0,0,0,0,0,0,2,4,0,6
182291.0,Graven Leonard,L,Germany,19.0,180.0,2023,Canada,Germany,2023-06-11,True,0,0,0,0,0,0,2,2,0,0,0,0,0,0,1,1,4,0,11,15,21,2,0,23
182291.0,Graven Leonard,L,Germany,19.0,180.0,2023,Iran,Germany,2023-06-20,False,0,0,0,0,0,0,1,1,0,0,0,0,0,0,0,0,1,3,13,17,7,4,0,11
182291.0,Graven Leonard,L,Germany,19.0,180.0,2023,Germany,Poland,2023-06-21,False,0,0,0,0,0,0,4,4,0,0,0,0,0,0,0,0,1,2,13,16,2,2,1,5
182291.0,Graven Leonard,L,Germany,19.0,180.0,2023,Serbia,Germany,2023-06-22,False,0,0,0,0,0,0,0,0,0,0,0,0,0,0,0,0,0,0,12,12,1,4,1,6
182291.0,Graven Leonard,L,Germany,19.0,180.0,2023,China,Germany,2023-06-24,False,0,0,0,0,0,0,1,1,0,0,0,0,0,0,0,0,3,1,7,11,8,8,2,18
182291.0,Graven Leonard,L,Germany,19.0,180.0,2023,Argentina,Germany,2023-07-06,False,0,0,0,0,0,0,3,3,0,0,0,0,0,0,0,0,2,2,10,14,6,5,1,12
116575.0,Kampa Lukas,S,Germany,37.0,196.0,2023,Netherlands,Germany,2023-06-09,False,0,2,8,10,6,1,54,61,0,0,0,0,0,2,4,6,0,0,0,0,4,3,0,7
116575.0,Kampa Lukas,S,Germany,37.0,196.0,2023,Germany,Italy,2023-06-10,False,1,2,4,7,6,0,28,34,1,0,0,1,0,1,1,2,0,0,0,0,4,3,0,7
116575.0,Kampa Lukas,S,Germany,37.0,196.0,2023,Canada,Germany,2023-06-11,True,0,1,1,2,3,0,17,20,0,0,0,0,0,1,0,1,0,0,0,0,0,0,0,0
116575.0,Kampa Lukas,S,Germany,37.0,196.0,2023,Argentina,Germany,2023-07-06,False,1,2,11,14,10,0,46,56,0,0,0,0,1,0,3,4,0,0,0,0,3,3,1,7
162081.0,Brehme Anton,MB,Germany,24.0,206.0,2023,Netherlands,Germany,2023-06-09,False,0,4,10,14,0,0,0,0,8,1,6,15,3,7,2,12,0,0,0,0,4,3,0,7
162081.0,Brehme Anton,MB,Germany,24.0,206.0,2023,Germany,Italy,2023-06-10,False,0,4,11,15,0,0,0,0,5,1,4,10,2,2,6,10,1,0,3,4,0,1,0,1
162081.0,Brehme Anton,MB,Germany,24.0,206.0,2023,Canada,Germany,2023-06-11,True,1,4,7,12,0,0,0,0,4,3,5,12,1,2,1,4,0,0,2,2,1,0,3,4
162081.0,Brehme Anton,MB,Germany,24.0,206.0,2023,Iran,Germany,2023-06-20,False,0,3,4,7,0,0,0,0,6,1,3,10,1,3,3,7,0,0,1,1,0,0,1,1
162081.0,Brehme Anton,MB,Germany,24.0,206.0,2023,Germany,Poland,2023-06-21,False,0,2,3,5,0,0,0,0,8,2,2,12,1,4,0,5,0,0,2,2,1,0,0,1
162081.0,Brehme Anton,MB,Germany,24.0,206.0,2023,Serbia,Germany,2023-06-22,False,1,2,13,16,0,0,1,1,13,1,2,16,1,7,4,12,1,0,1,2,2,1,0,3
162081.0,Brehme Anton,MB,Germany,24.0,206.0,2023,China,Germany,2023-06-24,False,0,3,10,13,0,0,0,0,17,0,1,18,0,5,3,8,0,1,5,6,1,0,0,1
162081.0,Brehme Anton,MB,Germany,24.0,206.0,2023,Argentina,Germany,2023-07-06,False,0,3,4,7,0,0,0,0,1,0,1,2,0,0,1,1,0,0,1,1,0,1,1,2
136441.0,Schott Ruben,OH,Germany,29.0,193.0,2023,Netherlands,Germany,2023-06-09,False,0,0,0,0,0,0,6,6,0,0,0,0,0,0,0,0,3,1,19,23,2,0,0,2
136441.0,Schott Ruben,OH,Germany,29.0,193.0,2023,Germany,Italy,2023-06-10,False,0,0,0,0,0,1,3,4,0,0,0,0,0,0,0,0,2,3,11,16,5,4,1,10
136441.0,Schott Ruben,OH,Germany,29.0,193.0,2023,Canada,Germany,2023-06-11,True,0,1,1,2,0,0,0,0,0,0,0,0,0,0,0,0,0,0,0,0,0,0,0,0
136441.0,Schott Ruben,OH,Germany,29.0,193.0,2023,Iran,Germany,2023-06-20,False,0,1,2,3,0,0,1,1,0,2,2,4,0,0,0,0,0,0,2,2,0,1,0,1
136441.0,Schott Ruben,OH,Germany,29.0,193.0,2023,Germany,Poland,2023-06-21,False,0,2,8,10,0,0,4,4,3,4,2,9,2,0,2,4,1,2,7,10,5,4,3,12
136441.0,Schott Ruben,OH,Germany,29.0,193.0,2023,Serbia,Germany,2023-06-22,False,1,3,9,13,0,0,7,7,7,3,6,16,1,1,3,5,7,1,14,22,7,4,1,12
136441.0,Schott Ruben,OH,Germany,29.0,193.0,2023,China,Germany,2023-06-24,False,1,2,5,8,0,0,2,2,5,5,12,22,0,2,1,3,12,2,11,25,1,3,1,5
136441.0,Schott Ruben,OH,Germany,29.0,193.0,2023,Argentina,Germany,2023-07-06,False,1,3,6,10,0,0,5,5,6,3,4,13,1,0,2,3,4,3,13,20,3,0,0,3
162790.0,Krage Florian,MB,Germany,27.0,203.0,2023,Netherlands,Germany,2023-06-09,False,0,0,0,0,0,0,0,0,0,0,0,0,0,0,0,0,0,0,0,0,0,0,0,0
162790.0,Krage Florian,MB,Germany,27.0,203.0,2023,Germany,Italy,2023-06-10,False,0,0,0,0,0,0,0,0,0,0,0,0,0,0,0,0,0,0,0,0,0,0,0,0
162790.0,Krage Florian,MB,Germany,27.0,203.0,2023,Canada,Germany,2023-06-11,True,0,0,1,1,0,0,0,0,2,0,0,2,0,0,0,0,0,0,0,0,0,0,0,0
162790.0,Krage Florian,MB,Germany,27.0,203.0,2023,Iran,Germany,2023-06-20,False,0,0,0,0,0,0,0,0,0,0,0,0,0,2,0,2,0,0,0,0,0,0,0,0
162790.0,Krage Florian,MB,Germany,27.0,203.0,2023,Germany,Poland,2023-06-21,False,1,1,14,16,0,0,3,3,3,2,2,7,4,6,7,17,0,0,1,1,3,0,0,3
162790.0,Krage Florian,MB,Germany,27.0,203.0,2023,Serbia,Germany,2023-06-22,False,1,0,9,10,0,0,0,0,6,1,5,12,1,5,3,9,0,1,0,1,2,1,1,4
162790.0,Krage Florian,MB,Germany,27.0,203.0,2023,China,Germany,2023-06-24,False,0,0,10,10,0,0,1,1,5,1,3,9,1,5,1,7,0,0,1,1,1,1,0,2
162790.0,Krage Florian,MB,Germany,27.0,203.0,2023,Argentina,Germany,2023-07-06,False,0,0,2,2,0,0,1,1,0,2,0,2,2,2,2,6,0,1,0,1,0,0,0,0
162082.0,Weber Linus,O,Germany,24.0,203.0,2023,Netherlands,Germany,2023-06-09,False,0,3,5,8,0,0,1,1,7,8,3,18,1,2,4,7,0,0,0,0,4,4,0,8
162082.0,Weber Linus,O,Germany,24.0,203.0,2023,Germany,Italy,2023-06-10,False,0,2,7,9,0,0,1,1,17,5,10,32,2,3,6,11,0,1,0,1,4,2,0,6
162082.0,Weber Linus,O,Germany,24.0,203.0,2023,Canada,Germany,2023-06-11,True,1,0,1,2,0,0,0,0,3,1,2,6,0,0,0,0,0,0,0,0,0,1,0,1
162082.0,Weber Linus,O,Germany,24.0,203.0,2023,Iran,Germany,2023-06-20,False,2,4,5,11,0,0,1,1,6,5,3,14,0,2,0,2,0,0,0,0,5,1,0,6
162082.0,Weber Linus,O,Germany,24.0,203.0,2023,Germany,Poland,2023-06-21,False,0,2,3,5,0,0,0,0,10,0,7,17,0,2,1,3,0,0,0,0,2,0,1,3
162082.0,Weber Linus,O,Germany,24.0,203.0,2023,Serbia,Germany,2023-06-22,False,2,8,4,14,0,0,0,0,12,8,11,31,1,3,4,8,0,0,0,0,5,1,1,7
162082.0,Weber Linus,O,Germany,24.0,203.0,2023,China,Germany,2023-06-24,False,0,0,0,0,0,0,0,0,0,0,0,0,0,0,0,0,0,0,0,0,0,0,0,0
162082.0,Weber Linus,O,Germany,24.0,203.0,2023,Argentina,Germany,2023-07-06,False,0,2,4,6,0,0,2,2,11,5,6,22,2,5,1,8,0,0,0,0,3,2,0,5
152349.0,Krick Tobias,MB,Germany,25.0,210.0,2023,Netherlands,Germany,2023-06-09,False,0,0,9,9,0,0,1,1,3,0,1,4,1,4,2,7,0,0,0,0,4,0,1,5
152349.0,Krick Tobias,MB,Germany,25.0,210.0,2023,Germany,Italy,2023-06-10,False,0,0,3,3,0,0,0,0,0,0,0,0,1,1,0,2,0,0,2,2,0,1,0,1
152349.0,Krick Tobias,MB,Germany,25.0,210.0,2023,Canada,Germany,2023-06-11,True,0,2,10,12,0,0,0,0,9,1,0,10,4,2,0,6,0,0,1,1,2,0,0,2
152349.0,Krick Tobias,MB,Germany,25.0,210.0,2023,Iran,Germany,2023-06-20,False,0,0,9,9,0,0,0,0,8,1,3,12,0,7,4,11,0,0,4,4,3,0,0,3
152349.0,Krick Tobias,MB,Germany,25.0,210.0,2023,Germany,Poland,2023-06-21,False,0,1,3,4,0,0,0,0,1,2,2,5,0,6,3,9,0,0,0,0,0,0,0,0
152349.0,Krick Tobias,MB,Germany,25.0,210.0,2023,Serbia,Germany,2023-06-22,False,0,1,4,5,0,0,0,0,4,2,1,7,1,1,0,2,0,0,0,0,0,0,0,0
152349.0,Krick Tobias,MB,Germany,25.0,210.0,2023,China,Germany,2023-06-24,False,0,0,0,0,0,0,0,0,0,0,0,0,0,0,0,0,0,0,0,0,0,0,0,0
152349.0,Krick Tobias,MB,Germany,25.0,210.0,2023,Argentina,Germany,2023-07-06,False,0,1,8,9,0,1,2,3,2,1,3,6,1,4,5,10,0,0,0,0,1,0,0,1
163592.0,Brand Tobias,OH,Germany,25.0,193.0,2023,Netherlands,Germany,2023-06-09,False,0,1,0,1,0,0,0,0,1,2,3,6,0,0,0,0,0,1,1,2,0,0,0,0
163592.0,Brand Tobias,OH,Germany,25.0,193.0,2023,Germany,Italy,2023-06-10,False,0,0,1,1,0,0,0,0,0,0,0,0,0,0,0,0,0,0,0,0,0,0,0,0
163592.0,Brand Tobias,OH,Germany,25.0,193.0,2023,Canada,Germany,2023-06-11,True,0,1,11,12,0,0,0,0,18,0,12,30,2,2,1,5,11,0,13,24,8,1,1,10
163592.0,Brand Tobias,OH,Germany,25.0,193.0,2023,Iran,Germany,2023-06-20,False,0,3,7,10,0,0,3,3,8,3,5,16,0,1,1,2,5,0,7,12,5,0,0,5
163592.0,Brand Tobias,OH,Germany,25.0,193.0,2023,Germany,Poland,2023-06-21,False,0,0,3,3,0,0,0,0,1,2,5,8,1,1,0,2,2,0,6,8,0,1,0,1
163592.0,Brand Tobias,OH,Germany,25.0,193.0,2023,Serbia,Germany,2023-06-22,False,0,0,0,0,0,0,0,0,0,0,0,0,0,0,0,0,0,0,0,0,0,0,0,0
163592.0,Brand Tobias,OH,Germany,25.0,193.0,2023,China,Germany,2023-06-24,False,0,1,3,4,0,0,0,0,2,2,1,5,0,2,0,2,4,0,6,10,1,2,0,3
163592.0,Brand Tobias,OH,Germany,25.0,193.0,2023,Argentina,Germany,2023-07-06,False,0,0,0,0,0,0,0,0,0,0,0,0,0,0,0,0,0,0,0,0,0,0,0,0
152352.0,Maase Lukas,MB,Germany,25.0,208.0,2023,Netherlands,Germany,2023-06-09,False,0,0,0,0,0,0,0,0,0,0,0,0,0,0,0,0,0,0,0,0,0,0,0,0
152352.0,Maase Lukas,MB,Germany,25.0,208.0,2023,Germany,Italy,2023-06-10,False,0,1,8,9,0,0,1,1,3,0,3,6,2,4,3,9,0,1,0,1,3,0,0,3
152352.0,Maase Lukas,MB,Germany,25.0,208.0,2023,Canada,Germany,2023-06-11,True,0,0,0,0,0,0,0,0,0,0,0,0,0,0,0,0,0,0,0,0,0,0,0,0
152352.0,Maase Lukas,MB,Germany,25.0,208.0,2023,Argentina,Germany,2023-07-06,False,0,0,0,0,0,0,0,0,0,0,0,0,0,0,0,0,0,0,0,0,0,0,0,0
184322.0,Böhme Yan,O,Germany,26.0,203.0,2023,Netherlands,Germany,2023-06-09,False,0,1,2,3,0,0,0,0,4,0,4,8,0,1,2,3,0,0,0,0,1,1,0,2
184322.0,Böhme Yan,O,Germany,26.0,203.0,2023,Germany,Italy,2023-06-10,False,0,1,0,1,0,0,0,0,2,1,0,3,1,0,0,1,0,0,0,0,0,2,0,2
184322.0,Böhme Yan,O,Germany,26.0,203.0,2023,Canada,Germany,2023-06-11,True,0,0,13,13,0,0,0,0,19,4,8,31,0,2,0,2,0,0,0,0,7,2,0,9
184322.0,Böhme Yan,O,Germany,26.0,203.0,2023,Iran,Germany,2023-06-20,False,0,0,1,1,0,0,0,0,2,1,0,3,0,0,0,0,0,0,0,0,0,0,0,0
184322.0,Böhme Yan,O,Germany,26.0,203.0,2023,Germany,Poland,2023-06-21,False,0,2,3,5,0,0,0,0,10,5,4,19,3,3,2,8,0,0,0,0,3,0,2,5
184322.0,Böhme Yan,O,Germany,26.0,203.0,2023,Serbia,Germany,2023-06-22,False,0,1,0,1,0,0,1,1,1,1,3,5,0,1,0,1,0,0,0,0,0,0,0,0
184322.0,Böhme Yan,O,Germany,26.0,203.0,2023,China,Germany,2023-06-24,False,0,1,0,1,0,0,1,1,0,0,2,2,0,1,0,1,0,0,0,0,0,0,0,0
184322.0,Böhme Yan,O,Germany,26.0,203.0,2023,Argentina,Germany,2023-07-06,False,0,0,0,0,0,0,1,1,1,0,4,5,0,1,1,2,0,0,0,0,1,0,0,1
163173.0,Jelveh Ghaziani Mahdi,MB,Iran,22.0,208.0,2023,Japan,Iran,2023-06-06,False,0,0,0,0,0,0,0,0,0,0,0,0,0,0,0,0,0,0,0,0,0,0,0,0
163173.0,Jelveh Ghaziani Mahdi,MB,Iran,22.0,208.0,2023,Poland,Iran,2023-06-08,False,0,0,0,0,0,0,0,0,0,0,0,0,0,0,0,0,0,0,0,0,0,0,0,0
163173.0,Jelveh Ghaziani Mahdi,MB,Iran,22.0,208.0,2023,Iran,China,2023-06-10,True,0,0,0,0,0,0,0,0,0,0,0,0,0,0,0,0,0,0,0,0,0,0,0,0
163173.0,Jelveh Ghaziani Mahdi,MB,Iran,22.0,208.0,2023,Slovenia,Iran,2023-06-11,False,0,0,0,0,0,0,0,0,0,0,0,0,0,0,0,0,0,0,0,0,0,0,0,0
163173.0,Jelveh Ghaziani Mahdi,MB,Iran,22.0,208.0,2023,Iran,Germany,2023-06-20,True,0,0,0,0,0,0,0,0,0,0,0,0,0,0,0,0,0,0,0,0,0,0,0,0
163173.0,Jelveh Ghaziani Mahdi,MB,Iran,22.0,208.0,2023,Iran,Italy,2023-06-21,False,0,0,0,0,0,0,0,0,0,0,0,0,0,0,0,0,0,0,0,0,0,0,0,0
163173.0,Jelveh Ghaziani Mahdi,MB,Iran,22.0,208.0,2023,Iran,USA,2023-06-23,False,0,0,0,0,0,0,0,0,0,0,0,0,0,0,0,0,0,0,0,0,0,0,0,0
163173.0,Jelveh Ghaziani Mahdi,MB,Iran,22.0,208.0,2023,Netherlands,Iran,2023-06-24,False,0,0,0,0,0,0,0,0,0,0,0,0,0,1,0,1,0,0,0,0,0,0,0,0
163173.0,Jelveh Ghaziani Mahdi,MB,Iran,22.0,208.0,2023,Iran,France,2023-07-04,False,0,0,14,14,0,0,0,0,6,0,4,10,0,1,1,2,0,0,0,0,0,1,0,1
163173.0,Jelveh Ghaziani Mahdi,MB,Iran,22.0,208.0,2023,Cuba,Iran,2023-07-09,False,0,0,0,0,0,0,0,0,0,0,0,0,0,0,0,0,0,0,0,0,1,0,0,1
118827.0,Mousavi Eraghi Seyed Mohammad,MB,Iran,36.0,203.0,2023,Japan,Iran,2023-06-06,False,0,3,5,8,0,0,2,2,4,1,4,9,4,4,4,12,2,0,2,4,3,0,0,3
118827.0,Mousavi Eraghi Seyed Mohammad,MB,Iran,36.0,203.0,2023,Poland,Iran,2023-06-08,False,1,5,10,16,0,0,1,1,4,2,6,12,4,5,3,12,0,0,0,0,0,0,0,0
118827.0,Mousavi Eraghi Seyed Mohammad,MB,Iran,36.0,203.0,2023,Iran,China,2023-06-10,True,0,2,15,17,0,0,6,6,5,2,3,10,1,3,1,5,0,0,0,0,4,0,0,4
118827.0,Mousavi Eraghi Seyed Mohammad,MB,Iran,36.0,203.0,2023,Slovenia,Iran,2023-06-11,False,0,3,4,7,0,0,0,0,1,1,2,4,0,3,2,5,2,0,1,3,4,0,0,4
118827.0,Mousavi Eraghi Seyed Mohammad,MB,Iran,36.0,203.0,2023,Iran,Germany,2023-06-20,True,1,3,6,10,0,0,1,1,4,0,1,5,4,3,1,8,1,0,0,1,0,0,0,0
118827.0,Mousavi Eraghi Seyed Mohammad,MB,Iran,36.0,203.0,2023,Iran,Italy,2023-06-21,False,0,2,6,8,0,0,1,1,4,1,0,5,1,2,2,5,0,0,2,2,2,0,1,3
118827.0,Mousavi Eraghi Seyed Mohammad,MB,Iran,36.0,203.0,2023,Iran,USA,2023-06-23,False,0,3,7,10,0,0,6,6,6,2,1,9,2,4,2,8,0,0,2,2,2,0,0,2
118827.0,Mousavi Eraghi Seyed Mohammad,MB,Iran,36.0,203.0,2023,Netherlands,Iran,2023-06-24,False,1,1,18,20,0,1,0,1,5,3,2,10,5,8,4,17,0,0,1,1,1,2,1,4
118827.0,Mousavi Eraghi Seyed Mohammad,MB,Iran,36.0,203.0,2023,Iran,France,2023-07-04,False,0,5,3,8,0,0,1,1,3,1,3,7,4,6,5,15,0,1,2,3,1,0,0,1
118827.0,Mousavi Eraghi Seyed Mohammad,MB,Iran,36.0,203.0,2023,Cuba,Iran,2023-07-09,False,0,4,9,13,0,0,2,2,11,3,4,18,3,9,4,16,0,0,1,1,2,2,1,5
163176.0,Hazratpourtalatappeh Mohammadreza,L,Iran,24.0,187.0,2023,Japan,Iran,2023-06-06,False,0,0,0,0,0,0,10,10,0,0,0,0,0,0,0,0,6,2,5,13,3,0,1,4
163176.0,Hazratpourtalatappeh Mohammadreza,L,Iran,24.0,187.0,2023,Poland,Iran,2023-06-08,False,0,0,0,0,0,0,7,7,0,0,0,0,0,0,0,0,9,1,15,25,10,0,2,12
163176.0,Hazratpourtalatappeh Mohammadreza,L,Iran,24.0,187.0,2023,Iran,China,2023-06-10,True,0,0,0,0,0,0,7,7,0,0,0,0,0,0,0,0,8,1,9,18,10,0,1,11
163176.0,Hazratpourtalatappeh Mohammadreza,L,Iran,24.0,187.0,2023,Slovenia,Iran,2023-06-11,False,0,0,0,0,0,0,7,7,0,0,0,0,0,0,0,0,2,2,10,14,8,1,1,10
163176.0,Hazratpourtalatappeh Mohammadreza,L,Iran,24.0,187.0,2023,Iran,Germany,2023-06-20,True,0,0,0,0,0,0,3,3,0,0,0,0,0,0,0,0,1,2,11,14,1,4,2,7
163176.0,Hazratpourtalatappeh Mohammadreza,L,Iran,24.0,187.0,2023,Iran,Italy,2023-06-21,False,0,0,0,0,0,0,5,5,0,0,0,0,0,0,0,0,1,2,9,12,8,2,0,10
163176.0,Hazratpourtalatappeh Mohammadreza,L,Iran,24.0,187.0,2023,Iran,USA,2023-06-23,False,0,0,0,0,0,0,3,3,0,0,0,0,0,0,0,0,3,1,7,11,4,1,0,5
163176.0,Hazratpourtalatappeh Mohammadreza,L,Iran,24.0,187.0,2023,Netherlands,Iran,2023-06-24,False,0,0,0,0,0,0,5,5,0,0,0,0,0,0,0,0,3,3,13,19,12,2,0,14
163176.0,Hazratpourtalatappeh Mohammadreza,L,Iran,24.0,187.0,2023,Iran,France,2023-07-04,False,0,0,0,0,0,0,2,2,0,0,0,0,0,0,0,0,2,2,10,14,7,1,0,8
163176.0,Hazratpourtalatappeh Mohammadreza,L,Iran,24.0,187.0,2023,Cuba,Iran,2023-07-09,False,0,0,0,0,0,0,0,0,0,0,0,0,0,0,0,0,0,0,0,0,0,0,0,0
153535.0,Moazzen Mohammadreza,L,Iran,32.0,175.0,2023,Iran,France,2023-07-04,False,0,0,0,0,0,0,3,3,0,0,0,0,0,0,0,0,0,0,0,0,0,0,0,0
153535.0,Moazzen Mohammadreza,L,Iran,32.0,175.0,2023,Cuba,Iran,2023-07-09,False,0,0,0,0,0,0,9,9,0,0,0,0,0,0,0,0,4,1,13,18,6,4,1,11
152752.0,Esfandiar Amirhossein,OH,Iran,25.0,209.0,2023,Japan,Iran,2023-06-06,False,0,0,1,1,0,0,0,0,1,2,2,5,0,0,1,1,1,0,4,5,3,0,0,3
152752.0,Esfandiar Amirhossein,OH,Iran,25.0,209.0,2023,Poland,Iran,2023-06-08,False,0,0,0,0,0,0,0,0,0,0,0,0,0,0,0,0,0,0,0,0,0,0,0,0
152752.0,Esfandiar Amirhossein,OH,Iran,25.0,209.0,2023,Iran,China,2023-06-10,True,0,1,0,1,0,0,0,0,0,0,0,0,0,0,0,0,0,0,0,0,0,0,0,0
152752.0,Esfandiar Amirhossein,OH,Iran,25.0,209.0,2023,Slovenia,Iran,2023-06-11,False,0,2,3,5,0,0,1,1,5,4,6,15,1,1,1,3,6,1,6,13,6,1,0,7
152752.0,Esfandiar Amirhossein,OH,Iran,25.0,209.0,2023,Iran,Germany,2023-06-20,True,0,0,0,0,0,0,0,0,0,0,0,0,0,0,0,0,0,0,0,0,0,0,0,0
152752.0,Esfandiar Amirhossein,OH,Iran,25.0,209.0,2023,Iran,Italy,2023-06-21,False,0,1,2,3,0,0,1,1,4,0,3,7,0,1,2,3,2,0,8,10,0,0,0,0
152752.0,Esfandiar Amirhossein,OH,Iran,25.0,209.0,2023,Iran,USA,2023-06-23,False,1,0,4,5,0,0,1,1,2,0,0,2,0,0,0,0,2,3,10,15,0,1,0,1
152752.0,Esfandiar Amirhossein,OH,Iran,25.0,209.0,2023,Netherlands,Iran,2023-06-24,False,1,4,10,15,0,0,2,2,4,6,7,17,1,3,1,5,9,2,24,35,3,3,1,7
152752.0,Esfandiar Amirhossein,OH,Iran,25.0,209.0,2023,Iran,France,2023-07-04,False,1,3,6,10,0,0,1,1,5,1,4,10,1,2,0,3,9,1,21,31,3,1,0,4
152752.0,Esfandiar Amirhossein,OH,Iran,25.0,209.0,2023,Cuba,Iran,2023-07-09,False,3,4,19,26,0,0,1,1,12,10,12,34,1,3,1,5,5,5,16,26,4,3,0,7
152753.0,Ramezani Ali,S,Iran,25.0,200.0,2023,Iran,France,2023-07-04,False,0,0,2,2,1,0,8,9,0,0,0,0,0,1,0,1,0,0,0,0,0,1,0,1
152753.0,Ramezani Ali,S,Iran,25.0,200.0,2023,Cuba,Iran,2023-07-09,False,0,2,14,16,31,0,70,101,1,0,1,2,0,2,2,4,0,0,0,0,2,3,0,5
182470.0,Hossein Khanzadeh Firouzjah Poriya,OH,Iran,19.0,198.0,2023,Japan,Iran,2023-06-06,False,0,2,1,3,0,0,0,0,1,2,4,7,0,0,0,0,2,1,7,10,1,0,2,3
182470.0,Hossein Khanzadeh Firouzjah Poriya,OH,Iran,19.0,198.0,2023,Poland,Iran,2023-06-08,False,1,3,18,22,0,0,2,2,12,4,9,25,2,0,2,4,7,4,31,42,5,0,0,5
182470.0,Hossein Khanzadeh Firouzjah Poriya,OH,Iran,19.0,198.0,2023,Iran,China,2023-06-10,True,1,0,14,15,0,0,2,2,14,2,2,18,1,1,3,5,3,1,16,20,3,0,0,3
182470.0,Hossein Khanzadeh Firouzjah Poriya,OH,Iran,19.0,198.0,2023,Slovenia,Iran,2023-06-11,False,0,1,4,5,0,0,0,0,3,0,3,6,0,0,0,0,3,4,2,9,1,0,2,3
182470.0,Hossein Khanzadeh Firouzjah Poriya,OH,Iran,19.0,198.0,2023,Iran,Germany,2023-06-20,True,1,2,9,12,0,0,2,2,6,2,4,12,1,1,1,3,0,0,14,14,7,2,0,9
182470.0,Hossein Khanzadeh Firouzjah Poriya,OH,Iran,19.0,198.0,2023,Iran,Italy,2023-06-21,False,0,0,5,5,0,0,1,1,3,2,3,8,0,0,1,1,3,1,5,9,2,2,1,5
182470.0,Hossein Khanzadeh Firouzjah Poriya,OH,Iran,19.0,198.0,2023,Iran,USA,2023-06-23,False,0,3,6,9,0,0,4,4,9,5,3,17,0,0,1,1,1,4,11,16,5,2,0,7
182470.0,Hossein Khanzadeh Firouzjah Poriya,OH,Iran,19.0,198.0,2023,Netherlands,Iran,2023-06-24,False,1,1,7,9,0,0,1,1,4,3,6,13,0,1,0,1,3,4,9,16,3,1,0,4
182470.0,Hossein Khanzadeh Firouzjah Poriya,OH,Iran,19.0,198.0,2023,Iran,France,2023-07-04,False,0,0,1,1,0,0,0,0,0,0,0,0,0,0,0,0,0,0,1,1,0,1,0,1
123413.0,Homayonfarmanesh Shahrooz,OH,Iran,34.0,192.0,2023,Japan,Iran,2023-06-06,False,0,0,3,3,0,0,1,1,0,0,0,0,0,0,1,1,1,0,4,5,1,0,0,1
123413.0,Homayonfarmanesh Shahrooz,OH,Iran,34.0,192.0,2023,Poland,Iran,2023-06-08,False,0,0,1,1,0,0,0,0,0,0,2,2,0,0,0,0,3,0,2,5,0,0,0,0
123413.0,Homayonfarmanesh Shahrooz,OH,Iran,34.0,192.0,2023,Iran,China,2023-06-10,True,0,0,0,0,0,0,0,0,2,0,0,2,0,0,1,1,2,1,6,9,1,0,1,2
123413.0,Homayonfarmanesh Shahrooz,OH,Iran,34.0,192.0,2023,Slovenia,Iran,2023-06-11,False,0,0,1,1,0,0,0,0,0,0,0,0,0,0,0,0,0,0,0,0,0,0,0,0
123413.0,Homayonfarmanesh Shahrooz,OH,Iran,34.0,192.0,2023,Iran,Germany,2023-06-20,True,0,1,5,6,0,0,2,2,1,0,0,1,0,0,0,0,1,0,0,1,0,0,0,0
123413.0,Homayonfarmanesh Shahrooz,OH,Iran,34.0,192.0,2023,Iran,Italy,2023-06-21,False,0,1,3,4,0,0,0,0,0,1,1,2,0,0,0,0,0,0,3,3,2,0,0,2
123413.0,Homayonfarmanesh Shahrooz,OH,Iran,34.0,192.0,2023,Iran,USA,2023-06-23,False,0,1,1,2,0,0,0,0,1,1,1,3,0,0,0,0,0,1,1,2,1,0,0,1
123413.0,Homayonfarmanesh Shahrooz,OH,Iran,34.0,192.0,2023,Netherlands,Iran,2023-06-24,False,0,0,1,1,0,0,0,0,0,0,0,0,0,0,0,0,0,0,4,4,0,0,1,1
123413.0,Homayonfarmanesh Shahrooz,OH,Iran,34.0,192.0,2023,Iran,France,2023-07-04,False,0,0,0,0,0,0,0,0,0,0,0,0,0,0,0,0,0,0,0,0,0,0,0,0
123413.0,Homayonfarmanesh Shahrooz,OH,Iran,34.0,192.0,2023,Cuba,Iran,2023-07-09,False,0,2,17,19,0,0,2,2,10,1,3,14,0,0,1,1,14,1,29,44,5,4,0,9
189602.0,Afshin Far Armin,OH,Iran,25.0,207.0,2023,Iran,France,2023-07-04,False,0,0,0,0,0,0,0,0,0,0,0,0,0,0,0,0,0,0,0,0,0,0,0,0
189602.0,Afshin Far Armin,OH,Iran,25.0,207.0,2023,Cuba,Iran,2023-07-09,False,0,0,0,0,0,0,0,0,0,0,0,0,0,0,0,0,0,0,0,0,0,0,0,0
168551.0,Saadat Bardia,O,Iran,21.0,205.0,2023,Iran,France,2023-07-04,False,0,2,3,5,0,0,0,0,4,2,4,10,0,0,3,3,0,0,0,0,0,3,1,4
168551.0,Saadat Bardia,O,Iran,21.0,205.0,2023,Cuba,Iran,2023-07-09,False,0,3,17,20,0,0,1,1,14,6,11,31,3,5,3,11,0,0,0,0,5,5,1,11
152755.0,Karimisouchelmaei Javad,S,Iran,26.0,204.0,2023,Japan,Iran,2023-06-06,False,1,2,4,7,1,0,40,41,0,0,1,1,0,0,1,1,0,0,1,1,2,0,0,2
152755.0,Karimisouchelmaei Javad,S,Iran,26.0,204.0,2023,Poland,Iran,2023-06-08,False,0,3,8,11,15,1,66,82,1,0,3,4,0,0,1,1,0,0,1,1,1,0,0,1
152755.0,Karimisouchelmaei Javad,S,Iran,26.0,204.0,2023,Iran,China,2023-06-10,True,1,3,9,13,13,1,58,72,4,0,1,5,1,4,2,7,0,0,1,1,5,0,1,6
152755.0,Karimisouchelmaei Javad,S,Iran,26.0,204.0,2023,Slovenia,Iran,2023-06-11,False,0,1,2,3,2,1,19,22,1,0,0,1,2,0,0,2,0,0,0,0,0,0,0,0
152755.0,Karimisouchelmaei Javad,S,Iran,26.0,204.0,2023,Iran,Germany,2023-06-20,True,0,0,0,0,0,0,2,2,0,0,0,0,0,0,0,0,0,0,0,0,0,1,0,1
152755.0,Karimisouchelmaei Javad,S,Iran,26.0,204.0,2023,Iran,Italy,2023-06-21,False,0,0,0,0,1,0,6,7,1,0,0,1,0,1,0,1,0,0,0,0,1,0,0,1
152755.0,Karimisouchelmaei Javad,S,Iran,26.0,204.0,2023,Iran,USA,2023-06-23,False,0,0,0,0,0,0,0,0,0,0,0,0,0,0,0,0,0,0,0,0,0,0,0,0
152755.0,Karimisouchelmaei Javad,S,Iran,26.0,204.0,2023,Netherlands,Iran,2023-06-24,False,0,0,0,0,4,0,2,6,0,0,0,0,0,0,0,0,0,0,0,0,0,0,0,0
152755.0,Karimisouchelmaei Javad,S,Iran,26.0,204.0,2023,Iran,France,2023-07-04,False,0,2,4,6,18,0,34,52,2,0,1,3,0,1,1,2,0,0,0,0,3,8,2,13
152755.0,Karimisouchelmaei Javad,S,Iran,26.0,204.0,2023,Cuba,Iran,2023-07-09,False,0,0,0,0,0,0,0,0,0,0,0,0,0,0,0,0,0,0,0,0,0,0,0,0
174373.0,Valizadeh Mohammad,MB,Iran,22.0,204.0,2023,Japan,Iran,2023-06-06,False,1,0,9,10,0,0,0,0,3,1,2,6,0,2,2,4,1,0,0,1,1,0,1,2
174373.0,Valizadeh Mohammad,MB,Iran,22.0,204.0,2023,Poland,Iran,2023-06-08,False,0,2,15,17,0,0,0,0,7,1,1,9,1,4,3,8,0,0,1,1,4,0,4,8
174373.0,Valizadeh Mohammad,MB,Iran,22.0,204.0,2023,Iran,China,2023-06-10,True,1,1,14,16,0,0,1,1,2,2,3,7,6,5,2,13,0,0,1,1,4,0,1,5
174373.0,Valizadeh Mohammad,MB,Iran,22.0,204.0,2023,Slovenia,Iran,2023-06-11,False,0,0,14,14,0,0,1,1,3,1,2,6,0,2,2,4,0,0,0,0,3,0,1,4
174373.0,Valizadeh Mohammad,MB,Iran,22.0,204.0,2023,Iran,Germany,2023-06-20,True,1,1,11,13,0,0,1,1,1,0,5,6,4,3,4,11,0,0,2,2,1,0,1,2
174373.0,Valizadeh Mohammad,MB,Iran,22.0,204.0,2023,Iran,Italy,2023-06-21,False,0,1,10,11,0,0,0,0,6,2,3,11,0,4,7,11,1,0,0,1,3,2,1,6
174373.0,Valizadeh Mohammad,MB,Iran,22.0,204.0,2023,Iran,USA,2023-06-23,False,0,0,14,14,0,0,0,0,3,0,2,5,1,0,2,3,0,0,1,1,1,1,1,3
174373.0,Valizadeh Mohammad,MB,Iran,22.0,204.0,2023,Netherlands,Iran,2023-06-24,False,1,1,13,15,0,0,0,0,9,1,2,12,1,4,4,9,0,0,0,0,3,0,2,5
174373.0,Valizadeh Mohammad,MB,Iran,22.0,204.0,2023,Iran,France,2023-07-04,False,0,0,0,0,0,0,0,0,0,0,0,0,0,0,0,0,0,0,0,0,0,0,0,0
174373.0,Valizadeh Mohammad,MB,Iran,22.0,204.0,2023,Cuba,Iran,2023-07-09,False,0,0,19,19,0,0,1,1,9,0,4,13,3,5,1,9,0,0,0,0,2,1,1,4
152742.0,Sharifi Morteza,OH,Iran,24.0,193.0,2023,Japan,Iran,2023-06-06,False,0,3,6,9,0,0,2,2,3,1,6,10,1,3,0,4,1,0,9,10,2,0,0,2
152742.0,Sharifi Morteza,OH,Iran,24.0,193.0,2023,Poland,Iran,2023-06-08,False,0,2,3,5,0,1,0,1,6,0,3,9,1,0,0,1,0,0,5,5,2,0,0,2
152742.0,Sharifi Morteza,OH,Iran,24.0,193.0,2023,Iran,China,2023-06-10,True,0,1,7,8,0,0,0,0,12,0,10,22,0,2,0,2,2,0,6,8,5,0,0,5
152742.0,Sharifi Morteza,OH,Iran,24.0,193.0,2023,Slovenia,Iran,2023-06-11,False,1,1,10,12,0,0,0,0,6,3,7,16,0,4,4,8,3,2,11,16,4,0,2,6
152742.0,Sharifi Morteza,OH,Iran,24.0,193.0,2023,Iran,Germany,2023-06-20,True,1,2,8,11,0,0,1,1,10,0,4,14,0,1,3,4,2,0,13,15,4,2,1,7
152742.0,Sharifi Morteza,OH,Iran,24.0,193.0,2023,Iran,Italy,2023-06-21,False,1,2,9,12,0,0,1,1,7,4,8,19,0,1,0,1,2,3,10,15,3,3,4,10
152742.0,Sharifi Morteza,OH,Iran,24.0,193.0,2023,Iran,USA,2023-06-23,False,0,0,6,6,0,0,0,0,4,2,3,9,1,2,1,4,2,3,7,12,2,0,0,2
152742.0,Sharifi Morteza,OH,Iran,24.0,193.0,2023,Netherlands,Iran,2023-06-24,False,0,0,1,1,0,0,1,1,4,3,2,9,0,1,0,1,2,0,5,7,0,0,0,0
152742.0,Sharifi Morteza,OH,Iran,24.0,193.0,2023,Iran,France,2023-07-04,False,0,2,9,11,0,0,0,0,8,4,5,17,0,0,1,1,0,2,7,9,3,1,1,5
163174.0,Daneshdoust Ehsan,OH,Iran,24.0,192.0,2023,Cuba,Iran,2023-07-09,False,0,0,0,0,0,0,0,0,0,0,0,0,0,0,0,0,0,0,0,0,0,0,0,0
171191.0,Michieletto Alessandro,OH,Italy,22.0,205.0,2023,Iran,Italy,2023-06-21,True,1,2,5,8,0,0,3,3,12,0,10,22,2,3,1,6,3,0,5,8,4,2,0,6
171191.0,Michieletto Alessandro,OH,Italy,22.0,205.0,2023,China,Italy,2023-06-22,True,1,0,12,13,0,0,2,2,2,1,1,4,3,0,0,3,1,0,7,8,1,0,0,1
171191.0,Michieletto Alessandro,OH,Italy,22.0,205.0,2023,Serbia,Italy,2023-06-23,True,0,0,11,11,0,0,6,6,8,2,3,13,1,0,4,5,4,1,10,15,3,2,0,5
171191.0,Michieletto Alessandro,OH,Italy,22.0,205.0,2023,Italy,Poland,2023-06-25,False,0,3,10,13,0,0,9,9,11,6,12,29,3,3,2,8,3,3,19,25,8,2,0,10
171191.0,Michieletto Alessandro,OH,Italy,22.0,205.0,2023,Brazil,Italy,2023-07-04,True,3,3,12,18,0,0,8,8,14,2,10,26,0,5,2,7,3,0,23,26,8,4,0,12
171191.0,Michieletto Alessandro,OH,Italy,22.0,205.0,2023,Canada,Italy,2023-07-06,True,1,3,15,19,0,0,10,10,14,1,13,28,3,2,2,7,4,2,16,22,8,2,0,10
171191.0,Michieletto Alessandro,OH,Italy,22.0,205.0,2023,Slovenia,Italy,2023-07-07,True,1,1,8,10,0,0,3,3,9,1,9,19,2,1,2,5,0,0,9,9,2,3,0,5
171191.0,Michieletto Alessandro,OH,Italy,22.0,205.0,2023,Japan,Italy,2023-07-08,True,1,2,12,15,0,0,3,3,12,4,6,22,1,0,2,3,7,2,16,25,2,3,1,6
171191.0,Michieletto Alessandro,OH,Italy,22.0,205.0,2023,Italy,Argentina,2023-07-19,True,1,1,14,16,0,0,2,2,13,2,4,19,1,1,0,2,1,0,9,10,7,1,0,8
171191.0,Michieletto Alessandro,OH,Italy,22.0,205.0,2023,USA,Italy,2023-07-22,False,0,1,8,9,0,0,5,5,9,2,13,24,0,0,2,2,1,1,24,26,5,2,1,8
171191.0,Michieletto Alessandro,OH,Italy,22.0,205.0,2023,Japan,Italy,2023-07-23,False,4,3,13,20,0,0,8,8,11,4,9,24,1,2,4,7,4,1,27,32,12,3,1,16
144005.0,Giannelli Simone,S,Italy,27.0,200.0,2023,Iran,Italy,2023-06-21,True,1,3,9,13,20,0,49,69,1,1,1,3,4,3,3,10,0,0,1,1,7,0,2,9
144005.0,Giannelli Simone,S,Italy,27.0,200.0,2023,China,Italy,2023-06-22,True,1,1,15,17,16,0,33,49,2,0,0,2,0,2,1,3,0,0,0,0,2,1,1,4
144005.0,Giannelli Simone,S,Italy,27.0,200.0,2023,Serbia,Italy,2023-06-23,True,0,0,13,13,22,0,30,52,3,1,0,4,1,3,1,5,0,0,0,0,8,2,0,10
144005.0,Giannelli Simone,S,Italy,27.0,200.0,2023,Italy,Poland,2023-06-25,False,1,3,14,18,29,1,64,94,2,0,3,5,2,5,7,14,0,0,2,2,5,1,1,7
144005.0,Giannelli Simone,S,Italy,27.0,200.0,2023,Brazil,Italy,2023-07-04,True,1,2,16,19,16,0,60,76,1,0,0,1,2,3,5,10,0,0,1,1,6,3,2,11
144005.0,Giannelli Simone,S,Italy,27.0,200.0,2023,Canada,Italy,2023-07-06,True,2,1,16,19,33,0,67,100,4,0,4,8,1,3,2,6,0,0,0,0,14,2,1,17
144005.0,Giannelli Simone,S,Italy,27.0,200.0,2023,Slovenia,Italy,2023-07-07,True,0,1,13,14,27,0,43,70,3,0,3,6,0,3,1,4,0,0,0,0,10,1,0,11
144005.0,Giannelli Simone,S,Italy,27.0,200.0,2023,Japan,Italy,2023-07-08,True,0,1,15,16,39,0,62,101,1,3,2,6,2,3,8,13,0,0,1,1,3,3,1,7
144005.0,Giannelli Simone,S,Italy,27.0,200.0,2023,Italy,Argentina,2023-07-19,True,0,1,11,12,18,0,43,61,2,0,1,3,2,0,4,6,0,0,0,0,4,1,0,5
144005.0,Giannelli Simone,S,Italy,27.0,200.0,2023,USA,Italy,2023-07-22,False,0,1,10,11,23,0,46,69,2,0,1,3,0,1,1,2,0,0,0,0,8,4,0,12
144005.0,Giannelli Simone,S,Italy,27.0,200.0,2023,Japan,Italy,2023-07-23,False,2,3,12,17,34,1,62,97,6,1,0,7,0,3,4,7,0,0,2,2,6,1,0,7
150436.0,Balaso Fabio,L,Italy,28.0,178.0,2023,Italy,Argentina,2023-06-06,False,0,0,0,0,0,0,12,12,0,0,0,0,0,0,0,0,3,0,9,12,10,1,3,14
150436.0,Balaso Fabio,L,Italy,28.0,178.0,2023,Italy,USA,2023-06-08,False,0,0,0,0,0,0,8,8,0,0,0,0,0,0,0,0,4,1,11,16,12,2,3,17
150436.0,Balaso Fabio,L,Italy,28.0,178.0,2023,Italy,Cuba,2023-06-09,True,0,0,0,0,0,0,7,7,0,0,0,0,0,0,0,0,5,0,14,19,14,1,1,16
150436.0,Balaso Fabio,L,Italy,28.0,178.0,2023,Germany,Italy,2023-06-10,True,0,0,0,0,0,0,11,11,0,0,0,0,0,0,0,0,8,2,17,27,11,4,0,15
150436.0,Balaso Fabio,L,Italy,28.0,178.0,2023,Italy,Argentina,2023-07-19,True,0,0,0,0,0,0,3,3,0,0,0,0,0,0,0,0,3,0,9,12,7,4,0,11
150436.0,Balaso Fabio,L,Italy,28.0,178.0,2023,USA,Italy,2023-07-22,False,0,0,0,0,0,1,6,7,0,0,0,0,0,0,0,0,5,1,14,20,5,3,0,8
150436.0,Balaso Fabio,L,Italy,28.0,178.0,2023,Japan,Italy,2023-07-23,False,0,0,0,0,0,0,6,6,0,0,0,0,0,0,0,0,7,2,12,21,11,3,0,14
152370.0,Sbertoli Riccardo,S,Italy,25.0,188.0,2023,Iran,Italy,2023-06-21,True,0,0,1,1,0,0,0,0,0,0,0,0,0,0,0,0,0,0,0,0,0,0,0,0
152370.0,Sbertoli Riccardo,S,Italy,25.0,188.0,2023,China,Italy,2023-06-22,True,0,1,0,1,2,0,4,6,0,0,0,0,0,1,0,1,0,0,0,0,0,0,0,0
152370.0,Sbertoli Riccardo,S,Italy,25.0,188.0,2023,Serbia,Italy,2023-06-23,True,0,0,1,1,0,0,0,0,0,0,0,0,0,0,0,0,0,0,0,0,0,0,0,0
152370.0,Sbertoli Riccardo,S,Italy,25.0,188.0,2023,Italy,Poland,2023-06-25,False,0,0,1,1,0,0,2,2,0,0,0,0,1,0,0,1,0,0,0,0,0,0,0,0
152370.0,Sbertoli Riccardo,S,Italy,25.0,188.0,2023,Brazil,Italy,2023-07-04,True,0,0,0,0,0,0,0,0,0,0,0,0,0,0,0,0,0,0,0,0,0,0,0,0
152370.0,Sbertoli Riccardo,S,Italy,25.0,188.0,2023,Canada,Italy,2023-07-06,True,0,1,3,4,0,0,0,0,0,0,0,0,0,0,0,0,0,0,0,0,0,1,0,1
152370.0,Sbertoli Riccardo,S,Italy,25.0,188.0,2023,Slovenia,Italy,2023-07-07,True,0,0,0,0,0,0,0,0,0,0,0,0,0,0,0,0,0,0,0,0,0,0,0,0
152370.0,Sbertoli Riccardo,S,Italy,25.0,188.0,2023,Japan,Italy,2023-07-08,True,0,1,2,3,0,0,1,1,0,0,0,0,0,0,0,0,0,0,0,0,0,0,0,0
152370.0,Sbertoli Riccardo,S,Italy,25.0,188.0,2023,Italy,Argentina,2023-07-19,True,0,0,0,0,0,0,0,0,0,0,0,0,0,0,0,0,0,0,0,0,0,0,0,0
152370.0,Sbertoli Riccardo,S,Italy,25.0,188.0,2023,USA,Italy,2023-07-22,False,0,1,0,1,2,0,1,3,0,0,0,0,0,0,0,0,0,0,0,0,0,0,0,0
152370.0,Sbertoli Riccardo,S,Italy,25.0,188.0,2023,Japan,Italy,2023-07-23,False,0,0,0,0,0,0,0,0,0,0,0,0,0,0,0,0,0,0,0,0,0,0,0,0
181128.0,Scanferla Leonardo,L,Italy,25.0,184.0,2023,Iran,Italy,2023-06-21,True,0,0,0,0,0,0,5,5,0,0,0,0,0,0,0,0,11,0,12,23,14,4,3,21
181128.0,Scanferla Leonardo,L,Italy,25.0,184.0,2023,China,Italy,2023-06-22,True,0,0,0,0,0,0,2,2,0,0,0,0,0,0,0,0,2,0,7,9,2,1,0,3
181128.0,Scanferla Leonardo,L,Italy,25.0,184.0,2023,Serbia,Italy,2023-06-23,True,0,0,0,0,0,0,3,3,0,0,0,0,0,0,0,0,2,0,5,7,4,1,1,6
181128.0,Scanferla Leonardo,L,Italy,25.0,184.0,2023,Italy,Poland,2023-06-25,False,0,0,0,0,0,0,6,6,0,0,0,0,0,0,0,0,6,1,15,22,5,3,1,9
181128.0,Scanferla Leonardo,L,Italy,25.0,184.0,2023,Brazil,Italy,2023-07-04,True,0,0,0,0,0,0,2,2,0,0,0,0,0,0,0,0,0,0,0,0,4,2,1,7
181128.0,Scanferla Leonardo,L,Italy,25.0,184.0,2023,Canada,Italy,2023-07-06,True,0,0,0,0,0,0,3,3,0,0,0,0,0,0,0,0,3,2,10,15,7,2,2,11
181128.0,Scanferla Leonardo,L,Italy,25.0,184.0,2023,Slovenia,Italy,2023-07-07,True,0,0,0,0,0,0,4,4,0,0,0,0,0,0,0,0,0,0,0,0,3,2,0,5
181128.0,Scanferla Leonardo,L,Italy,25.0,184.0,2023,Japan,Italy,2023-07-08,True,0,0,0,0,0,0,2,2,0,0,0,0,0,0,0,0,0,0,0,0,9,2,0,11
181128.0,Scanferla Leonardo,L,Italy,25.0,184.0,2023,Italy,Argentina,2023-07-19,True,0,0,0,0,0,0,0,0,0,0,0,0,0,0,0,0,0,0,0,0,0,0,0,0
181128.0,Scanferla Leonardo,L,Italy,25.0,184.0,2023,USA,Italy,2023-07-22,False,0,0,0,0,0,0,0,0,0,0,0,0,0,0,0,0,0,0,0,0,0,0,0,0
181128.0,Scanferla Leonardo,L,Italy,25.0,184.0,2023,Japan,Italy,2023-07-23,False,0,0,0,0,0,0,0,0,0,0,0,0,0,0,0,0,0,0,0,0,0,0,0,0
163447.0,Bottolo Mattia,OH,Italy,24.0,196.0,2023,Italy,Argentina,2023-06-06,False,0,0,3,3,0,0,0,0,3,1,0,4,0,0,0,0,0,1,1,2,0,0,0,0
163447.0,Bottolo Mattia,OH,Italy,24.0,196.0,2023,Italy,USA,2023-06-08,False,0,2,2,4,0,0,1,1,8,2,8,18,0,2,1,3,1,3,10,14,1,1,0,2
163447.0,Bottolo Mattia,OH,Italy,24.0,196.0,2023,Italy,Cuba,2023-06-09,True,1,2,9,12,0,0,2,2,15,6,5,26,1,3,0,4,3,0,15,18,6,2,0,8
163447.0,Bottolo Mattia,OH,Italy,24.0,196.0,2023,Germany,Italy,2023-06-10,True,1,4,15,20,0,0,2,2,11,4,11,26,1,2,3,6,2,3,26,31,12,2,0,14
163447.0,Bottolo Mattia,OH,Italy,24.0,196.0,2023,Brazil,Italy,2023-07-04,True,0,0,0,0,0,0,0,0,0,0,0,0,0,0,0,0,0,0,0,0,0,0,0,0
163447.0,Bottolo Mattia,OH,Italy,24.0,196.0,2023,Canada,Italy,2023-07-06,True,0,0,0,0,0,0,0,0,0,0,0,0,0,0,0,0,0,0,0,0,0,0,0,0
163447.0,Bottolo Mattia,OH,Italy,24.0,196.0,2023,Slovenia,Italy,2023-07-07,True,0,0,0,0,0,0,0,0,0,0,0,0,0,0,0,0,0,0,0,0,0,0,0,0
163447.0,Bottolo Mattia,OH,Italy,24.0,196.0,2023,Japan,Italy,2023-07-08,True,0,0,0,0,0,0,0,0,0,0,0,0,0,0,0,0,0,0,0,0,0,0,0,0
163447.0,Bottolo Mattia,OH,Italy,24.0,196.0,2023,Italy,Argentina,2023-07-19,True,0,0,0,0,0,0,0,0,0,0,0,0,0,0,0,0,0,0,0,0,0,0,0,0
163447.0,Bottolo Mattia,OH,Italy,24.0,196.0,2023,USA,Italy,2023-07-22,False,0,0,0,0,0,0,0,0,0,0,0,0,0,0,0,0,0,0,0,0,0,0,0,0
163447.0,Bottolo Mattia,OH,Italy,24.0,196.0,2023,Japan,Italy,2023-07-23,False,0,0,0,0,0,0,0,0,0,0,0,0,0,0,0,0,0,0,0,0,0,0,0,0
152408.0,Galassi Gianluca,MB,Italy,26.0,201.0,2023,Iran,Italy,2023-06-21,True,0,1,5,6,0,0,1,1,3,1,2,6,2,6,2,10,0,0,0,0,2,0,0,2
152408.0,Galassi Gianluca,MB,Italy,26.0,201.0,2023,China,Italy,2023-06-22,True,0,3,8,11,0,0,0,0,3,2,0,5,0,4,1,5,0,0,0,0,0,0,0,0
152408.0,Galassi Gianluca,MB,Italy,26.0,201.0,2023,Serbia,Italy,2023-06-23,True,0,0,0,0,0,0,0,0,0,0,0,0,0,0,0,0,0,0,0,0,0,0,0,0
152408.0,Galassi Gianluca,MB,Italy,26.0,201.0,2023,Italy,Poland,2023-06-25,False,0,1,3,4,0,0,1,1,0,0,5,5,0,0,1,1,0,0,1,1,1,0,0,1
152408.0,Galassi Gianluca,MB,Italy,26.0,201.0,2023,Brazil,Italy,2023-07-04,True,1,3,6,10,0,0,1,1,7,0,1,8,4,6,8,18,0,0,1,1,3,0,1,4
152408.0,Galassi Gianluca,MB,Italy,26.0,201.0,2023,Canada,Italy,2023-07-06,True,2,5,4,11,0,0,1,1,10,0,1,11,3,5,7,15,0,0,0,0,1,0,0,1
152408.0,Galassi Gianluca,MB,Italy,26.0,201.0,2023,Slovenia,Italy,2023-07-07,True,0,3,3,6,0,0,0,0,5,0,6,11,1,3,4,8,0,0,1,1,4,0,2,6
152408.0,Galassi Gianluca,MB,Italy,26.0,201.0,2023,Japan,Italy,2023-07-08,True,0,3,9,12,0,0,2,2,6,0,3,9,5,4,6,15,0,1,2,3,3,0,0,3
152408.0,Galassi Gianluca,MB,Italy,26.0,201.0,2023,Italy,Argentina,2023-07-19,True,1,2,10,13,0,0,0,0,4,0,2,6,1,2,4,7,0,0,0,0,3,1,0,4
152408.0,Galassi Gianluca,MB,Italy,26.0,201.0,2023,USA,Italy,2023-07-22,False,3,4,4,11,0,0,0,0,5,1,3,9,1,4,4,9,0,0,0,0,0,0,0,0
152408.0,Galassi Gianluca,MB,Italy,26.0,201.0,2023,Japan,Italy,2023-07-23,False,1,3,8,12,0,0,0,0,3,0,5,8,5,9,6,20,0,0,1,1,0,0,0,0
153200.0,Lavia Daniele,OH,Italy,24.0,200.0,2023,Iran,Italy,2023-06-21,True,1,0,18,19,0,0,4,4,9,0,12,21,1,2,3,6,4,1,16,21,4,1,0,5
153200.0,Lavia Daniele,OH,Italy,24.0,200.0,2023,China,Italy,2023-06-22,True,0,2,5,7,0,0,4,4,9,3,8,20,2,3,1,6,6,0,8,14,1,3,1,5
153200.0,Lavia Daniele,OH,Italy,24.0,200.0,2023,Serbia,Italy,2023-06-23,True,0,0,12,12,0,0,4,4,5,2,5,12,2,1,3,6,3,0,16,19,4,0,0,4
153200.0,Lavia Daniele,OH,Italy,24.0,200.0,2023,Italy,Poland,2023-06-25,False,1,3,9,13,0,0,2,2,15,2,16,33,2,3,5,10,6,3,14,23,7,1,1,9
153200.0,Lavia Daniele,OH,Italy,24.0,200.0,2023,Brazil,Italy,2023-07-04,True,2,2,16,20,0,0,2,2,8,2,16,26,0,1,4,5,1,2,16,19,4,1,0,5
153200.0,Lavia Daniele,OH,Italy,24.0,200.0,2023,Canada,Italy,2023-07-06,True,0,2,12,14,0,0,5,5,10,2,17,29,1,2,0,3,7,2,22,31,8,2,0,10
153200.0,Lavia Daniele,OH,Italy,24.0,200.0,2023,Slovenia,Italy,2023-07-07,True,1,0,12,13,0,0,2,2,7,3,10,20,5,2,3,10,8,1,15,24,5,0,1,6
153200.0,Lavia Daniele,OH,Italy,24.0,200.0,2023,Japan,Italy,2023-07-08,True,1,3,16,20,0,0,2,2,15,0,18,33,2,5,1,8,14,3,13,30,4,3,1,8
153200.0,Lavia Daniele,OH,Italy,24.0,200.0,2023,Italy,Argentina,2023-07-19,True,0,0,8,8,0,0,5,5,11,1,10,22,1,3,4,8,6,2,6,14,3,3,0,6
153200.0,Lavia Daniele,OH,Italy,24.0,200.0,2023,USA,Italy,2023-07-22,False,0,3,5,8,0,0,5,5,8,3,12,23,1,5,2,8,2,1,13,16,4,2,0,6
153200.0,Lavia Daniele,OH,Italy,24.0,200.0,2023,Japan,Italy,2023-07-23,False,0,3,12,15,0,0,3,3,11,4,16,31,3,4,6,13,4,4,16,24,6,1,0,7
162520.0,Romanò Yuri,O,Italy,26.0,201.0,2023,Italy,Argentina,2023-06-06,False,1,3,6,10,0,1,2,3,12,5,10,27,1,1,2,4,0,0,0,0,5,1,1,7
162520.0,Romanò Yuri,O,Italy,26.0,201.0,2023,Italy,USA,2023-06-08,False,0,3,4,7,0,0,0,0,8,5,10,23,0,5,1,6,0,0,0,0,3,1,0,4
162520.0,Romanò Yuri,O,Italy,26.0,201.0,2023,Italy,Cuba,2023-06-09,True,2,3,14,19,0,0,1,1,15,3,12,30,0,0,6,6,0,0,0,0,2,2,0,4
162520.0,Romanò Yuri,O,Italy,26.0,201.0,2023,Germany,Italy,2023-06-10,True,2,7,9,18,0,0,1,1,14,5,15,34,1,2,2,5,0,0,1,1,4,2,1,7
162520.0,Romanò Yuri,O,Italy,26.0,201.0,2023,Iran,Italy,2023-06-21,True,2,4,9,15,0,0,0,0,11,5,7,23,1,0,0,1,0,0,0,0,1,2,1,4
162520.0,Romanò Yuri,O,Italy,26.0,201.0,2023,China,Italy,2023-06-22,True,0,0,6,6,0,0,1,1,8,1,5,14,4,1,1,6,0,1,1,2,3,0,0,3
162520.0,Romanò Yuri,O,Italy,26.0,201.0,2023,Serbia,Italy,2023-06-23,True,2,1,8,11,0,0,1,1,13,4,8,25,0,6,4,10,0,0,0,0,2,2,0,4
162520.0,Romanò Yuri,O,Italy,26.0,201.0,2023,Italy,Poland,2023-06-25,False,1,4,11,16,0,0,2,2,17,5,14,36,0,6,6,12,0,0,1,1,7,2,0,9
162520.0,Romanò Yuri,O,Italy,26.0,201.0,2023,Brazil,Italy,2023-07-04,True,4,3,9,16,0,0,1,1,16,1,14,31,0,4,5,9,0,0,0,0,4,2,2,8
162520.0,Romanò Yuri,O,Italy,26.0,201.0,2023,Canada,Italy,2023-07-06,True,1,5,10,16,0,0,2,2,16,6,19,41,1,6,8,15,0,0,1,1,5,8,0,13
162520.0,Romanò Yuri,O,Italy,26.0,201.0,2023,Slovenia,Italy,2023-07-07,True,3,1,7,11,0,0,2,2,11,5,12,28,2,3,5,10,0,0,0,0,3,2,1,6
162520.0,Romanò Yuri,O,Italy,26.0,201.0,2023,Japan,Italy,2023-07-08,True,3,5,15,23,0,0,1,1,16,6,5,27,3,5,2,10,0,0,1,1,5,2,3,10
162520.0,Romanò Yuri,O,Italy,26.0,201.0,2023,Italy,Argentina,2023-07-19,True,0,4,3,7,0,0,2,2,10,3,6,19,1,2,1,4,0,0,0,0,8,2,0,10
162520.0,Romanò Yuri,O,Italy,26.0,201.0,2023,USA,Italy,2023-07-22,False,1,2,1,4,0,0,2,2,4,6,13,23,1,3,3,7,0,0,0,0,2,0,1,3
162520.0,Romanò Yuri,O,Italy,26.0,201.0,2023,Japan,Italy,2023-07-23,False,0,4,9,13,0,1,1,2,14,4,17,35,1,5,7,13,0,0,0,0,4,1,2,7
163032.0,Gironi Fabrizio,OH,Italy,24.0,200.0,2023,Italy,Argentina,2023-06-06,False,0,1,2,3,0,1,0,1,1,2,2,5,0,0,0,0,0,0,0,0,0,0,0,0
163032.0,Gironi Fabrizio,OH,Italy,24.0,200.0,2023,Italy,USA,2023-06-08,False,0,0,1,1,0,0,0,0,1,0,1,2,0,0,2,2,0,0,0,0,0,0,0,0
163032.0,Gironi Fabrizio,OH,Italy,24.0,200.0,2023,Italy,Cuba,2023-06-09,True,0,0,0,0,0,0,0,0,0,0,0,0,0,0,1,1,0,0,0,0,0,0,0,0
163032.0,Gironi Fabrizio,OH,Italy,24.0,200.0,2023,Germany,Italy,2023-06-10,True,0,0,1,1,0,0,0,0,0,0,0,0,0,0,0,0,0,0,0,0,0,0,0,0
163032.0,Gironi Fabrizio,OH,Italy,24.0,200.0,2023,Iran,Italy,2023-06-21,True,0,0,0,0,0,0,0,0,0,0,0,0,0,0,0,0,0,0,0,0,0,0,0,0
163032.0,Gironi Fabrizio,OH,Italy,24.0,200.0,2023,China,Italy,2023-06-22,True,0,1,1,2,0,0,0,0,1,0,2,3,0,0,0,0,0,0,0,0,1,0,0,1
163032.0,Gironi Fabrizio,OH,Italy,24.0,200.0,2023,Serbia,Italy,2023-06-23,True,0,0,0,0,0,0,0,0,0,0,0,0,0,0,0,0,0,0,0,0,0,0,0,0
163032.0,Gironi Fabrizio,OH,Italy,24.0,200.0,2023,Italy,Poland,2023-06-25,False,0,1,1,2,0,0,0,0,0,0,0,0,0,0,0,0,0,0,0,0,0,0,0,0
163032.0,Gironi Fabrizio,OH,Italy,24.0,200.0,2023,Italy,Argentina,2023-07-19,True,0,0,0,0,0,0,0,0,0,0,0,0,0,0,0,0,0,0,0,0,0,0,0,0
163032.0,Gironi Fabrizio,OH,Italy,24.0,200.0,2023,USA,Italy,2023-07-22,False,0,0,4,4,0,0,1,1,0,1,2,3,0,0,0,0,0,0,0,0,0,2,0,2
163032.0,Gironi Fabrizio,OH,Italy,24.0,200.0,2023,Japan,Italy,2023-07-23,False,0,0,0,0,0,0,0,0,0,0,0,0,0,0,0,0,0,0,0,0,0,0,0,0
152405.0,Russo Roberto,MB,Italy,27.0,207.0,2023,Iran,Italy,2023-06-21,True,2,4,6,12,0,0,0,0,5,0,6,11,2,2,1,5,0,0,0,0,1,0,0,1
152405.0,Russo Roberto,MB,Italy,27.0,207.0,2023,China,Italy,2023-06-22,True,0,0,0,0,0,0,0,0,0,0,0,0,0,0,0,0,0,0,0,0,0,0,0,0
152405.0,Russo Roberto,MB,Italy,27.0,207.0,2023,Serbia,Italy,2023-06-23,True,3,0,15,18,0,0,0,0,5,1,2,8,6,6,3,15,0,0,1,1,2,2,1,5
152405.0,Russo Roberto,MB,Italy,27.0,207.0,2023,Italy,Poland,2023-06-25,False,0,3,11,14,0,0,0,0,8,0,5,13,0,6,5,11,0,0,2,2,4,0,1,5
152405.0,Russo Roberto,MB,Italy,27.0,207.0,2023,Brazil,Italy,2023-07-04,True,2,1,14,17,0,0,2,2,4,0,2,6,1,5,7,13,0,0,1,1,2,0,0,2
152405.0,Russo Roberto,MB,Italy,27.0,207.0,2023,Canada,Italy,2023-07-06,True,2,2,23,27,0,0,2,2,11,2,3,16,2,4,6,12,0,0,0,0,3,1,0,4
152405.0,Russo Roberto,MB,Italy,27.0,207.0,2023,Slovenia,Italy,2023-07-07,True,1,2,13,16,0,0,2,2,3,1,3,7,4,3,8,15,0,0,0,0,3,2,1,6
152405.0,Russo Roberto,MB,Italy,27.0,207.0,2023,Japan,Italy,2023-07-08,True,0,2,8,10,0,0,0,0,6,0,4,10,0,6,2,8,0,0,1,1,2,0,0,2
152405.0,Russo Roberto,MB,Italy,27.0,207.0,2023,Italy,Argentina,2023-07-19,True,3,0,14,17,0,0,0,0,4,1,1,6,3,4,2,9,0,0,1,1,5,0,1,6
152405.0,Russo Roberto,MB,Italy,27.0,207.0,2023,USA,Italy,2023-07-22,False,0,1,8,9,0,0,0,0,5,1,3,9,3,2,5,10,1,0,2,3,3,0,0,3
152405.0,Russo Roberto,MB,Italy,27.0,207.0,2023,Japan,Italy,2023-07-23,False,0,2,19,21,0,0,3,3,8,3,4,15,3,4,9,16,0,0,3,3,1,1,0,2
172962.0,Rinaldi Tommaso,OH,Italy,22.0,200.0,2023,Italy,Argentina,2023-06-06,False,0,2,6,8,0,0,1,1,6,3,11,20,0,1,0,1,0,1,9,10,4,2,0,6
172962.0,Rinaldi Tommaso,OH,Italy,22.0,200.0,2023,Italy,USA,2023-06-08,False,1,1,10,12,0,0,1,1,8,1,7,16,0,1,1,2,1,2,14,17,4,1,0,5
172962.0,Rinaldi Tommaso,OH,Italy,22.0,200.0,2023,Italy,Cuba,2023-06-09,True,0,3,15,18,0,0,0,0,9,4,9,22,2,3,3,8,3,3,19,25,4,1,0,5
172962.0,Rinaldi Tommaso,OH,Italy,22.0,200.0,2023,Germany,Italy,2023-06-10,True,1,3,11,15,0,0,3,3,16,5,9,30,1,3,1,5,0,0,11,11,6,9,2,17
172962.0,Rinaldi Tommaso,OH,Italy,22.0,200.0,2023,Iran,Italy,2023-06-21,True,0,0,0,0,0,0,0,0,0,0,0,0,0,0,0,0,0,0,0,0,0,0,0,0
172962.0,Rinaldi Tommaso,OH,Italy,22.0,200.0,2023,China,Italy,2023-06-22,True,1,0,4,5,0,0,0,0,3,1,7,11,0,0,1,1,1,0,9,10,2,1,0,3
172962.0,Rinaldi Tommaso,OH,Italy,22.0,200.0,2023,Serbia,Italy,2023-06-23,True,0,0,0,0,0,0,0,0,0,0,0,0,0,0,0,0,0,0,0,0,0,0,0,0
172962.0,Rinaldi Tommaso,OH,Italy,22.0,200.0,2023,Italy,Poland,2023-06-25,False,0,0,0,0,0,0,0,0,0,0,0,0,0,0,0,0,1,0,1,2,0,0,0,0
172962.0,Rinaldi Tommaso,OH,Italy,22.0,200.0,2023,Brazil,Italy,2023-07-04,True,0,0,0,0,0,0,0,0,0,0,0,0,0,0,0,0,0,0,0,0,0,0,0,0
172962.0,Rinaldi Tommaso,OH,Italy,22.0,200.0,2023,Canada,Italy,2023-07-06,True,0,0,0,0,0,0,0,0,0,0,0,0,0,0,0,0,0,0,0,0,0,0,0,0
172962.0,Rinaldi Tommaso,OH,Italy,22.0,200.0,2023,Slovenia,Italy,2023-07-07,True,0,0,0,0,0,0,0,0,0,0,0,0,0,0,0,0,0,0,0,0,0,0,0,0
172962.0,Rinaldi Tommaso,OH,Italy,22.0,200.0,2023,Japan,Italy,2023-07-08,True,0,1,2,3,0,0,1,1,5,1,4,10,0,3,2,5,1,0,6,7,2,0,0,2
172962.0,Rinaldi Tommaso,OH,Italy,22.0,200.0,2023,Italy,Argentina,2023-07-19,True,0,0,0,0,0,0,0,0,0,0,0,0,0,0,0,0,0,0,0,0,0,0,0,0
172962.0,Rinaldi Tommaso,OH,Italy,22.0,200.0,2023,USA,Italy,2023-07-22,False,0,0,0,0,0,0,0,0,0,0,0,0,0,0,0,0,0,0,0,0,0,0,0,0
172962.0,Rinaldi Tommaso,OH,Italy,22.0,200.0,2023,Japan,Italy,2023-07-23,False,0,0,2,2,0,0,0,0,0,0,0,0,0,0,0,0,0,2,1,3,0,0,0,0
174076.0,Sanguinetti Giovanni,MB,Italy,23.0,203.0,2023,Italy,Argentina,2023-06-06,False,0,0,2,2,0,0,0,0,0,1,0,1,0,0,2,2,0,0,0,0,0,0,0,0
174076.0,Sanguinetti Giovanni,MB,Italy,23.0,203.0,2023,Italy,USA,2023-06-08,False,1,0,3,4,0,0,0,0,1,0,2,3,0,1,3,4,0,0,0,0,1,0,0,1
174076.0,Sanguinetti Giovanni,MB,Italy,23.0,203.0,2023,Italy,Cuba,2023-06-09,True,1,6,5,12,0,0,1,1,7,1,1,9,3,0,3,6,0,0,0,0,1,0,0,1
174076.0,Sanguinetti Giovanni,MB,Italy,23.0,203.0,2023,Germany,Italy,2023-06-10,True,3,4,9,16,0,0,1,1,4,0,2,6,1,5,1,7,0,0,0,0,3,0,0,3
174076.0,Sanguinetti Giovanni,MB,Italy,23.0,203.0,2023,Brazil,Italy,2023-07-04,True,0,0,0,0,0,0,0,0,0,0,0,0,0,0,0,0,0,0,0,0,0,0,0,0
174076.0,Sanguinetti Giovanni,MB,Italy,23.0,203.0,2023,Canada,Italy,2023-07-06,True,0,0,0,0,0,0,0,0,0,0,0,0,0,0,0,0,0,0,0,0,0,0,0,0
174076.0,Sanguinetti Giovanni,MB,Italy,23.0,203.0,2023,Slovenia,Italy,2023-07-07,True,0,0,0,0,0,0,0,0,0,0,0,0,0,0,0,0,0,0,0,0,0,0,0,0
174076.0,Sanguinetti Giovanni,MB,Italy,23.0,203.0,2023,Japan,Italy,2023-07-08,True,0,0,0,0,0,0,0,0,0,0,0,0,0,0,0,0,0,0,0,0,0,0,0,0
174076.0,Sanguinetti Giovanni,MB,Italy,23.0,203.0,2023,Italy,Argentina,2023-07-19,True,0,0,0,0,0,0,0,0,0,0,0,0,0,0,0,0,0,0,0,0,0,0,0,0
174076.0,Sanguinetti Giovanni,MB,Italy,23.0,203.0,2023,USA,Italy,2023-07-22,False,0,0,0,0,0,0,0,0,0,0,0,0,0,0,0,0,0,0,0,0,0,0,0,0
174076.0,Sanguinetti Giovanni,MB,Italy,23.0,203.0,2023,Japan,Italy,2023-07-23,False,0,0,0,0,0,0,0,0,0,0,0,0,0,0,0,0,0,0,0,0,0,0,0,0
174074.0,Mosca Leandro Ausibio,MB,Italy,23.0,208.0,2023,Italy,Argentina,2023-06-06,False,0,0,7,7,0,0,0,0,6,1,1,8,1,0,1,2,0,0,0,0,1,2,0,3
174074.0,Mosca Leandro Ausibio,MB,Italy,23.0,208.0,2023,Italy,USA,2023-06-08,False,0,1,4,5,0,1,0,1,1,1,4,6,1,0,1,2,0,1,0,1,0,0,0,0
174074.0,Mosca Leandro Ausibio,MB,Italy,23.0,208.0,2023,Italy,Cuba,2023-06-09,True,0,2,11,13,0,0,4,4,2,1,0,3,2,6,2,10,0,0,1,1,0,1,0,1
174074.0,Mosca Leandro Ausibio,MB,Italy,23.0,208.0,2023,Germany,Italy,2023-06-10,True,0,0,12,12,0,0,0,0,7,0,1,8,2,1,3,6,0,0,0,0,0,1,0,1
174074.0,Mosca Leandro Ausibio,MB,Italy,23.0,208.0,2023,Brazil,Italy,2023-07-04,True,0,0,0,0,0,0,0,0,0,0,0,0,0,0,0,0,0,0,0,0,0,0,0,0
174074.0,Mosca Leandro Ausibio,MB,Italy,23.0,208.0,2023,Canada,Italy,2023-07-06,True,0,0,0,0,0,0,0,0,0,0,0,0,1,0,0,1,0,0,0,0,0,0,0,0
174074.0,Mosca Leandro Ausibio,MB,Italy,23.0,208.0,2023,Slovenia,Italy,2023-07-07,True,0,0,0,0,0,0,0,0,0,0,0,0,0,0,0,0,0,0,0,0,0,0,0,0
174074.0,Mosca Leandro Ausibio,MB,Italy,23.0,208.0,2023,Japan,Italy,2023-07-08,True,0,0,2,2,0,0,0,0,1,0,0,1,0,3,0,3,0,0,0,0,0,0,0,0
174074.0,Mosca Leandro Ausibio,MB,Italy,23.0,208.0,2023,Italy,Argentina,2023-07-19,True,0,0,0,0,0,0,0,0,0,0,0,0,0,0,0,0,0,0,0,0,0,0,0,0
174074.0,Mosca Leandro Ausibio,MB,Italy,23.0,208.0,2023,USA,Italy,2023-07-22,False,0,0,0,0,0,0,0,0,0,0,0,0,0,0,0,0,0,0,0,0,0,0,0,0
174074.0,Mosca Leandro Ausibio,MB,Italy,23.0,208.0,2023,Japan,Italy,2023-07-23,False,0,0,0,0,0,0,0,0,0,0,0,0,0,0,0,0,0,0,0,0,0,0,0,0
142565.0,Onodera Taishi,MB,Japan,28.0,200.0,2023,Japan,Iran,2023-06-06,True,1,0,10,11,0,0,2,2,2,0,1,3,1,4,4,9,0,0,0,0,2,0,0,2
142565.0,Onodera Taishi,MB,Japan,28.0,200.0,2023,Japan,Serbia,2023-06-09,True,0,1,11,12,0,0,0,0,5,1,1,7,1,5,2,8,0,0,0,0,3,0,0,3
142565.0,Onodera Taishi,MB,Japan,28.0,200.0,2023,Japan,Bulgaria,2023-06-10,True,0,4,10,14,0,0,2,2,8,2,3,13,1,0,2,3,2,1,0,3,2,0,2,4
142565.0,Onodera Taishi,MB,Japan,28.0,200.0,2023,Japan,France,2023-06-11,True,0,2,10,12,0,0,0,0,5,1,1,7,1,4,5,10,0,1,1,2,3,0,0,3
142565.0,Onodera Taishi,MB,Japan,28.0,200.0,2023,Japan,Canada,2023-06-20,True,0,1,7,8,0,0,1,1,9,0,2,11,3,3,2,8,0,0,0,0,2,0,0,2
142565.0,Onodera Taishi,MB,Japan,28.0,200.0,2023,Japan,Cuba,2023-06-21,True,0,0,9,9,0,0,0,0,7,0,0,7,1,2,1,4,0,0,1,1,2,2,0,4
142565.0,Onodera Taishi,MB,Japan,28.0,200.0,2023,Japan,Brazil,2023-06-22,True,0,2,13,15,0,0,0,0,4,1,4,9,3,3,2,8,1,0,0,1,2,3,0,5
142565.0,Onodera Taishi,MB,Japan,28.0,200.0,2023,Japan,Argentina,2023-06-24,True,0,3,13,16,0,0,2,2,8,0,2,10,0,2,1,3,1,0,2,3,3,1,1,5
142565.0,Onodera Taishi,MB,Japan,28.0,200.0,2023,Japan,China,2023-07-04,True,1,2,17,20,0,0,2,2,5,2,3,10,1,4,5,10,0,0,1,1,1,1,1,3
142565.0,Onodera Taishi,MB,Japan,28.0,200.0,2023,Japan,Netherlands,2023-07-07,True,0,3,8,11,0,0,0,0,3,1,4,8,3,4,1,8,0,0,1,1,2,0,0,2
142565.0,Onodera Taishi,MB,Japan,28.0,200.0,2023,Japan,Italy,2023-07-08,False,1,1,11,13,0,0,1,1,6,1,4,11,0,6,5,11,2,0,2,4,0,0,0,0
142565.0,Onodera Taishi,MB,Japan,28.0,200.0,2023,Japan,Poland,2023-07-09,False,0,0,3,3,0,0,0,0,1,0,2,3,0,2,1,3,1,0,0,1,1,0,0,1
142565.0,Onodera Taishi,MB,Japan,28.0,200.0,2023,Japan,Slovenia,2023-07-20,True,0,1,18,19,0,0,2,2,5,0,6,11,1,3,4,8,0,0,2,2,4,1,0,5
142565.0,Onodera Taishi,MB,Japan,28.0,200.0,2023,Japan,Poland,2023-07-22,False,0,3,8,11,0,0,0,0,8,0,8,16,2,8,2,12,2,0,0,2,4,0,0,4
142565.0,Onodera Taishi,MB,Japan,28.0,200.0,2023,Japan,Italy,2023-07-23,True,1,1,11,13,0,0,0,0,2,0,3,5,0,3,4,7,0,0,0,0,1,1,0,2
163038.0,Miyaura Kento,O,Japan,25.0,190.0,2023,Japan,Iran,2023-06-06,True,0,0,0,0,0,0,0,0,3,1,0,4,0,1,0,1,0,0,0,0,2,0,0,2
163038.0,Miyaura Kento,O,Japan,25.0,190.0,2023,Japan,Serbia,2023-06-09,True,1,1,0,2,0,0,0,0,0,0,0,0,0,0,0,0,0,0,0,0,0,0,0,0
163038.0,Miyaura Kento,O,Japan,25.0,190.0,2023,Japan,Bulgaria,2023-06-10,True,0,0,0,0,0,0,0,0,0,0,0,0,0,0,0,0,0,0,0,0,0,0,0,0
163038.0,Miyaura Kento,O,Japan,25.0,190.0,2023,Japan,France,2023-06-11,True,2,1,3,6,0,0,1,1,10,1,1,12,1,3,0,4,0,0,0,0,1,0,0,1
163038.0,Miyaura Kento,O,Japan,25.0,190.0,2023,Japan,Canada,2023-06-20,True,0,1,0,1,0,0,0,0,2,1,1,4,0,1,0,1,0,0,0,0,0,0,0,0
163038.0,Miyaura Kento,O,Japan,25.0,190.0,2023,Japan,Cuba,2023-06-21,True,0,1,0,1,0,0,1,1,0,0,0,0,0,0,0,0,0,0,0,0,0,0,0,0
163038.0,Miyaura Kento,O,Japan,25.0,190.0,2023,Japan,Brazil,2023-06-22,True,1,8,10,19,0,0,1,1,22,9,6,37,1,2,3,6,0,0,0,0,5,7,0,12
163038.0,Miyaura Kento,O,Japan,25.0,190.0,2023,Japan,Argentina,2023-06-24,True,0,5,18,23,0,1,0,1,27,5,7,39,1,6,2,9,0,0,0,0,2,2,1,5
163038.0,Miyaura Kento,O,Japan,25.0,190.0,2023,Japan,China,2023-07-04,True,1,3,4,8,0,0,1,1,14,3,3,20,0,2,0,2,0,0,0,0,2,2,1,5
163038.0,Miyaura Kento,O,Japan,25.0,190.0,2023,Japan,Netherlands,2023-07-07,True,2,1,10,13,0,0,0,0,9,7,6,22,1,2,0,3,0,0,0,0,4,2,1,7
163038.0,Miyaura Kento,O,Japan,25.0,190.0,2023,Japan,Italy,2023-07-08,False,1,0,1,2,0,0,0,0,0,0,0,0,0,0,0,0,0,0,0,0,0,0,0,0
163038.0,Miyaura Kento,O,Japan,25.0,190.0,2023,Japan,Poland,2023-07-09,False,0,2,2,4,0,0,0,0,3,2,8,13,0,2,1,3,0,0,0,0,0,2,0,2
163038.0,Miyaura Kento,O,Japan,25.0,190.0,2023,Japan,Slovenia,2023-07-20,True,0,0,0,0,0,0,0,0,1,0,1,2,0,1,0,1,0,0,0,0,0,0,0,0
163038.0,Miyaura Kento,O,Japan,25.0,190.0,2023,Japan,Poland,2023-07-22,False,0,2,16,18,0,0,1,1,13,6,6,25,0,0,2,2,0,0,1,1,3,3,0,6
163038.0,Miyaura Kento,O,Japan,25.0,190.0,2023,Japan,Italy,2023-07-23,True,7,5,11,23,0,1,1,2,12,7,11,30,1,1,6,8,0,0,0,0,10,2,0,12
163516.0,Otsuka Tatsunori,OH,Japan,23.0,194.0,2023,Japan,Serbia,2023-06-09,True,0,0,0,0,0,0,0,0,0,0,0,0,0,0,0,0,0,0,0,0,0,0,0,0
163516.0,Otsuka Tatsunori,OH,Japan,23.0,194.0,2023,Japan,Bulgaria,2023-06-10,True,0,0,0,0,0,0,0,0,1,0,0,1,0,0,0,0,0,0,0,0,0,0,0,0
163516.0,Otsuka Tatsunori,OH,Japan,23.0,194.0,2023,Japan,France,2023-06-11,True,0,0,0,0,0,0,0,0,0,0,0,0,0,0,0,0,0,0,0,0,0,0,0,0
163516.0,Otsuka Tatsunori,OH,Japan,23.0,194.0,2023,Japan,Canada,2023-06-20,True,0,0,0,0,0,0,0,0,0,0,0,0,0,0,0,0,0,0,0,0,0,0,0,0
163516.0,Otsuka Tatsunori,OH,Japan,23.0,194.0,2023,Japan,Cuba,2023-06-21,True,0,0,0,0,0,0,0,0,0,0,0,0,0,0,0,0,0,0,0,0,0,0,0,0
163516.0,Otsuka Tatsunori,OH,Japan,23.0,194.0,2023,Japan,Brazil,2023-06-22,True,0,0,1,1,0,0,0,0,2,0,2,4,0,2,1,3,1,0,1,2,0,0,0,0
163516.0,Otsuka Tatsunori,OH,Japan,23.0,194.0,2023,Japan,Argentina,2023-06-24,True,0,0,1,1,0,0,0,0,0,0,0,0,0,0,0,0,0,0,0,0,0,0,0,0
163516.0,Otsuka Tatsunori,OH,Japan,23.0,194.0,2023,Japan,China,2023-07-04,True,0,0,1,1,0,0,0,0,2,1,3,6,0,0,0,0,0,0,5,5,0,0,0,0
163516.0,Otsuka Tatsunori,OH,Japan,23.0,194.0,2023,Japan,Netherlands,2023-07-07,True,0,1,0,1,0,0,0,0,0,0,0,0,0,0,0,0,0,0,0,0,0,0,0,0
163516.0,Otsuka Tatsunori,OH,Japan,23.0,194.0,2023,Japan,Italy,2023-07-08,False,0,2,13,15,0,0,5,5,14,4,9,27,0,0,1,1,8,3,30,41,10,0,0,10
163516.0,Otsuka Tatsunori,OH,Japan,23.0,194.0,2023,Japan,Poland,2023-07-09,False,0,1,7,8,0,0,4,4,11,2,9,22,0,1,2,3,2,2,16,20,3,2,0,5
163516.0,Otsuka Tatsunori,OH,Japan,23.0,194.0,2023,Japan,Slovenia,2023-07-20,True,0,0,0,0,0,0,0,0,0,0,0,0,0,0,0,0,0,0,0,0,0,0,0,0
163516.0,Otsuka Tatsunori,OH,Japan,23.0,194.0,2023,Japan,Poland,2023-07-22,False,0,0,1,1,0,0,0,0,0,0,0,0,0,0,0,0,0,0,0,0,0,0,0,0
163516.0,Otsuka Tatsunori,OH,Japan,23.0,194.0,2023,Japan,Italy,2023-07-23,True,0,0,2,2,0,0,2,2,1,2,4,7,0,2,0,2,1,1,8,10,3,2,1,6
146409.0,Yamauchi Akihiro,MB,Japan,30.0,204.0,2023,Japan,Iran,2023-06-06,True,0,0,6,6,0,0,0,0,7,1,2,10,2,3,2,7,1,0,0,1,2,0,0,2
146409.0,Yamauchi Akihiro,MB,Japan,30.0,204.0,2023,Japan,Serbia,2023-06-09,True,0,0,5,5,0,0,0,0,0,1,1,2,0,3,0,3,0,0,0,0,1,0,0,1
146409.0,Yamauchi Akihiro,MB,Japan,30.0,204.0,2023,Japan,Bulgaria,2023-06-10,True,0,0,0,0,0,0,0,0,0,0,0,0,0,0,0,0,0,0,0,0,0,0,0,0
146409.0,Yamauchi Akihiro,MB,Japan,30.0,204.0,2023,Japan,France,2023-06-11,True,0,0,0,0,0,0,0,0,0,0,0,0,0,0,0,0,0,0,0,0,0,0,0,0
146409.0,Yamauchi Akihiro,MB,Japan,30.0,204.0,2023,Japan,Canada,2023-06-20,True,2,0,26,28,0,0,3,3,4,2,4,10,1,5,1,7,0,0,0,0,2,1,2,5
146409.0,Yamauchi Akihiro,MB,Japan,30.0,204.0,2023,Japan,Cuba,2023-06-21,True,0,1,14,15,0,0,0,0,8,0,3,11,1,2,0,3,0,0,0,0,0,2,0,2
146409.0,Yamauchi Akihiro,MB,Japan,30.0,204.0,2023,Japan,Brazil,2023-06-22,True,1,2,10,13,0,0,0,0,1,2,5,8,0,5,0,5,0,0,0,0,1,2,0,3
146409.0,Yamauchi Akihiro,MB,Japan,30.0,204.0,2023,Japan,Argentina,2023-06-24,True,0,3,17,20,0,0,0,0,7,1,4,12,1,4,6,11,0,0,0,0,0,1,0,1
146409.0,Yamauchi Akihiro,MB,Japan,30.0,204.0,2023,Japan,China,2023-07-04,True,0,1,10,11,0,0,0,0,4,1,2,7,1,4,1,6,0,0,0,0,1,0,0,1
146409.0,Yamauchi Akihiro,MB,Japan,30.0,204.0,2023,Japan,Netherlands,2023-07-07,True,0,1,9,10,0,0,0,0,10,2,1,13,3,2,3,8,1,0,0,1,0,0,0,0
146409.0,Yamauchi Akihiro,MB,Japan,30.0,204.0,2023,Japan,Italy,2023-07-08,False,0,1,15,16,0,0,2,2,3,1,3,7,0,1,3,4,0,0,0,0,1,1,0,2
146409.0,Yamauchi Akihiro,MB,Japan,30.0,204.0,2023,Japan,Poland,2023-07-09,False,0,0,0,0,0,0,0,0,0,0,0,0,0,0,0,0,0,0,0,0,0,0,0,0
146409.0,Yamauchi Akihiro,MB,Japan,30.0,204.0,2023,Japan,Slovenia,2023-07-20,True,0,1,5,6,0,0,1,1,5,2,5,12,1,3,4,8,0,0,0,0,1,0,0,1
146409.0,Yamauchi Akihiro,MB,Japan,30.0,204.0,2023,Japan,Poland,2023-07-22,False,0,1,6,7,0,0,0,0,2,0,3,5,0,4,3,7,0,0,0,0,0,1,0,1
146409.0,Yamauchi Akihiro,MB,Japan,30.0,204.0,2023,Japan,Italy,2023-07-23,True,1,1,11,13,0,0,2,2,7,0,5,12,2,1,6,9,1,0,4,5,2,0,1,3
133009.0,Sekita Masahiro,S,Japan,30.0,175.0,2023,Japan,Iran,2023-06-06,True,1,0,17,18,5,0,66,71,0,0,0,0,0,1,0,1,0,0,1,1,5,0,1,6
133009.0,Sekita Masahiro,S,Japan,30.0,175.0,2023,Japan,Serbia,2023-06-09,True,1,0,16,17,19,1,70,90,1,0,0,1,0,2,3,5,0,0,0,0,5,0,2,7
133009.0,Sekita Masahiro,S,Japan,30.0,175.0,2023,Japan,Bulgaria,2023-06-10,True,0,1,13,14,22,0,47,69,1,0,0,1,0,2,2,4,0,0,0,0,1,0,0,1
133009.0,Sekita Masahiro,S,Japan,30.0,175.0,2023,Japan,France,2023-06-11,True,0,0,12,12,8,0,51,59,0,0,0,0,0,0,0,0,0,0,0,0,5,1,0,6
133009.0,Sekita Masahiro,S,Japan,30.0,175.0,2023,Japan,Canada,2023-06-20,True,0,0,17,17,19,0,61,80,0,0,0,0,0,3,3,6,0,0,0,0,7,2,1,10
133009.0,Sekita Masahiro,S,Japan,30.0,175.0,2023,Japan,Cuba,2023-06-21,True,0,1,16,17,29,0,29,58,0,0,0,0,0,2,1,3,0,0,0,0,1,1,0,2
133009.0,Sekita Masahiro,S,Japan,30.0,175.0,2023,Japan,Brazil,2023-06-22,True,1,1,17,19,23,0,88,111,0,0,0,0,0,3,2,5,0,0,0,0,5,7,3,15
133009.0,Sekita Masahiro,S,Japan,30.0,175.0,2023,Japan,Argentina,2023-06-24,True,1,1,15,17,21,0,87,108,0,0,0,0,0,7,0,7,0,0,0,0,7,8,1,16
133009.0,Sekita Masahiro,S,Japan,30.0,175.0,2023,Japan,China,2023-07-04,True,0,1,15,16,27,0,69,96,0,0,1,1,0,2,1,3,0,0,0,0,9,3,2,14
133009.0,Sekita Masahiro,S,Japan,30.0,175.0,2023,Japan,Netherlands,2023-07-07,True,0,1,20,21,25,0,59,84,0,0,0,0,1,3,3,7,0,0,0,0,3,1,0,4
133009.0,Sekita Masahiro,S,Japan,30.0,175.0,2023,Japan,Italy,2023-07-08,False,0,1,15,16,24,2,82,108,0,0,1,1,0,0,3,3,0,0,1,1,7,6,1,14
133009.0,Sekita Masahiro,S,Japan,30.0,175.0,2023,Japan,Poland,2023-07-09,False,0,0,0,0,0,0,0,0,0,0,0,0,0,0,0,0,0,0,0,0,0,0,0,0
133009.0,Sekita Masahiro,S,Japan,30.0,175.0,2023,Japan,Slovenia,2023-07-20,True,1,0,15,16,28,0,59,87,0,0,1,1,0,1,6,7,0,0,1,1,6,0,2,8
133009.0,Sekita Masahiro,S,Japan,30.0,175.0,2023,Japan,Poland,2023-07-22,False,0,0,9,9,13,0,67,80,0,0,0,0,0,4,3,7,0,0,0,0,2,2,1,5
133009.0,Sekita Masahiro,S,Japan,30.0,175.0,2023,Japan,Italy,2023-07-23,True,0,1,21,22,33,0,77,110,0,0,1,1,0,0,0,0,0,0,0,0,8,7,4,19
142561.0,Takahashi Kentaro,MB,Japan,29.0,202.0,2023,Japan,Iran,2023-06-06,True,0,0,0,0,0,0,0,0,0,0,0,0,0,0,0,0,0,0,0,0,0,0,0,0
142561.0,Takahashi Kentaro,MB,Japan,29.0,202.0,2023,Japan,Serbia,2023-06-09,True,0,1,6,7,0,0,1,1,6,0,0,6,0,6,3,9,0,0,0,0,0,1,0,1
142561.0,Takahashi Kentaro,MB,Japan,29.0,202.0,2023,Japan,Bulgaria,2023-06-10,True,0,1,7,8,0,0,1,1,4,0,0,4,2,6,4,12,1,0,0,1,2,0,0,2
142561.0,Takahashi Kentaro,MB,Japan,29.0,202.0,2023,Japan,France,2023-06-11,True,0,1,13,14,0,0,0,0,6,0,4,10,2,5,3,10,0,0,0,0,1,0,1,2
142561.0,Takahashi Kentaro,MB,Japan,29.0,202.0,2023,Japan,Canada,2023-06-20,True,0,0,0,0,0,0,0,0,0,0,0,0,0,0,0,0,0,0,0,0,0,0,0,0
142561.0,Takahashi Kentaro,MB,Japan,29.0,202.0,2023,Japan,Cuba,2023-06-21,True,0,0,0,0,0,0,0,0,0,0,0,0,0,0,0,0,0,0,0,0,0,0,0,0
142561.0,Takahashi Kentaro,MB,Japan,29.0,202.0,2023,Japan,Brazil,2023-06-22,True,0,2,4,6,0,0,1,1,0,0,2,2,0,1,0,1,0,0,0,0,1,0,0,1
142561.0,Takahashi Kentaro,MB,Japan,29.0,202.0,2023,Japan,Argentina,2023-06-24,True,0,0,0,0,0,0,0,0,0,0,0,0,1,0,0,1,0,0,0,0,0,0,0,0
142561.0,Takahashi Kentaro,MB,Japan,29.0,202.0,2023,Japan,China,2023-07-04,True,0,1,2,3,0,0,0,0,1,2,0,3,1,2,2,5,0,0,0,0,0,0,0,0
142561.0,Takahashi Kentaro,MB,Japan,29.0,202.0,2023,Japan,Netherlands,2023-07-07,True,0,0,0,0,0,0,0,0,0,0,0,0,0,0,0,0,0,0,0,0,0,0,0,0
142561.0,Takahashi Kentaro,MB,Japan,29.0,202.0,2023,Japan,Italy,2023-07-08,False,0,0,0,0,0,0,0,0,0,0,0,0,0,0,0,0,0,0,0,0,0,0,0,0
142561.0,Takahashi Kentaro,MB,Japan,29.0,202.0,2023,Japan,Poland,2023-07-09,False,0,0,6,6,0,0,1,1,2,0,2,4,0,5,1,6,0,1,0,1,1,0,0,1
142561.0,Takahashi Kentaro,MB,Japan,29.0,202.0,2023,Japan,Slovenia,2023-07-20,True,0,0,0,0,0,0,0,0,0,0,0,0,0,0,0,0,0,0,0,0,0,0,0,0
142561.0,Takahashi Kentaro,MB,Japan,29.0,202.0,2023,Japan,Poland,2023-07-22,False,0,1,3,4,0,0,0,0,0,0,1,1,0,1,1,2,0,0,0,0,0,0,0,0
142561.0,Takahashi Kentaro,MB,Japan,29.0,202.0,2023,Japan,Italy,2023-07-23,True,0,0,0,0,0,0,0,0,0,0,0,0,0,0,0,0,0,0,0,0,0,0,0,0
178761.0,Tomita Shoma,OH,Japan,26.0,190.0,2023,Japan,Iran,2023-06-06,True,0,0,0,0,0,0,0,0,0,0,0,0,0,0,0,0,0,0,0,0,0,0,0,0
178761.0,Tomita Shoma,OH,Japan,26.0,190.0,2023,Japan,Serbia,2023-06-09,True,0,0,0,0,0,0,0,0,0,0,0,0,0,0,0,0,0,0,0,0,0,0,0,0
178761.0,Tomita Shoma,OH,Japan,26.0,190.0,2023,Japan,Bulgaria,2023-06-10,True,0,0,0,0,0,0,0,0,0,0,0,0,0,0,0,0,1,0,0,1,0,0,0,0
178761.0,Tomita Shoma,OH,Japan,26.0,190.0,2023,Japan,France,2023-06-11,True,0,0,0,0,0,0,0,0,0,0,0,0,0,0,0,0,0,0,0,0,0,0,0,0
178761.0,Tomita Shoma,OH,Japan,26.0,190.0,2023,Japan,Canada,2023-06-20,True,0,0,0,0,0,0,2,2,0,0,0,0,0,0,0,0,1,0,3,4,1,0,0,1
178761.0,Tomita Shoma,OH,Japan,26.0,190.0,2023,Japan,Cuba,2023-06-21,True,0,0,0,0,0,0,0,0,0,0,0,0,0,0,0,0,1,0,0,1,0,0,0,0
178761.0,Tomita Shoma,OH,Japan,26.0,190.0,2023,Japan,Brazil,2023-06-22,True,0,0,1,1,0,0,0,0,0,0,0,0,0,0,0,0,0,0,0,0,0,1,0,1
178761.0,Tomita Shoma,OH,Japan,26.0,190.0,2023,Japan,Argentina,2023-06-24,True,0,0,0,0,0,0,0,0,0,0,0,0,0,0,0,0,1,0,0,1,0,0,0,0
178761.0,Tomita Shoma,OH,Japan,26.0,190.0,2023,Japan,China,2023-07-04,True,0,0,1,1,0,0,0,0,0,0,0,0,0,0,0,0,0,0,1,1,0,0,0,0
178761.0,Tomita Shoma,OH,Japan,26.0,190.0,2023,Japan,Netherlands,2023-07-07,True,0,1,2,3,0,0,0,0,4,0,2,6,0,0,0,0,3,0,2,5,1,0,0,1
178761.0,Tomita Shoma,OH,Japan,26.0,190.0,2023,Japan,Italy,2023-07-08,False,0,0,0,0,0,0,0,0,0,0,0,0,0,0,0,0,1,0,3,4,0,0,0,0
178761.0,Tomita Shoma,OH,Japan,26.0,190.0,2023,Japan,Poland,2023-07-09,False,0,1,2,3,0,0,2,2,5,0,4,9,0,0,0,0,0,0,9,9,2,1,0,3
178761.0,Tomita Shoma,OH,Japan,26.0,190.0,2023,Japan,Slovenia,2023-07-20,True,0,0,0,0,0,0,0,0,0,0,0,0,0,0,0,0,0,0,0,0,0,0,0,0
178761.0,Tomita Shoma,OH,Japan,26.0,190.0,2023,Japan,Poland,2023-07-22,False,0,0,0,0,0,0,0,0,0,0,0,0,0,0,0,0,0,0,1,1,0,0,0,0
178761.0,Tomita Shoma,OH,Japan,26.0,190.0,2023,Japan,Italy,2023-07-23,True,0,0,0,0,0,0,0,0,0,0,0,0,0,0,0,0,0,0,1,1,1,0,0,1
178762.0,Takahashi Ran,OH,Japan,22.0,188.0,2023,Japan,Iran,2023-06-06,True,1,3,10,14,0,0,2,2,9,3,10,22,0,0,1,1,4,1,15,20,8,0,2,10
178762.0,Takahashi Ran,OH,Japan,22.0,188.0,2023,Japan,Serbia,2023-06-09,True,2,3,16,21,0,0,1,1,13,6,3,22,0,1,3,4,6,0,15,21,8,1,1,10
178762.0,Takahashi Ran,OH,Japan,22.0,188.0,2023,Japan,Bulgaria,2023-06-10,True,0,1,7,8,0,0,3,3,10,0,3,13,0,1,2,3,5,2,8,15,8,0,3,11
178762.0,Takahashi Ran,OH,Japan,22.0,188.0,2023,Japan,France,2023-06-11,True,2,3,15,20,0,0,2,2,14,5,7,26,1,2,1,4,7,0,14,21,4,0,0,4
178762.0,Takahashi Ran,OH,Japan,22.0,188.0,2023,Japan,Canada,2023-06-20,True,0,1,11,12,0,0,1,1,15,4,10,29,3,3,5,11,1,3,12,16,10,4,1,15
178762.0,Takahashi Ran,OH,Japan,22.0,188.0,2023,Japan,Cuba,2023-06-21,True,0,1,8,9,0,0,2,2,13,2,4,19,1,2,1,4,3,1,12,16,6,3,0,9
178762.0,Takahashi Ran,OH,Japan,22.0,188.0,2023,Japan,Brazil,2023-06-22,True,2,4,12,18,0,0,7,7,19,1,11,31,0,5,1,6,8,0,17,25,9,2,2,13
178762.0,Takahashi Ran,OH,Japan,22.0,188.0,2023,Japan,Argentina,2023-06-24,True,1,3,15,19,0,0,4,4,29,3,8,40,2,6,4,12,13,2,29,44,9,4,0,13
178762.0,Takahashi Ran,OH,Japan,22.0,188.0,2023,Japan,China,2023-07-04,True,4,5,15,24,0,0,8,8,10,6,9,25,0,2,0,2,10,2,28,40,7,4,1,12
178762.0,Takahashi Ran,OH,Japan,22.0,188.0,2023,Japan,Netherlands,2023-07-07,True,0,3,13,16,0,0,5,5,9,1,5,15,1,3,1,5,3,1,18,22,8,1,0,9
178762.0,Takahashi Ran,OH,Japan,22.0,188.0,2023,Japan,Italy,2023-07-08,False,0,0,0,0,0,0,0,0,0,0,0,0,0,0,0,0,0,0,0,0,0,0,0,0
178762.0,Takahashi Ran,OH,Japan,22.0,188.0,2023,Japan,Poland,2023-07-09,False,0,0,0,0,0,0,0,0,0,0,0,0,0,0,0,0,0,0,0,0,0,0,0,0
178762.0,Takahashi Ran,OH,Japan,22.0,188.0,2023,Japan,Slovenia,2023-07-20,True,0,2,13,15,1,0,6,7,9,4,5,18,0,4,1,5,5,0,15,20,7,1,1,9
178762.0,Takahashi Ran,OH,Japan,22.0,188.0,2023,Japan,Poland,2023-07-22,False,3,3,12,18,0,0,4,4,12,5,7,24,1,4,4,9,7,1,15,23,6,4,0,10
178762.0,Takahashi Ran,OH,Japan,22.0,188.0,2023,Japan,Italy,2023-07-23,True,0,2,6,8,0,0,2,2,11,6,12,29,1,1,4,6,4,4,12,20,6,2,0,8
180990.0,Ogawa Tomohiro,L,Japan,27.0,176.0,2023,Japan,Iran,2023-06-06,True,0,0,0,0,0,0,0,0,0,0,0,0,0,0,0,0,0,0,0,0,0,0,0,0
180990.0,Ogawa Tomohiro,L,Japan,27.0,176.0,2023,Japan,Serbia,2023-06-09,True,0,0,0,0,0,0,0,0,0,0,0,0,0,0,0,0,0,0,0,0,0,0,0,0
180990.0,Ogawa Tomohiro,L,Japan,27.0,176.0,2023,Japan,Bulgaria,2023-06-10,True,0,0,0,0,0,0,0,0,0,0,0,0,0,0,0,0,0,0,0,0,0,0,0,0
180990.0,Ogawa Tomohiro,L,Japan,27.0,176.0,2023,Japan,France,2023-06-11,True,0,0,0,0,0,0,0,0,0,0,0,0,0,0,0,0,0,0,0,0,0,0,0,0
180990.0,Ogawa Tomohiro,L,Japan,27.0,176.0,2023,Japan,Canada,2023-06-20,True,0,0,0,0,0,0,0,0,0,0,0,0,0,0,0,0,0,0,0,0,0,0,0,0
180990.0,Ogawa Tomohiro,L,Japan,27.0,176.0,2023,Japan,Cuba,2023-06-21,True,0,0,0,0,0,0,0,0,0,0,0,0,0,0,0,0,0,0,0,0,0,0,0,0
180990.0,Ogawa Tomohiro,L,Japan,27.0,176.0,2023,Japan,Brazil,2023-06-22,True,0,0,0,0,0,0,0,0,0,0,0,0,0,0,0,0,0,0,0,0,0,0,0,0
180990.0,Ogawa Tomohiro,L,Japan,27.0,176.0,2023,Japan,Argentina,2023-06-24,True,0,0,0,0,0,0,0,0,0,0,0,0,0,0,0,0,0,0,0,0,0,0,0,0
180990.0,Ogawa Tomohiro,L,Japan,27.0,176.0,2023,Japan,China,2023-07-04,True,0,0,0,0,0,0,0,0,0,0,0,0,0,0,0,0,0,0,0,0,0,0,0,0
180990.0,Ogawa Tomohiro,L,Japan,27.0,176.0,2023,Japan,Netherlands,2023-07-07,True,0,0,0,0,0,0,4,4,0,0,0,0,0,0,0,0,2,0,5,7,8,1,0,9
180990.0,Ogawa Tomohiro,L,Japan,27.0,176.0,2023,Japan,Italy,2023-07-08,False,0,0,0,0,0,0,0,0,0,0,0,0,0,0,0,0,0,0,0,0,0,0,0,0
180990.0,Ogawa Tomohiro,L,Japan,27.0,176.0,2023,Japan,Poland,2023-07-09,False,0,0,0,0,0,0,3,3,0,0,0,0,0,0,0,0,6,2,7,15,8,2,2,12
180990.0,Ogawa Tomohiro,L,Japan,27.0,176.0,2023,Japan,Slovenia,2023-07-20,True,0,0,0,0,0,0,0,0,0,0,0,0,0,0,0,0,0,0,0,0,0,0,0,0
180990.0,Ogawa Tomohiro,L,Japan,27.0,176.0,2023,Japan,Poland,2023-07-22,False,0,0,0,0,0,0,0,0,0,0,0,0,0,0,0,0,0,0,0,0,0,0,0,0
180990.0,Ogawa Tomohiro,L,Japan,27.0,176.0,2023,Japan,Italy,2023-07-23,True,0,0,0,0,0,0,0,0,0,0,0,0,0,0,0,0,0,0,0,0,0,0,0,0
142568.0,Ishikawa Yuki,OH,Japan,28.0,191.0,2023,Japan,Iran,2023-06-06,True,1,4,9,14,0,0,2,2,18,5,7,30,1,2,2,5,3,2,10,15,5,0,0,5
142568.0,Ishikawa Yuki,OH,Japan,28.0,191.0,2023,Japan,Serbia,2023-06-09,True,1,3,13,17,0,0,1,1,15,4,7,26,1,1,1,3,9,0,20,29,7,0,0,7
142568.0,Ishikawa Yuki,OH,Japan,28.0,191.0,2023,Japan,Bulgaria,2023-06-10,True,3,5,8,16,0,0,1,1,12,3,12,27,2,3,4,9,7,1,17,25,9,0,1,10
142568.0,Ishikawa Yuki,OH,Japan,28.0,191.0,2023,Japan,France,2023-06-11,True,1,3,14,18,0,1,6,7,14,2,8,24,1,3,2,6,11,1,16,28,10,1,1,12
142568.0,Ishikawa Yuki,OH,Japan,28.0,191.0,2023,Japan,Canada,2023-06-20,True,3,5,9,17,0,0,2,2,19,2,9,30,1,5,2,8,7,3,17,27,5,4,1,10
142568.0,Ishikawa Yuki,OH,Japan,28.0,191.0,2023,Japan,Cuba,2023-06-21,True,0,4,8,12,0,0,2,2,5,1,5,11,0,2,3,5,3,1,5,9,4,1,0,5
142568.0,Ishikawa Yuki,OH,Japan,28.0,191.0,2023,Japan,Brazil,2023-06-22,True,2,4,10,16,0,0,6,6,25,3,15,43,0,7,4,11,13,1,26,40,3,1,0,4
142568.0,Ishikawa Yuki,OH,Japan,28.0,191.0,2023,Japan,Argentina,2023-06-24,True,1,6,15,22,0,0,4,4,16,5,6,27,0,1,6,7,8,1,20,29,6,2,1,9
142568.0,Ishikawa Yuki,OH,Japan,28.0,191.0,2023,Japan,China,2023-07-04,True,1,4,10,15,0,0,2,2,16,4,15,35,1,1,4,6,3,1,15,19,2,3,1,6
142568.0,Ishikawa Yuki,OH,Japan,28.0,191.0,2023,Japan,Netherlands,2023-07-07,True,1,5,12,18,0,0,4,4,14,5,8,27,2,6,6,14,8,0,12,20,1,1,1,3
142568.0,Ishikawa Yuki,OH,Japan,28.0,191.0,2023,Japan,Italy,2023-07-08,False,1,3,12,16,0,0,2,2,17,8,17,42,3,2,0,5,2,2,13,17,7,2,4,13
142568.0,Ishikawa Yuki,OH,Japan,28.0,191.0,2023,Japan,Poland,2023-07-09,False,1,2,4,7,0,0,3,3,6,2,5,13,0,2,2,4,0,2,11,13,1,1,1,3
142568.0,Ishikawa Yuki,OH,Japan,28.0,191.0,2023,Japan,Slovenia,2023-07-20,True,1,3,5,9,1,0,2,3,22,2,13,37,4,8,3,15,2,0,18,20,5,2,0,7
142568.0,Ishikawa Yuki,OH,Japan,28.0,191.0,2023,Japan,Poland,2023-07-22,False,4,4,10,18,0,0,4,4,17,2,9,28,1,2,0,3,1,1,29,31,3,3,4,10
142568.0,Ishikawa Yuki,OH,Japan,28.0,191.0,2023,Japan,Italy,2023-07-23,True,0,3,13,16,0,1,7,8,21,8,19,48,0,4,3,7,7,2,18,27,4,3,0,7
192453.0,Nishiyama Hiroto,O,Japan,21.0,193.0,2023,Japan,Slovenia,2023-07-20,True,0,0,0,0,0,0,0,0,0,0,0,0,0,0,0,0,0,0,0,0,0,0,0,0
192453.0,Nishiyama Hiroto,O,Japan,21.0,193.0,2023,Japan,Poland,2023-07-22,False,1,2,0,3,0,0,0,0,3,2,1,6,0,1,0,1,0,0,0,0,2,0,0,2
192453.0,Nishiyama Hiroto,O,Japan,21.0,193.0,2023,Japan,Italy,2023-07-23,True,0,0,2,2,0,0,0,0,0,1,0,1,0,0,0,0,0,0,0,0,0,0,0,0
172893.0,Yamamoto Tomohiro,L,Japan,29.0,171.0,2023,Japan,Iran,2023-06-06,True,0,0,0,0,0,0,2,2,0,0,0,0,0,0,0,0,2,0,6,8,11,1,1,13
172893.0,Yamamoto Tomohiro,L,Japan,29.0,171.0,2023,Japan,Serbia,2023-06-09,True,0,0,0,0,0,0,3,3,0,0,0,0,0,0,0,0,9,2,7,18,10,1,2,13
172893.0,Yamamoto Tomohiro,L,Japan,29.0,171.0,2023,Japan,Bulgaria,2023-06-10,True,0,0,0,0,0,0,1,1,0,0,0,0,0,0,0,0,5,1,4,10,7,1,1,9
172893.0,Yamamoto Tomohiro,L,Japan,29.0,171.0,2023,Japan,France,2023-06-11,True,0,0,0,0,0,0,4,4,0,0,0,0,0,0,0,0,7,1,9,17,8,1,3,12
172893.0,Yamamoto Tomohiro,L,Japan,29.0,171.0,2023,Japan,Canada,2023-06-20,True,0,0,0,0,0,0,11,11,0,0,0,0,0,0,0,0,3,2,17,22,12,4,0,16
172893.0,Yamamoto Tomohiro,L,Japan,29.0,171.0,2023,Japan,Cuba,2023-06-21,True,0,0,0,0,0,0,2,2,0,0,0,0,0,0,0,0,3,1,8,12,6,3,1,10
172893.0,Yamamoto Tomohiro,L,Japan,29.0,171.0,2023,Japan,Brazil,2023-06-22,True,0,0,0,0,0,0,5,5,0,0,0,0,0,0,0,0,12,1,13,26,11,3,4,18
172893.0,Yamamoto Tomohiro,L,Japan,29.0,171.0,2023,Japan,Argentina,2023-06-24,True,0,0,0,0,0,0,6,6,0,0,0,0,0,0,0,0,5,1,7,13,10,4,3,17
172893.0,Yamamoto Tomohiro,L,Japan,29.0,171.0,2023,Japan,China,2023-07-04,True,0,0,0,0,0,0,8,8,0,0,0,0,0,0,0,0,4,2,14,20,7,2,2,11
172893.0,Yamamoto Tomohiro,L,Japan,29.0,171.0,2023,Japan,Netherlands,2023-07-07,True,0,0,0,0,0,0,2,2,0,0,0,0,0,0,0,0,3,1,5,9,5,3,0,8
172893.0,Yamamoto Tomohiro,L,Japan,29.0,171.0,2023,Japan,Italy,2023-07-08,False,0,0,0,0,0,0,5,5,0,0,0,0,0,0,0,0,4,0,14,18,9,7,1,17
172893.0,Yamamoto Tomohiro,L,Japan,29.0,171.0,2023,Japan,Poland,2023-07-09,False,0,0,0,0,0,0,0,0,0,0,0,0,0,0,0,0,0,0,0,0,0,0,0,0
172893.0,Yamamoto Tomohiro,L,Japan,29.0,171.0,2023,Japan,Slovenia,2023-07-20,True,0,0,0,0,0,0,6,6,0,0,0,0,0,0,0,0,5,0,8,13,10,4,1,15
172893.0,Yamamoto Tomohiro,L,Japan,29.0,171.0,2023,Japan,Poland,2023-07-22,False,0,0,0,0,0,0,2,2,0,0,0,0,0,0,0,0,3,2,16,21,11,4,0,15
172893.0,Yamamoto Tomohiro,L,Japan,29.0,171.0,2023,Japan,Italy,2023-07-23,True,0,0,0,0,0,0,6,6,0,0,0,0,0,0,0,0,7,0,12,19,14,5,0,19
142562.0,Eiro Motoki,S,Japan,27.0,192.0,2023,Japan,China,2023-07-04,True,0,0,0,0,0,0,10,10,0,0,0,0,0,0,0,0,0,0,0,0,1,0,0,1
142562.0,Eiro Motoki,S,Japan,27.0,192.0,2023,Japan,Netherlands,2023-07-07,True,0,0,0,0,0,0,1,1,0,0,0,0,0,0,0,0,0,0,0,0,0,0,0,0
142562.0,Eiro Motoki,S,Japan,27.0,192.0,2023,Japan,Italy,2023-07-08,False,0,0,0,0,0,0,0,0,0,0,0,0,0,0,0,0,0,0,0,0,0,0,0,0
142562.0,Eiro Motoki,S,Japan,27.0,192.0,2023,Japan,Poland,2023-07-09,False,0,1,6,7,16,0,55,71,0,0,0,0,1,5,1,7,0,0,0,0,7,4,0,11
142562.0,Eiro Motoki,S,Japan,27.0,192.0,2023,Japan,Slovenia,2023-07-20,True,0,0,0,0,0,0,0,0,0,0,0,0,0,0,0,0,0,0,0,0,0,0,0,0
142562.0,Eiro Motoki,S,Japan,27.0,192.0,2023,Japan,Poland,2023-07-22,False,0,0,1,1,3,1,12,16,0,0,0,0,0,0,1,1,0,0,1,1,0,1,0,1
142562.0,Eiro Motoki,S,Japan,27.0,192.0,2023,Japan,Italy,2023-07-23,True,0,0,0,0,1,0,1,2,0,0,0,0,0,0,0,0,0,0,0,0,0,0,0,0
189039.0,Evbade-Dan Larry Ik,MB,Japan,23.0,195.0,2023,Japan,China,2023-07-04,True,0,0,0,0,0,0,0,0,0,0,0,0,0,0,0,0,0,0,0,0,0,0,0,0
189039.0,Evbade-Dan Larry Ik,MB,Japan,23.0,195.0,2023,Japan,Netherlands,2023-07-07,True,0,0,0,0,0,0,0,0,0,0,0,0,0,0,0,0,0,0,0,0,0,0,0,0
189039.0,Evbade-Dan Larry Ik,MB,Japan,23.0,195.0,2023,Japan,Italy,2023-07-08,False,0,0,0,0,0,0,0,0,0,0,0,0,0,0,0,0,0,0,0,0,0,0,0,0
189039.0,Evbade-Dan Larry Ik,MB,Japan,23.0,195.0,2023,Japan,Poland,2023-07-09,False,0,0,9,9,0,0,0,0,2,1,2,5,0,1,1,2,1,1,0,2,2,1,0,3
189039.0,Evbade-Dan Larry Ik,MB,Japan,23.0,195.0,2023,Japan,Italy,2023-07-23,True,0,0,0,0,0,0,0,0,0,0,0,0,0,0,0,0,0,0,0,0,0,0,0,0
188782.0,Korenblek Siebe,MB,Netherlands,22.0,215.0,2023,USA,Netherlands,2023-06-07,False,0,0,0,0,0,0,0,0,0,0,0,0,0,0,0,0,0,0,0,0,0,0,0,0
188782.0,Korenblek Siebe,MB,Netherlands,22.0,215.0,2023,Netherlands,Cuba,2023-06-08,True,0,0,0,0,0,0,0,0,0,0,0,0,0,0,0,0,0,0,0,0,0,0,0,0
188782.0,Korenblek Siebe,MB,Netherlands,22.0,215.0,2023,Netherlands,Germany,2023-06-09,True,0,0,0,0,0,0,0,0,0,0,0,0,0,0,0,0,0,0,0,0,0,0,0,0
188782.0,Korenblek Siebe,MB,Netherlands,22.0,215.0,2023,Argentina,Netherlands,2023-06-11,False,0,0,0,0,0,0,0,0,0,0,0,0,0,0,0,0,0,0,0,0,0,0,0,0
188782.0,Korenblek Siebe,MB,Netherlands,22.0,215.0,2023,Netherlands,China,2023-06-20,True,0,1,1,2,0,0,0,0,0,0,0,0,1,0,0,1,0,0,0,0,0,0,0,0
188782.0,Korenblek Siebe,MB,Netherlands,22.0,215.0,2023,Netherlands,Poland,2023-06-22,False,0,0,0,0,0,0,0,0,0,0,0,0,0,0,0,0,0,0,0,0,0,0,0,0
188782.0,Korenblek Siebe,MB,Netherlands,22.0,215.0,2023,Netherlands,Iran,2023-06-24,True,0,0,0,0,0,0,0,0,0,0,0,0,0,0,0,0,0,0,0,0,0,0,0,0
188782.0,Korenblek Siebe,MB,Netherlands,22.0,215.0,2023,Netherlands,Serbia,2023-06-25,False,0,0,0,0,0,0,0,0,0,0,0,0,0,0,0,0,0,0,0,0,0,0,0,0
188782.0,Korenblek Siebe,MB,Netherlands,22.0,215.0,2023,Canada,Netherlands,2023-07-05,True,0,1,1,2,0,0,0,0,2,0,0,2,1,0,2,3,0,0,0,0,0,0,0,0
188782.0,Korenblek Siebe,MB,Netherlands,22.0,215.0,2023,Brazil,Netherlands,2023-07-06,False,0,0,0,0,0,0,0,0,0,0,0,0,0,0,0,0,0,0,0,0,0,0,0,0
188782.0,Korenblek Siebe,MB,Netherlands,22.0,215.0,2023,Japan,Netherlands,2023-07-07,False,0,0,0,0,0,0,0,0,0,0,0,0,0,0,0,0,0,0,0,0,0,0,0,0
188782.0,Korenblek Siebe,MB,Netherlands,22.0,215.0,2023,Slovenia,Netherlands,2023-07-09,False,0,0,0,0,0,0,0,0,0,0,0,0,0,0,0,0,0,0,0,0,0,0,0,0
141546.0,Keemink Wessel,S,Netherlands,30.0,197.0,2023,USA,Netherlands,2023-06-07,False,0,1,7,8,8,0,33,41,0,0,1,1,0,1,0,1,0,0,0,0,0,1,0,1
141546.0,Keemink Wessel,S,Netherlands,30.0,197.0,2023,Netherlands,Cuba,2023-06-08,True,0,0,10,10,17,0,44,61,1,0,0,1,0,0,3,3,0,0,0,0,5,1,2,8
141546.0,Keemink Wessel,S,Netherlands,30.0,197.0,2023,Netherlands,Germany,2023-06-09,True,0,1,8,9,9,1,51,61,1,0,0,1,2,5,5,12,0,0,0,0,6,2,1,9
141546.0,Keemink Wessel,S,Netherlands,30.0,197.0,2023,Argentina,Netherlands,2023-06-11,False,2,0,15,17,22,0,82,104,2,0,0,2,2,5,3,10,0,0,1,1,3,5,1,9
141546.0,Keemink Wessel,S,Netherlands,30.0,197.0,2023,Netherlands,China,2023-06-20,True,0,0,15,15,13,0,47,60,1,0,0,1,1,1,1,3,0,1,0,1,4,3,2,9
141546.0,Keemink Wessel,S,Netherlands,30.0,197.0,2023,Netherlands,Poland,2023-06-22,False,0,3,11,14,15,3,62,80,1,0,0,1,0,2,1,3,0,0,0,0,3,0,0,3
141546.0,Keemink Wessel,S,Netherlands,30.0,197.0,2023,Netherlands,Iran,2023-06-24,True,0,0,7,7,21,0,55,76,1,0,0,1,1,0,0,1,0,1,0,1,4,1,1,6
141546.0,Keemink Wessel,S,Netherlands,30.0,197.0,2023,Netherlands,Serbia,2023-06-25,False,0,0,16,16,30,2,73,105,2,0,0,2,2,4,1,7,0,0,0,0,4,1,0,5
141546.0,Keemink Wessel,S,Netherlands,30.0,197.0,2023,Canada,Netherlands,2023-07-05,True,1,0,11,12,18,0,61,79,1,0,0,1,0,3,1,4,0,0,0,0,4,2,2,8
141546.0,Keemink Wessel,S,Netherlands,30.0,197.0,2023,Brazil,Netherlands,2023-07-06,False,0,0,3,3,15,0,34,49,1,0,2,3,0,1,1,2,0,0,0,0,0,1,0,1
141546.0,Keemink Wessel,S,Netherlands,30.0,197.0,2023,Japan,Netherlands,2023-07-07,False,0,1,10,11,20,0,62,82,0,0,0,0,0,2,2,4,0,0,1,1,1,2,1,4
141546.0,Keemink Wessel,S,Netherlands,30.0,197.0,2023,Slovenia,Netherlands,2023-07-09,False,0,1,9,10,17,0,58,75,1,0,0,1,0,2,4,6,0,0,1,1,1,1,0,2
139929.0,Van Garderen Maarten,OH,Netherlands,34.0,200.0,2023,USA,Netherlands,2023-06-07,False,1,1,6,8,0,0,1,1,4,5,5,14,0,0,2,2,2,2,13,17,7,4,0,11
139929.0,Van Garderen Maarten,OH,Netherlands,34.0,200.0,2023,Netherlands,Cuba,2023-06-08,True,0,1,11,12,0,0,4,4,11,1,6,18,4,0,0,4,1,1,4,6,6,2,2,10
139929.0,Van Garderen Maarten,OH,Netherlands,34.0,200.0,2023,Netherlands,Germany,2023-06-09,True,2,2,8,12,0,0,2,2,15,2,9,26,4,2,1,7,0,0,11,11,1,0,0,1
139929.0,Van Garderen Maarten,OH,Netherlands,34.0,200.0,2023,Argentina,Netherlands,2023-06-11,False,1,2,16,19,0,0,0,0,12,5,12,29,1,3,1,5,7,5,23,35,6,5,1,12
139929.0,Van Garderen Maarten,OH,Netherlands,34.0,200.0,2023,Netherlands,China,2023-06-20,True,2,2,7,11,0,0,4,4,10,4,11,25,2,1,4,7,2,1,12,15,5,0,0,5
139929.0,Van Garderen Maarten,OH,Netherlands,34.0,200.0,2023,Netherlands,Poland,2023-06-22,False,0,5,5,10,0,0,4,4,9,2,2,13,1,5,0,6,5,1,5,11,2,2,1,5
139929.0,Van Garderen Maarten,OH,Netherlands,34.0,200.0,2023,Netherlands,Iran,2023-06-24,True,0,3,7,10,0,0,1,1,6,2,7,15,1,0,0,1,1,2,14,17,3,1,0,4
139929.0,Van Garderen Maarten,OH,Netherlands,34.0,200.0,2023,Netherlands,Serbia,2023-06-25,False,3,3,14,20,0,0,7,7,16,5,11,32,0,3,0,3,6,4,31,41,5,0,0,5
139929.0,Van Garderen Maarten,OH,Netherlands,34.0,200.0,2023,Canada,Netherlands,2023-07-05,True,0,3,11,14,0,0,3,3,11,1,12,24,0,3,1,4,4,2,23,29,3,0,1,4
139929.0,Van Garderen Maarten,OH,Netherlands,34.0,200.0,2023,Brazil,Netherlands,2023-07-06,False,0,0,0,0,0,0,0,0,0,0,0,0,0,0,0,0,0,0,0,0,0,0,0,0
139929.0,Van Garderen Maarten,OH,Netherlands,34.0,200.0,2023,Japan,Netherlands,2023-07-07,False,0,2,6,8,0,1,3,4,7,5,9,21,1,0,0,1,5,1,6,12,4,4,0,8
139929.0,Van Garderen Maarten,OH,Netherlands,34.0,200.0,2023,Slovenia,Netherlands,2023-07-09,False,1,2,4,7,0,0,1,1,2,5,6,13,1,1,1,3,6,2,9,17,1,0,2,3
137345.0,Ter Horst Thijs,OH,Netherlands,32.0,204.0,2023,Netherlands,China,2023-06-20,True,0,0,0,0,0,0,0,0,0,0,0,0,0,0,0,0,0,0,0,0,0,0,0,0
137345.0,Ter Horst Thijs,OH,Netherlands,32.0,204.0,2023,Netherlands,Poland,2023-06-22,False,1,1,2,4,0,0,1,1,5,3,3,11,0,1,2,3,2,1,11,14,0,0,0,0
137345.0,Ter Horst Thijs,OH,Netherlands,32.0,204.0,2023,Netherlands,Iran,2023-06-24,True,0,0,0,0,0,0,0,0,0,0,0,0,0,0,0,0,0,0,0,0,0,0,0,0
137345.0,Ter Horst Thijs,OH,Netherlands,32.0,204.0,2023,Netherlands,Serbia,2023-06-25,False,0,0,0,0,0,0,0,0,0,0,0,0,0,0,0,0,0,0,0,0,0,0,0,0
137345.0,Ter Horst Thijs,OH,Netherlands,32.0,204.0,2023,Canada,Netherlands,2023-07-05,True,0,0,0,0,0,0,0,0,0,0,0,0,0,0,0,0,0,0,0,0,0,0,0,0
137345.0,Ter Horst Thijs,OH,Netherlands,32.0,204.0,2023,Brazil,Netherlands,2023-07-06,False,0,3,1,4,0,0,2,2,3,3,5,11,0,1,1,2,3,1,18,22,1,0,0,1
137345.0,Ter Horst Thijs,OH,Netherlands,32.0,204.0,2023,Japan,Netherlands,2023-07-07,False,0,0,0,0,0,0,0,0,0,0,0,0,0,0,0,0,0,0,0,0,0,0,0,0
137345.0,Ter Horst Thijs,OH,Netherlands,32.0,204.0,2023,Slovenia,Netherlands,2023-07-09,False,0,1,1,2,0,0,1,1,3,1,3,7,1,1,1,3,1,0,4,5,0,3,0,3
169921.0,van Der Ent Cornelis Luuc,MB,Netherlands,25.0,208.0,2023,USA,Netherlands,2023-06-07,False,0,0,0,0,0,0,0,0,0,0,0,0,0,0,0,0,0,0,0,0,0,0,0,0
169921.0,van Der Ent Cornelis Luuc,MB,Netherlands,25.0,208.0,2023,Netherlands,Cuba,2023-06-08,True,0,0,0,0,0,0,0,0,0,0,0,0,0,0,0,0,0,0,0,0,0,0,0,0
169921.0,van Der Ent Cornelis Luuc,MB,Netherlands,25.0,208.0,2023,Netherlands,Germany,2023-06-09,True,0,0,0,0,0,0,0,0,0,0,0,0,0,0,0,0,0,0,0,0,0,0,0,0
169921.0,van Der Ent Cornelis Luuc,MB,Netherlands,25.0,208.0,2023,Argentina,Netherlands,2023-06-11,False,0,0,0,0,0,0,0,0,0,0,0,0,0,0,0,0,0,0,0,0,0,0,0,0
169921.0,van Der Ent Cornelis Luuc,MB,Netherlands,25.0,208.0,2023,Japan,Netherlands,2023-07-07,False,0,0,0,0,0,0,0,0,0,0,0,0,0,0,0,0,0,0,0,0,0,0,0,0
169921.0,van Der Ent Cornelis Luuc,MB,Netherlands,25.0,208.0,2023,Slovenia,Netherlands,2023-07-09,False,0,0,0,0,0,0,0,0,0,0,0,0,0,0,0,0,0,0,0,0,0,0,0,0
188784.0,Meijs Silvester,S,Netherlands,22.0,202.0,2023,USA,Netherlands,2023-06-07,False,0,2,0,2,9,0,22,31,0,0,0,0,0,1,0,1,0,0,0,0,3,0,0,3
188784.0,Meijs Silvester,S,Netherlands,22.0,202.0,2023,Netherlands,Cuba,2023-06-08,True,0,0,0,0,0,0,0,0,0,0,0,0,0,0,0,0,0,0,0,0,0,0,0,0
188784.0,Meijs Silvester,S,Netherlands,22.0,202.0,2023,Netherlands,Germany,2023-06-09,True,0,0,0,0,0,0,0,0,0,0,0,0,0,0,0,0,0,0,0,0,0,0,0,0
188784.0,Meijs Silvester,S,Netherlands,22.0,202.0,2023,Argentina,Netherlands,2023-06-11,False,0,1,1,2,2,0,3,5,0,0,0,0,0,0,1,1,0,0,0,0,0,0,0,0
188784.0,Meijs Silvester,S,Netherlands,22.0,202.0,2023,Netherlands,China,2023-06-20,True,0,0,0,0,0,0,0,0,0,0,0,0,0,0,0,0,0,0,0,0,0,0,0,0
188784.0,Meijs Silvester,S,Netherlands,22.0,202.0,2023,Netherlands,Poland,2023-06-22,False,0,0,0,0,2,0,3,5,0,0,0,0,0,0,0,0,0,0,0,0,0,0,0,0
188784.0,Meijs Silvester,S,Netherlands,22.0,202.0,2023,Netherlands,Iran,2023-06-24,True,0,1,4,5,2,0,21,23,0,0,0,0,1,0,0,1,0,0,0,0,0,0,0,0
188784.0,Meijs Silvester,S,Netherlands,22.0,202.0,2023,Netherlands,Serbia,2023-06-25,False,0,0,0,0,2,0,1,3,0,0,0,0,0,0,0,0,0,0,0,0,0,0,0,0
188784.0,Meijs Silvester,S,Netherlands,22.0,202.0,2023,Canada,Netherlands,2023-07-05,True,1,1,1,3,3,0,12,15,0,0,1,1,0,1,2,3,0,0,0,0,0,0,1,1
188784.0,Meijs Silvester,S,Netherlands,22.0,202.0,2023,Brazil,Netherlands,2023-07-06,False,0,1,3,4,6,2,19,27,0,0,1,1,1,0,1,2,0,0,0,0,1,1,0,2
188784.0,Meijs Silvester,S,Netherlands,22.0,202.0,2023,Japan,Netherlands,2023-07-07,False,0,0,0,0,0,0,7,7,0,1,0,1,1,0,1,2,0,0,0,0,0,0,0,0
188784.0,Meijs Silvester,S,Netherlands,22.0,202.0,2023,Slovenia,Netherlands,2023-07-09,False,0,0,1,1,1,0,0,1,0,0,0,0,0,0,0,0,0,0,0,0,0,0,0,0
131980.0,Jorna Gijs,OH,Netherlands,34.0,196.0,2023,USA,Netherlands,2023-06-07,False,0,0,6,6,0,0,0,0,2,1,2,5,0,1,0,1,3,3,15,21,2,0,0,2
131980.0,Jorna Gijs,OH,Netherlands,34.0,196.0,2023,Netherlands,Cuba,2023-06-08,True,0,1,7,8,0,1,4,5,0,3,1,4,0,6,1,7,4,1,10,15,3,0,1,4
131980.0,Jorna Gijs,OH,Netherlands,34.0,196.0,2023,Netherlands,Germany,2023-06-09,True,0,0,10,10,0,0,3,3,1,2,3,6,0,2,1,3,3,0,13,16,2,2,1,5
131980.0,Jorna Gijs,OH,Netherlands,34.0,196.0,2023,Argentina,Netherlands,2023-06-11,False,0,1,3,4,0,0,2,2,0,0,3,3,0,0,0,0,3,0,6,9,1,0,0,1
131980.0,Jorna Gijs,OH,Netherlands,34.0,196.0,2023,Netherlands,China,2023-06-20,True,0,1,8,9,0,0,1,1,2,2,5,9,1,4,5,10,2,2,10,14,3,0,1,4
131980.0,Jorna Gijs,OH,Netherlands,34.0,196.0,2023,Netherlands,Poland,2023-06-22,False,0,1,14,15,0,0,5,5,6,1,6,13,0,5,1,6,7,3,24,34,4,5,0,9
131980.0,Jorna Gijs,OH,Netherlands,34.0,196.0,2023,Netherlands,Iran,2023-06-24,True,0,1,9,10,0,1,2,3,4,1,3,8,0,1,0,1,5,0,13,18,1,3,1,5
131980.0,Jorna Gijs,OH,Netherlands,34.0,196.0,2023,Netherlands,Serbia,2023-06-25,False,0,0,0,0,0,0,0,0,0,1,0,1,0,1,0,1,1,0,1,2,0,0,0,0
131980.0,Jorna Gijs,OH,Netherlands,34.0,196.0,2023,Canada,Netherlands,2023-07-05,True,0,2,17,19,0,0,4,4,10,3,10,23,2,3,1,6,6,3,16,25,7,0,0,7
131980.0,Jorna Gijs,OH,Netherlands,34.0,196.0,2023,Brazil,Netherlands,2023-07-06,False,1,1,5,7,0,0,2,2,1,2,6,9,1,0,3,4,0,0,4,4,1,1,0,2
131980.0,Jorna Gijs,OH,Netherlands,34.0,196.0,2023,Japan,Netherlands,2023-07-07,False,0,2,13,15,0,0,4,4,7,6,9,22,3,3,1,7,10,1,27,38,3,8,1,12
131980.0,Jorna Gijs,OH,Netherlands,34.0,196.0,2023,Slovenia,Netherlands,2023-07-09,False,0,0,2,2,0,0,0,0,1,1,2,4,0,0,0,0,4,0,4,8,0,1,1,2
156678.0,Plak Fabian,MB,Netherlands,26.0,198.0,2023,USA,Netherlands,2023-06-07,False,0,3,6,9,0,0,2,2,5,0,6,11,0,1,4,5,0,0,0,0,3,0,0,3
156678.0,Plak Fabian,MB,Netherlands,26.0,198.0,2023,Netherlands,Cuba,2023-06-08,True,0,5,8,13,0,0,0,0,5,0,5,10,1,4,3,8,0,0,1,1,3,0,0,3
156678.0,Plak Fabian,MB,Netherlands,26.0,198.0,2023,Netherlands,Germany,2023-06-09,True,2,4,11,17,0,0,1,1,4,2,2,8,1,3,2,6,0,0,1,1,0,3,0,3
156678.0,Plak Fabian,MB,Netherlands,26.0,198.0,2023,Argentina,Netherlands,2023-06-11,False,1,2,10,13,0,1,2,3,9,1,5,15,2,5,4,11,0,0,0,0,4,2,0,6
156678.0,Plak Fabian,MB,Netherlands,26.0,198.0,2023,Netherlands,China,2023-06-20,True,0,0,0,0,0,0,0,0,0,0,0,0,0,0,0,0,0,0,0,0,0,0,0,0
156678.0,Plak Fabian,MB,Netherlands,26.0,198.0,2023,Netherlands,Poland,2023-06-22,False,3,6,5,14,0,0,0,0,9,0,1,10,4,7,4,15,0,0,0,0,2,0,0,2
156678.0,Plak Fabian,MB,Netherlands,26.0,198.0,2023,Netherlands,Iran,2023-06-24,True,0,4,10,14,0,1,1,2,2,2,8,12,5,9,3,17,0,0,0,0,1,0,0,1
156678.0,Plak Fabian,MB,Netherlands,26.0,198.0,2023,Netherlands,Serbia,2023-06-25,False,0,5,9,14,0,0,1,1,2,3,3,8,5,10,6,21,0,1,0,1,4,0,0,4
156678.0,Plak Fabian,MB,Netherlands,26.0,198.0,2023,Canada,Netherlands,2023-07-05,True,0,3,6,9,0,0,0,0,6,2,2,10,2,4,1,7,0,0,0,0,1,0,0,1
156678.0,Plak Fabian,MB,Netherlands,26.0,198.0,2023,Brazil,Netherlands,2023-07-06,False,0,4,5,9,0,0,2,2,4,1,1,6,1,2,4,7,0,1,2,3,3,0,2,5
156678.0,Plak Fabian,MB,Netherlands,26.0,198.0,2023,Japan,Netherlands,2023-07-07,False,1,5,7,13,0,0,0,0,5,2,3,10,2,7,4,13,0,0,0,0,1,2,1,4
156678.0,Plak Fabian,MB,Netherlands,26.0,198.0,2023,Slovenia,Netherlands,2023-07-09,False,0,4,8,12,0,0,0,0,6,0,3,9,2,3,2,7,0,0,0,0,1,0,1,2
170436.0,Tuinstra Bennie Junior,OH,Netherlands,23.0,200.0,2023,USA,Netherlands,2023-06-07,False,0,0,4,4,0,0,1,1,2,3,9,14,0,0,0,0,2,1,5,8,1,0,0,1
170436.0,Tuinstra Bennie Junior,OH,Netherlands,23.0,200.0,2023,Netherlands,Cuba,2023-06-08,True,1,2,5,8,0,0,0,0,2,0,3,5,0,0,0,0,2,0,2,4,0,1,0,1
170436.0,Tuinstra Bennie Junior,OH,Netherlands,23.0,200.0,2023,Netherlands,Germany,2023-06-09,True,1,2,2,5,0,0,2,2,3,2,2,7,0,0,0,0,4,0,6,10,2,1,1,4
170436.0,Tuinstra Bennie Junior,OH,Netherlands,23.0,200.0,2023,Argentina,Netherlands,2023-06-11,False,2,5,10,17,0,0,4,4,18,6,6,30,0,0,2,2,10,3,21,34,5,5,2,12
170436.0,Tuinstra Bennie Junior,OH,Netherlands,23.0,200.0,2023,Netherlands,China,2023-06-20,True,0,0,1,1,0,0,0,0,0,0,0,0,0,1,0,1,0,0,1,1,0,0,0,0
170436.0,Tuinstra Bennie Junior,OH,Netherlands,23.0,200.0,2023,Netherlands,Poland,2023-06-22,False,0,2,1,3,0,0,0,0,0,0,0,0,0,0,0,0,0,0,1,1,0,0,0,0
170436.0,Tuinstra Bennie Junior,OH,Netherlands,23.0,200.0,2023,Netherlands,Iran,2023-06-24,True,3,2,11,16,0,0,1,1,16,8,7,31,1,3,2,6,5,1,20,26,2,1,3,6
170436.0,Tuinstra Bennie Junior,OH,Netherlands,23.0,200.0,2023,Netherlands,Serbia,2023-06-25,False,4,3,15,22,0,0,2,2,12,6,12,30,1,1,1,3,8,1,19,28,1,1,0,2
170436.0,Tuinstra Bennie Junior,OH,Netherlands,23.0,200.0,2023,Canada,Netherlands,2023-07-05,True,0,0,1,1,0,0,0,0,3,0,0,3,0,1,0,1,2,0,4,6,0,0,1,1
170436.0,Tuinstra Bennie Junior,OH,Netherlands,23.0,200.0,2023,Brazil,Netherlands,2023-07-06,False,0,1,7,8,0,0,6,6,6,4,9,19,1,1,0,2,7,0,11,18,8,2,0,10
170436.0,Tuinstra Bennie Junior,OH,Netherlands,23.0,200.0,2023,Japan,Netherlands,2023-07-07,False,0,2,3,5,0,0,1,1,2,1,3,6,0,1,0,1,4,0,5,9,3,3,0,6
170436.0,Tuinstra Bennie Junior,OH,Netherlands,23.0,200.0,2023,Slovenia,Netherlands,2023-07-09,False,0,3,6,9,0,0,0,0,5,4,7,16,0,3,0,3,3,2,18,23,3,1,0,4
137498.0,Abdel-Aziz Nimir,O,Netherlands,32.0,201.0,2023,USA,Netherlands,2023-06-07,False,2,3,10,15,0,0,1,1,21,6,6,33,1,2,1,4,0,0,0,0,4,1,0,5
137498.0,Abdel-Aziz Nimir,O,Netherlands,32.0,201.0,2023,Netherlands,Cuba,2023-06-08,True,0,7,7,14,0,0,3,3,22,4,13,39,0,5,3,8,0,0,1,1,1,2,0,3
137498.0,Abdel-Aziz Nimir,O,Netherlands,32.0,201.0,2023,Netherlands,Germany,2023-06-09,True,3,6,9,18,0,0,3,3,10,8,7,25,1,1,3,5,1,0,0,1,4,0,1,5
137498.0,Abdel-Aziz Nimir,O,Netherlands,32.0,201.0,2023,Argentina,Netherlands,2023-06-11,False,1,5,14,20,0,0,3,3,16,11,14,41,0,1,3,4,1,0,0,1,5,6,3,14
137498.0,Abdel-Aziz Nimir,O,Netherlands,32.0,201.0,2023,Netherlands,China,2023-06-20,True,0,3,7,10,0,0,3,3,17,4,8,29,2,1,1,4,0,0,0,0,3,0,0,3
137498.0,Abdel-Aziz Nimir,O,Netherlands,32.0,201.0,2023,Netherlands,Poland,2023-06-22,False,2,7,14,23,0,0,1,1,21,5,11,37,0,1,1,2,1,0,0,1,2,2,0,4
137498.0,Abdel-Aziz Nimir,O,Netherlands,32.0,201.0,2023,Netherlands,Iran,2023-06-24,True,6,3,9,18,0,0,1,1,20,7,10,37,1,1,3,5,0,1,0,1,5,1,0,6
137498.0,Abdel-Aziz Nimir,O,Netherlands,32.0,201.0,2023,Netherlands,Serbia,2023-06-25,False,7,1,9,17,0,0,1,1,7,4,10,21,0,1,0,1,0,0,0,0,3,0,0,3
137498.0,Abdel-Aziz Nimir,O,Netherlands,32.0,201.0,2023,Canada,Netherlands,2023-07-05,True,2,7,3,12,0,0,3,3,22,5,11,38,0,4,0,4,0,0,0,0,4,3,2,9
137498.0,Abdel-Aziz Nimir,O,Netherlands,32.0,201.0,2023,Brazil,Netherlands,2023-07-06,False,0,3,2,5,0,0,2,2,7,5,9,21,1,1,0,2,0,0,0,0,3,3,0,6
137498.0,Abdel-Aziz Nimir,O,Netherlands,32.0,201.0,2023,Japan,Netherlands,2023-07-07,False,0,2,6,8,0,0,0,0,3,0,0,3,0,0,0,0,0,0,0,0,1,0,0,1
137498.0,Abdel-Aziz Nimir,O,Netherlands,32.0,201.0,2023,Slovenia,Netherlands,2023-07-09,False,2,6,11,19,0,0,3,3,18,7,6,31,2,2,2,6,0,0,0,0,3,2,0,5
154521.0,Ter Maat Wouter,O,Netherlands,32.0,200.0,2023,Netherlands,China,2023-06-20,True,0,0,0,0,0,0,0,0,0,0,0,0,0,0,0,0,0,0,0,0,0,0,0,0
154521.0,Ter Maat Wouter,O,Netherlands,32.0,200.0,2023,Netherlands,Poland,2023-06-22,False,0,0,1,1,0,0,0,0,2,1,0,3,0,1,0,1,0,0,0,0,0,0,0,0
154521.0,Ter Maat Wouter,O,Netherlands,32.0,200.0,2023,Netherlands,Iran,2023-06-24,True,1,2,5,8,0,0,1,1,2,2,1,5,1,0,0,1,0,0,0,0,2,0,0,2
154521.0,Ter Maat Wouter,O,Netherlands,32.0,200.0,2023,Netherlands,Serbia,2023-06-25,False,0,2,7,9,0,0,1,1,13,5,3,21,0,2,1,3,0,0,0,0,4,3,2,9
154521.0,Ter Maat Wouter,O,Netherlands,32.0,200.0,2023,Canada,Netherlands,2023-07-05,True,0,1,0,1,0,0,1,1,2,0,1,3,0,0,0,0,0,0,0,0,0,0,0,0
154521.0,Ter Maat Wouter,O,Netherlands,32.0,200.0,2023,Brazil,Netherlands,2023-07-06,False,0,2,1,3,0,0,0,0,9,3,3,15,1,1,1,3,0,0,1,1,0,1,0,1
154521.0,Ter Maat Wouter,O,Netherlands,32.0,200.0,2023,Japan,Netherlands,2023-07-07,False,1,5,7,13,0,0,1,1,18,6,13,37,2,1,3,6,1,0,2,3,4,4,0,8
154521.0,Ter Maat Wouter,O,Netherlands,32.0,200.0,2023,Slovenia,Netherlands,2023-07-09,False,0,1,1,2,0,0,0,0,0,0,0,0,0,0,0,0,1,0,0,1,0,0,0,0
121992.0,Andringa Robbert,L,Netherlands,33.0,192.0,2023,USA,Netherlands,2023-06-07,False,0,0,0,0,0,0,4,4,0,0,0,0,0,0,0,0,4,0,8,12,7,1,3,11
121992.0,Andringa Robbert,L,Netherlands,33.0,192.0,2023,Netherlands,Cuba,2023-06-08,True,0,0,0,0,0,0,4,4,0,0,0,0,0,0,0,0,5,1,18,24,8,2,0,10
121992.0,Andringa Robbert,L,Netherlands,33.0,192.0,2023,Netherlands,Germany,2023-06-09,True,0,0,0,0,0,0,3,3,0,0,0,0,0,0,0,0,0,0,16,16,8,4,0,12
121992.0,Andringa Robbert,L,Netherlands,33.0,192.0,2023,Argentina,Netherlands,2023-06-11,False,0,0,0,0,0,0,7,7,0,0,0,0,0,0,0,0,9,0,11,20,12,6,0,18
121992.0,Andringa Robbert,L,Netherlands,33.0,192.0,2023,Netherlands,China,2023-06-20,True,0,0,0,0,0,0,4,4,0,0,0,0,0,0,0,0,4,2,16,22,9,1,1,11
121992.0,Andringa Robbert,L,Netherlands,33.0,192.0,2023,Netherlands,Poland,2023-06-22,False,0,0,0,0,0,0,2,2,0,0,0,0,0,0,0,0,2,0,17,19,6,1,0,7
121992.0,Andringa Robbert,L,Netherlands,33.0,192.0,2023,Netherlands,Iran,2023-06-24,True,0,0,0,0,0,0,4,4,0,0,0,0,0,0,0,0,5,2,15,22,8,2,1,11
121992.0,Andringa Robbert,L,Netherlands,33.0,192.0,2023,Netherlands,Serbia,2023-06-25,False,0,0,0,0,0,0,2,2,0,0,0,0,0,0,0,0,8,0,15,23,7,5,2,14
121992.0,Andringa Robbert,L,Netherlands,33.0,192.0,2023,Canada,Netherlands,2023-07-05,True,0,0,0,0,0,0,3,3,0,0,0,0,0,0,0,0,1,0,16,17,8,2,0,10
121992.0,Andringa Robbert,L,Netherlands,33.0,192.0,2023,Brazil,Netherlands,2023-07-06,False,0,0,0,0,0,0,2,2,0,0,0,0,0,0,0,0,3,1,10,14,7,3,2,12
121992.0,Andringa Robbert,L,Netherlands,33.0,192.0,2023,Japan,Netherlands,2023-07-07,False,0,0,0,0,0,0,3,3,0,0,0,0,0,0,0,0,2,2,13,17,0,5,1,6
121992.0,Andringa Robbert,L,Netherlands,33.0,192.0,2023,Slovenia,Netherlands,2023-07-09,False,0,0,0,0,0,0,4,4,0,0,0,0,0,0,0,0,2,0,9,11,3,3,3,9
150703.0,Wiltenburg Twan,MB,Netherlands,27.0,205.0,2023,USA,Netherlands,2023-06-07,False,0,2,10,12,0,0,0,0,2,0,3,5,1,1,2,4,0,0,1,1,4,1,2,7
150703.0,Wiltenburg Twan,MB,Netherlands,27.0,205.0,2023,Netherlands,Cuba,2023-06-08,True,0,2,10,12,0,0,1,1,1,0,3,4,1,4,4,9,0,0,1,1,1,2,1,4
150703.0,Wiltenburg Twan,MB,Netherlands,27.0,205.0,2023,Netherlands,Germany,2023-06-09,True,0,0,11,11,0,0,0,0,2,0,0,2,4,3,3,10,0,0,0,0,0,3,0,3
150703.0,Wiltenburg Twan,MB,Netherlands,27.0,205.0,2023,Argentina,Netherlands,2023-06-11,False,0,5,12,17,0,0,1,1,3,0,5,8,4,8,5,17,0,0,0,0,0,1,1,2
150703.0,Wiltenburg Twan,MB,Netherlands,27.0,205.0,2023,Netherlands,China,2023-06-20,True,0,2,10,12,0,1,0,1,2,1,2,5,2,1,2,5,0,0,0,0,0,0,0,0
150703.0,Wiltenburg Twan,MB,Netherlands,27.0,205.0,2023,Netherlands,Poland,2023-06-22,False,1,2,13,16,0,0,0,0,2,1,3,6,2,2,1,5,0,0,0,0,1,3,0,4
150703.0,Wiltenburg Twan,MB,Netherlands,27.0,205.0,2023,Netherlands,Iran,2023-06-24,True,0,0,2,2,0,0,0,0,1,0,0,1,0,0,4,4,0,0,0,0,0,0,0,0
150703.0,Wiltenburg Twan,MB,Netherlands,27.0,205.0,2023,Netherlands,Serbia,2023-06-25,False,0,1,8,9,0,0,1,1,4,0,0,4,1,5,4,10,0,0,1,1,1,0,1,2
150703.0,Wiltenburg Twan,MB,Netherlands,27.0,205.0,2023,Canada,Netherlands,2023-07-05,True,2,2,14,18,0,0,3,3,5,1,2,8,2,1,2,5,0,0,0,0,2,1,1,4
150703.0,Wiltenburg Twan,MB,Netherlands,27.0,205.0,2023,Brazil,Netherlands,2023-07-06,False,0,1,13,14,0,0,0,0,2,2,1,5,0,2,2,4,0,0,2,2,3,0,0,3
150703.0,Wiltenburg Twan,MB,Netherlands,27.0,205.0,2023,Japan,Netherlands,2023-07-07,False,0,2,11,13,0,0,0,0,5,0,1,6,1,1,4,6,0,0,0,0,3,0,0,3
150703.0,Wiltenburg Twan,MB,Netherlands,27.0,205.0,2023,Slovenia,Netherlands,2023-07-09,False,0,2,8,10,0,0,0,0,5,0,0,5,2,2,2,6,0,0,1,1,1,0,2,3
188785.0,Lipke Niels,L,Netherlands,21.0,180.0,2023,USA,Netherlands,2023-06-07,False,0,0,0,0,0,0,0,0,0,0,0,0,0,0,0,0,0,0,0,0,0,0,0,0
188785.0,Lipke Niels,L,Netherlands,21.0,180.0,2023,Netherlands,Cuba,2023-06-08,True,0,0,0,0,0,0,0,0,0,0,0,0,0,0,0,0,0,0,0,0,0,0,0,0
188785.0,Lipke Niels,L,Netherlands,21.0,180.0,2023,Netherlands,Germany,2023-06-09,True,0,0,0,0,0,0,0,0,0,0,0,0,0,0,0,0,0,0,0,0,0,0,0,0
188785.0,Lipke Niels,L,Netherlands,21.0,180.0,2023,Argentina,Netherlands,2023-06-11,False,0,0,0,0,0,0,0,0,0,0,0,0,0,0,0,0,0,0,0,0,0,0,0,0
188785.0,Lipke Niels,L,Netherlands,21.0,180.0,2023,Netherlands,China,2023-06-20,True,0,0,0,0,0,0,0,0,0,0,0,0,0,0,0,0,0,0,0,0,0,0,0,0
188785.0,Lipke Niels,L,Netherlands,21.0,180.0,2023,Netherlands,Poland,2023-06-22,False,0,0,0,0,0,0,0,0,0,0,0,0,0,0,0,0,0,0,0,0,0,0,0,0
188785.0,Lipke Niels,L,Netherlands,21.0,180.0,2023,Netherlands,Iran,2023-06-24,True,0,0,0,0,0,0,0,0,0,0,0,0,0,0,0,0,0,0,0,0,0,0,0,0
188785.0,Lipke Niels,L,Netherlands,21.0,180.0,2023,Netherlands,Serbia,2023-06-25,False,0,0,0,0,0,0,0,0,0,0,0,0,0,0,0,0,0,0,0,0,0,0,0,0
188785.0,Lipke Niels,L,Netherlands,21.0,180.0,2023,Canada,Netherlands,2023-07-05,True,0,0,0,0,0,0,0,0,0,0,0,0,0,0,0,0,0,0,0,0,0,0,0,0
188785.0,Lipke Niels,L,Netherlands,21.0,180.0,2023,Brazil,Netherlands,2023-07-06,False,0,0,0,0,0,0,0,0,0,0,0,0,0,0,0,0,0,0,0,0,0,0,0,0
188785.0,Lipke Niels,L,Netherlands,21.0,180.0,2023,Japan,Netherlands,2023-07-07,False,0,0,0,0,0,0,0,0,0,0,0,0,0,0,0,0,0,0,0,0,0,0,0,0
188785.0,Lipke Niels,L,Netherlands,21.0,180.0,2023,Slovenia,Netherlands,2023-07-09,False,0,0,0,0,0,0,0,0,0,0,0,0,0,0,0,0,0,0,0,0,0,0,0,0
153388.0,Popiwczak Jakub,L,Poland,27.0,180.0,2023,Poland,Slovenia,2023-07-05,True,0,0,0,0,0,0,1,1,0,0,0,0,0,0,0,0,4,1,11,16,5,5,0,10
153388.0,Popiwczak Jakub,L,Poland,27.0,180.0,2023,Poland,Brazil,2023-07-07,True,0,0,0,0,0,0,4,4,0,0,0,0,0,0,0,0,2,0,10,12,1,1,0,2
153388.0,Popiwczak Jakub,L,Poland,27.0,180.0,2023,Poland,Canada,2023-07-08,True,0,0,0,0,0,0,1,1,0,0,0,0,0,0,0,0,6,2,18,26,4,4,0,8
153388.0,Popiwczak Jakub,L,Poland,27.0,180.0,2023,Japan,Poland,2023-07-09,True,0,0,0,0,0,0,0,0,0,0,0,0,0,0,0,0,0,0,0,0,0,0,0,0
153388.0,Popiwczak Jakub,L,Poland,27.0,180.0,2023,Poland,Brazil,2023-07-20,True,0,0,0,0,0,0,0,0,0,0,0,0,0,0,0,0,0,0,0,0,0,0,0,0
153388.0,Popiwczak Jakub,L,Poland,27.0,180.0,2023,Japan,Poland,2023-07-22,True,0,0,0,0,0,0,0,0,0,0,0,0,0,0,0,0,0,0,0,0,0,0,0,0
153388.0,Popiwczak Jakub,L,Poland,27.0,180.0,2023,Poland,USA,2023-07-23,True,0,0,0,0,0,0,0,0,0,0,0,0,0,0,0,0,0,0,0,0,0,0,0,0
162105.0,Kaczmarek Lukasz,O,Poland,29.0,204.0,2023,Poland,Slovenia,2023-07-05,True,0,1,5,6,0,0,1,1,7,3,11,21,2,2,4,8,1,0,0,1,4,5,1,10
162105.0,Kaczmarek Lukasz,O,Poland,29.0,204.0,2023,Poland,Brazil,2023-07-07,True,0,0,6,6,0,1,0,1,7,1,2,10,1,0,1,2,0,0,0,0,1,1,0,2
162105.0,Kaczmarek Lukasz,O,Poland,29.0,204.0,2023,Poland,Canada,2023-07-08,True,0,2,9,11,0,0,3,3,9,0,7,16,1,3,4,8,1,0,0,1,2,1,1,4
162105.0,Kaczmarek Lukasz,O,Poland,29.0,204.0,2023,Japan,Poland,2023-07-09,True,1,1,12,14,0,0,4,4,11,0,6,17,0,4,1,5,0,0,0,0,5,3,1,9
162105.0,Kaczmarek Lukasz,O,Poland,29.0,204.0,2023,Poland,Brazil,2023-07-20,True,0,2,2,4,0,0,2,2,2,0,4,6,1,2,2,5,0,0,0,0,0,2,0,2
162105.0,Kaczmarek Lukasz,O,Poland,29.0,204.0,2023,Japan,Poland,2023-07-22,True,0,4,13,17,0,0,4,4,15,3,9,27,4,5,4,13,0,0,3,3,5,3,0,8
162105.0,Kaczmarek Lukasz,O,Poland,29.0,204.0,2023,Poland,USA,2023-07-23,True,1,3,13,17,0,0,0,0,23,4,8,35,1,3,3,7,0,0,1,1,3,4,1,8
115806.0,Kurek Bartosz,O,Poland,35.0,205.0,2023,Germany,Poland,2023-06-21,True,0,5,8,13,0,0,1,1,16,6,8,30,2,8,0,10,0,0,0,0,2,0,0,2
115806.0,Kurek Bartosz,O,Poland,35.0,205.0,2023,Netherlands,Poland,2023-06-22,True,0,2,6,8,0,0,0,0,6,1,5,12,0,1,1,2,0,0,0,0,3,0,0,3
115806.0,Kurek Bartosz,O,Poland,35.0,205.0,2023,Poland,USA,2023-06-24,False,0,3,7,10,0,0,3,3,10,4,11,25,1,3,0,4,0,1,0,1,3,2,0,5
115806.0,Kurek Bartosz,O,Poland,35.0,205.0,2023,Italy,Poland,2023-06-25,True,0,3,8,11,0,0,0,0,20,6,10,36,0,0,5,5,1,0,0,1,8,4,0,12
115806.0,Kurek Bartosz,O,Poland,35.0,205.0,2023,Poland,Slovenia,2023-07-05,True,2,4,11,17,0,0,3,3,8,6,8,22,0,1,7,8,1,0,0,1,3,0,0,3
115806.0,Kurek Bartosz,O,Poland,35.0,205.0,2023,Poland,Brazil,2023-07-07,True,0,5,2,7,0,0,1,1,10,2,8,20,0,3,0,3,1,1,0,2,3,0,1,4
115806.0,Kurek Bartosz,O,Poland,35.0,205.0,2023,Poland,Canada,2023-07-08,True,0,0,0,0,0,0,0,0,0,0,0,0,0,0,0,0,0,0,0,0,0,0,0,0
115806.0,Kurek Bartosz,O,Poland,35.0,205.0,2023,Japan,Poland,2023-07-09,True,0,0,0,0,0,0,0,0,0,0,0,0,0,0,0,0,0,0,0,0,0,0,0,0
115806.0,Kurek Bartosz,O,Poland,35.0,205.0,2023,Poland,Brazil,2023-07-20,True,0,3,5,8,0,0,0,0,6,5,4,15,1,3,0,4,0,0,0,0,3,1,0,4
115806.0,Kurek Bartosz,O,Poland,35.0,205.0,2023,Japan,Poland,2023-07-22,True,0,0,0,0,0,0,0,0,0,0,0,0,0,0,0,0,0,0,0,0,0,0,0,0
115806.0,Kurek Bartosz,O,Poland,35.0,205.0,2023,Poland,USA,2023-07-23,True,0,0,0,0,0,0,0,0,0,0,0,0,0,0,0,0,0,0,0,0,0,0,0,0
119646.0,Leon Venero Wilfredo,OH,Poland,30.0,202.0,2023,Germany,Poland,2023-06-21,True,2,3,12,17,0,0,5,5,15,7,15,37,2,0,3,5,4,1,33,38,4,4,0,8
119646.0,Leon Venero Wilfredo,OH,Poland,30.0,202.0,2023,Netherlands,Poland,2023-06-22,True,0,3,2,5,0,0,0,0,13,2,3,18,1,3,0,4,0,0,5,5,0,0,0,0
119646.0,Leon Venero Wilfredo,OH,Poland,30.0,202.0,2023,Poland,USA,2023-06-24,False,0,2,2,4,0,0,2,2,3,2,8,13,0,1,3,4,1,2,12,15,1,1,1,3
119646.0,Leon Venero Wilfredo,OH,Poland,30.0,202.0,2023,Italy,Poland,2023-06-25,True,2,3,9,14,0,0,4,4,14,3,11,28,0,3,2,5,5,2,29,36,3,2,1,6
119646.0,Leon Venero Wilfredo,OH,Poland,30.0,202.0,2023,Poland,Slovenia,2023-07-05,True,0,0,0,0,0,0,0,0,0,0,0,0,0,0,0,0,0,0,0,0,0,0,0,0
119646.0,Leon Venero Wilfredo,OH,Poland,30.0,202.0,2023,Poland,Brazil,2023-07-07,True,1,7,7,15,0,0,0,0,20,0,13,33,1,2,1,4,1,3,16,20,4,2,0,6
119646.0,Leon Venero Wilfredo,OH,Poland,30.0,202.0,2023,Poland,Canada,2023-07-08,True,2,2,1,5,0,0,0,0,4,1,3,8,0,0,0,0,0,0,0,0,0,0,0,0
119646.0,Leon Venero Wilfredo,OH,Poland,30.0,202.0,2023,Japan,Poland,2023-07-09,True,3,5,4,12,0,1,2,3,10,0,9,19,3,3,0,6,1,1,5,7,2,1,0,3
119646.0,Leon Venero Wilfredo,OH,Poland,30.0,202.0,2023,Poland,Brazil,2023-07-20,True,2,3,14,19,0,0,3,3,6,4,11,21,3,3,0,6,2,1,19,22,5,1,1,7
119646.0,Leon Venero Wilfredo,OH,Poland,30.0,202.0,2023,Japan,Poland,2023-07-22,True,0,4,7,11,0,0,5,5,21,2,6,29,2,2,5,9,4,3,7,14,1,1,2,4
119646.0,Leon Venero Wilfredo,OH,Poland,30.0,202.0,2023,Poland,USA,2023-07-23,True,2,1,5,8,0,0,0,0,3,2,7,12,2,2,3,7,1,1,15,17,1,0,1,2
150742.0,Bednorz Bartosz,OH,Poland,29.0,201.0,2023,Germany,Poland,2023-06-21,True,1,2,12,15,0,0,5,5,10,4,6,20,3,3,1,7,1,0,13,14,7,1,0,8
150742.0,Bednorz Bartosz,OH,Poland,29.0,201.0,2023,Netherlands,Poland,2023-06-22,True,0,0,0,0,0,0,0,0,0,0,0,0,0,0,0,0,0,0,0,0,0,0,0,0
150742.0,Bednorz Bartosz,OH,Poland,29.0,201.0,2023,Poland,USA,2023-06-24,False,0,2,7,9,0,0,4,4,5,3,4,12,1,2,1,4,6,1,13,20,3,1,0,4
150742.0,Bednorz Bartosz,OH,Poland,29.0,201.0,2023,Italy,Poland,2023-06-25,True,0,0,0,0,0,0,0,0,0,0,1,1,0,0,0,0,1,0,0,1,0,0,0,0
150742.0,Bednorz Bartosz,OH,Poland,29.0,201.0,2023,Poland,Slovenia,2023-07-05,True,0,4,10,14,0,0,0,0,13,1,10,24,1,2,2,5,2,0,10,12,2,0,1,3
150742.0,Bednorz Bartosz,OH,Poland,29.0,201.0,2023,Poland,Brazil,2023-07-07,True,2,1,16,19,0,0,1,1,9,4,6,19,0,4,3,7,3,0,18,21,3,2,0,5
150742.0,Bednorz Bartosz,OH,Poland,29.0,201.0,2023,Poland,Canada,2023-07-08,True,0,1,2,3,0,0,0,0,0,0,0,0,0,0,0,0,0,0,0,0,0,0,0,0
150742.0,Bednorz Bartosz,OH,Poland,29.0,201.0,2023,Japan,Poland,2023-07-09,True,0,0,2,2,0,0,0,0,0,0,1,1,0,0,0,0,0,0,2,2,1,0,1,2
150742.0,Bednorz Bartosz,OH,Poland,29.0,201.0,2023,Poland,Brazil,2023-07-20,True,0,0,0,0,0,0,0,0,1,0,0,1,0,0,0,0,0,0,0,0,0,0,0,0
150742.0,Bednorz Bartosz,OH,Poland,29.0,201.0,2023,Japan,Poland,2023-07-22,True,0,0,1,1,0,0,0,0,2,1,4,7,0,0,0,0,0,0,2,2,1,0,0,1
150742.0,Bednorz Bartosz,OH,Poland,29.0,201.0,2023,Poland,USA,2023-07-23,True,0,0,0,0,0,0,0,0,0,0,0,0,0,0,0,0,0,0,0,0,0,0,0,0
142679.0,Sliwka Aleksander,OH,Poland,28.0,196.0,2023,Poland,Slovenia,2023-07-05,True,1,2,17,20,0,0,5,5,18,3,15,36,1,8,4,13,12,1,28,41,7,5,0,12
142679.0,Sliwka Aleksander,OH,Poland,28.0,196.0,2023,Poland,Brazil,2023-07-07,True,0,0,1,1,0,0,0,0,1,0,1,2,0,0,0,0,0,0,2,2,2,0,0,2
142679.0,Sliwka Aleksander,OH,Poland,28.0,196.0,2023,Poland,Canada,2023-07-08,True,0,2,11,13,0,0,5,5,7,0,5,12,1,2,0,3,4,1,8,13,4,5,0,9
142679.0,Sliwka Aleksander,OH,Poland,28.0,196.0,2023,Japan,Poland,2023-07-09,True,0,2,12,14,0,0,5,5,11,2,4,17,0,3,1,4,2,0,17,19,4,1,0,5
142679.0,Sliwka Aleksander,OH,Poland,28.0,196.0,2023,Poland,Brazil,2023-07-20,True,2,1,7,10,0,0,5,5,12,2,4,18,2,1,1,4,1,3,12,16,1,2,0,3
142679.0,Sliwka Aleksander,OH,Poland,28.0,196.0,2023,Japan,Poland,2023-07-22,True,1,2,15,18,0,0,4,4,12,1,6,19,1,3,1,5,3,4,25,32,6,2,0,8
142679.0,Sliwka Aleksander,OH,Poland,28.0,196.0,2023,Poland,USA,2023-07-23,True,0,3,16,19,1,0,4,5,13,4,8,25,1,5,0,6,3,0,15,18,6,1,0,7
115794.0,Lomacz Grzegorz,S,Poland,36.0,187.0,2023,Poland,France,2023-06-07,True,0,0,0,0,3,0,3,6,0,0,0,0,0,0,0,0,0,0,2,2,0,1,0,1
115794.0,Lomacz Grzegorz,S,Poland,36.0,187.0,2023,Poland,Iran,2023-06-08,True,0,0,12,12,19,1,71,91,0,0,0,0,1,1,3,5,0,0,1,1,4,0,4,8
115794.0,Lomacz Grzegorz,S,Poland,36.0,187.0,2023,Poland,Bulgaria,2023-06-09,True,0,0,6,6,4,0,32,36,0,0,0,0,0,0,1,1,0,0,0,0,1,0,0,1
115794.0,Lomacz Grzegorz,S,Poland,36.0,187.0,2023,Serbia,Poland,2023-06-11,False,0,0,4,4,14,0,27,41,0,0,0,0,0,1,1,2,0,0,0,0,2,0,0,2
115794.0,Lomacz Grzegorz,S,Poland,36.0,187.0,2023,Germany,Poland,2023-06-21,True,1,1,11,13,23,0,55,78,0,0,0,0,0,1,1,2,0,0,0,0,8,0,2,10
115794.0,Lomacz Grzegorz,S,Poland,36.0,187.0,2023,Netherlands,Poland,2023-06-22,True,0,0,7,7,10,0,34,44,1,0,0,1,0,0,0,0,0,0,0,0,2,2,0,4
115794.0,Lomacz Grzegorz,S,Poland,36.0,187.0,2023,Poland,USA,2023-06-24,False,0,1,3,4,4,0,32,36,0,0,0,0,0,1,0,1,0,0,0,0,2,1,0,3
115794.0,Lomacz Grzegorz,S,Poland,36.0,187.0,2023,Italy,Poland,2023-06-25,True,0,0,12,12,20,0,54,74,0,0,0,0,1,2,4,7,0,0,1,1,11,4,2,17
115794.0,Lomacz Grzegorz,S,Poland,36.0,187.0,2023,Poland,Slovenia,2023-07-05,True,0,0,0,0,3,0,8,11,0,0,0,0,0,0,0,0,0,0,1,1,1,0,0,1
115794.0,Lomacz Grzegorz,S,Poland,36.0,187.0,2023,Poland,Brazil,2023-07-07,True,0,0,0,0,0,0,0,0,0,0,0,0,0,0,0,0,0,0,0,0,0,0,0,0
115794.0,Lomacz Grzegorz,S,Poland,36.0,187.0,2023,Poland,Canada,2023-07-08,True,0,0,10,10,13,1,43,57,1,0,0,1,1,0,1,2,0,0,0,0,5,3,1,9
115794.0,Lomacz Grzegorz,S,Poland,36.0,187.0,2023,Japan,Poland,2023-07-09,True,0,0,1,1,2,0,6,8,0,0,0,0,0,2,0,2,0,0,0,0,1,1,0,2
115794.0,Lomacz Grzegorz,S,Poland,36.0,187.0,2023,Poland,Brazil,2023-07-20,True,0,0,0,0,0,0,0,0,0,0,0,0,0,0,0,0,0,0,0,0,0,0,0,0
115794.0,Lomacz Grzegorz,S,Poland,36.0,187.0,2023,Japan,Poland,2023-07-22,True,0,0,0,0,0,0,1,1,0,0,0,0,0,0,0,0,0,0,0,0,0,0,0,0
115794.0,Lomacz Grzegorz,S,Poland,36.0,187.0,2023,Poland,USA,2023-07-23,True,0,0,0,0,0,0,0,0,0,0,0,0,0,0,0,0,0,0,0,0,0,0,0,0
152870.0,Kochanowski Jakub,MB,Poland,26.0,199.0,2023,Germany,Poland,2023-06-21,True,2,1,7,10,0,0,1,1,1,0,3,4,0,0,2,2,0,0,0,0,1,0,0,1
152870.0,Kochanowski Jakub,MB,Poland,26.0,199.0,2023,Netherlands,Poland,2023-06-22,True,5,2,14,21,0,0,0,0,10,0,1,11,2,4,3,9,0,0,0,0,1,2,0,3
152870.0,Kochanowski Jakub,MB,Poland,26.0,199.0,2023,Poland,USA,2023-06-24,False,1,1,8,10,0,0,0,0,3,0,2,5,2,4,6,12,0,0,1,1,6,1,0,7
152870.0,Kochanowski Jakub,MB,Poland,26.0,199.0,2023,Italy,Poland,2023-06-25,True,2,1,10,13,0,1,4,5,8,0,2,10,4,3,3,10,0,0,1,1,2,0,0,2
152870.0,Kochanowski Jakub,MB,Poland,26.0,199.0,2023,Poland,Slovenia,2023-07-05,True,1,3,10,14,0,0,1,1,6,0,2,8,2,5,7,14,0,0,1,1,3,1,0,4
152870.0,Kochanowski Jakub,MB,Poland,26.0,199.0,2023,Poland,Brazil,2023-07-07,True,0,5,15,20,0,0,1,1,2,2,0,4,1,7,6,14,1,0,0,1,5,0,0,5
152870.0,Kochanowski Jakub,MB,Poland,26.0,199.0,2023,Poland,Canada,2023-07-08,True,0,0,0,0,0,0,0,0,0,0,0,0,0,0,0,0,0,0,0,0,0,0,0,0
152870.0,Kochanowski Jakub,MB,Poland,26.0,199.0,2023,Japan,Poland,2023-07-09,True,0,0,7,7,0,0,1,1,6,0,2,8,3,5,7,15,0,0,0,0,0,0,0,0
152870.0,Kochanowski Jakub,MB,Poland,26.0,199.0,2023,Poland,Brazil,2023-07-20,True,1,1,5,7,0,0,1,1,4,0,2,6,2,4,3,9,0,0,0,0,1,2,0,3
152870.0,Kochanowski Jakub,MB,Poland,26.0,199.0,2023,Japan,Poland,2023-07-22,True,0,3,2,5,0,0,0,0,1,0,1,2,1,3,0,4,0,0,0,0,0,0,0,0
152870.0,Kochanowski Jakub,MB,Poland,26.0,199.0,2023,Poland,USA,2023-07-23,True,1,2,11,14,0,0,0,0,4,0,2,6,3,6,3,12,0,0,0,0,4,0,0,4
153395.0,Semeniuk Kamil,OH,Poland,27.0,195.0,2023,Poland,France,2023-06-07,True,2,3,15,20,0,0,2,2,4,4,7,15,3,1,2,6,7,1,10,18,3,0,1,4
153395.0,Semeniuk Kamil,OH,Poland,27.0,195.0,2023,Poland,Iran,2023-06-08,True,1,3,14,18,0,1,5,6,15,2,7,24,0,4,1,5,10,2,17,29,11,0,1,12
153395.0,Semeniuk Kamil,OH,Poland,27.0,195.0,2023,Poland,Bulgaria,2023-06-09,True,1,2,15,18,0,0,4,4,4,1,3,8,1,0,0,1,3,1,9,13,5,0,0,5
153395.0,Semeniuk Kamil,OH,Poland,27.0,195.0,2023,Serbia,Poland,2023-06-11,False,0,1,4,5,0,0,0,0,6,2,6,14,1,1,2,4,3,1,6,10,3,0,0,3
153395.0,Semeniuk Kamil,OH,Poland,27.0,195.0,2023,Poland,Slovenia,2023-07-05,True,1,0,5,6,0,0,0,0,6,2,8,16,1,0,4,5,0,3,3,6,2,0,1,3
153395.0,Semeniuk Kamil,OH,Poland,27.0,195.0,2023,Poland,Brazil,2023-07-07,True,0,0,1,1,0,0,1,1,0,0,0,0,0,0,0,0,0,0,0,0,0,0,0,0
153395.0,Semeniuk Kamil,OH,Poland,27.0,195.0,2023,Poland,Canada,2023-07-08,True,0,1,10,11,0,0,2,2,9,4,12,25,2,1,2,5,6,3,6,15,3,1,1,5
153395.0,Semeniuk Kamil,OH,Poland,27.0,195.0,2023,Japan,Poland,2023-07-09,True,0,0,0,0,0,0,0,0,1,0,1,2,0,0,0,0,1,0,0,1,1,0,0,1
153395.0,Semeniuk Kamil,OH,Poland,27.0,195.0,2023,Poland,Brazil,2023-07-20,True,0,0,0,0,0,0,0,0,0,0,0,0,0,0,0,0,0,0,0,0,0,0,0,0
153395.0,Semeniuk Kamil,OH,Poland,27.0,195.0,2023,Japan,Poland,2023-07-22,True,0,0,0,0,0,0,0,0,1,0,0,1,0,0,0,0,0,0,3,3,0,1,0,1
153395.0,Semeniuk Kamil,OH,Poland,27.0,195.0,2023,Poland,USA,2023-07-23,True,0,0,1,1,0,0,0,0,0,0,0,0,0,0,0,0,0,0,0,0,0,0,0,0
118614.0,Zatorski Pawel,L,Poland,33.0,184.0,2023,Germany,Poland,2023-06-21,True,0,0,0,0,0,0,10,10,0,0,0,0,0,0,0,0,4,0,16,20,14,3,0,17
118614.0,Zatorski Pawel,L,Poland,33.0,184.0,2023,Netherlands,Poland,2023-06-22,True,0,0,0,0,0,0,4,4,0,0,0,0,0,0,0,0,9,3,18,30,6,3,0,9
118614.0,Zatorski Pawel,L,Poland,33.0,184.0,2023,Poland,USA,2023-06-24,False,0,0,0,0,0,0,4,4,0,0,0,0,0,0,0,0,1,0,9,10,5,2,1,8
118614.0,Zatorski Pawel,L,Poland,33.0,184.0,2023,Italy,Poland,2023-06-25,True,0,0,0,0,0,0,9,9,0,0,0,0,0,0,0,0,1,1,11,13,9,1,2,12
118614.0,Zatorski Pawel,L,Poland,33.0,184.0,2023,Poland,Slovenia,2023-07-05,True,0,0,0,0,0,0,5,5,0,0,0,0,0,0,0,0,3,0,9,12,6,4,1,11
118614.0,Zatorski Pawel,L,Poland,33.0,184.0,2023,Poland,Brazil,2023-07-07,True,0,0,0,0,0,0,5,5,0,0,0,0,0,0,0,0,0,0,9,9,3,2,0,5
118614.0,Zatorski Pawel,L,Poland,33.0,184.0,2023,Poland,Canada,2023-07-08,True,0,0,0,0,0,0,0,0,0,0,0,0,0,0,0,0,0,0,0,0,0,0,0,0
118614.0,Zatorski Pawel,L,Poland,33.0,184.0,2023,Japan,Poland,2023-07-09,True,0,0,0,0,0,0,2,2,0,0,0,0,0,0,0,0,2,1,12,15,8,2,1,11
118614.0,Zatorski Pawel,L,Poland,33.0,184.0,2023,Poland,Brazil,2023-07-20,True,0,0,0,0,0,0,11,11,0,0,0,0,0,0,0,0,3,1,11,15,10,2,0,12
118614.0,Zatorski Pawel,L,Poland,33.0,184.0,2023,Japan,Poland,2023-07-22,True,0,0,0,0,0,0,2,2,0,0,0,0,0,0,0,0,6,1,10,17,9,5,2,16
118614.0,Zatorski Pawel,L,Poland,33.0,184.0,2023,Poland,USA,2023-07-23,True,0,0,0,0,0,0,1,1,0,0,0,0,0,0,0,0,3,1,17,21,8,1,1,10
165942.0,Janusz Marcin,S,Poland,29.0,196.0,2023,Poland,Slovenia,2023-07-05,True,0,1,12,13,27,0,87,114,0,0,0,0,0,2,2,4,0,0,0,0,7,5,1,13
165942.0,Janusz Marcin,S,Poland,29.0,196.0,2023,Poland,Brazil,2023-07-07,True,0,2,10,12,19,0,60,79,0,0,2,2,0,1,3,4,0,0,0,0,6,1,1,8
165942.0,Janusz Marcin,S,Poland,29.0,196.0,2023,Poland,Canada,2023-07-08,True,0,0,0,0,2,0,9,11,0,0,0,0,0,0,0,0,0,0,0,0,1,1,0,2
165942.0,Janusz Marcin,S,Poland,29.0,196.0,2023,Japan,Poland,2023-07-09,True,1,0,9,10,12,0,40,52,0,0,0,0,0,3,1,4,0,0,0,0,3,2,0,5
165942.0,Janusz Marcin,S,Poland,29.0,196.0,2023,Poland,Brazil,2023-07-20,True,0,0,11,11,15,1,40,56,0,0,0,0,1,0,5,6,0,0,0,0,3,3,2,8
165942.0,Janusz Marcin,S,Poland,29.0,196.0,2023,Japan,Poland,2023-07-22,True,0,0,14,14,20,0,57,77,0,0,0,0,0,3,0,3,0,0,1,1,6,4,1,11
165942.0,Janusz Marcin,S,Poland,29.0,196.0,2023,Poland,USA,2023-07-23,True,1,2,8,11,30,0,65,95,0,0,0,0,0,2,1,3,0,0,0,0,2,3,0,5
150734.0,Bieniek Mateusz,MB,Poland,29.0,210.0,2023,Poland,France,2023-06-07,True,0,4,11,15,0,0,0,0,10,0,3,13,2,2,5,9,1,0,2,3,3,0,0,3
150734.0,Bieniek Mateusz,MB,Poland,29.0,210.0,2023,Poland,Iran,2023-06-08,True,0,1,15,16,0,0,0,0,13,1,4,18,2,5,9,16,0,0,0,0,1,0,1,2
150734.0,Bieniek Mateusz,MB,Poland,29.0,210.0,2023,Poland,Bulgaria,2023-06-09,True,1,2,12,15,0,0,2,2,5,6,5,16,2,2,9,13,0,0,0,0,4,0,1,5
150734.0,Bieniek Mateusz,MB,Poland,29.0,210.0,2023,Serbia,Poland,2023-06-11,False,2,2,10,14,0,0,0,0,6,2,2,10,0,2,3,5,0,0,0,0,4,0,0,4
150734.0,Bieniek Mateusz,MB,Poland,29.0,210.0,2023,Poland,Slovenia,2023-07-05,True,1,6,14,21,0,0,2,2,8,1,7,16,2,4,5,11,0,0,1,1,5,2,2,9
150734.0,Bieniek Mateusz,MB,Poland,29.0,210.0,2023,Poland,Brazil,2023-07-07,True,0,0,0,0,0,0,0,0,0,0,0,0,0,0,0,0,0,0,0,0,0,0,0,0
150734.0,Bieniek Mateusz,MB,Poland,29.0,210.0,2023,Poland,Canada,2023-07-08,True,0,0,0,0,0,0,0,0,0,0,0,0,0,0,0,0,0,0,0,0,0,0,0,0
150734.0,Bieniek Mateusz,MB,Poland,29.0,210.0,2023,Japan,Poland,2023-07-09,True,0,0,0,0,0,0,0,0,0,0,0,0,0,0,0,0,0,0,0,0,0,0,0,0
150734.0,Bieniek Mateusz,MB,Poland,29.0,210.0,2023,Poland,Brazil,2023-07-20,True,4,2,10,16,0,0,1,1,6,0,4,10,0,1,7,8,0,0,0,0,2,1,2,5
150734.0,Bieniek Mateusz,MB,Poland,29.0,210.0,2023,Japan,Poland,2023-07-22,True,3,2,16,21,0,0,2,2,4,2,3,9,1,5,5,11,0,0,1,1,1,3,2,6
150734.0,Bieniek Mateusz,MB,Poland,29.0,210.0,2023,Poland,USA,2023-07-23,True,1,2,7,10,0,0,0,0,4,0,1,5,0,3,2,5,0,0,1,1,2,1,0,3
152866.0,Fornal Tomasz,OH,Poland,26.0,198.0,2023,Germany,Poland,2023-06-21,True,0,1,1,2,0,0,2,2,0,0,2,2,0,1,0,1,0,0,3,3,1,0,0,1
152866.0,Fornal Tomasz,OH,Poland,26.0,198.0,2023,Netherlands,Poland,2023-06-22,True,0,6,12,18,0,0,1,1,8,3,5,16,0,3,0,3,6,2,21,29,7,5,1,13
152866.0,Fornal Tomasz,OH,Poland,26.0,198.0,2023,Poland,USA,2023-06-24,False,0,0,4,4,0,0,1,1,4,2,5,11,0,2,1,3,3,3,4,10,2,2,1,5
152866.0,Fornal Tomasz,OH,Poland,26.0,198.0,2023,Italy,Poland,2023-06-25,True,0,4,14,18,0,0,4,4,11,2,12,25,1,2,6,9,6,1,12,19,7,2,2,11
152866.0,Fornal Tomasz,OH,Poland,26.0,198.0,2023,Poland,Brazil,2023-07-20,True,0,0,0,0,0,0,0,0,0,0,0,0,0,0,0,0,0,0,0,0,0,0,0,0
152866.0,Fornal Tomasz,OH,Poland,26.0,198.0,2023,Japan,Poland,2023-07-22,True,0,0,0,0,0,0,0,0,0,0,0,0,0,0,0,0,0,0,0,0,0,0,0,0
152866.0,Fornal Tomasz,OH,Poland,26.0,198.0,2023,Poland,USA,2023-07-23,True,0,1,5,6,0,0,4,4,7,2,5,14,1,0,1,2,3,1,11,15,5,1,1,7
152869.0,Huber Norbert,MB,Poland,25.0,204.0,2023,Germany,Poland,2023-06-21,True,0,2,11,13,0,0,1,1,6,1,4,11,4,2,7,13,0,0,2,2,2,1,0,3
152869.0,Huber Norbert,MB,Poland,25.0,204.0,2023,Netherlands,Poland,2023-06-22,True,0,1,7,8,0,0,1,1,4,0,0,4,1,0,1,2,0,0,0,0,0,1,0,1
152869.0,Huber Norbert,MB,Poland,25.0,204.0,2023,Poland,USA,2023-06-24,False,1,3,11,15,0,0,1,1,4,4,1,9,2,3,1,6,0,0,0,0,0,1,0,1
152869.0,Huber Norbert,MB,Poland,25.0,204.0,2023,Italy,Poland,2023-06-25,True,3,5,17,25,0,0,6,6,1,1,4,6,2,7,4,13,0,0,0,0,1,0,2,3
152869.0,Huber Norbert,MB,Poland,25.0,204.0,2023,Poland,Slovenia,2023-07-05,True,0,1,2,3,0,0,0,0,0,0,2,2,0,3,0,3,0,0,2,2,0,0,0,0
152869.0,Huber Norbert,MB,Poland,25.0,204.0,2023,Poland,Brazil,2023-07-07,True,0,2,5,7,0,0,1,1,3,0,0,3,2,2,1,5,0,0,1,1,0,1,0,1
152869.0,Huber Norbert,MB,Poland,25.0,204.0,2023,Poland,Canada,2023-07-08,True,1,3,10,14,0,0,0,0,6,1,2,9,4,2,3,9,0,0,0,0,2,1,0,3
152869.0,Huber Norbert,MB,Poland,25.0,204.0,2023,Japan,Poland,2023-07-09,True,3,3,8,14,0,0,0,0,5,0,2,7,1,2,4,7,0,0,1,1,2,3,0,5
152869.0,Huber Norbert,MB,Poland,25.0,204.0,2023,Poland,Brazil,2023-07-20,True,0,0,0,0,0,0,0,0,0,0,0,0,0,0,0,0,0,0,0,0,0,0,0,0
152869.0,Huber Norbert,MB,Poland,25.0,204.0,2023,Japan,Poland,2023-07-22,True,0,1,8,9,0,0,0,0,5,0,0,5,0,2,2,4,0,0,1,1,1,1,0,2
152869.0,Huber Norbert,MB,Poland,25.0,204.0,2023,Poland,USA,2023-07-23,True,1,0,11,12,0,1,0,1,5,1,3,9,1,4,2,7,0,0,0,0,1,1,0,2
124926.0,Kovacevic Uros,OH,Serbia,30.0,197.0,2023,Argentina,Serbia,2023-07-04,False,0,0,0,0,0,0,0,0,0,0,0,0,0,0,0,0,0,0,0,0,0,0,0,0
124926.0,Kovacevic Uros,OH,Serbia,30.0,197.0,2023,Serbia,France,2023-07-07,False,0,0,0,0,0,0,0,0,0,0,0,0,0,0,0,0,0,0,0,0,0,0,0,0
124926.0,Kovacevic Uros,OH,Serbia,30.0,197.0,2023,Bulgaria,Serbia,2023-07-08,True,0,0,0,0,0,0,0,0,0,0,0,0,0,0,0,0,0,0,0,0,0,0,0,0
136360.0,Kapur Milorad,L,Serbia,33.0,181.0,2023,Slovenia,Serbia,2023-06-07,False,0,0,0,0,0,0,4,4,0,0,0,0,0,0,0,0,3,1,22,26,10,1,0,11
136360.0,Kapur Milorad,L,Serbia,33.0,181.0,2023,Serbia,China,2023-06-08,True,0,0,0,0,0,0,5,5,0,0,0,0,0,0,0,0,3,0,8,11,8,2,2,12
136360.0,Kapur Milorad,L,Serbia,33.0,181.0,2023,Japan,Serbia,2023-06-09,False,0,0,0,0,0,1,4,5,0,0,0,0,0,0,0,0,3,0,11,14,8,2,1,11
136360.0,Kapur Milorad,L,Serbia,33.0,181.0,2023,Serbia,Poland,2023-06-11,True,0,0,0,0,0,0,8,8,0,0,0,0,0,0,0,0,3,1,10,14,10,0,1,11
136360.0,Kapur Milorad,L,Serbia,33.0,181.0,2023,USA,Serbia,2023-06-20,False,0,0,0,0,0,1,8,9,0,0,0,0,0,0,0,0,6,1,10,17,9,7,0,16
136360.0,Kapur Milorad,L,Serbia,33.0,181.0,2023,Serbia,Germany,2023-06-22,True,0,0,0,0,0,0,6,6,0,0,0,0,0,0,0,0,3,1,15,19,3,6,0,9
136360.0,Kapur Milorad,L,Serbia,33.0,181.0,2023,Serbia,Italy,2023-06-23,False,0,0,0,0,0,0,10,10,0,0,0,0,0,0,0,0,2,1,7,10,4,1,0,5
136360.0,Kapur Milorad,L,Serbia,33.0,181.0,2023,Netherlands,Serbia,2023-06-25,True,0,0,0,0,0,0,12,12,0,0,0,0,0,0,0,0,5,5,21,31,8,2,0,10
136360.0,Kapur Milorad,L,Serbia,33.0,181.0,2023,Argentina,Serbia,2023-07-04,False,0,0,0,0,0,1,7,8,0,0,0,0,0,0,0,0,3,1,13,17,4,6,0,10
136360.0,Kapur Milorad,L,Serbia,33.0,181.0,2023,Serbia,France,2023-07-07,False,0,0,0,0,0,0,8,8,0,0,0,0,0,0,0,0,2,1,13,16,5,4,3,12
136360.0,Kapur Milorad,L,Serbia,33.0,181.0,2023,Bulgaria,Serbia,2023-07-08,True,0,0,0,0,0,0,3,3,0,0,0,0,0,0,0,0,2,1,5,8,4,7,2,13
192041.0,Mašulović Veljko,OH,Serbia,21.0,198.0,2023,Slovenia,Serbia,2023-06-07,False,0,1,2,3,0,0,1,1,0,0,0,0,0,0,0,0,0,0,1,1,3,0,0,3
192041.0,Mašulović Veljko,OH,Serbia,21.0,198.0,2023,Serbia,China,2023-06-08,True,0,1,0,1,0,0,0,0,0,0,1,1,1,0,0,1,0,0,0,0,0,0,0,0
192041.0,Mašulović Veljko,OH,Serbia,21.0,198.0,2023,Japan,Serbia,2023-06-09,False,0,0,1,1,0,0,0,0,0,0,1,1,0,0,0,0,0,0,0,0,0,0,0,0
192041.0,Mašulović Veljko,OH,Serbia,21.0,198.0,2023,Serbia,Poland,2023-06-11,True,0,0,0,0,0,0,0,0,0,0,0,0,0,0,0,0,0,0,0,0,0,0,0,0
192041.0,Mašulović Veljko,OH,Serbia,21.0,198.0,2023,Argentina,Serbia,2023-07-04,False,0,0,0,0,0,0,0,0,0,0,0,0,0,0,0,0,0,0,0,0,0,0,0,0
192041.0,Mašulović Veljko,OH,Serbia,21.0,198.0,2023,Serbia,France,2023-07-07,False,0,0,0,0,0,0,0,0,0,0,0,0,0,0,0,0,0,0,0,0,0,0,0,0
192041.0,Mašulović Veljko,OH,Serbia,21.0,198.0,2023,Bulgaria,Serbia,2023-07-08,True,0,0,0,0,0,0,0,0,0,0,0,0,0,0,0,0,0,0,0,0,0,0,0,0
146579.0,Krsmanovic Petar,MB,Serbia,33.0,205.0,2023,Slovenia,Serbia,2023-06-07,False,0,1,16,17,0,0,1,1,7,1,2,10,2,2,0,4,0,0,0,0,1,0,0,1
146579.0,Krsmanovic Petar,MB,Serbia,33.0,205.0,2023,Serbia,China,2023-06-08,True,1,0,15,16,0,0,1,1,4,1,1,6,1,2,1,4,0,0,0,0,2,0,0,2
146579.0,Krsmanovic Petar,MB,Serbia,33.0,205.0,2023,Japan,Serbia,2023-06-09,False,0,4,8,12,0,0,0,0,6,0,1,7,1,4,1,6,0,0,0,0,2,0,0,2
146579.0,Krsmanovic Petar,MB,Serbia,33.0,205.0,2023,Serbia,Poland,2023-06-11,True,0,0,12,12,0,0,1,1,4,1,2,7,3,5,3,11,0,0,0,0,4,0,0,4
146579.0,Krsmanovic Petar,MB,Serbia,33.0,205.0,2023,USA,Serbia,2023-06-20,False,1,2,12,15,0,0,3,3,8,0,2,10,2,3,3,8,0,0,0,0,1,2,1,4
146579.0,Krsmanovic Petar,MB,Serbia,33.0,205.0,2023,Serbia,Germany,2023-06-22,True,2,2,17,21,0,0,2,2,6,2,1,9,5,4,3,12,0,0,1,1,3,1,2,6
146579.0,Krsmanovic Petar,MB,Serbia,33.0,205.0,2023,Serbia,Italy,2023-06-23,False,0,0,0,0,0,0,0,0,0,0,0,0,0,0,0,0,0,0,0,0,0,0,0,0
146579.0,Krsmanovic Petar,MB,Serbia,33.0,205.0,2023,Netherlands,Serbia,2023-06-25,True,1,1,21,23,0,0,2,2,11,3,4,18,5,6,4,15,0,0,2,2,3,1,0,4
146579.0,Krsmanovic Petar,MB,Serbia,33.0,205.0,2023,Argentina,Serbia,2023-07-04,False,0,2,13,15,0,0,3,3,5,1,5,11,0,3,1,4,0,0,0,0,5,2,1,8
146579.0,Krsmanovic Petar,MB,Serbia,33.0,205.0,2023,Serbia,France,2023-07-07,False,2,1,16,19,0,0,0,0,5,3,2,10,4,3,5,12,0,0,1,1,3,1,0,4
146579.0,Krsmanovic Petar,MB,Serbia,33.0,205.0,2023,Bulgaria,Serbia,2023-07-08,True,0,1,8,9,0,0,1,1,4,1,1,6,3,3,5,11,0,0,0,0,1,0,0,1
132022.0,Ivovic Marko,OH,Serbia,33.0,194.0,2023,USA,Serbia,2023-06-20,False,1,4,6,11,0,0,5,5,6,5,12,23,0,0,3,3,2,2,19,23,2,2,0,4
132022.0,Ivovic Marko,OH,Serbia,33.0,194.0,2023,Serbia,Germany,2023-06-22,True,0,2,14,16,0,1,8,9,11,1,15,27,1,4,3,8,7,5,16,28,8,0,3,11
132022.0,Ivovic Marko,OH,Serbia,33.0,194.0,2023,Serbia,Italy,2023-06-23,False,0,0,0,0,0,0,0,0,0,0,0,0,0,0,0,0,0,0,0,0,0,0,0,0
132022.0,Ivovic Marko,OH,Serbia,33.0,194.0,2023,Netherlands,Serbia,2023-06-25,True,2,2,22,26,1,0,5,6,10,6,6,22,1,1,0,2,9,5,25,39,7,2,0,9
132022.0,Ivovic Marko,OH,Serbia,33.0,194.0,2023,Argentina,Serbia,2023-07-04,False,1,4,7,12,0,0,3,3,9,6,10,25,0,1,1,2,9,4,22,35,6,2,1,9
132022.0,Ivovic Marko,OH,Serbia,33.0,194.0,2023,Serbia,France,2023-07-07,False,0,4,9,13,1,0,2,3,11,6,11,28,1,5,5,11,8,0,28,36,3,3,0,6
132022.0,Ivovic Marko,OH,Serbia,33.0,194.0,2023,Bulgaria,Serbia,2023-07-08,True,1,1,16,18,0,0,2,2,7,1,7,15,1,1,1,3,2,1,12,15,1,2,1,4
162122.0,Kujundžić Miran,OH,Serbia,26.0,196.0,2023,Slovenia,Serbia,2023-06-07,False,1,2,12,15,0,0,5,5,12,2,14,28,1,2,1,4,7,0,16,23,15,0,0,15
162122.0,Kujundžić Miran,OH,Serbia,26.0,196.0,2023,Serbia,China,2023-06-08,True,4,1,10,15,0,0,2,2,10,4,6,20,2,4,1,7,9,0,11,20,6,0,2,8
162122.0,Kujundžić Miran,OH,Serbia,26.0,196.0,2023,Japan,Serbia,2023-06-09,False,1,5,14,20,0,0,2,2,8,0,12,20,1,2,1,4,7,0,19,26,5,0,0,5
162122.0,Kujundžić Miran,OH,Serbia,26.0,196.0,2023,Serbia,Poland,2023-06-11,True,3,3,7,13,0,0,3,3,12,1,4,17,0,2,0,2,5,0,2,7,1,0,2,3
162122.0,Kujundžić Miran,OH,Serbia,26.0,196.0,2023,USA,Serbia,2023-06-20,False,1,1,6,8,1,0,1,2,4,4,5,13,0,0,0,0,1,1,11,13,3,3,0,6
162122.0,Kujundžić Miran,OH,Serbia,26.0,196.0,2023,Serbia,Germany,2023-06-22,True,1,3,14,18,0,0,5,5,12,1,2,15,1,3,3,7,1,3,18,22,8,2,0,10
162122.0,Kujundžić Miran,OH,Serbia,26.0,196.0,2023,Serbia,Italy,2023-06-23,False,0,2,7,9,0,0,6,6,10,6,8,24,0,2,0,2,3,1,13,17,2,2,0,4
162122.0,Kujundžić Miran,OH,Serbia,26.0,196.0,2023,Netherlands,Serbia,2023-06-25,True,2,3,10,15,0,0,1,1,20,6,8,34,4,2,5,11,6,4,9,19,5,3,0,8
162122.0,Kujundžić Miran,OH,Serbia,26.0,196.0,2023,Argentina,Serbia,2023-07-04,False,1,3,10,14,0,0,5,5,14,3,14,31,1,2,1,4,3,0,21,24,6,4,0,10
162122.0,Kujundžić Miran,OH,Serbia,26.0,196.0,2023,Serbia,France,2023-07-07,False,0,5,13,18,0,0,3,3,9,6,10,25,0,3,4,7,5,1,13,19,4,3,2,9
162122.0,Kujundžić Miran,OH,Serbia,26.0,196.0,2023,Bulgaria,Serbia,2023-07-08,True,0,0,0,0,0,0,0,0,0,0,0,0,0,0,0,0,0,0,0,0,0,0,0,0
173249.0,Batak Aleksa,S,Serbia,24.0,198.0,2023,Slovenia,Serbia,2023-06-07,False,0,0,3,3,2,0,14,16,0,0,0,0,1,1,0,2,0,0,0,0,2,0,0,2
173249.0,Batak Aleksa,S,Serbia,24.0,198.0,2023,Serbia,China,2023-06-08,True,0,0,0,0,2,0,5,7,0,0,0,0,0,0,0,0,0,0,0,0,0,0,0,0
173249.0,Batak Aleksa,S,Serbia,24.0,198.0,2023,Japan,Serbia,2023-06-09,False,0,5,7,12,15,0,69,84,0,0,1,1,0,3,2,5,0,0,0,0,0,0,0,0
173249.0,Batak Aleksa,S,Serbia,24.0,198.0,2023,Serbia,Poland,2023-06-11,True,0,0,0,0,0,0,0,0,0,0,0,0,0,0,0,0,0,0,0,0,0,0,0,0
173249.0,Batak Aleksa,S,Serbia,24.0,198.0,2023,USA,Serbia,2023-06-20,False,0,0,0,0,2,0,5,7,0,0,0,0,0,0,0,0,0,0,0,0,0,0,0,0
173249.0,Batak Aleksa,S,Serbia,24.0,198.0,2023,Serbia,Germany,2023-06-22,True,0,0,0,0,1,0,4,5,0,0,0,0,0,0,0,0,0,0,0,0,0,0,0,0
173249.0,Batak Aleksa,S,Serbia,24.0,198.0,2023,Serbia,Italy,2023-06-23,False,0,1,7,8,14,1,61,76,0,0,0,0,0,2,2,4,0,0,1,1,5,2,0,7
173249.0,Batak Aleksa,S,Serbia,24.0,198.0,2023,Netherlands,Serbia,2023-06-25,True,0,0,0,0,0,0,1,1,0,0,0,0,0,0,0,0,0,0,0,0,0,0,0,0
173249.0,Batak Aleksa,S,Serbia,24.0,198.0,2023,Argentina,Serbia,2023-07-04,False,0,0,1,1,1,0,14,15,0,0,0,0,0,0,1,1,0,0,0,0,3,0,0,3
173249.0,Batak Aleksa,S,Serbia,24.0,198.0,2023,Serbia,France,2023-07-07,False,0,0,0,0,0,0,0,0,0,0,0,0,0,2,0,2,0,0,0,0,1,0,0,1
173249.0,Batak Aleksa,S,Serbia,24.0,198.0,2023,Bulgaria,Serbia,2023-07-08,True,0,0,0,0,0,0,2,2,0,0,0,0,0,0,0,0,0,0,0,0,0,0,0,0
173251.0,Peric Pavle,OH,Serbia,25.0,207.0,2023,Slovenia,Serbia,2023-06-07,False,0,1,6,7,0,0,0,0,7,3,9,19,1,0,1,2,3,1,17,21,7,0,0,7
173251.0,Peric Pavle,OH,Serbia,25.0,207.0,2023,Serbia,China,2023-06-08,True,0,0,0,0,0,0,0,0,0,0,0,0,0,0,0,0,0,0,0,0,0,0,0,0
173251.0,Peric Pavle,OH,Serbia,25.0,207.0,2023,Japan,Serbia,2023-06-09,False,1,4,9,14,0,0,1,1,17,2,11,30,4,1,1,6,3,4,24,31,4,1,1,6
173251.0,Peric Pavle,OH,Serbia,25.0,207.0,2023,Serbia,Poland,2023-06-11,True,1,2,7,10,0,0,1,1,5,1,8,14,1,0,2,3,3,2,18,23,3,0,0,3
173251.0,Peric Pavle,OH,Serbia,25.0,207.0,2023,USA,Serbia,2023-06-20,False,0,5,5,10,0,0,0,0,5,6,10,21,1,1,1,3,1,2,21,24,7,1,0,8
173251.0,Peric Pavle,OH,Serbia,25.0,207.0,2023,Serbia,Germany,2023-06-22,True,0,0,0,0,0,0,0,0,0,0,0,0,0,0,0,0,0,0,0,0,0,0,0,0
173251.0,Peric Pavle,OH,Serbia,25.0,207.0,2023,Serbia,Italy,2023-06-23,False,0,2,10,12,0,0,0,0,14,5,10,29,1,1,1,3,3,3,36,42,5,2,0,7
173251.0,Peric Pavle,OH,Serbia,25.0,207.0,2023,Netherlands,Serbia,2023-06-25,True,0,1,1,2,0,0,0,0,3,0,4,7,0,0,1,1,1,0,4,5,0,0,1,1
173251.0,Peric Pavle,OH,Serbia,25.0,207.0,2023,Argentina,Serbia,2023-07-04,False,0,0,1,1,0,0,0,0,2,1,1,4,0,0,0,0,0,0,1,1,1,0,0,1
173251.0,Peric Pavle,OH,Serbia,25.0,207.0,2023,Serbia,France,2023-07-07,False,0,0,0,0,0,0,0,0,0,0,1,1,0,0,0,0,0,0,1,1,0,0,0,0
173251.0,Peric Pavle,OH,Serbia,25.0,207.0,2023,Bulgaria,Serbia,2023-07-08,True,2,4,8,14,0,0,1,1,9,5,8,22,0,1,4,5,8,1,17,26,5,4,1,10
150382.0,Masulovic Nemanja,MB,Serbia,28.0,205.0,2023,USA,Serbia,2023-06-20,False,0,0,0,0,0,0,0,0,0,0,0,0,0,0,0,0,0,0,0,0,0,0,0,0
150382.0,Masulovic Nemanja,MB,Serbia,28.0,205.0,2023,Serbia,Germany,2023-06-22,True,0,0,0,0,0,0,0,0,0,0,0,0,0,0,0,0,0,0,0,0,0,0,0,0
150382.0,Masulovic Nemanja,MB,Serbia,28.0,205.0,2023,Serbia,Italy,2023-06-23,False,1,0,9,10,0,0,0,0,3,1,2,6,0,2,5,7,0,0,2,2,2,1,1,4
150382.0,Masulovic Nemanja,MB,Serbia,28.0,205.0,2023,Netherlands,Serbia,2023-06-25,True,0,0,0,0,0,0,0,0,0,0,0,0,0,0,0,0,0,0,0,0,0,0,0,0
150382.0,Masulovic Nemanja,MB,Serbia,28.0,205.0,2023,Argentina,Serbia,2023-07-04,False,0,0,0,0,0,0,0,0,0,0,0,0,0,0,0,0,0,0,0,0,0,0,0,0
150382.0,Masulovic Nemanja,MB,Serbia,28.0,205.0,2023,Serbia,France,2023-07-07,False,0,0,0,0,0,0,0,0,0,0,0,0,0,0,0,0,0,0,0,0,0,0,0,0
150382.0,Masulovic Nemanja,MB,Serbia,28.0,205.0,2023,Bulgaria,Serbia,2023-07-08,True,0,0,0,0,0,0,0,0,0,0,0,0,0,0,0,0,0,0,0,0,0,0,0,0
143794.0,Luburic Drazen,O,Serbia,30.0,202.0,2023,Slovenia,Serbia,2023-06-07,False,0,4,12,16,0,0,3,3,20,6,11,37,1,2,4,7,0,0,0,0,6,1,0,7
143794.0,Luburic Drazen,O,Serbia,30.0,202.0,2023,Serbia,China,2023-06-08,True,2,2,13,17,0,0,2,2,16,5,8,29,1,0,2,3,0,0,2,2,3,0,1,4
143794.0,Luburic Drazen,O,Serbia,30.0,202.0,2023,Japan,Serbia,2023-06-09,False,0,4,10,14,0,0,1,1,17,4,10,31,0,0,1,1,0,0,0,0,6,0,0,6
143794.0,Luburic Drazen,O,Serbia,30.0,202.0,2023,Serbia,Poland,2023-06-11,True,1,3,7,11,0,0,2,2,18,3,9,30,0,1,1,2,0,0,0,0,6,0,0,6
143794.0,Luburic Drazen,O,Serbia,30.0,202.0,2023,USA,Serbia,2023-06-20,False,3,3,9,15,0,0,3,3,16,4,17,37,0,4,3,7,0,0,0,0,4,4,1,9
143794.0,Luburic Drazen,O,Serbia,30.0,202.0,2023,Serbia,Germany,2023-06-22,True,1,4,10,15,0,0,2,2,15,7,17,39,0,1,7,8,0,0,1,1,2,3,1,6
143794.0,Luburic Drazen,O,Serbia,30.0,202.0,2023,Serbia,Italy,2023-06-23,False,0,0,0,0,0,0,0,0,0,0,0,0,0,0,0,0,0,0,0,0,0,0,0,0
143794.0,Luburic Drazen,O,Serbia,30.0,202.0,2023,Netherlands,Serbia,2023-06-25,True,1,7,14,22,0,0,0,0,18,5,11,34,1,4,2,7,0,0,0,0,4,0,0,4
143794.0,Luburic Drazen,O,Serbia,30.0,202.0,2023,Argentina,Serbia,2023-07-04,False,2,3,10,15,0,0,3,3,8,11,6,25,2,2,4,8,0,0,0,0,4,4,0,8
143794.0,Luburic Drazen,O,Serbia,30.0,202.0,2023,Serbia,France,2023-07-07,False,0,5,10,15,0,0,4,4,16,6,10,32,0,1,1,2,0,0,0,0,8,1,0,9
143794.0,Luburic Drazen,O,Serbia,30.0,202.0,2023,Bulgaria,Serbia,2023-07-08,True,1,2,11,14,0,0,3,3,13,4,6,23,1,1,2,4,0,0,0,0,5,2,2,9
116525.0,Podrascanin Marko,MB,Serbia,36.0,204.0,2023,Argentina,Serbia,2023-07-04,False,0,0,0,0,0,0,0,0,0,0,0,0,0,0,0,0,0,0,0,0,0,0,0,0
116525.0,Podrascanin Marko,MB,Serbia,36.0,204.0,2023,Serbia,France,2023-07-07,False,0,0,0,0,0,0,0,0,0,0,0,0,0,0,0,0,0,0,0,0,0,0,0,0
116525.0,Podrascanin Marko,MB,Serbia,36.0,204.0,2023,Bulgaria,Serbia,2023-07-08,True,0,0,0,0,0,0,0,0,0,0,0,0,0,0,0,0,0,0,0,0,0,0,0,0
173250.0,Todorovic Vuk,S,Serbia,25.0,190.0,2023,Slovenia,Serbia,2023-06-07,False,0,3,8,11,10,0,76,86,1,0,0,1,2,1,1,4,0,0,0,0,1,0,0,1
173250.0,Todorovic Vuk,S,Serbia,25.0,190.0,2023,Serbia,China,2023-06-08,True,0,0,10,10,18,1,48,67,0,0,0,0,0,3,1,4,0,0,0,0,5,0,1,6
173250.0,Todorovic Vuk,S,Serbia,25.0,190.0,2023,Japan,Serbia,2023-06-09,False,0,0,1,1,2,0,3,5,0,0,0,0,0,0,0,0,0,0,0,0,1,0,0,1
173250.0,Todorovic Vuk,S,Serbia,25.0,190.0,2023,Serbia,Poland,2023-06-11,True,1,1,14,16,7,0,50,57,0,0,2,2,1,0,0,1,0,0,0,0,6,0,0,6
173250.0,Todorovic Vuk,S,Serbia,25.0,190.0,2023,USA,Serbia,2023-06-20,False,0,2,13,15,25,0,64,89,0,0,2,2,0,3,3,6,0,0,1,1,8,7,1,16
173250.0,Todorovic Vuk,S,Serbia,25.0,190.0,2023,Serbia,Germany,2023-06-22,True,0,1,11,12,17,0,57,74,0,0,0,0,1,3,1,5,0,1,1,2,7,8,0,15
173250.0,Todorovic Vuk,S,Serbia,25.0,190.0,2023,Serbia,Italy,2023-06-23,False,0,0,0,0,0,0,0,0,0,0,0,0,0,0,0,0,0,0,0,0,0,0,0,0
173250.0,Todorovic Vuk,S,Serbia,25.0,190.0,2023,Netherlands,Serbia,2023-06-25,True,0,4,13,17,33,0,67,100,1,0,1,2,0,3,4,7,0,0,0,0,9,3,1,13
173250.0,Todorovic Vuk,S,Serbia,25.0,190.0,2023,Argentina,Serbia,2023-07-04,False,0,0,7,7,14,0,61,75,1,0,0,1,0,2,1,3,0,0,1,1,3,4,0,7
173250.0,Todorovic Vuk,S,Serbia,25.0,190.0,2023,Serbia,France,2023-07-07,False,0,1,13,14,21,0,66,87,0,0,0,0,2,1,4,7,0,0,0,0,4,1,0,5
173250.0,Todorovic Vuk,S,Serbia,25.0,190.0,2023,Bulgaria,Serbia,2023-07-08,True,0,1,7,8,20,0,41,61,1,0,0,1,0,4,3,7,0,0,0,0,3,1,0,4
168276.0,Vucicevic Bozidar,O,Serbia,25.0,205.0,2023,Slovenia,Serbia,2023-06-07,False,0,0,5,5,0,0,1,1,3,1,1,5,0,1,0,1,0,0,0,0,1,0,0,1
168276.0,Vucicevic Bozidar,O,Serbia,25.0,205.0,2023,Serbia,China,2023-06-08,True,0,1,1,2,0,0,0,0,0,1,1,2,0,0,0,0,0,0,0,0,2,0,0,2
168276.0,Vucicevic Bozidar,O,Serbia,25.0,205.0,2023,Japan,Serbia,2023-06-09,False,0,0,1,1,0,0,0,0,1,0,0,1,0,1,1,2,0,0,0,0,0,0,0,0
168276.0,Vucicevic Bozidar,O,Serbia,25.0,205.0,2023,Serbia,Poland,2023-06-11,True,0,0,0,0,0,0,0,0,0,0,0,0,0,0,0,0,0,0,0,0,0,0,0,0
168276.0,Vucicevic Bozidar,O,Serbia,25.0,205.0,2023,USA,Serbia,2023-06-20,False,0,0,3,3,0,0,0,0,1,1,2,4,1,0,0,1,0,0,0,0,0,1,0,1
168276.0,Vucicevic Bozidar,O,Serbia,25.0,205.0,2023,Serbia,Germany,2023-06-22,True,0,0,1,1,0,0,0,0,0,0,0,0,0,0,0,0,0,0,0,0,0,0,0,0
168276.0,Vucicevic Bozidar,O,Serbia,25.0,205.0,2023,Serbia,Italy,2023-06-23,False,0,5,3,8,0,0,0,0,10,8,8,26,2,2,3,7,0,0,0,0,3,4,1,8
168276.0,Vucicevic Bozidar,O,Serbia,25.0,205.0,2023,Netherlands,Serbia,2023-06-25,True,0,0,0,0,0,0,0,0,0,0,0,0,0,0,0,0,0,0,0,0,0,0,0,0
168276.0,Vucicevic Bozidar,O,Serbia,25.0,205.0,2023,Argentina,Serbia,2023-07-04,False,0,1,1,2,0,0,2,2,3,2,1,6,0,0,0,0,0,0,0,0,2,1,0,3
168276.0,Vucicevic Bozidar,O,Serbia,25.0,205.0,2023,Serbia,France,2023-07-07,False,0,0,0,0,0,0,0,0,0,0,0,0,0,0,0,0,0,0,0,0,0,0,0,0
168276.0,Vucicevic Bozidar,O,Serbia,25.0,205.0,2023,Bulgaria,Serbia,2023-07-08,True,0,0,0,0,0,0,0,0,0,0,0,0,0,0,0,0,0,0,0,0,0,0,0,0
164985.0,Nedeljkovic Aleksandar,MB,Serbia,26.0,205.0,2023,Slovenia,Serbia,2023-06-07,False,0,0,16,16,0,0,0,0,3,1,3,7,1,4,7,12,0,0,2,2,0,0,0,0
164985.0,Nedeljkovic Aleksandar,MB,Serbia,26.0,205.0,2023,Serbia,China,2023-06-08,True,1,0,11,12,0,0,0,0,8,0,4,12,3,1,3,7,0,0,1,1,1,0,0,1
164985.0,Nedeljkovic Aleksandar,MB,Serbia,26.0,205.0,2023,Japan,Serbia,2023-06-09,False,0,0,13,13,0,0,0,0,1,0,5,6,2,3,0,5,1,0,1,2,1,0,0,1
164985.0,Nedeljkovic Aleksandar,MB,Serbia,26.0,205.0,2023,Serbia,Poland,2023-06-11,True,0,0,11,11,0,0,2,2,4,0,1,5,4,5,5,14,0,0,0,0,1,0,0,1
164985.0,Nedeljkovic Aleksandar,MB,Serbia,26.0,205.0,2023,USA,Serbia,2023-06-20,False,0,3,5,8,0,0,1,1,5,0,1,6,0,2,4,6,0,0,0,0,3,0,0,3
164985.0,Nedeljkovic Aleksandar,MB,Serbia,26.0,205.0,2023,Serbia,Germany,2023-06-22,True,0,1,10,11,0,0,0,0,7,1,4,12,4,4,7,15,0,0,0,0,2,0,1,3
164985.0,Nedeljkovic Aleksandar,MB,Serbia,26.0,205.0,2023,Serbia,Italy,2023-06-23,False,0,0,6,6,0,0,0,0,3,0,2,5,3,2,2,7,0,0,0,0,0,1,1,2
164985.0,Nedeljkovic Aleksandar,MB,Serbia,26.0,205.0,2023,Netherlands,Serbia,2023-06-25,True,0,0,12,12,0,0,1,1,7,1,2,10,1,5,9,15,0,0,1,1,2,0,1,3
164985.0,Nedeljkovic Aleksandar,MB,Serbia,26.0,205.0,2023,Argentina,Serbia,2023-07-04,False,1,1,10,12,0,0,1,1,4,3,1,8,2,4,7,13,0,0,0,0,3,0,0,3
164985.0,Nedeljkovic Aleksandar,MB,Serbia,26.0,205.0,2023,Serbia,France,2023-07-07,False,0,2,14,16,0,0,1,1,7,0,1,8,3,5,3,11,0,0,1,1,2,2,0,4
164985.0,Nedeljkovic Aleksandar,MB,Serbia,26.0,205.0,2023,Bulgaria,Serbia,2023-07-08,True,1,1,9,11,0,0,0,0,6,0,2,8,0,4,6,10,0,0,0,0,2,0,1,3
114962.0,Pajenk Alen,MB,Slovenia,37.0,203.0,2023,Slovenia,Serbia,2023-06-07,True,0,4,12,16,0,0,0,0,6,1,6,13,4,3,5,12,0,0,0,0,7,0,0,7
114962.0,Pajenk Alen,MB,Slovenia,37.0,203.0,2023,Slovenia,Bulgaria,2023-06-08,False,0,2,6,8,0,0,0,0,4,1,3,8,0,0,4,4,1,0,2,3,1,0,0,1
114962.0,Pajenk Alen,MB,Slovenia,37.0,203.0,2023,France,Slovenia,2023-06-10,True,0,2,15,17,0,0,0,0,3,1,3,7,2,3,2,7,0,0,2,2,1,0,0,1
114962.0,Pajenk Alen,MB,Slovenia,37.0,203.0,2023,Slovenia,Iran,2023-06-11,True,0,2,7,9,0,0,0,0,2,0,2,4,1,3,4,8,0,0,0,0,5,1,0,6
114962.0,Pajenk Alen,MB,Slovenia,37.0,203.0,2023,Argentina,Slovenia,2023-06-20,True,0,4,13,17,0,0,1,1,7,1,2,10,0,1,4,5,1,0,0,1,3,1,1,5
114962.0,Pajenk Alen,MB,Slovenia,37.0,203.0,2023,Slovenia,Canada,2023-06-21,True,2,1,5,8,0,0,1,1,5,0,4,9,2,3,6,11,2,0,0,2,1,0,0,1
114962.0,Pajenk Alen,MB,Slovenia,37.0,203.0,2023,Slovenia,Cuba,2023-06-22,True,1,1,19,21,0,0,1,1,4,0,4,8,1,2,0,3,0,0,2,2,0,0,0,0
114962.0,Pajenk Alen,MB,Slovenia,37.0,203.0,2023,Brazil,Slovenia,2023-06-24,False,0,3,10,13,0,0,2,2,6,1,0,7,0,2,4,6,0,0,0,0,0,2,0,2
114962.0,Pajenk Alen,MB,Slovenia,37.0,203.0,2023,Poland,Slovenia,2023-07-05,False,0,2,11,13,0,0,1,1,7,0,3,10,1,3,8,12,0,0,1,1,3,2,2,7
114962.0,Pajenk Alen,MB,Slovenia,37.0,203.0,2023,China,Slovenia,2023-07-06,True,0,3,14,17,0,0,0,0,5,3,4,12,1,5,4,10,0,0,0,0,3,0,2,5
114962.0,Pajenk Alen,MB,Slovenia,37.0,203.0,2023,Slovenia,Italy,2023-07-07,False,0,2,6,8,0,0,0,0,1,1,4,6,1,2,3,6,0,0,0,0,3,1,0,4
114962.0,Pajenk Alen,MB,Slovenia,37.0,203.0,2023,Slovenia,Netherlands,2023-07-09,True,0,2,9,11,0,0,2,2,5,1,0,6,4,4,3,11,1,0,0,1,1,0,0,1
114962.0,Pajenk Alen,MB,Slovenia,37.0,203.0,2023,Japan,Slovenia,2023-07-20,False,0,2,5,7,0,0,0,0,11,0,5,16,1,10,8,19,2,0,3,5,3,0,0,3
168715.0,Planinšič Uroš,S,Slovenia,25.0,186.0,2023,Slovenia,Serbia,2023-06-07,True,0,0,1,1,0,0,1,1,0,0,0,0,0,0,0,0,0,0,0,0,1,0,0,1
168715.0,Planinšič Uroš,S,Slovenia,25.0,186.0,2023,Slovenia,Bulgaria,2023-06-08,False,0,0,0,0,0,0,3,3,0,0,0,0,0,1,0,1,0,0,0,0,1,0,0,1
168715.0,Planinšič Uroš,S,Slovenia,25.0,186.0,2023,France,Slovenia,2023-06-10,True,0,2,12,14,10,0,67,77,0,0,1,1,3,1,1,5,0,0,0,0,3,0,1,4
168715.0,Planinšič Uroš,S,Slovenia,25.0,186.0,2023,Slovenia,Iran,2023-06-11,True,0,1,0,1,0,0,0,0,0,0,0,0,0,0,0,0,0,0,0,0,0,0,0,0
168715.0,Planinšič Uroš,S,Slovenia,25.0,186.0,2023,Argentina,Slovenia,2023-06-20,True,0,0,1,1,0,0,2,2,0,0,0,0,0,0,0,0,0,0,0,0,0,0,0,0
168715.0,Planinšič Uroš,S,Slovenia,25.0,186.0,2023,Slovenia,Canada,2023-06-21,True,0,0,0,0,0,0,0,0,0,0,0,0,0,0,0,0,0,0,0,0,0,0,0,0
168715.0,Planinšič Uroš,S,Slovenia,25.0,186.0,2023,Slovenia,Cuba,2023-06-22,True,0,0,0,0,0,0,0,0,0,0,0,0,0,0,0,0,0,0,0,0,0,0,0,0
168715.0,Planinšič Uroš,S,Slovenia,25.0,186.0,2023,Brazil,Slovenia,2023-06-24,False,0,0,2,2,2,0,4,6,0,0,0,0,0,0,0,0,0,0,0,0,1,1,0,2
168715.0,Planinšič Uroš,S,Slovenia,25.0,186.0,2023,Poland,Slovenia,2023-07-05,False,0,1,2,3,2,0,18,20,0,0,0,0,1,0,2,3,0,0,0,0,0,0,0,0
168715.0,Planinšič Uroš,S,Slovenia,25.0,186.0,2023,China,Slovenia,2023-07-06,True,0,0,2,2,4,0,14,18,0,0,0,0,0,1,1,2,0,0,0,0,2,0,0,2
168715.0,Planinšič Uroš,S,Slovenia,25.0,186.0,2023,Slovenia,Italy,2023-07-07,False,0,1,0,1,1,0,5,6,0,0,1,1,0,1,1,2,0,0,0,0,0,1,0,1
168715.0,Planinšič Uroš,S,Slovenia,25.0,186.0,2023,Slovenia,Netherlands,2023-07-09,True,0,1,1,2,0,0,0,0,0,0,0,0,0,0,0,0,0,0,0,0,1,0,0,1
168715.0,Planinšič Uroš,S,Slovenia,25.0,186.0,2023,Japan,Slovenia,2023-07-20,False,0,1,6,7,7,0,26,33,0,0,0,0,0,3,2,5,0,0,0,0,1,0,0,1
151391.0,Kozamernik Jan,MB,Slovenia,28.0,204.0,2023,Slovenia,Serbia,2023-06-07,True,1,2,19,22,0,0,0,0,6,0,3,9,1,10,6,17,1,0,0,1,5,0,0,5
151391.0,Kozamernik Jan,MB,Slovenia,28.0,204.0,2023,Slovenia,Bulgaria,2023-06-08,False,1,1,10,12,0,0,1,1,4,0,2,6,0,2,4,6,0,0,1,1,2,0,0,2
151391.0,Kozamernik Jan,MB,Slovenia,28.0,204.0,2023,France,Slovenia,2023-06-10,True,0,4,16,20,0,0,2,2,5,2,4,11,3,3,13,19,0,0,1,1,0,0,0,0
151391.0,Kozamernik Jan,MB,Slovenia,28.0,204.0,2023,Slovenia,Iran,2023-06-11,True,1,2,13,16,0,0,1,1,4,0,1,5,1,3,1,5,0,0,0,0,3,0,0,3
151391.0,Kozamernik Jan,MB,Slovenia,28.0,204.0,2023,Argentina,Slovenia,2023-06-20,True,1,2,14,17,0,0,2,2,3,0,7,10,4,1,6,11,0,0,0,0,1,1,1,3
151391.0,Kozamernik Jan,MB,Slovenia,28.0,204.0,2023,Slovenia,Canada,2023-06-21,True,0,0,16,16,0,0,2,2,4,0,2,6,1,7,6,14,2,0,3,5,4,1,0,5
151391.0,Kozamernik Jan,MB,Slovenia,28.0,204.0,2023,Slovenia,Cuba,2023-06-22,True,0,2,13,15,0,0,2,2,3,0,2,5,6,1,5,12,0,0,0,0,0,1,1,2
151391.0,Kozamernik Jan,MB,Slovenia,28.0,204.0,2023,Brazil,Slovenia,2023-06-24,False,0,2,15,17,0,0,4,4,3,1,2,6,1,5,6,12,0,0,4,4,2,3,0,5
151391.0,Kozamernik Jan,MB,Slovenia,28.0,204.0,2023,Poland,Slovenia,2023-07-05,False,2,3,20,25,0,0,3,3,5,0,6,11,4,6,5,15,0,0,4,4,7,1,1,9
151391.0,Kozamernik Jan,MB,Slovenia,28.0,204.0,2023,China,Slovenia,2023-07-06,True,4,3,16,23,0,0,7,7,8,1,1,10,1,3,4,8,0,1,2,3,6,1,0,7
151391.0,Kozamernik Jan,MB,Slovenia,28.0,204.0,2023,Slovenia,Italy,2023-07-07,False,0,1,4,5,0,0,2,2,1,4,1,6,1,0,3,4,0,0,2,2,1,0,0,1
151391.0,Kozamernik Jan,MB,Slovenia,28.0,204.0,2023,Slovenia,Netherlands,2023-07-09,True,0,1,15,16,0,0,0,0,7,0,2,9,0,1,3,4,0,0,0,0,0,1,0,1
151391.0,Kozamernik Jan,MB,Slovenia,28.0,204.0,2023,Japan,Slovenia,2023-07-20,False,0,2,11,13,0,0,1,1,2,0,1,3,1,3,3,7,0,0,0,0,0,0,0,0
151405.0,Kök Matej,OH,Slovenia,27.0,196.0,2023,Slovenia,Serbia,2023-06-07,True,0,0,1,1,0,0,0,0,0,1,1,2,0,1,1,2,0,0,0,0,0,0,0,0
151405.0,Kök Matej,OH,Slovenia,27.0,196.0,2023,Slovenia,Bulgaria,2023-06-08,False,0,2,9,11,0,0,1,1,5,5,5,15,0,1,0,1,0,0,1,1,0,0,1,1
151405.0,Kök Matej,OH,Slovenia,27.0,196.0,2023,France,Slovenia,2023-06-10,True,0,0,0,0,0,0,0,0,0,0,0,0,0,0,0,0,0,0,0,0,0,0,0,0
151405.0,Kök Matej,OH,Slovenia,27.0,196.0,2023,Slovenia,Iran,2023-06-11,True,0,0,0,0,0,0,0,0,0,0,0,0,0,0,0,0,0,0,0,0,0,0,0,0
151405.0,Kök Matej,OH,Slovenia,27.0,196.0,2023,Argentina,Slovenia,2023-06-20,True,0,1,4,5,0,0,0,0,0,0,0,0,0,0,0,0,0,0,0,0,0,0,0,0
151405.0,Kök Matej,OH,Slovenia,27.0,196.0,2023,Slovenia,Canada,2023-06-21,True,0,0,0,0,0,0,0,0,1,0,1,2,0,1,0,1,0,0,0,0,0,0,0,0
151405.0,Kök Matej,OH,Slovenia,27.0,196.0,2023,Slovenia,Cuba,2023-06-22,True,0,0,1,1,0,0,0,0,0,0,0,0,0,0,0,0,0,0,0,0,1,0,0,1
151405.0,Kök Matej,OH,Slovenia,27.0,196.0,2023,Brazil,Slovenia,2023-06-24,False,0,0,0,0,0,0,0,0,0,0,0,0,0,0,0,0,0,0,0,0,0,0,0,0
151405.0,Kök Matej,OH,Slovenia,27.0,196.0,2023,Poland,Slovenia,2023-07-05,False,0,0,0,0,0,0,0,0,0,0,0,0,0,0,0,0,0,0,0,0,0,0,0,0
151405.0,Kök Matej,OH,Slovenia,27.0,196.0,2023,China,Slovenia,2023-07-06,True,0,0,0,0,0,0,0,0,0,0,0,0,0,0,0,0,0,0,0,0,0,0,0,0
151405.0,Kök Matej,OH,Slovenia,27.0,196.0,2023,Slovenia,Italy,2023-07-07,False,0,0,0,0,0,0,0,0,0,0,0,0,0,0,0,0,0,0,0,0,0,0,0,0
151405.0,Kök Matej,OH,Slovenia,27.0,196.0,2023,Slovenia,Netherlands,2023-07-09,True,0,1,0,1,0,0,0,0,0,0,0,0,0,0,0,0,0,0,0,0,0,0,0,0
151405.0,Kök Matej,OH,Slovenia,27.0,196.0,2023,Japan,Slovenia,2023-07-20,False,0,0,0,0,0,0,0,0,0,0,0,0,0,0,0,0,0,0,0,0,0,0,0,0
161756.0,Toman Urban,L,Slovenia,26.0,185.0,2023,Slovenia,Serbia,2023-06-07,True,0,0,0,0,0,0,0,0,0,0,0,0,0,0,0,0,0,0,0,0,0,0,0,0
161756.0,Toman Urban,L,Slovenia,26.0,185.0,2023,Slovenia,Bulgaria,2023-06-08,False,0,0,0,0,0,0,0,0,0,0,0,0,0,0,0,0,0,0,0,0,0,0,0,0
161756.0,Toman Urban,L,Slovenia,26.0,185.0,2023,France,Slovenia,2023-06-10,True,0,0,0,0,0,0,0,0,0,0,0,0,0,0,0,0,0,0,0,0,0,0,0,0
161756.0,Toman Urban,L,Slovenia,26.0,185.0,2023,Slovenia,Iran,2023-06-11,True,0,0,0,0,0,0,0,0,0,0,0,0,0,0,0,0,0,0,0,0,0,0,0,0
161756.0,Toman Urban,L,Slovenia,26.0,185.0,2023,Argentina,Slovenia,2023-06-20,True,0,0,0,0,0,0,0,0,0,0,0,0,0,0,0,0,0,0,0,0,0,0,0,0
161756.0,Toman Urban,L,Slovenia,26.0,185.0,2023,Slovenia,Canada,2023-06-21,True,0,0,0,0,0,0,0,0,0,0,0,0,0,0,0,0,1,1,1,3,0,0,0,0
161756.0,Toman Urban,L,Slovenia,26.0,185.0,2023,Slovenia,Cuba,2023-06-22,True,0,0,0,0,0,0,0,0,0,0,0,0,0,0,0,0,0,0,0,0,0,0,0,0
161756.0,Toman Urban,L,Slovenia,26.0,185.0,2023,Brazil,Slovenia,2023-06-24,False,0,0,0,0,0,0,0,0,0,0,0,0,0,0,0,0,0,0,0,0,0,0,0,0
161756.0,Toman Urban,L,Slovenia,26.0,185.0,2023,Poland,Slovenia,2023-07-05,False,0,0,0,0,0,0,0,0,0,0,0,0,0,0,0,0,0,0,0,0,0,0,0,0
161756.0,Toman Urban,L,Slovenia,26.0,185.0,2023,China,Slovenia,2023-07-06,True,0,0,0,0,0,0,0,0,0,0,0,0,0,0,0,0,0,0,0,0,0,0,0,0
161756.0,Toman Urban,L,Slovenia,26.0,185.0,2023,Slovenia,Italy,2023-07-07,False,0,0,0,0,0,0,0,0,0,0,0,0,0,0,0,0,0,0,0,0,0,0,0,0
161756.0,Toman Urban,L,Slovenia,26.0,185.0,2023,Slovenia,Netherlands,2023-07-09,True,0,0,0,0,0,0,0,0,0,0,0,0,0,0,0,0,0,0,0,0,0,0,0,0
161756.0,Toman Urban,L,Slovenia,26.0,185.0,2023,Japan,Slovenia,2023-07-20,False,0,0,0,0,0,0,0,0,0,0,0,0,0,0,0,0,0,0,0,0,0,0,0,0
151404.0,Štalekar Sašo,MB,Slovenia,27.0,214.0,2023,Slovenia,Serbia,2023-06-07,True,0,0,0,0,0,0,0,0,0,0,0,0,0,0,0,0,0,0,0,0,0,0,0,0
151404.0,Štalekar Sašo,MB,Slovenia,27.0,214.0,2023,Slovenia,Bulgaria,2023-06-08,False,0,0,0,0,0,0,0,0,0,0,0,0,0,0,0,0,0,0,0,0,0,0,0,0
151404.0,Štalekar Sašo,MB,Slovenia,27.0,214.0,2023,France,Slovenia,2023-06-10,True,0,0,0,0,0,0,0,0,0,0,0,0,0,0,0,0,0,0,0,0,0,0,0,0
151404.0,Štalekar Sašo,MB,Slovenia,27.0,214.0,2023,Slovenia,Iran,2023-06-11,True,0,0,0,0,0,0,0,0,0,0,0,0,0,0,0,0,0,0,0,0,0,0,0,0
151404.0,Štalekar Sašo,MB,Slovenia,27.0,214.0,2023,Argentina,Slovenia,2023-06-20,True,0,0,0,0,0,0,0,0,0,0,0,0,0,0,0,0,0,0,0,0,0,0,0,0
151404.0,Štalekar Sašo,MB,Slovenia,27.0,214.0,2023,Slovenia,Canada,2023-06-21,True,0,1,0,1,0,0,0,0,1,0,1,2,0,0,0,0,0,0,0,0,0,0,0,0
151404.0,Štalekar Sašo,MB,Slovenia,27.0,214.0,2023,Slovenia,Cuba,2023-06-22,True,0,0,0,0,0,0,0,0,0,0,0,0,0,0,0,0,0,0,0,0,0,0,0,0
151404.0,Štalekar Sašo,MB,Slovenia,27.0,214.0,2023,Brazil,Slovenia,2023-06-24,False,0,0,0,0,0,0,0,0,0,0,0,0,0,0,0,0,0,0,0,0,0,0,0,0
151404.0,Štalekar Sašo,MB,Slovenia,27.0,214.0,2023,Poland,Slovenia,2023-07-05,False,0,0,0,0,0,0,0,0,0,0,0,0,0,0,0,0,0,0,0,0,0,0,0,0
151404.0,Štalekar Sašo,MB,Slovenia,27.0,214.0,2023,China,Slovenia,2023-07-06,True,0,0,0,0,0,0,0,0,0,0,0,0,0,0,0,0,0,0,0,0,0,0,0,0
151404.0,Štalekar Sašo,MB,Slovenia,27.0,214.0,2023,Slovenia,Italy,2023-07-07,False,0,0,5,5,0,0,1,1,4,1,3,8,0,4,2,6,0,0,0,0,0,1,1,2
151404.0,Štalekar Sašo,MB,Slovenia,27.0,214.0,2023,Slovenia,Netherlands,2023-07-09,True,0,0,0,0,0,0,0,0,0,0,0,0,0,0,0,0,0,0,0,0,0,0,0,0
151404.0,Štalekar Sašo,MB,Slovenia,27.0,214.0,2023,Japan,Slovenia,2023-07-20,False,0,0,0,0,0,0,0,0,0,0,0,0,0,0,0,0,0,0,0,0,0,0,0,0
144483.0,Koncilja Danijel,MB,Slovenia,33.0,201.0,2023,Slovenia,Serbia,2023-06-07,True,0,0,0,0,0,0,0,0,0,0,0,0,0,0,0,0,0,0,0,0,0,0,0,0
144483.0,Koncilja Danijel,MB,Slovenia,33.0,201.0,2023,Slovenia,Bulgaria,2023-06-08,False,0,0,0,0,0,0,0,0,0,0,0,0,0,0,0,0,0,0,0,0,0,0,0,0
144483.0,Koncilja Danijel,MB,Slovenia,33.0,201.0,2023,France,Slovenia,2023-06-10,True,0,0,0,0,0,0,0,0,0,0,0,0,0,0,0,0,0,0,0,0,0,0,0,0
144483.0,Koncilja Danijel,MB,Slovenia,33.0,201.0,2023,Slovenia,Iran,2023-06-11,True,0,0,0,0,0,0,0,0,0,0,0,0,0,0,0,0,0,0,0,0,0,0,0,0
144483.0,Koncilja Danijel,MB,Slovenia,33.0,201.0,2023,Argentina,Slovenia,2023-06-20,True,0,0,0,0,0,0,0,0,0,0,0,0,0,0,0,0,0,0,0,0,0,0,0,0
144483.0,Koncilja Danijel,MB,Slovenia,33.0,201.0,2023,Slovenia,Canada,2023-06-21,True,0,0,0,0,0,0,0,0,0,0,0,0,0,0,0,0,0,0,0,0,0,0,0,0
144483.0,Koncilja Danijel,MB,Slovenia,33.0,201.0,2023,Slovenia,Cuba,2023-06-22,True,0,0,0,0,0,0,0,0,0,0,0,0,0,0,0,0,0,0,0,0,0,0,0,0
144483.0,Koncilja Danijel,MB,Slovenia,33.0,201.0,2023,Brazil,Slovenia,2023-06-24,False,0,0,0,0,0,0,0,0,0,0,0,0,0,0,0,0,0,0,0,0,0,0,0,0
144483.0,Koncilja Danijel,MB,Slovenia,33.0,201.0,2023,Poland,Slovenia,2023-07-05,False,0,0,0,0,0,0,0,0,0,0,0,0,0,0,0,0,0,0,0,0,0,0,0,0
144483.0,Koncilja Danijel,MB,Slovenia,33.0,201.0,2023,China,Slovenia,2023-07-06,True,0,0,0,0,0,0,0,0,0,0,0,0,0,0,0,0,0,0,0,0,0,0,0,0
144483.0,Koncilja Danijel,MB,Slovenia,33.0,201.0,2023,Slovenia,Italy,2023-07-07,False,0,0,0,0,0,0,0,0,0,0,0,0,0,0,0,0,0,0,0,0,0,0,0,0
144483.0,Koncilja Danijel,MB,Slovenia,33.0,201.0,2023,Slovenia,Netherlands,2023-07-09,True,0,0,0,0,0,0,0,0,0,0,0,0,0,0,0,0,0,0,0,0,0,0,0,0
144483.0,Koncilja Danijel,MB,Slovenia,33.0,201.0,2023,Japan,Slovenia,2023-07-20,False,0,0,0,0,0,0,0,0,0,0,0,0,0,0,0,0,0,0,0,0,0,0,0,0
144415.0,Kovačič Jani,L,Slovenia,31.0,186.0,2023,Slovenia,Serbia,2023-06-07,True,0,0,0,0,0,0,3,3,0,0,0,0,0,0,0,0,11,0,12,23,10,1,1,12
144415.0,Kovačič Jani,L,Slovenia,31.0,186.0,2023,Slovenia,Bulgaria,2023-06-08,False,0,0,0,0,0,0,1,1,0,0,0,0,0,0,0,0,6,1,9,16,11,2,0,13
144415.0,Kovačič Jani,L,Slovenia,31.0,186.0,2023,France,Slovenia,2023-06-10,True,0,0,0,0,0,0,10,10,0,0,0,0,0,0,0,0,5,1,5,11,12,0,0,12
144415.0,Kovačič Jani,L,Slovenia,31.0,186.0,2023,Slovenia,Iran,2023-06-11,True,0,0,0,0,0,0,3,3,0,0,0,0,0,0,0,0,6,0,13,19,9,1,1,11
144415.0,Kovačič Jani,L,Slovenia,31.0,186.0,2023,Argentina,Slovenia,2023-06-20,True,0,0,0,0,0,0,3,3,0,0,0,0,0,0,0,0,7,0,10,17,9,5,1,15
144415.0,Kovačič Jani,L,Slovenia,31.0,186.0,2023,Slovenia,Canada,2023-06-21,True,0,0,0,0,0,0,3,3,0,0,0,0,0,0,0,0,2,0,5,7,5,3,5,13
144415.0,Kovačič Jani,L,Slovenia,31.0,186.0,2023,Slovenia,Cuba,2023-06-22,True,0,0,0,0,0,0,6,6,0,0,0,0,0,0,0,0,4,2,13,19,9,1,1,11
144415.0,Kovačič Jani,L,Slovenia,31.0,186.0,2023,Brazil,Slovenia,2023-06-24,False,0,0,0,0,0,0,7,7,0,0,0,0,0,0,0,0,4,2,16,22,15,8,0,23
144415.0,Kovačič Jani,L,Slovenia,31.0,186.0,2023,Poland,Slovenia,2023-07-05,False,0,0,0,0,0,0,6,6,0,0,0,0,0,0,0,0,14,2,12,28,16,5,2,23
144415.0,Kovačič Jani,L,Slovenia,31.0,186.0,2023,China,Slovenia,2023-07-06,True,0,0,0,0,0,1,9,10,0,0,0,0,0,0,0,0,9,2,11,22,13,2,1,16
144415.0,Kovačič Jani,L,Slovenia,31.0,186.0,2023,Slovenia,Italy,2023-07-07,False,0,0,0,0,0,0,7,7,0,0,0,0,0,0,0,0,7,1,11,19,7,2,2,11
144415.0,Kovačič Jani,L,Slovenia,31.0,186.0,2023,Slovenia,Netherlands,2023-07-09,True,0,0,0,0,0,0,6,6,0,0,0,0,0,0,0,0,7,0,16,23,3,1,1,5
144415.0,Kovačič Jani,L,Slovenia,31.0,186.0,2023,Japan,Slovenia,2023-07-20,False,0,0,0,0,0,0,11,11,0,0,0,0,0,0,0,0,5,1,4,10,9,7,1,17
155920.0,Štern Žiga,OH,Slovenia,30.0,193.0,2023,Slovenia,Serbia,2023-06-07,True,0,0,0,0,0,0,0,0,0,0,0,0,0,0,0,0,0,0,0,0,0,0,0,0
155920.0,Štern Žiga,OH,Slovenia,30.0,193.0,2023,Slovenia,Bulgaria,2023-06-08,False,0,0,1,1,0,0,0,0,1,0,0,1,0,0,0,0,1,0,2,3,0,0,0,0
155920.0,Štern Žiga,OH,Slovenia,30.0,193.0,2023,France,Slovenia,2023-06-10,True,0,0,0,0,0,0,0,0,0,0,0,0,0,0,0,0,0,0,0,0,0,0,0,0
155920.0,Štern Žiga,OH,Slovenia,30.0,193.0,2023,Slovenia,Iran,2023-06-11,True,0,0,0,0,0,0,0,0,0,0,0,0,0,0,0,0,0,0,0,0,0,0,0,0
155920.0,Štern Žiga,OH,Slovenia,30.0,193.0,2023,Argentina,Slovenia,2023-06-20,True,0,0,0,0,0,0,0,0,0,0,0,0,1,0,0,1,0,0,0,0,0,0,0,0
155920.0,Štern Žiga,OH,Slovenia,30.0,193.0,2023,Slovenia,Canada,2023-06-21,True,0,0,1,1,0,0,0,0,3,0,0,3,1,0,2,3,0,0,0,0,0,0,1,1
155920.0,Štern Žiga,OH,Slovenia,30.0,193.0,2023,Slovenia,Cuba,2023-06-22,True,0,3,5,8,0,0,1,1,12,2,7,21,1,2,1,4,3,0,8,11,4,3,0,7
155920.0,Štern Žiga,OH,Slovenia,30.0,193.0,2023,Brazil,Slovenia,2023-06-24,False,0,2,5,7,0,0,1,1,6,0,7,13,0,3,2,5,3,1,6,10,0,1,1,2
155920.0,Štern Žiga,OH,Slovenia,30.0,193.0,2023,Poland,Slovenia,2023-07-05,False,0,1,2,3,0,0,2,2,3,1,0,4,1,0,0,1,1,0,2,3,0,0,0,0
155920.0,Štern Žiga,OH,Slovenia,30.0,193.0,2023,China,Slovenia,2023-07-06,True,1,0,15,16,0,0,8,8,17,3,13,33,0,8,3,11,8,0,10,18,3,1,1,5
155920.0,Štern Žiga,OH,Slovenia,30.0,193.0,2023,Slovenia,Italy,2023-07-07,False,0,0,1,1,0,0,0,0,2,0,6,8,0,1,0,1,2,2,4,8,0,0,0,0
155920.0,Štern Žiga,OH,Slovenia,30.0,193.0,2023,Slovenia,Netherlands,2023-07-09,True,0,0,0,0,0,0,0,0,0,0,0,0,0,0,0,0,0,0,0,0,0,0,0,0
155920.0,Štern Žiga,OH,Slovenia,30.0,193.0,2023,Japan,Slovenia,2023-07-20,False,0,0,4,4,0,0,0,0,0,1,2,3,0,1,1,2,2,0,6,8,0,1,0,1
119018.0,Ropret Gregor,S,Slovenia,35.0,192.0,2023,Slovenia,Serbia,2023-06-07,True,0,2,9,11,14,1,96,111,2,1,1,4,0,4,4,8,0,0,1,1,3,0,1,4
119018.0,Ropret Gregor,S,Slovenia,35.0,192.0,2023,Slovenia,Bulgaria,2023-06-08,False,0,3,6,9,17,0,52,69,1,0,1,2,0,0,2,2,0,0,1,1,0,0,1,1
119018.0,Ropret Gregor,S,Slovenia,35.0,192.0,2023,France,Slovenia,2023-06-10,True,0,0,1,1,2,0,7,9,0,0,0,0,1,0,1,2,0,0,0,0,1,0,0,1
119018.0,Ropret Gregor,S,Slovenia,35.0,192.0,2023,Slovenia,Iran,2023-06-11,True,0,0,8,8,14,1,61,76,0,0,0,0,2,1,1,4,0,0,0,0,6,0,1,7
119018.0,Ropret Gregor,S,Slovenia,35.0,192.0,2023,Argentina,Slovenia,2023-06-20,True,0,0,11,11,22,0,58,80,0,0,2,2,1,1,1,3,0,0,1,1,8,2,3,13
119018.0,Ropret Gregor,S,Slovenia,35.0,192.0,2023,Slovenia,Canada,2023-06-21,True,1,2,6,9,21,0,41,62,0,0,1,1,0,1,2,3,0,0,1,1,7,2,2,11
119018.0,Ropret Gregor,S,Slovenia,35.0,192.0,2023,Slovenia,Cuba,2023-06-22,True,0,2,12,14,16,0,50,66,1,1,0,2,1,0,4,5,0,0,0,0,2,4,1,7
119018.0,Ropret Gregor,S,Slovenia,35.0,192.0,2023,Brazil,Slovenia,2023-06-24,False,0,1,13,14,24,1,52,77,0,0,2,2,1,2,6,9,0,0,0,0,11,4,0,15
119018.0,Ropret Gregor,S,Slovenia,35.0,192.0,2023,Poland,Slovenia,2023-07-05,False,0,0,13,13,21,1,81,103,1,0,0,1,0,1,2,3,0,0,0,0,5,6,0,11
119018.0,Ropret Gregor,S,Slovenia,35.0,192.0,2023,China,Slovenia,2023-07-06,True,0,2,7,9,22,0,61,83,1,0,0,1,0,1,2,3,0,0,0,0,6,1,1,8
119018.0,Ropret Gregor,S,Slovenia,35.0,192.0,2023,Slovenia,Italy,2023-07-07,False,0,1,7,8,20,1,46,67,0,0,0,0,0,1,3,4,0,0,0,0,7,3,3,13
119018.0,Ropret Gregor,S,Slovenia,35.0,192.0,2023,Slovenia,Netherlands,2023-07-09,True,0,0,11,11,21,0,41,62,0,0,2,2,0,4,1,5,0,0,1,1,4,7,0,11
119018.0,Ropret Gregor,S,Slovenia,35.0,192.0,2023,Japan,Slovenia,2023-07-20,False,0,0,6,6,9,1,35,45,0,0,1,1,0,2,2,4,0,0,0,0,3,3,0,6
114957.0,Urnaut Tine,OH,Slovenia,35.0,200.0,2023,Slovenia,Serbia,2023-06-07,True,1,2,16,19,0,0,8,8,21,5,9,35,0,1,1,2,5,0,16,21,12,0,2,14
114957.0,Urnaut Tine,OH,Slovenia,35.0,200.0,2023,Slovenia,Bulgaria,2023-06-08,False,2,1,7,10,0,0,2,2,11,5,6,22,0,1,1,2,4,1,9,14,3,0,1,4
114957.0,Urnaut Tine,OH,Slovenia,35.0,200.0,2023,France,Slovenia,2023-06-10,True,1,4,7,12,0,0,1,1,14,2,12,28,1,0,0,1,8,2,21,31,8,0,3,11
114957.0,Urnaut Tine,OH,Slovenia,35.0,200.0,2023,Slovenia,Iran,2023-06-11,True,5,4,5,14,0,0,6,6,6,5,10,21,2,3,1,6,6,1,13,20,6,0,0,6
114957.0,Urnaut Tine,OH,Slovenia,35.0,200.0,2023,Argentina,Slovenia,2023-06-20,True,1,3,11,15,0,0,6,6,11,6,7,24,0,3,0,3,10,2,16,28,5,0,0,5
114957.0,Urnaut Tine,OH,Slovenia,35.0,200.0,2023,Slovenia,Canada,2023-06-21,True,0,1,12,13,0,0,3,3,9,3,12,24,0,1,0,1,5,0,10,15,4,2,0,6
114957.0,Urnaut Tine,OH,Slovenia,35.0,200.0,2023,Slovenia,Cuba,2023-06-22,True,3,6,10,19,0,0,5,5,16,0,5,21,0,4,2,6,3,1,11,15,3,3,0,6
114957.0,Urnaut Tine,OH,Slovenia,35.0,200.0,2023,Brazil,Slovenia,2023-06-24,False,1,2,12,15,0,0,7,7,15,2,10,27,1,4,2,7,3,1,17,21,6,3,0,9
114957.0,Urnaut Tine,OH,Slovenia,35.0,200.0,2023,Poland,Slovenia,2023-07-05,False,2,5,13,20,0,1,6,7,14,6,21,41,0,5,2,7,5,3,20,28,6,4,0,10
114957.0,Urnaut Tine,OH,Slovenia,35.0,200.0,2023,China,Slovenia,2023-07-06,True,0,3,15,18,0,0,5,5,13,1,17,31,0,4,2,6,10,1,18,29,7,2,0,9
114957.0,Urnaut Tine,OH,Slovenia,35.0,200.0,2023,Slovenia,Italy,2023-07-07,False,0,2,8,10,0,0,5,5,10,3,11,24,0,1,2,3,1,0,16,17,5,1,0,6
114957.0,Urnaut Tine,OH,Slovenia,35.0,200.0,2023,Slovenia,Netherlands,2023-07-09,True,2,1,13,16,0,0,3,3,12,5,4,21,0,0,1,1,3,3,9,15,4,5,1,10
114957.0,Urnaut Tine,OH,Slovenia,35.0,200.0,2023,Japan,Slovenia,2023-07-20,False,0,3,8,11,0,0,4,4,12,4,14,30,0,2,4,6,2,0,12,14,7,2,1,10
136918.0,Čebulj Klemen,OH,Slovenia,32.0,202.0,2023,Slovenia,Serbia,2023-06-07,True,0,3,11,14,0,0,1,1,11,7,5,23,0,4,1,5,2,0,12,14,6,0,0,6
136918.0,Čebulj Klemen,OH,Slovenia,32.0,202.0,2023,Slovenia,Bulgaria,2023-06-08,False,0,0,4,4,0,1,1,2,7,1,1,9,1,2,2,5,2,0,6,8,4,0,0,4
136918.0,Čebulj Klemen,OH,Slovenia,32.0,202.0,2023,France,Slovenia,2023-06-10,True,0,5,10,15,0,0,3,3,7,4,17,28,0,2,1,3,2,0,7,9,11,0,1,12
136918.0,Čebulj Klemen,OH,Slovenia,32.0,202.0,2023,Slovenia,Iran,2023-06-11,True,0,4,9,13,0,0,5,5,8,1,16,25,1,1,5,7,0,0,9,9,7,0,1,8
136918.0,Čebulj Klemen,OH,Slovenia,32.0,202.0,2023,Argentina,Slovenia,2023-06-20,True,3,5,12,20,0,0,3,3,12,4,8,24,3,2,2,7,5,0,4,9,2,3,1,6
136918.0,Čebulj Klemen,OH,Slovenia,32.0,202.0,2023,Slovenia,Canada,2023-06-21,True,2,2,12,16,0,0,2,2,9,2,4,15,1,1,1,3,6,0,6,12,3,3,2,8
136918.0,Čebulj Klemen,OH,Slovenia,32.0,202.0,2023,Slovenia,Cuba,2023-06-22,True,1,5,10,16,0,0,4,4,12,2,6,20,1,2,2,5,2,0,3,5,2,6,1,9
136918.0,Čebulj Klemen,OH,Slovenia,32.0,202.0,2023,Brazil,Slovenia,2023-06-24,False,0,4,14,18,0,0,4,4,18,7,12,37,0,7,1,8,2,0,10,12,1,3,1,5
136918.0,Čebulj Klemen,OH,Slovenia,32.0,202.0,2023,Poland,Slovenia,2023-07-05,False,0,7,10,17,0,1,5,6,19,8,17,44,1,2,1,4,1,0,10,11,9,3,2,14
136918.0,Čebulj Klemen,OH,Slovenia,32.0,202.0,2023,China,Slovenia,2023-07-06,True,1,3,9,13,0,0,3,3,18,8,18,44,2,2,2,6,0,1,4,5,5,6,3,14
136918.0,Čebulj Klemen,OH,Slovenia,32.0,202.0,2023,Slovenia,Italy,2023-07-07,False,1,2,8,11,0,0,6,6,8,6,6,20,3,3,2,8,0,1,3,4,5,2,0,7
136918.0,Čebulj Klemen,OH,Slovenia,32.0,202.0,2023,Slovenia,Netherlands,2023-07-09,True,1,5,9,15,0,0,4,4,8,2,5,15,4,3,2,9,2,0,5,7,3,2,0,5
136918.0,Čebulj Klemen,OH,Slovenia,32.0,202.0,2023,Japan,Slovenia,2023-07-20,False,0,1,9,10,0,0,3,3,8,2,12,22,1,0,0,1,4,1,12,17,3,4,1,8
168747.0,Možič Rok,OH,Slovenia,22.0,200.0,2023,Slovenia,Serbia,2023-06-07,True,0,4,11,15,0,0,0,0,22,2,19,43,2,2,0,4,6,1,17,24,1,0,0,1
168747.0,Možič Rok,OH,Slovenia,22.0,200.0,2023,Slovenia,Bulgaria,2023-06-08,False,0,1,9,10,0,0,0,0,5,4,6,15,2,2,0,4,5,2,8,15,3,0,1,4
168747.0,Možič Rok,OH,Slovenia,22.0,200.0,2023,France,Slovenia,2023-06-10,True,2,7,7,16,0,0,3,3,17,5,10,32,2,0,1,3,4,0,8,12,6,0,1,7
168747.0,Možič Rok,OH,Slovenia,22.0,200.0,2023,Slovenia,Iran,2023-06-11,True,4,3,5,12,0,0,2,2,20,3,10,33,1,7,1,9,3,0,6,9,4,0,0,4
168747.0,Možič Rok,OH,Slovenia,22.0,200.0,2023,Argentina,Slovenia,2023-06-20,True,0,4,5,9,0,0,2,2,16,1,11,28,0,2,2,4,7,0,4,11,4,0,1,5
168747.0,Možič Rok,OH,Slovenia,22.0,200.0,2023,Slovenia,Canada,2023-06-21,True,2,3,5,10,0,0,3,3,16,1,5,22,1,2,6,9,1,1,6,8,4,1,1,6
168747.0,Možič Rok,OH,Slovenia,22.0,200.0,2023,Slovenia,Cuba,2023-06-22,True,0,2,1,3,0,0,0,0,1,0,5,6,0,2,0,2,0,1,4,5,0,1,1,2
168747.0,Možič Rok,OH,Slovenia,22.0,200.0,2023,Brazil,Slovenia,2023-06-24,False,0,2,4,6,0,0,1,1,7,1,7,15,0,1,3,4,1,0,5,6,2,1,0,3
168747.0,Možič Rok,OH,Slovenia,22.0,200.0,2023,Poland,Slovenia,2023-07-05,False,1,0,18,19,0,0,2,2,15,3,13,31,1,3,2,6,1,1,15,17,3,5,1,9
168747.0,Možič Rok,OH,Slovenia,22.0,200.0,2023,China,Slovenia,2023-07-06,True,0,0,0,0,0,0,0,0,0,0,0,0,0,0,0,0,0,0,0,0,0,0,0,0
168747.0,Možič Rok,OH,Slovenia,22.0,200.0,2023,Slovenia,Italy,2023-07-07,False,0,2,3,5,0,0,0,0,5,3,12,20,1,2,1,4,1,2,12,15,4,1,0,5
168747.0,Možič Rok,OH,Slovenia,22.0,200.0,2023,Slovenia,Netherlands,2023-07-09,True,1,2,5,8,0,0,1,1,8,6,9,23,2,6,1,9,1,0,6,7,5,2,0,7
168747.0,Možič Rok,OH,Slovenia,22.0,200.0,2023,Japan,Slovenia,2023-07-20,False,0,1,7,8,0,0,2,2,8,2,11,21,2,7,0,9,3,0,6,9,7,2,1,10
182325.0,Mujanovič Nik,O,Slovenia,19.0,206.0,2023,Argentina,Slovenia,2023-06-20,True,0,0,0,0,0,0,0,0,0,0,0,0,0,0,0,0,0,0,0,0,0,0,0,0
182325.0,Mujanovič Nik,O,Slovenia,19.0,206.0,2023,Slovenia,Canada,2023-06-21,True,0,0,0,0,0,0,0,0,0,0,0,0,0,0,0,0,0,0,0,0,0,0,0,0
182325.0,Mujanovič Nik,O,Slovenia,19.0,206.0,2023,Slovenia,Cuba,2023-06-22,True,0,0,0,0,0,0,0,0,1,0,0,1,0,0,0,0,0,0,0,0,0,0,0,0
182325.0,Mujanovič Nik,O,Slovenia,19.0,206.0,2023,Brazil,Slovenia,2023-06-24,False,0,0,0,0,0,0,0,0,0,0,0,0,0,0,0,0,0,0,0,0,0,0,0,0
182325.0,Mujanovič Nik,O,Slovenia,19.0,206.0,2023,Poland,Slovenia,2023-07-05,False,0,0,0,0,0,0,0,0,0,0,0,0,0,0,0,0,0,0,0,0,0,0,0,0
182325.0,Mujanovič Nik,O,Slovenia,19.0,206.0,2023,China,Slovenia,2023-07-06,True,0,0,0,0,0,0,0,0,0,0,0,0,0,0,0,0,0,0,0,0,0,0,0,0
182325.0,Mujanovič Nik,O,Slovenia,19.0,206.0,2023,Slovenia,Italy,2023-07-07,False,0,0,0,0,0,0,0,0,0,0,0,0,0,0,0,0,0,0,0,0,0,0,0,0
182325.0,Mujanovič Nik,O,Slovenia,19.0,206.0,2023,Slovenia,Netherlands,2023-07-09,True,0,0,0,0,0,0,0,0,0,0,0,0,0,0,0,0,0,0,0,0,0,0,0,0
182325.0,Mujanovič Nik,O,Slovenia,19.0,206.0,2023,Japan,Slovenia,2023-07-20,False,0,0,0,0,0,0,0,0,0,0,0,0,0,0,0,0,0,0,0,0,0,0,0,0
118893.0,Anderson Matthew,O,USA,36.0,202.0,2023,USA,Netherlands,2023-06-07,False,0,0,0,0,0,0,0,0,0,0,0,0,0,0,0,0,0,0,0,0,0,0,0,0
118893.0,Anderson Matthew,O,USA,36.0,202.0,2023,Italy,USA,2023-06-08,False,1,3,2,6,0,1,0,1,6,0,13,19,0,3,2,5,0,0,1,1,6,2,4,12
118893.0,Anderson Matthew,O,USA,36.0,202.0,2023,USA,Brazil,2023-06-11,False,0,0,0,0,0,0,0,0,0,0,0,0,0,0,0,0,0,0,0,0,0,0,0,0
118893.0,Anderson Matthew,O,USA,36.0,202.0,2023,USA,Serbia,2023-06-20,False,2,2,16,20,0,0,5,5,10,4,8,22,4,0,5,9,0,0,2,2,7,7,2,16
118893.0,Anderson Matthew,O,USA,36.0,202.0,2023,USA,China,2023-06-21,False,0,0,2,2,0,0,1,1,1,0,0,1,0,0,0,0,0,0,0,0,0,1,0,1
118893.0,Anderson Matthew,O,USA,36.0,202.0,2023,Iran,USA,2023-06-23,False,0,2,5,7,0,0,1,1,13,2,7,22,0,3,0,3,0,0,2,2,4,3,0,7
118893.0,Anderson Matthew,O,USA,36.0,202.0,2023,Poland,USA,2023-06-24,False,2,0,13,15,0,0,3,3,7,3,5,15,0,3,4,7,0,0,1,1,9,2,0,11
118893.0,Anderson Matthew,O,USA,36.0,202.0,2023,USA,France,2023-07-19,False,2,2,10,14,0,0,3,3,20,2,15,37,0,1,3,4,0,0,1,1,7,3,0,10
118893.0,Anderson Matthew,O,USA,36.0,202.0,2023,USA,Italy,2023-07-22,False,0,2,11,13,0,0,1,1,17,1,7,25,0,2,3,5,0,0,1,1,8,2,0,10
118893.0,Anderson Matthew,O,USA,36.0,202.0,2023,Poland,USA,2023-07-23,False,1,1,10,12,0,0,0,0,9,6,7,22,0,3,0,3,0,1,5,6,3,2,1,6
132624.0,Russell Aaron,OH,USA,30.0,205.0,2023,USA,Netherlands,2023-06-07,False,0,4,5,9,0,0,3,3,9,3,10,22,2,1,0,3,6,1,17,24,1,0,0,1
132624.0,Russell Aaron,OH,USA,30.0,205.0,2023,Italy,USA,2023-06-08,False,0,0,0,0,0,0,0,0,0,0,0,0,0,0,0,0,0,0,0,0,0,0,0,0
132624.0,Russell Aaron,OH,USA,30.0,205.0,2023,USA,Brazil,2023-06-11,False,0,1,5,6,0,0,3,3,7,1,10,18,0,3,3,6,2,3,10,15,3,0,0,3
132624.0,Russell Aaron,OH,USA,30.0,205.0,2023,USA,Serbia,2023-06-20,False,2,3,14,19,0,0,3,3,13,1,12,26,0,1,1,2,3,3,13,19,6,2,0,8
132624.0,Russell Aaron,OH,USA,30.0,205.0,2023,USA,China,2023-06-21,False,0,0,0,0,0,0,0,0,0,0,0,0,0,0,0,0,0,0,0,0,0,0,0,0
132624.0,Russell Aaron,OH,USA,30.0,205.0,2023,Iran,USA,2023-06-23,False,7,1,14,22,0,0,2,2,2,3,11,16,0,3,1,4,4,1,16,21,1,3,0,4
132624.0,Russell Aaron,OH,USA,30.0,205.0,2023,Poland,USA,2023-06-24,False,1,4,4,9,0,0,0,0,8,4,7,19,2,1,1,4,1,1,13,15,8,1,0,9
132624.0,Russell Aaron,OH,USA,30.0,205.0,2023,USA,Italy,2023-07-22,False,0,0,0,0,0,0,0,0,0,0,0,0,0,0,0,0,0,0,0,0,0,0,0,0
132624.0,Russell Aaron,OH,USA,30.0,205.0,2023,Poland,USA,2023-07-23,False,0,2,4,6,0,0,1,1,9,5,4,18,2,3,3,8,5,0,14,19,2,2,0,4
147721.0,Jendryk II Jeffrey,MB,USA,28.0,208.0,2023,USA,Netherlands,2023-06-07,False,0,1,15,16,0,0,0,0,5,0,4,9,0,2,3,5,1,0,0,1,2,1,1,4
147721.0,Jendryk II Jeffrey,MB,USA,28.0,208.0,2023,Italy,USA,2023-06-08,False,0,0,0,0,0,0,0,0,0,0,0,0,0,0,0,0,0,0,0,0,0,0,0,0
147721.0,Jendryk II Jeffrey,MB,USA,28.0,208.0,2023,USA,Brazil,2023-06-11,False,0,0,0,0,0,0,0,0,0,0,0,0,0,0,0,0,0,0,0,0,0,0,0,0
147721.0,Jendryk II Jeffrey,MB,USA,28.0,208.0,2023,USA,Serbia,2023-06-20,False,0,1,12,13,0,0,1,1,10,0,3,13,0,4,4,8,0,0,0,0,0,1,0,1
147721.0,Jendryk II Jeffrey,MB,USA,28.0,208.0,2023,USA,China,2023-06-21,False,0,0,0,0,0,0,0,0,0,0,0,0,0,0,0,0,0,0,0,0,0,0,0,0
147721.0,Jendryk II Jeffrey,MB,USA,28.0,208.0,2023,Iran,USA,2023-06-23,False,0,0,0,0,0,0,0,0,0,0,0,0,0,0,0,0,0,0,0,0,0,0,0,0
147721.0,Jendryk II Jeffrey,MB,USA,28.0,208.0,2023,Poland,USA,2023-06-24,False,0,3,6,9,0,0,1,1,4,0,3,7,1,3,4,8,0,0,0,0,1,0,0,1
147721.0,Jendryk II Jeffrey,MB,USA,28.0,208.0,2023,USA,France,2023-07-19,False,0,0,0,0,0,0,0,0,0,0,0,0,0,0,0,0,0,0,0,0,0,0,0,0
147721.0,Jendryk II Jeffrey,MB,USA,28.0,208.0,2023,USA,Italy,2023-07-22,False,0,0,0,0,0,0,0,0,0,0,0,0,0,0,0,0,0,0,0,0,0,0,0,0
147721.0,Jendryk II Jeffrey,MB,USA,28.0,208.0,2023,Poland,USA,2023-07-23,False,0,0,0,0,0,0,0,0,0,0,0,0,0,0,0,0,0,0,0,0,0,0,0,0
139254.0,Defalco Torey,OH,USA,26.0,198.0,2023,USA,Netherlands,2023-06-07,False,3,3,3,9,0,0,2,2,10,2,8,20,0,1,1,2,6,0,9,15,4,0,2,6
139254.0,Defalco Torey,OH,USA,26.0,198.0,2023,Italy,USA,2023-06-08,False,4,2,10,16,0,0,4,4,9,1,5,15,2,3,1,6,4,1,5,10,7,1,0,8
139254.0,Defalco Torey,OH,USA,26.0,198.0,2023,USA,Brazil,2023-06-11,False,1,2,4,7,0,0,2,2,7,3,5,15,0,1,2,3,3,1,18,22,2,0,1,3
139254.0,Defalco Torey,OH,USA,26.0,198.0,2023,USA,Serbia,2023-06-20,False,2,7,12,21,0,1,1,2,14,5,11,30,1,5,5,11,6,2,23,31,7,1,0,8
139254.0,Defalco Torey,OH,USA,26.0,198.0,2023,USA,China,2023-06-21,False,0,2,7,9,0,0,4,4,11,1,3,15,0,3,0,3,4,4,15,23,3,1,0,4
139254.0,Defalco Torey,OH,USA,26.0,198.0,2023,Iran,USA,2023-06-23,False,0,0,0,0,0,0,0,0,0,0,0,0,0,0,0,0,0,0,0,0,0,0,0,0
139254.0,Defalco Torey,OH,USA,26.0,198.0,2023,Poland,USA,2023-06-24,False,2,5,4,11,0,0,2,2,14,2,10,26,1,3,2,6,3,1,14,18,5,2,0,7
139254.0,Defalco Torey,OH,USA,26.0,198.0,2023,USA,France,2023-07-19,False,0,4,7,11,0,0,5,5,10,5,8,23,2,2,8,12,5,2,13,20,6,1,0,7
139254.0,Defalco Torey,OH,USA,26.0,198.0,2023,USA,Italy,2023-07-22,False,0,2,9,11,0,1,2,3,8,4,5,17,3,1,7,11,2,2,16,20,6,3,2,11
139254.0,Defalco Torey,OH,USA,26.0,198.0,2023,Poland,USA,2023-07-23,False,1,3,12,16,0,0,4,4,13,3,7,23,0,6,0,6,6,1,13,20,7,4,1,12
170104.0,Hanes Jake,O,USA,25.0,210.0,2023,USA,Netherlands,2023-06-07,False,2,2,8,12,0,0,0,0,8,3,8,19,2,2,1,5,0,0,0,0,4,3,3,10
170104.0,Hanes Jake,O,USA,25.0,210.0,2023,Italy,USA,2023-06-08,False,0,0,0,0,0,0,0,0,0,0,2,2,0,0,0,0,0,0,0,0,0,0,0,0
170104.0,Hanes Jake,O,USA,25.0,210.0,2023,USA,Brazil,2023-06-11,False,3,4,6,13,0,0,0,0,8,7,7,22,0,3,1,4,0,0,0,0,4,4,0,8
170104.0,Hanes Jake,O,USA,25.0,210.0,2023,USA,Serbia,2023-06-20,False,0,0,0,0,0,0,0,0,0,0,0,0,0,0,0,0,0,0,0,0,0,0,0,0
170104.0,Hanes Jake,O,USA,25.0,210.0,2023,USA,China,2023-06-21,False,0,2,11,13,0,0,0,0,10,1,7,18,1,1,2,4,0,0,0,0,4,3,1,8
170104.0,Hanes Jake,O,USA,25.0,210.0,2023,Iran,USA,2023-06-23,False,1,1,1,3,0,0,0,0,0,0,0,0,0,0,0,0,0,0,0,0,0,0,0,0
170104.0,Hanes Jake,O,USA,25.0,210.0,2023,Poland,USA,2023-06-24,False,0,1,1,2,0,0,0,0,0,0,0,0,0,0,0,0,0,0,0,0,0,0,0,0
170104.0,Hanes Jake,O,USA,25.0,210.0,2023,USA,France,2023-07-19,False,0,1,0,1,0,0,0,0,0,0,0,0,0,0,0,0,0,0,0,0,0,0,0,0
170104.0,Hanes Jake,O,USA,25.0,210.0,2023,USA,Italy,2023-07-22,False,0,0,0,0,0,0,0,0,0,0,0,0,0,0,0,0,0,0,0,0,0,0,0,0
170104.0,Hanes Jake,O,USA,25.0,210.0,2023,Poland,USA,2023-07-23,False,0,0,0,0,0,0,1,1,1,1,0,2,0,0,0,0,0,0,0,0,1,0,0,1
142445.0,Dagostino Kyle,L,USA,28.0,175.0,2023,USA,Serbia,2023-06-20,False,0,0,0,0,0,0,0,0,0,0,0,0,0,0,0,0,0,0,0,0,0,0,0,0
142445.0,Dagostino Kyle,L,USA,28.0,175.0,2023,USA,China,2023-06-21,False,0,0,0,0,0,0,4,4,0,0,0,0,0,0,0,0,2,0,3,5,1,2,0,3
142445.0,Dagostino Kyle,L,USA,28.0,175.0,2023,Iran,USA,2023-06-23,False,0,0,0,0,0,0,0,0,0,0,0,0,0,0,0,0,0,0,0,0,0,0,0,0
142445.0,Dagostino Kyle,L,USA,28.0,175.0,2023,Poland,USA,2023-06-24,False,0,0,0,0,0,0,0,0,0,0,0,0,0,0,0,0,0,0,0,0,0,0,0,0
142445.0,Dagostino Kyle,L,USA,28.0,175.0,2023,USA,France,2023-07-19,False,0,0,0,0,0,0,0,0,0,0,0,0,0,0,0,0,0,0,0,0,0,0,0,0
142445.0,Dagostino Kyle,L,USA,28.0,175.0,2023,USA,Italy,2023-07-22,False,0,0,0,0,0,0,0,0,0,0,0,0,0,0,0,0,0,0,0,0,0,0,0,0
142445.0,Dagostino Kyle,L,USA,28.0,175.0,2023,Poland,USA,2023-07-23,False,0,0,0,0,0,0,0,0,0,0,0,0,0,0,0,0,0,0,0,0,0,0,0,0
124879.0,Christenson Micah,S,USA,30.0,198.0,2023,USA,Netherlands,2023-06-07,False,1,0,12,13,27,0,36,63,1,0,0,1,2,0,2,4,0,0,0,0,8,2,0,10
124879.0,Christenson Micah,S,USA,30.0,198.0,2023,Italy,USA,2023-06-08,False,1,1,9,11,16,1,35,52,1,0,2,3,1,2,4,7,0,0,1,1,0,2,1,3
124879.0,Christenson Micah,S,USA,30.0,198.0,2023,USA,Brazil,2023-06-11,False,0,0,0,0,1,0,0,1,0,0,0,0,0,0,0,0,0,0,0,0,0,0,0,0
124879.0,Christenson Micah,S,USA,30.0,198.0,2023,USA,Serbia,2023-06-20,False,0,0,10,10,35,0,47,82,0,1,3,4,0,2,2,4,0,0,0,0,7,5,1,13
124879.0,Christenson Micah,S,USA,30.0,198.0,2023,USA,China,2023-06-21,False,0,0,1,1,5,0,2,7,0,0,0,0,0,1,0,1,0,0,0,0,1,0,1,2
124879.0,Christenson Micah,S,USA,30.0,198.0,2023,Iran,USA,2023-06-23,False,0,2,8,10,23,0,32,55,0,0,0,0,2,0,0,2,0,0,0,0,4,2,0,6
124879.0,Christenson Micah,S,USA,30.0,198.0,2023,Poland,USA,2023-06-24,False,1,1,13,15,16,1,43,60,1,0,1,2,4,4,4,12,0,0,0,0,4,0,3,7
124879.0,Christenson Micah,S,USA,30.0,198.0,2023,USA,France,2023-07-19,False,1,2,20,23,49,0,52,101,0,0,1,1,0,5,2,7,0,0,1,1,12,3,1,16
124879.0,Christenson Micah,S,USA,30.0,198.0,2023,USA,Italy,2023-07-22,False,0,0,10,10,23,0,44,67,1,0,1,2,2,1,4,7,0,0,2,2,3,2,0,5
124879.0,Christenson Micah,S,USA,30.0,198.0,2023,Poland,USA,2023-07-23,False,0,2,12,14,28,0,60,88,0,0,1,1,0,0,3,3,0,0,0,0,2,2,1,5
118901.0,Holt Maxwell,MB,USA,37.0,205.0,2023,USA,Netherlands,2023-06-07,False,0,0,0,0,0,0,0,0,0,0,0,0,0,0,0,0,0,0,0,0,0,0,0,0
118901.0,Holt Maxwell,MB,USA,37.0,205.0,2023,Italy,USA,2023-06-08,False,1,2,6,9,0,0,0,0,7,0,1,8,2,1,4,7,0,0,0,0,4,0,0,4
118901.0,Holt Maxwell,MB,USA,37.0,205.0,2023,USA,Brazil,2023-06-11,False,0,5,11,16,0,0,1,1,5,1,4,10,0,6,5,11,0,0,0,0,3,1,0,4
118901.0,Holt Maxwell,MB,USA,37.0,205.0,2023,USA,Serbia,2023-06-20,False,0,0,0,0,0,0,0,0,0,0,0,0,0,0,0,0,0,0,0,0,0,0,0,0
118901.0,Holt Maxwell,MB,USA,37.0,205.0,2023,USA,China,2023-06-21,False,4,5,15,24,0,0,0,0,5,0,1,6,1,3,5,9,0,0,1,1,1,1,0,2
118901.0,Holt Maxwell,MB,USA,37.0,205.0,2023,Iran,USA,2023-06-23,False,0,0,0,0,0,0,0,0,0,0,0,0,0,0,0,0,0,0,0,0,0,0,0,0
118901.0,Holt Maxwell,MB,USA,37.0,205.0,2023,Poland,USA,2023-06-24,False,1,2,10,13,0,0,0,0,4,1,0,5,0,2,3,5,0,0,1,1,1,1,0,2
118901.0,Holt Maxwell,MB,USA,37.0,205.0,2023,USA,France,2023-07-19,False,1,3,9,13,0,0,1,1,6,1,4,11,2,6,6,14,0,0,2,2,4,0,0,4
118901.0,Holt Maxwell,MB,USA,37.0,205.0,2023,USA,Italy,2023-07-22,False,0,2,10,12,0,0,4,4,3,1,3,7,1,5,6,12,2,0,0,2,1,2,0,3
118901.0,Holt Maxwell,MB,USA,37.0,205.0,2023,Poland,USA,2023-07-23,False,0,1,6,7,0,0,0,0,4,1,3,8,3,2,3,8,0,0,1,1,0,0,1,1
147421.0,Ma'a Micah,S,USA,26.0,192.0,2023,USA,Netherlands,2023-06-07,False,0,0,0,0,0,0,0,0,0,0,0,0,0,0,0,0,0,0,0,0,0,0,0,0
147421.0,Ma'a Micah,S,USA,26.0,192.0,2023,Italy,USA,2023-06-08,False,0,0,0,0,0,0,1,1,0,0,0,0,0,0,0,0,0,0,0,0,0,0,0,0
147421.0,Ma'a Micah,S,USA,26.0,192.0,2023,USA,Brazil,2023-06-11,False,0,2,11,13,24,1,68,93,3,1,0,4,1,3,3,7,0,0,0,0,6,2,2,10
147421.0,Ma'a Micah,S,USA,26.0,192.0,2023,USA,France,2023-07-19,False,0,0,3,3,0,0,0,0,0,0,0,0,0,0,0,0,0,0,0,0,2,0,0,2
147421.0,Ma'a Micah,S,USA,26.0,192.0,2023,USA,Italy,2023-07-22,False,0,0,0,0,0,0,0,0,0,0,0,0,0,0,0,0,0,0,0,0,0,0,0,0
147421.0,Ma'a Micah,S,USA,26.0,192.0,2023,Poland,USA,2023-07-23,False,0,0,0,0,3,0,2,5,0,0,1,1,1,1,0,2,0,0,0,0,0,0,0,0
143682.0,Jaeschke Thomas,OH,USA,30.0,198.0,2023,USA,Serbia,2023-06-20,False,0,0,0,0,0,0,0,0,0,0,0,0,0,0,0,0,0,0,0,0,0,0,0,0
143682.0,Jaeschke Thomas,OH,USA,30.0,198.0,2023,USA,China,2023-06-21,False,1,3,8,12,0,0,5,5,12,0,7,19,2,5,1,8,4,1,19,24,5,3,0,8
143682.0,Jaeschke Thomas,OH,USA,30.0,198.0,2023,Iran,USA,2023-06-23,False,2,2,7,11,0,0,0,0,7,3,6,16,0,0,1,1,7,1,7,15,1,2,0,3
143682.0,Jaeschke Thomas,OH,USA,30.0,198.0,2023,Poland,USA,2023-06-24,False,0,0,0,0,0,0,0,0,0,0,0,0,0,0,0,0,0,0,0,0,0,0,0,0
143682.0,Jaeschke Thomas,OH,USA,30.0,198.0,2023,USA,France,2023-07-19,False,0,4,16,20,0,1,3,4,14,5,11,30,2,3,0,5,7,1,20,28,9,1,1,11
143682.0,Jaeschke Thomas,OH,USA,30.0,198.0,2023,USA,Italy,2023-07-22,False,2,2,9,13,0,0,3,3,12,3,11,26,2,0,2,4,2,2,3,7,10,2,1,13
143682.0,Jaeschke Thomas,OH,USA,30.0,198.0,2023,Poland,USA,2023-07-23,False,0,1,10,11,0,0,2,2,7,3,5,15,2,0,0,2,2,4,8,14,5,5,0,10
133463.0,Muagututia Garrett,OH,USA,36.0,205.0,2023,USA,Netherlands,2023-06-07,False,0,0,0,0,0,0,0,0,0,0,0,0,0,0,0,0,0,0,0,0,0,0,0,0
133463.0,Muagututia Garrett,OH,USA,36.0,205.0,2023,Italy,USA,2023-06-08,False,2,1,15,18,0,0,1,1,7,1,4,12,0,2,1,3,2,0,13,15,4,0,0,4
133463.0,Muagututia Garrett,OH,USA,36.0,205.0,2023,USA,Brazil,2023-06-11,False,0,0,6,6,0,0,0,0,3,2,5,10,1,1,0,2,1,1,4,6,3,1,0,4
133463.0,Muagututia Garrett,OH,USA,36.0,205.0,2023,USA,France,2023-07-19,False,0,0,6,6,0,0,2,2,4,1,4,9,0,0,3,3,1,0,6,7,2,1,1,4
133463.0,Muagututia Garrett,OH,USA,36.0,205.0,2023,USA,Italy,2023-07-22,False,0,0,0,0,0,0,0,0,0,0,0,0,0,0,0,0,0,0,0,0,0,0,0,0
133463.0,Muagututia Garrett,OH,USA,36.0,205.0,2023,Poland,USA,2023-07-23,False,0,0,0,0,0,0,0,0,1,0,2,3,0,0,0,0,1,0,2,3,0,0,0,0
148120.0,Averill Taylor,MB,USA,32.0,201.0,2023,USA,Netherlands,2023-06-07,False,0,0,0,0,0,0,0,0,0,0,0,0,0,0,0,0,0,0,0,0,0,0,0,0
148120.0,Averill Taylor,MB,USA,32.0,201.0,2023,Italy,USA,2023-06-08,False,1,2,11,14,0,0,1,1,5,0,1,6,2,4,4,10,0,0,0,0,0,0,0,0
148120.0,Averill Taylor,MB,USA,32.0,201.0,2023,USA,Brazil,2023-06-11,False,0,3,10,13,0,0,0,0,6,0,3,9,0,0,4,4,0,0,0,0,3,0,0,3
148120.0,Averill Taylor,MB,USA,32.0,201.0,2023,USA,Serbia,2023-06-20,False,0,0,0,0,0,0,0,0,0,0,0,0,0,0,0,0,0,0,0,0,0,0,0,0
148120.0,Averill Taylor,MB,USA,32.0,201.0,2023,USA,China,2023-06-21,False,1,4,4,9,0,0,0,0,9,0,2,11,0,3,2,5,0,0,0,0,1,1,0,2
148120.0,Averill Taylor,MB,USA,32.0,201.0,2023,Iran,USA,2023-06-23,False,1,2,4,7,0,0,2,2,10,0,3,13,2,1,2,5,0,0,0,0,1,1,2,4
148120.0,Averill Taylor,MB,USA,32.0,201.0,2023,Poland,USA,2023-06-24,False,0,0,0,0,0,0,0,0,0,0,0,0,0,0,0,0,0,0,0,0,0,0,0,0
148120.0,Averill Taylor,MB,USA,32.0,201.0,2023,USA,France,2023-07-19,False,0,2,6,8,0,0,0,0,5,2,4,11,1,6,3,10,0,0,0,0,1,1,0,2
148120.0,Averill Taylor,MB,USA,32.0,201.0,2023,USA,Italy,2023-07-22,False,0,0,0,0,0,0,0,0,0,0,0,0,0,0,0,0,0,0,0,0,0,0,0,0
148120.0,Averill Taylor,MB,USA,32.0,201.0,2023,Poland,USA,2023-07-23,False,1,1,2,4,0,0,0,0,1,0,0,1,0,2,2,4,0,0,0,0,2,0,1,3
116069.0,Smith David,MB,USA,38.0,201.0,2023,USA,Netherlands,2023-06-07,False,0,5,7,12,0,0,3,3,8,0,1,9,2,1,4,7,0,0,0,0,4,0,0,4
116069.0,Smith David,MB,USA,38.0,201.0,2023,Italy,USA,2023-06-08,False,0,0,0,0,0,0,0,0,0,0,0,0,0,0,0,0,0,0,0,0,0,0,0,0
116069.0,Smith David,MB,USA,38.0,201.0,2023,USA,Brazil,2023-06-11,False,0,0,0,0,0,0,0,0,0,0,0,0,0,0,0,0,0,0,0,0,0,0,0,0
116069.0,Smith David,MB,USA,38.0,201.0,2023,USA,Serbia,2023-06-20,False,0,4,9,13,0,0,2,2,3,2,4,9,6,6,8,20,0,0,0,0,6,2,0,8
116069.0,Smith David,MB,USA,38.0,201.0,2023,USA,China,2023-06-21,False,0,0,0,0,0,0,0,0,0,0,0,0,0,0,0,0,0,0,0,0,0,0,0,0
116069.0,Smith David,MB,USA,38.0,201.0,2023,Iran,USA,2023-06-23,False,2,3,9,14,0,0,1,1,1,0,3,4,3,2,2,7,0,0,0,0,2,1,0,3
116069.0,Smith David,MB,USA,38.0,201.0,2023,Poland,USA,2023-06-24,False,0,0,0,0,0,0,0,0,0,0,0,0,0,0,0,0,0,0,0,0,0,0,0,0
116069.0,Smith David,MB,USA,38.0,201.0,2023,USA,France,2023-07-19,False,1,0,5,6,0,0,1,1,2,0,1,3,1,5,2,8,0,0,0,0,0,2,0,2
116069.0,Smith David,MB,USA,38.0,201.0,2023,USA,Italy,2023-07-22,False,1,1,13,15,0,0,2,2,3,0,4,7,2,2,6,10,0,0,1,1,3,0,1,4
116069.0,Smith David,MB,USA,38.0,201.0,2023,Poland,USA,2023-07-23,False,0,2,14,16,0,1,0,1,6,0,5,11,0,4,2,6,0,0,1,1,3,1,3,7
119732.0,Shoji Erik,L,USA,34.0,184.0,2023,USA,Netherlands,2023-06-07,False,0,0,0,0,0,0,6,6,0,0,0,0,0,0,0,0,2,2,7,11,5,0,0,5
119732.0,Shoji Erik,L,USA,34.0,184.0,2023,Italy,USA,2023-06-08,False,0,0,0,0,0,0,3,3,0,0,0,0,0,0,0,0,2,3,8,13,10,2,1,13
119732.0,Shoji Erik,L,USA,34.0,184.0,2023,USA,Brazil,2023-06-11,False,0,0,0,0,0,0,7,7,0,0,0,0,0,0,0,0,3,0,14,17,3,3,2,8
119732.0,Shoji Erik,L,USA,34.0,184.0,2023,USA,Serbia,2023-06-20,False,0,0,0,0,0,0,8,8,0,0,0,0,0,0,0,0,5,1,7,13,8,3,0,11
119732.0,Shoji Erik,L,USA,34.0,184.0,2023,USA,China,2023-06-21,False,0,0,0,0,0,0,0,0,0,0,0,0,0,0,0,0,0,0,0,0,0,0,0,0
119732.0,Shoji Erik,L,USA,34.0,184.0,2023,Iran,USA,2023-06-23,False,0,0,0,0,0,0,7,7,0,0,0,0,0,0,0,0,4,0,9,13,6,5,0,11
119732.0,Shoji Erik,L,USA,34.0,184.0,2023,Poland,USA,2023-06-24,False,0,0,0,0,0,0,8,8,0,0,0,0,0,0,0,0,2,0,10,12,1,1,0,2
119732.0,Shoji Erik,L,USA,34.0,184.0,2023,USA,France,2023-07-19,False,0,0,0,0,0,0,10,10,0,0,0,0,0,0,0,0,3,3,13,19,10,10,0,20
119732.0,Shoji Erik,L,USA,34.0,184.0,2023,USA,Italy,2023-07-22,False,0,0,0,0,0,0,6,6,0,0,0,0,0,0,0,0,3,0,8,11,10,2,1,13
119732.0,Shoji Erik,L,USA,34.0,184.0,2023,Poland,USA,2023-07-23,False,0,0,0,0,0,0,4,4,0,0,0,0,0,0,0,0,6,1,13,20,4,4,1,9
