Player_ID,Player Name,Position,Nationality,Age,Height,Year,Versus,Match_Date,Winner,Serve_Points,Serve_Errors,Serve_Attempts,Total_Serves,Set_Successes,Set_Errors,Set_Attempts,Total_Sets,Attack_Success,Attack Errors,Attack_Attempts,Total_Attacks,Block_Successful,Block_Errors,Block_Rebounds,Total_Blocks,Reception_Successful,Reception_Errors,Reception_Attemps,Total_Receptions,Dig_Success,Dig_Errors,Dig_Attempts,Total_Digs
160209.0,Van Sas Elise,S,Belgium,24.0,188,2021,Netherlands,2021-05-25,False,0,0,0,0,0,0,0,0,0,0,0,0,0,0,0,0,0,0,0,0,0,0,0,0
160209.0,Van Sas Elise,S,Belgium,24.0,188,2021,Germany,2021-05-27,False,0,0,0,0,0,0,1,1,0,0,1,1,0,0,0,0,0,0,0,0,0,0,0,0
160209.0,Van Sas Elise,S,Belgium,24.0,188,2021,Poland,2021-06-01,True,0,0,0,0,0,0,0,0,0,0,0,0,0,0,0,0,0,0,0,0,0,0,0,0
160209.0,Van Sas Elise,S,Belgium,24.0,188,2021,China,2021-06-06,True,0,0,6,6,4,0,12,16,0,0,0,0,2,0,0,2,0,0,0,0,0,1,0,1
160209.0,Van Sas Elise,S,Belgium,24.0,188,2021,Brazil,2021-06-07,False,0,1,2,3,3,0,20,23,0,0,0,0,0,0,1,1,0,0,0,0,0,1,0,1
160209.0,Van Sas Elise,S,Belgium,24.0,188,2021,Serbia,2021-06-08,True,0,0,0,0,1,0,6,7,0,0,0,0,0,0,0,0,0,0,0,0,0,0,0,0
160209.0,Van Sas Elise,S,Belgium,24.0,188,2021,USA,2021-06-12,False,0,0,0,0,1,0,2,3,0,0,0,0,0,0,0,0,0,0,0,0,0,0,0,0
160209.0,Van Sas Elise,S,Belgium,24.0,188,2021,Japan,2021-06-14,False,0,0,0,0,0,0,0,0,0,0,0,0,0,0,0,0,0,0,0,0,0,0,0,0
160209.0,Van Sas Elise,S,Belgium,24.0,188,2021,Thailand,2021-06-18,True,0,0,0,0,0,0,2,2,0,0,0,0,0,0,0,0,0,0,0,0,0,0,0,0
160209.0,Van Sas Elise,S,Belgium,24.0,188,2021,Italy,2021-06-19,True,0,0,0,0,0,0,0,0,0,0,0,0,0,0,0,0,0,0,0,0,0,0,0,0
160209.0,Van Sas Elise,S,Belgium,24.0,188,2021,Canada,2021-06-20,True,1,1,2,4,2,0,10,12,0,0,0,0,1,0,1,2,0,0,0,0,1,0,1,2
152042.0,Herbots Britt,OH,Belgium,22.0,182,2021,Netherlands,2021-05-25,False,0,2,5,7,0,0,0,0,13,3,20,36,0,2,6,8,10,1,7,18,2,0,1,3
152042.0,Herbots Britt,OH,Belgium,22.0,182,2021,Russia,2021-05-26,False,2,1,17,20,0,0,3,3,27,13,28,68,0,4,2,6,6,0,7,13,15,3,2,20
152042.0,Herbots Britt,OH,Belgium,22.0,182,2021,Germany,2021-05-27,False,1,2,6,9,0,0,2,2,11,4,17,32,0,1,0,1,4,1,9,14,0,0,0,0
152042.0,Herbots Britt,OH,Belgium,22.0,182,2021,Dominican Republic,2021-05-31,True,0,2,16,18,0,0,0,0,32,5,29,66,1,5,5,11,2,0,8,10,14,4,0,18
152042.0,Herbots Britt,OH,Belgium,22.0,182,2021,Poland,2021-06-01,True,1,2,13,16,0,0,5,5,19,8,26,53,0,5,5,10,0,0,3,3,9,3,5,17
152042.0,Herbots Britt,OH,Belgium,22.0,182,2021,China,2021-06-06,True,1,2,10,13,0,0,2,2,26,8,33,67,1,3,1,5,2,0,3,5,7,4,2,13
152042.0,Herbots Britt,OH,Belgium,22.0,182,2021,Brazil,2021-06-07,False,0,0,7,7,0,0,0,0,12,4,11,27,0,3,0,3,5,0,14,19,2,1,2,5
152042.0,Herbots Britt,OH,Belgium,22.0,182,2021,Serbia,2021-06-08,True,0,3,11,14,0,0,4,4,27,7,43,77,1,7,1,9,3,0,4,7,13,4,3,20
152042.0,Herbots Britt,OH,Belgium,22.0,182,2021,Japan,2021-06-14,False,0,2,10,12,0,0,6,6,23,9,36,68,3,3,2,8,7,0,17,24,8,1,1,10
152042.0,Herbots Britt,OH,Belgium,22.0,182,2021,Thailand,2021-06-18,True,1,3,11,15,0,0,2,2,31,5,22,58,1,1,0,2,11,0,17,28,6,6,1,13
152042.0,Herbots Britt,OH,Belgium,22.0,182,2021,Italy,2021-06-19,True,0,1,12,13,0,0,1,1,33,10,24,67,1,4,1,6,6,0,11,17,4,1,1,6
152042.0,Herbots Britt,OH,Belgium,22.0,182,2021,Canada,2021-06-20,True,3,3,8,14,0,0,2,2,23,3,17,43,0,4,1,5,2,0,10,12,14,1,0,15
135880.0,Lemmens Nathalie,MB,Belgium,27.0,192,2021,Russia,2021-05-26,False,0,0,12,12,0,0,0,0,0,0,2,2,1,1,2,4,0,0,0,0,3,0,0,3
135880.0,Lemmens Nathalie,MB,Belgium,27.0,192,2021,Germany,2021-05-27,False,0,0,0,0,0,0,0,0,0,0,0,0,0,0,0,0,0,0,0,0,0,0,0,0
135880.0,Lemmens Nathalie,MB,Belgium,27.0,192,2021,Dominican Republic,2021-05-31,True,0,1,9,10,0,0,0,0,2,0,3,5,0,5,5,10,0,0,0,0,4,0,0,4
135880.0,Lemmens Nathalie,MB,Belgium,27.0,192,2021,Poland,2021-06-01,True,0,0,0,0,0,0,0,0,0,0,0,0,0,0,0,0,0,0,0,0,0,0,0,0
135880.0,Lemmens Nathalie,MB,Belgium,27.0,192,2021,China,2021-06-06,True,0,0,0,0,0,0,0,0,0,0,0,0,0,0,0,0,0,0,0,0,0,0,0,0
135880.0,Lemmens Nathalie,MB,Belgium,27.0,192,2021,Brazil,2021-06-07,False,0,0,0,0,0,0,0,0,0,0,0,0,0,0,0,0,0,0,0,0,0,0,0,0
135880.0,Lemmens Nathalie,MB,Belgium,27.0,192,2021,Serbia,2021-06-08,True,0,0,0,0,0,0,0,0,0,0,0,0,0,0,1,1,0,0,0,0,0,0,0,0
135880.0,Lemmens Nathalie,MB,Belgium,27.0,192,2021,USA,2021-06-12,False,0,0,5,5,0,0,0,0,4,0,5,9,2,0,7,9,0,0,0,0,1,0,0,1
135880.0,Lemmens Nathalie,MB,Belgium,27.0,192,2021,Japan,2021-06-14,False,0,2,4,6,0,0,0,0,1,1,3,5,1,2,10,13,0,0,0,0,1,0,0,1
135880.0,Lemmens Nathalie,MB,Belgium,27.0,192,2021,Thailand,2021-06-18,True,1,0,17,18,0,0,2,2,1,0,2,3,2,2,3,7,0,0,1,1,3,1,0,4
135880.0,Lemmens Nathalie,MB,Belgium,27.0,192,2021,Italy,2021-06-19,True,0,0,3,3,0,0,1,1,0,0,0,0,0,1,0,1,0,0,0,0,0,0,0,0
135880.0,Lemmens Nathalie,MB,Belgium,27.0,192,2021,Canada,2021-06-20,True,0,0,0,0,0,0,0,0,0,0,0,0,0,0,0,0,0,0,0,0,0,0,0,0
156326.0,Guilliams Jodie,OH,Belgium,24.0,180,2021,Netherlands,2021-05-25,False,0,2,7,9,0,0,0,0,5,2,10,17,0,0,2,2,1,1,4,6,1,2,0,3
156326.0,Guilliams Jodie,OH,Belgium,24.0,180,2021,Russia,2021-05-26,False,0,1,12,13,0,0,0,0,7,8,9,24,0,4,5,9,3,1,7,11,5,0,1,6
156326.0,Guilliams Jodie,OH,Belgium,24.0,180,2021,Germany,2021-05-27,False,0,1,5,6,0,0,1,1,3,2,6,11,0,0,0,0,6,2,3,11,1,0,0,1
156326.0,Guilliams Jodie,OH,Belgium,24.0,180,2021,Dominican Republic,2021-05-31,True,1,2,14,17,0,0,0,0,14,6,24,44,3,5,3,11,7,1,3,11,15,5,4,24
156326.0,Guilliams Jodie,OH,Belgium,24.0,180,2021,Poland,2021-06-01,True,0,3,21,24,0,0,3,3,11,6,13,30,0,8,2,10,6,0,14,20,12,0,2,14
156326.0,Guilliams Jodie,OH,Belgium,24.0,180,2021,China,2021-06-06,True,2,1,6,9,0,0,4,4,2,2,14,18,0,2,5,7,3,0,13,16,12,3,0,15
156326.0,Guilliams Jodie,OH,Belgium,24.0,180,2021,Brazil,2021-06-07,False,1,1,5,7,0,0,1,1,1,1,8,10,0,6,0,6,3,1,13,17,2,2,2,6
156326.0,Guilliams Jodie,OH,Belgium,24.0,180,2021,Serbia,2021-06-08,True,2,3,15,20,0,1,3,4,9,7,21,37,3,2,2,7,3,1,20,24,15,4,2,21
156326.0,Guilliams Jodie,OH,Belgium,24.0,180,2021,USA,2021-06-12,False,0,0,2,2,0,0,0,0,0,0,6,6,0,0,0,0,2,0,10,12,2,0,0,2
156326.0,Guilliams Jodie,OH,Belgium,24.0,180,2021,Japan,2021-06-14,False,0,0,1,1,0,0,0,0,0,0,0,0,0,0,0,0,0,0,5,5,0,0,0,0
156326.0,Guilliams Jodie,OH,Belgium,24.0,180,2021,Thailand,2021-06-18,True,0,0,0,0,0,0,0,0,1,1,1,3,0,0,0,0,1,0,1,2,0,0,0,0
156326.0,Guilliams Jodie,OH,Belgium,24.0,180,2021,Italy,2021-06-19,True,0,1,15,16,0,0,1,1,6,1,10,17,0,2,0,2,1,0,2,3,4,1,0,5
156326.0,Guilliams Jodie,OH,Belgium,24.0,180,2021,Canada,2021-06-20,True,0,2,2,4,0,0,2,2,1,0,3,4,0,2,4,6,1,0,0,1,1,0,0,1
181274.0,Gilson Helena,OH,Belgium,22.0,184,2021,Netherlands,2021-05-25,False,0,0,0,0,0,0,0,0,0,0,0,0,0,0,0,0,0,0,0,0,0,0,0,0
181274.0,Gilson Helena,OH,Belgium,22.0,184,2021,Russia,2021-05-26,False,0,0,0,0,0,0,0,0,2,1,1,4,0,0,0,0,0,0,0,0,0,0,0,0
181274.0,Gilson Helena,OH,Belgium,22.0,184,2021,Germany,2021-05-27,False,0,2,1,3,0,0,0,0,1,1,3,5,0,1,0,1,0,0,1,1,0,0,0,0
181274.0,Gilson Helena,OH,Belgium,22.0,184,2021,Dominican Republic,2021-05-31,True,0,0,0,0,0,0,0,0,0,0,0,0,0,0,0,0,0,0,0,0,0,0,0,0
181274.0,Gilson Helena,OH,Belgium,22.0,184,2021,Poland,2021-06-01,True,0,0,0,0,0,0,0,0,2,1,2,5,0,0,0,0,0,0,0,0,0,0,0,0
181274.0,Gilson Helena,OH,Belgium,22.0,184,2021,China,2021-06-06,True,0,0,0,0,0,0,0,0,0,1,2,3,0,1,0,1,0,0,1,1,0,0,0,0
181274.0,Gilson Helena,OH,Belgium,22.0,184,2021,Serbia,2021-06-08,True,0,0,0,0,0,0,0,0,0,0,3,3,0,0,0,0,0,0,1,1,0,0,0,0
181274.0,Gilson Helena,OH,Belgium,22.0,184,2021,USA,2021-06-12,False,0,1,4,5,0,0,2,2,4,6,21,31,0,5,3,8,0,1,6,7,6,0,1,7
181274.0,Gilson Helena,OH,Belgium,22.0,184,2021,Japan,2021-06-14,False,0,0,0,0,0,0,0,0,0,0,0,0,0,0,0,0,0,0,0,0,0,0,0,0
181274.0,Gilson Helena,OH,Belgium,22.0,184,2021,Italy,2021-06-19,True,0,0,0,0,0,0,0,0,0,0,0,0,0,0,0,0,0,0,0,0,0,0,0,0
181274.0,Gilson Helena,OH,Belgium,22.0,184,2021,Canada,2021-06-20,True,0,0,0,0,0,0,0,0,0,0,0,0,0,0,0,0,0,0,0,0,0,0,0,0
151117.0,Van Gestel Celine,OH,Belgium,24.0,183,2021,Netherlands,2021-05-25,False,1,2,8,11,0,0,2,2,4,1,12,17,0,5,2,7,7,1,10,18,3,1,0,4
151117.0,Van Gestel Celine,OH,Belgium,24.0,183,2021,Russia,2021-05-26,False,0,1,12,13,0,0,2,2,9,6,10,25,0,1,3,4,15,1,22,38,15,5,0,20
151117.0,Van Gestel Celine,OH,Belgium,24.0,183,2021,Germany,2021-05-27,False,1,0,10,11,0,0,0,0,8,4,10,22,0,1,0,1,5,3,14,22,1,0,0,1
151117.0,Van Gestel Celine,OH,Belgium,24.0,183,2021,Dominican Republic,2021-05-31,True,4,0,18,22,0,0,0,0,9,4,17,30,0,5,4,9,12,0,20,32,18,4,0,22
151117.0,Van Gestel Celine,OH,Belgium,24.0,183,2021,Poland,2021-06-01,True,1,0,12,13,0,0,1,1,12,4,16,32,2,2,6,10,11,1,37,49,13,4,1,18
151117.0,Van Gestel Celine,OH,Belgium,24.0,183,2021,China,2021-06-06,True,3,0,14,17,0,0,2,2,11,4,13,28,1,7,7,15,12,0,31,43,11,2,1,14
151117.0,Van Gestel Celine,OH,Belgium,24.0,183,2021,Brazil,2021-06-07,False,0,0,7,7,0,0,1,1,8,4,15,27,1,0,2,3,2,1,9,12,6,4,1,11
151117.0,Van Gestel Celine,OH,Belgium,24.0,183,2021,Serbia,2021-06-08,True,1,1,15,17,0,0,2,2,8,3,23,34,1,4,1,6,14,2,40,56,19,3,3,25
151117.0,Van Gestel Celine,OH,Belgium,24.0,183,2021,USA,2021-06-12,False,2,0,8,10,0,0,3,3,4,1,8,13,0,2,1,3,1,0,12,13,8,5,0,13
151117.0,Van Gestel Celine,OH,Belgium,24.0,183,2021,Japan,2021-06-14,False,0,2,16,18,0,0,2,2,11,4,19,34,0,7,7,14,8,1,38,47,8,1,1,10
151117.0,Van Gestel Celine,OH,Belgium,24.0,183,2021,Thailand,2021-06-18,True,2,1,13,16,0,0,1,1,10,4,22,36,0,2,2,4,16,1,14,31,6,3,0,9
151117.0,Van Gestel Celine,OH,Belgium,24.0,183,2021,Italy,2021-06-19,True,1,2,16,19,0,0,0,0,9,4,14,27,2,3,0,5,10,0,24,34,7,0,1,8
151117.0,Van Gestel Celine,OH,Belgium,24.0,183,2021,Canada,2021-06-20,True,2,0,11,13,0,0,1,1,12,2,12,26,0,1,6,7,5,0,15,20,11,1,1,13
181275.0,Demeyer Nel,OH,Belgium,21.0,175,2021,Netherlands,2021-05-25,False,0,0,0,0,0,0,0,0,0,0,0,0,0,0,0,0,0,0,0,0,0,0,0,0
181275.0,Demeyer Nel,OH,Belgium,21.0,175,2021,Russia,2021-05-26,False,0,0,0,0,0,0,0,0,0,0,0,0,0,0,0,0,0,0,1,1,0,0,0,0
181275.0,Demeyer Nel,OH,Belgium,21.0,175,2021,Germany,2021-05-27,False,0,0,0,0,0,0,0,0,0,0,0,0,0,0,0,0,0,0,0,0,0,0,0,0
181275.0,Demeyer Nel,OH,Belgium,21.0,175,2021,Dominican Republic,2021-05-31,True,0,0,0,0,0,0,0,0,0,0,0,0,0,0,0,0,0,0,0,0,0,0,0,0
181275.0,Demeyer Nel,OH,Belgium,21.0,175,2021,Poland,2021-06-01,True,0,0,0,0,0,0,0,0,0,0,0,0,0,0,0,0,0,0,0,0,0,0,0,0
181275.0,Demeyer Nel,OH,Belgium,21.0,175,2021,China,2021-06-06,True,0,0,0,0,0,0,0,0,0,0,0,0,0,0,0,0,0,0,0,0,0,0,0,0
181275.0,Demeyer Nel,OH,Belgium,21.0,175,2021,Brazil,2021-06-07,False,0,0,0,0,0,0,0,0,0,0,0,0,0,0,0,0,0,0,0,0,0,0,0,0
181275.0,Demeyer Nel,OH,Belgium,21.0,175,2021,Serbia,2021-06-08,True,0,0,0,0,0,0,0,0,0,0,0,0,0,0,0,0,0,0,0,0,0,1,0,1
181275.0,Demeyer Nel,OH,Belgium,21.0,175,2021,USA,2021-06-12,False,0,1,1,2,0,0,0,0,0,0,0,0,0,0,0,0,1,0,0,1,1,1,0,2
181275.0,Demeyer Nel,OH,Belgium,21.0,175,2021,Japan,2021-06-14,False,0,0,0,0,0,1,16,17,0,0,0,0,0,0,0,0,5,1,4,10,22,7,4,33
181275.0,Demeyer Nel,OH,Belgium,21.0,175,2021,Thailand,2021-06-18,True,0,0,0,0,0,0,0,0,0,0,0,0,0,0,0,0,0,0,0,0,0,0,0,0
181275.0,Demeyer Nel,OH,Belgium,21.0,175,2021,Italy,2021-06-19,True,0,0,0,0,0,0,0,0,0,0,0,0,0,0,0,0,0,0,0,0,0,0,0,0
181275.0,Demeyer Nel,OH,Belgium,21.0,175,2021,Canada,2021-06-20,True,0,0,0,0,0,0,0,0,0,0,0,0,0,0,0,0,0,0,0,0,0,0,0,0
119429.0,Sobolska-Tarasova Dominika,MB,Poland,30.0,187,2021,Netherlands,2021-05-25,False,0,2,3,5,0,0,0,0,2,1,4,7,0,5,4,9,1,0,0,1,0,0,1,1
119429.0,Sobolska-Tarasova Dominika,MB,Poland,30.0,187,2021,Belgium,2021-05-26,False,0,2,3,5,0,0,0,0,5,2,9,16,6,8,12,26,0,0,0,0,2,0,0,2
119429.0,Sobolska-Tarasova Dominika,MB,Poland,30.0,187,2021,Germany,2021-05-27,False,0,0,4,4,0,0,0,0,2,1,3,6,2,2,0,4,0,0,0,0,2,0,0,2
119429.0,Sobolska-Tarasova Dominika,MB,Poland,30.0,187,2021,Belgium,2021-05-31,False,0,0,4,4,0,0,0,0,1,0,5,6,0,5,2,7,0,0,0,0,1,0,0,1
119429.0,Sobolska-Tarasova Dominika,MB,Poland,30.0,187,2021,Belgium,2021-06-01,False,0,0,4,4,0,0,0,0,1,2,4,7,0,3,4,7,0,1,0,1,2,0,0,2
119429.0,Sobolska-Tarasova Dominika,MB,Poland,30.0,187,2021,China,2021-06-06,False,0,0,0,0,0,0,0,0,0,1,1,2,0,0,0,0,0,0,0,0,1,0,0,1
119429.0,Sobolska-Tarasova Dominika,MB,Poland,30.0,187,2021,Belgium,2021-06-07,False,0,2,4,6,0,1,0,1,3,0,1,4,1,2,0,3,0,0,0,0,1,0,1,2
119429.0,Sobolska-Tarasova Dominika,MB,Poland,30.0,187,2021,Belgium,2021-06-08,False,0,0,0,0,0,0,0,0,0,0,0,0,0,0,0,0,0,0,0,0,0,0,0,0
119429.0,Sobolska-Tarasova Dominika,MB,Poland,30.0,187,2021,USA,2021-06-12,False,0,1,2,3,0,0,0,0,1,1,5,7,0,2,2,4,0,0,0,0,0,0,1,1
119429.0,Sobolska-Tarasova Dominika,MB,Poland,30.0,187,2021,Belgium,2021-06-14,False,0,0,2,2,0,0,0,0,2,0,1,3,1,1,0,2,0,0,0,0,0,1,0,1
119429.0,Sobolska-Tarasova Dominika,MB,Poland,30.0,187,2021,Thailand,2021-06-18,False,0,0,0,0,0,0,0,0,0,0,0,0,0,0,0,0,0,0,0,0,0,0,0,0
119429.0,Sobolska-Tarasova Dominika,MB,Poland,30.0,187,2021,Belgium,2021-06-19,False,0,1,4,5,0,0,0,0,1,0,1,2,1,1,1,3,0,0,0,0,0,1,0,1
119429.0,Sobolska-Tarasova Dominika,MB,Poland,30.0,187,2021,Belgium,2021-06-20,False,2,0,8,10,0,0,1,1,1,0,2,3,0,4,6,10,0,0,0,0,5,1,1,7
152039.0,De Tant Amber,L,Belgium,24.0,178,2021,USA,2021-06-12,False,0,0,0,0,0,0,0,0,0,0,0,0,0,0,0,0,0,0,1,1,0,0,0,0
156325.0,Janssens Marlies,MB,Belgium,24.0,193,2021,Netherlands,2021-05-25,False,0,2,10,12,0,0,0,0,10,1,5,16,1,5,2,8,0,0,0,0,3,0,0,3
156325.0,Janssens Marlies,MB,Belgium,24.0,193,2021,Russia,2021-05-26,False,0,0,0,0,0,0,0,0,0,0,0,0,0,0,0,0,0,0,0,0,0,0,0,0
156325.0,Janssens Marlies,MB,Belgium,24.0,193,2021,Germany,2021-05-27,False,0,0,7,7,0,0,1,1,2,4,3,9,1,0,1,2,0,0,0,0,2,0,0,2
156325.0,Janssens Marlies,MB,Belgium,24.0,193,2021,Dominican Republic,2021-05-31,True,2,2,15,19,0,1,0,1,8,1,5,14,5,7,4,16,0,0,0,0,5,0,1,6
156325.0,Janssens Marlies,MB,Belgium,24.0,193,2021,Poland,2021-06-01,True,3,0,12,15,0,0,1,1,9,4,6,19,7,3,4,14,0,0,1,1,4,1,0,5
156325.0,Janssens Marlies,MB,Belgium,24.0,193,2021,China,2021-06-06,True,1,2,12,15,0,0,2,2,7,0,11,18,9,5,6,20,0,0,0,0,1,1,0,2
156325.0,Janssens Marlies,MB,Belgium,24.0,193,2021,Brazil,2021-06-07,False,0,0,7,7,0,0,0,0,4,1,2,7,1,2,0,3,0,0,0,0,2,3,0,5
156325.0,Janssens Marlies,MB,Belgium,24.0,193,2021,Serbia,2021-06-08,True,2,2,16,20,0,0,2,2,10,2,10,22,1,4,9,14,0,0,0,0,4,0,3,7
156325.0,Janssens Marlies,MB,Belgium,24.0,193,2021,Japan,2021-06-14,False,3,4,11,18,0,0,1,1,11,1,6,18,8,1,5,14,0,0,1,1,3,0,0,3
156325.0,Janssens Marlies,MB,Belgium,24.0,193,2021,Thailand,2021-06-18,True,2,3,12,17,1,0,0,1,7,0,12,19,2,3,2,7,0,0,0,0,2,4,0,6
156325.0,Janssens Marlies,MB,Belgium,24.0,193,2021,Italy,2021-06-19,True,6,2,10,18,0,0,0,0,9,4,4,17,1,4,2,7,0,0,2,2,2,0,0,2
156325.0,Janssens Marlies,MB,Belgium,24.0,193,2021,Canada,2021-06-20,True,2,0,11,13,0,0,0,0,4,2,5,11,2,4,5,11,0,0,0,0,2,4,1,7
119420.0,De Valkeneer Lise,OH,Belgium,32.0,177,2021,Netherlands,2021-05-25,False,0,0,0,0,0,0,0,0,0,0,0,0,0,0,0,0,0,0,0,0,0,0,0,0
119420.0,De Valkeneer Lise,OH,Belgium,32.0,177,2021,Dominican Republic,2021-05-31,True,0,0,0,0,0,0,0,0,0,0,0,0,0,0,0,0,0,0,0,0,0,0,0,0
119420.0,De Valkeneer Lise,OH,Belgium,32.0,177,2021,Brazil,2021-06-07,False,0,1,3,4,0,0,0,0,3,3,3,9,0,0,4,4,0,0,1,1,2,0,0,2
119420.0,De Valkeneer Lise,OH,Belgium,32.0,177,2021,USA,2021-06-12,False,0,0,5,5,0,0,1,1,3,3,8,14,2,1,2,5,0,0,1,1,1,4,1,6
119420.0,De Valkeneer Lise,OH,Belgium,32.0,177,2021,Japan,2021-06-14,False,0,0,1,1,0,0,0,0,0,0,0,0,0,0,0,0,0,0,1,1,0,0,0,0
119420.0,De Valkeneer Lise,OH,Belgium,32.0,177,2021,Thailand,2021-06-18,True,0,0,0,0,0,0,0,0,0,0,0,0,0,0,0,0,0,0,0,0,0,0,0,0
160208.0,Van De Vyver Jutta,S,Belgium,25.0,173,2021,Netherlands,2021-05-25,False,0,0,0,0,0,0,0,0,0,0,0,0,0,0,0,0,0,0,0,0,0,0,0,0
160208.0,Van De Vyver Jutta,S,Belgium,25.0,173,2021,Russia,2021-05-26,False,0,0,0,0,0,0,3,3,0,0,0,0,0,0,0,0,0,0,0,0,0,0,1,1
160208.0,Van De Vyver Jutta,S,Belgium,25.0,173,2021,Germany,2021-05-27,False,0,0,0,0,0,0,0,0,0,0,0,0,0,0,0,0,0,0,0,0,0,0,0,0
160208.0,Van De Vyver Jutta,S,Belgium,25.0,173,2021,Dominican Republic,2021-05-31,True,0,0,0,0,0,0,0,0,0,0,0,0,0,0,0,0,0,0,0,0,0,0,0,0
160208.0,Van De Vyver Jutta,S,Belgium,25.0,173,2021,Poland,2021-06-01,True,0,0,0,0,0,0,0,0,0,0,0,0,0,0,0,0,0,0,0,0,0,0,0,0
160208.0,Van De Vyver Jutta,S,Belgium,25.0,173,2021,China,2021-06-06,True,0,0,0,0,0,0,0,0,0,0,0,0,0,0,0,0,0,0,0,0,0,0,0,0
160208.0,Van De Vyver Jutta,S,Belgium,25.0,173,2021,Serbia,2021-06-08,True,0,0,0,0,0,0,0,0,0,0,0,0,0,0,0,0,0,0,0,0,0,0,0,0
160208.0,Van De Vyver Jutta,S,Belgium,25.0,173,2021,USA,2021-06-12,False,0,0,0,0,0,0,0,0,0,0,0,0,0,0,0,0,0,0,0,0,0,0,0,0
160208.0,Van De Vyver Jutta,S,Belgium,25.0,173,2021,Japan,2021-06-14,False,0,0,1,1,2,1,7,10,0,0,0,0,0,0,0,0,0,0,0,0,0,0,0,0
160208.0,Van De Vyver Jutta,S,Belgium,25.0,173,2021,Thailand,2021-06-18,True,0,0,0,0,0,0,0,0,0,0,0,0,0,0,0,0,0,0,0,0,0,0,0,0
160208.0,Van De Vyver Jutta,S,Belgium,25.0,173,2021,Italy,2021-06-19,True,0,0,1,1,0,0,2,2,0,0,1,1,0,0,0,0,0,0,0,0,0,0,0,0
160208.0,Van De Vyver Jutta,S,Belgium,25.0,173,2021,Canada,2021-06-20,True,0,0,0,0,0,0,0,0,0,0,0,0,0,0,0,0,0,0,0,0,0,0,0,0
119537.0,Van De Vyver Ilka,S,Belgium,29.0,180,2021,Netherlands,2021-05-25,False,1,0,10,11,32,0,59,91,1,0,1,2,1,3,0,4,0,1,0,1,3,1,0,4
119537.0,Van De Vyver Ilka,S,Belgium,29.0,180,2021,Russia,2021-05-26,False,0,1,13,14,26,1,120,147,2,0,2,4,0,4,4,8,0,0,0,0,12,1,3,16
119537.0,Van De Vyver Ilka,S,Belgium,29.0,180,2021,Germany,2021-05-27,False,0,1,8,9,1,0,81,82,0,0,0,0,0,1,1,2,0,0,0,0,0,0,0,0
119537.0,Van De Vyver Ilka,S,Belgium,29.0,180,2021,Dominican Republic,2021-05-31,True,4,1,17,22,22,0,0,22,0,0,3,3,0,5,3,8,0,0,2,2,16,5,0,21
119537.0,Van De Vyver Ilka,S,Belgium,29.0,180,2021,Poland,2021-06-01,True,1,0,17,18,31,0,105,136,0,0,0,0,0,1,4,5,0,0,0,0,9,3,2,14
119537.0,Van De Vyver Ilka,S,Belgium,29.0,180,2021,China,2021-06-06,True,0,0,17,17,33,0,87,120,0,0,1,1,0,2,0,2,0,0,0,0,16,3,3,22
119537.0,Van De Vyver Ilka,S,Belgium,29.0,180,2021,Brazil,2021-06-07,False,0,0,3,3,11,2,30,43,0,0,1,1,0,0,1,1,0,0,0,0,6,4,0,10
119537.0,Van De Vyver Ilka,S,Belgium,29.0,180,2021,Serbia,2021-06-08,True,2,1,18,21,40,1,117,158,0,0,2,2,0,2,9,11,0,0,0,0,19,4,3,26
119537.0,Van De Vyver Ilka,S,Belgium,29.0,180,2021,USA,2021-06-12,False,0,1,11,12,7,0,66,73,0,1,2,3,0,1,1,2,0,0,0,0,8,2,2,12
119537.0,Van De Vyver Ilka,S,Belgium,29.0,180,2021,Japan,2021-06-14,False,0,2,12,14,25,1,85,111,0,0,1,1,0,8,5,13,0,0,1,1,12,2,4,18
119537.0,Van De Vyver Ilka,S,Belgium,29.0,180,2021,Thailand,2021-06-18,True,0,1,19,20,24,1,110,135,0,0,3,3,0,3,1,4,0,0,0,0,9,5,0,14
119537.0,Van De Vyver Ilka,S,Belgium,29.0,180,2021,Italy,2021-06-19,True,1,2,13,16,7,2,123,132,0,0,1,1,2,1,5,8,0,1,0,1,3,5,0,8
119537.0,Van De Vyver Ilka,S,Belgium,29.0,180,2021,Canada,2021-06-20,True,1,0,6,7,9,0,66,75,0,0,0,0,0,2,3,5,0,0,0,0,4,1,2,7
168160.0,Rampelberg Britt,L,Belgium,21.0,165,2021,Netherlands,2021-05-25,False,0,0,0,0,0,0,4,4,0,0,0,0,0,0,0,0,11,1,8,20,5,3,0,8
168160.0,Rampelberg Britt,L,Belgium,21.0,165,2021,Russia,2021-05-26,False,0,0,0,0,0,0,6,6,0,0,0,0,0,0,0,0,10,2,20,32,16,2,2,20
168160.0,Rampelberg Britt,L,Belgium,21.0,165,2021,Germany,2021-05-27,False,0,0,0,0,0,1,2,3,0,0,0,0,0,0,0,0,5,2,10,17,2,0,0,2
168160.0,Rampelberg Britt,L,Belgium,21.0,165,2021,Dominican Republic,2021-05-31,True,0,0,0,0,1,1,0,2,0,0,0,0,0,0,0,0,14,2,18,34,11,5,0,16
168160.0,Rampelberg Britt,L,Belgium,21.0,165,2021,Poland,2021-06-01,True,0,0,0,0,0,0,10,10,0,0,0,0,0,0,0,0,4,0,9,13,17,5,5,27
168160.0,Rampelberg Britt,L,Belgium,21.0,165,2021,China,2021-06-06,True,0,0,0,0,0,1,11,12,0,0,0,0,0,0,0,0,10,0,14,24,23,5,5,33
168160.0,Rampelberg Britt,L,Belgium,21.0,165,2021,Brazil,2021-06-07,False,0,0,0,0,0,0,8,8,0,0,0,0,0,0,0,0,4,0,12,16,7,1,3,11
168160.0,Rampelberg Britt,L,Belgium,21.0,165,2021,Serbia,2021-06-08,True,0,0,0,0,0,0,17,17,0,0,0,0,0,0,0,0,5,1,4,10,25,9,7,41
168160.0,Rampelberg Britt,L,Belgium,21.0,165,2021,USA,2021-06-12,False,0,0,0,0,0,0,13,13,0,0,0,0,0,0,0,0,6,1,17,24,8,5,2,15
168160.0,Rampelberg Britt,L,Belgium,21.0,165,2021,Thailand,2021-06-18,True,0,0,0,0,0,0,8,8,0,0,0,0,0,0,0,0,14,2,6,22,20,14,1,35
168160.0,Rampelberg Britt,L,Belgium,21.0,165,2021,Italy,2021-06-19,True,0,0,0,0,0,0,5,5,0,0,0,0,0,0,0,0,10,3,12,25,12,5,0,17
168160.0,Rampelberg Britt,L,Belgium,21.0,165,2021,Canada,2021-06-20,True,0,0,0,0,0,0,6,6,0,0,0,0,0,0,0,0,4,3,10,17,14,2,2,18
152040.0,Van Avermaet Silke,MB,Belgium,22.0,192,2021,Netherlands,2021-05-25,False,0,0,1,1,0,0,0,0,0,0,1,1,0,0,0,0,0,0,0,0,0,0,0,0
152040.0,Van Avermaet Silke,MB,Belgium,22.0,192,2021,Russia,2021-05-26,False,1,2,8,11,0,0,1,1,6,2,12,20,1,10,6,17,0,0,0,0,2,1,1,4
152040.0,Van Avermaet Silke,MB,Belgium,22.0,192,2021,Germany,2021-05-27,False,0,2,0,2,0,0,0,0,3,0,3,6,1,0,0,1,0,0,0,0,1,0,0,1
152040.0,Van Avermaet Silke,MB,Belgium,22.0,192,2021,Dominican Republic,2021-05-31,True,0,0,0,0,0,0,0,0,1,0,0,1,0,1,0,1,0,0,0,0,0,0,0,0
152040.0,Van Avermaet Silke,MB,Belgium,22.0,192,2021,Poland,2021-06-01,True,2,1,10,13,0,0,0,0,7,0,1,8,1,1,2,4,0,1,0,1,5,0,1,6
152040.0,Van Avermaet Silke,MB,Belgium,22.0,192,2021,China,2021-06-06,True,1,1,19,21,0,0,3,3,9,0,14,23,4,6,2,12,1,0,0,1,3,1,2,6
152040.0,Van Avermaet Silke,MB,Belgium,22.0,192,2021,Brazil,2021-06-07,False,1,0,4,5,0,0,2,2,2,3,1,6,2,0,3,5,0,0,1,1,3,0,0,3
152040.0,Van Avermaet Silke,MB,Belgium,22.0,192,2021,Serbia,2021-06-08,True,1,1,15,17,0,0,2,2,11,3,11,25,7,6,8,21,0,0,0,0,6,1,1,8
152040.0,Van Avermaet Silke,MB,Belgium,22.0,192,2021,USA,2021-06-12,False,1,0,7,8,0,0,0,0,5,2,3,10,1,3,1,5,0,0,0,0,5,0,0,5
152040.0,Van Avermaet Silke,MB,Belgium,22.0,192,2021,Japan,2021-06-14,False,0,2,13,15,0,0,0,0,6,1,11,18,1,3,4,8,0,0,0,0,5,3,2,10
152040.0,Van Avermaet Silke,MB,Belgium,22.0,192,2021,Thailand,2021-06-18,True,0,3,5,8,0,0,0,0,20,0,11,31,1,1,0,2,0,0,0,0,9,3,1,13
152040.0,Van Avermaet Silke,MB,Belgium,22.0,192,2021,Italy,2021-06-19,True,2,1,12,15,0,0,0,0,5,2,7,14,0,3,3,6,0,0,0,0,6,1,0,7
152040.0,Van Avermaet Silke,MB,Belgium,22.0,192,2021,Canada,2021-06-20,True,0,0,8,8,0,0,0,0,4,1,5,10,1,1,0,2,0,1,0,1,1,1,1,3
152057.0,Stragier Manon,OH,Belgium,23.0,182,2021,Netherlands,2021-05-25,False,0,1,3,4,0,0,0,0,0,0,0,0,0,0,0,0,0,0,0,0,0,0,0,0
152057.0,Stragier Manon,OH,Belgium,23.0,182,2021,Russia,2021-05-26,False,0,1,8,9,0,0,0,0,1,0,3,4,0,0,0,0,0,0,0,0,4,0,0,4
152057.0,Stragier Manon,OH,Belgium,23.0,182,2021,Germany,2021-05-27,False,0,1,1,2,0,0,0,0,0,0,0,0,0,0,0,0,0,0,0,0,0,0,0,0
152057.0,Stragier Manon,OH,Belgium,23.0,182,2021,Dominican Republic,2021-05-31,True,0,0,3,3,0,0,0,0,0,0,0,0,0,0,0,0,0,0,0,0,0,0,0,0
152057.0,Stragier Manon,OH,Belgium,23.0,182,2021,Poland,2021-06-01,True,0,0,1,1,0,0,0,0,0,0,0,0,0,0,0,0,0,0,0,0,0,1,0,1
152057.0,Stragier Manon,OH,Belgium,23.0,182,2021,China,2021-06-06,True,1,0,8,9,0,0,2,2,0,1,4,5,0,1,0,1,1,0,3,4,3,1,2,6
152057.0,Stragier Manon,OH,Belgium,23.0,182,2021,Brazil,2021-06-07,False,0,0,0,0,0,0,0,0,0,0,0,0,0,0,0,0,0,0,1,1,0,0,0,0
152057.0,Stragier Manon,OH,Belgium,23.0,182,2021,Serbia,2021-06-08,True,0,1,2,3,0,0,0,0,0,1,1,2,0,0,0,0,0,0,0,0,2,0,0,2
152057.0,Stragier Manon,OH,Belgium,23.0,182,2021,USA,2021-06-12,False,1,1,1,3,0,0,0,0,0,1,0,1,0,1,1,2,0,0,0,0,0,0,0,0
152057.0,Stragier Manon,OH,Belgium,23.0,182,2021,Japan,2021-06-14,False,0,1,1,2,0,0,0,0,0,0,0,0,0,0,0,0,0,0,0,0,1,1,0,2
152057.0,Stragier Manon,OH,Belgium,23.0,182,2021,Thailand,2021-06-18,True,0,0,4,4,0,0,1,1,0,0,0,0,0,0,0,0,0,0,0,0,0,0,0,0
152057.0,Stragier Manon,OH,Belgium,23.0,182,2021,Italy,2021-06-19,True,0,1,0,1,0,0,0,0,0,0,0,0,0,0,0,0,0,0,0,0,0,0,0,0
152057.0,Stragier Manon,OH,Belgium,23.0,182,2021,Canada,2021-06-20,True,0,1,1,2,0,0,0,0,0,0,0,0,0,0,0,0,0,0,0,0,0,1,0,1
113245.0,De Oliveira Saad Gattaz Caroline,MB,Brazil,40.0,192,2021,Canada,2021-05-25,True,0,0,0,0,0,0,0,0,0,0,0,0,0,0,0,0,0,0,0,0,0,0,0,0
113245.0,De Oliveira Saad Gattaz Caroline,MB,Brazil,40.0,192,2021,Dominican Republic,2021-05-26,True,0,0,12,12,0,0,0,0,7,1,6,14,3,3,2,8,0,0,0,0,2,0,0,2
113245.0,De Oliveira Saad Gattaz Caroline,MB,Brazil,40.0,192,2021,USA,2021-05-27,False,0,1,4,5,0,0,0,0,3,0,6,9,1,3,4,8,0,0,1,1,1,0,0,1
113245.0,De Oliveira Saad Gattaz Caroline,MB,Brazil,40.0,192,2021,Japan,2021-05-31,True,1,0,7,8,0,0,1,1,2,0,2,4,1,4,0,5,0,0,0,0,3,0,0,3
113245.0,De Oliveira Saad Gattaz Caroline,MB,Brazil,40.0,192,2021,Russia,2021-06-01,True,1,1,2,4,0,0,3,3,7,1,5,13,2,4,7,13,1,0,0,1,5,0,0,5
113245.0,De Oliveira Saad Gattaz Caroline,MB,Brazil,40.0,192,2021,Italy,2021-06-02,True,0,0,0,0,0,0,0,0,0,0,0,0,0,0,0,0,0,0,0,0,0,0,0,0
113245.0,De Oliveira Saad Gattaz Caroline,MB,Brazil,40.0,192,2021,Serbia,2021-06-06,True,0,1,6,7,0,0,3,3,1,0,4,5,2,3,2,7,1,0,1,2,3,0,1,4
113245.0,De Oliveira Saad Gattaz Caroline,MB,Brazil,40.0,192,2021,Belgium,2021-06-07,True,0,1,5,6,0,0,3,3,6,1,1,8,0,3,8,11,1,0,2,3,1,2,0,3
113245.0,De Oliveira Saad Gattaz Caroline,MB,Brazil,40.0,192,2021,China,2021-06-08,False,1,2,7,10,0,0,3,3,16,1,7,24,2,7,12,21,0,0,1,1,4,1,0,5
113245.0,De Oliveira Saad Gattaz Caroline,MB,Brazil,40.0,192,2021,Poland,2021-06-12,True,0,2,8,10,0,0,1,1,4,1,4,9,3,5,3,11,0,0,1,1,3,0,0,3
113245.0,De Oliveira Saad Gattaz Caroline,MB,Brazil,40.0,192,2021,Netherlands,2021-06-19,True,0,0,12,12,0,0,5,5,7,0,3,10,0,3,3,6,0,0,1,1,6,0,0,6
113245.0,De Oliveira Saad Gattaz Caroline,MB,Brazil,40.0,192,2021,Japan,2021-06-24,True,1,0,18,19,0,0,3,3,4,1,9,14,3,4,6,13,0,0,0,0,6,0,0,6
113245.0,De Oliveira Saad Gattaz Caroline,MB,Brazil,40.0,192,2021,USA,2021-06-25,False,0,0,13,13,0,0,2,2,9,0,3,12,3,4,7,14,0,0,0,0,3,0,2,5
112625.0,Rodrigues Lins Dos Santos Danielle,S,Brazil,37.0,181,2021,Canada,2021-05-25,True,0,0,1,1,0,0,13,13,0,0,0,0,1,1,0,2,0,0,0,0,3,0,0,3
112625.0,Rodrigues Lins Dos Santos Danielle,S,Brazil,37.0,181,2021,USA,2021-05-27,False,0,0,4,4,6,0,17,23,0,0,0,0,0,0,1,1,0,0,0,0,2,0,0,2
112625.0,Rodrigues Lins Dos Santos Danielle,S,Brazil,37.0,181,2021,Russia,2021-06-01,True,0,1,1,2,4,0,9,13,0,0,0,0,0,2,0,2,0,0,0,0,3,0,1,4
112625.0,Rodrigues Lins Dos Santos Danielle,S,Brazil,37.0,181,2021,Serbia,2021-06-06,True,0,2,3,5,6,0,26,32,0,0,0,0,0,0,2,2,0,1,0,1,5,0,1,6
112625.0,Rodrigues Lins Dos Santos Danielle,S,Brazil,37.0,181,2021,China,2021-06-08,False,0,0,6,6,4,1,14,19,0,0,0,0,0,0,0,0,0,0,0,0,2,0,2,4
112625.0,Rodrigues Lins Dos Santos Danielle,S,Brazil,37.0,181,2021,Germany,2021-06-13,True,0,1,4,5,0,1,13,14,0,0,0,0,0,0,0,0,0,0,0,0,0,0,0,0
112625.0,Rodrigues Lins Dos Santos Danielle,S,Brazil,37.0,181,2021,USA,2021-06-25,False,0,1,1,2,1,0,12,13,0,0,0,0,0,0,0,0,0,0,0,0,0,2,0,2
113955.0,Da Silva Adenizia,MB,Brazil,35.0,185,2021,Canada,2021-05-25,True,0,0,0,0,0,0,0,0,0,0,0,0,0,0,0,0,0,0,0,0,0,0,0,0
113955.0,Da Silva Adenizia,MB,Brazil,35.0,185,2021,USA,2021-05-27,False,1,0,6,7,0,0,1,1,3,2,4,9,2,5,2,9,0,0,1,1,1,0,0,1
113955.0,Da Silva Adenizia,MB,Brazil,35.0,185,2021,Japan,2021-05-31,True,0,0,0,0,0,0,0,0,0,0,0,0,0,0,0,0,0,0,0,0,0,0,0,0
113955.0,Da Silva Adenizia,MB,Brazil,35.0,185,2021,Italy,2021-06-02,True,0,0,0,0,0,0,0,0,0,0,0,0,0,0,0,0,0,0,0,0,0,0,0,0
113955.0,Da Silva Adenizia,MB,Brazil,35.0,185,2021,Serbia,2021-06-06,True,0,0,1,1,0,0,1,1,3,0,0,3,2,1,2,5,0,0,0,0,1,0,0,1
113955.0,Da Silva Adenizia,MB,Brazil,35.0,185,2021,China,2021-06-08,False,0,0,0,0,0,0,0,0,0,0,0,0,0,0,0,0,0,0,0,0,0,0,0,0
113955.0,Da Silva Adenizia,MB,Brazil,35.0,185,2021,Poland,2021-06-12,True,0,0,2,2,0,0,0,0,0,0,1,1,0,2,0,2,0,0,0,0,0,0,0,0
113955.0,Da Silva Adenizia,MB,Brazil,35.0,185,2021,Germany,2021-06-13,True,0,0,0,0,0,0,0,0,0,0,0,0,0,0,0,0,0,0,0,0,0,0,0,0
113955.0,Da Silva Adenizia,MB,Brazil,35.0,185,2021,Thailand,2021-06-14,True,0,0,10,10,0,0,1,1,4,0,2,6,1,3,1,5,0,0,0,0,1,0,0,1
113955.0,Da Silva Adenizia,MB,Brazil,35.0,185,2021,Netherlands,2021-06-19,True,1,0,1,2,0,0,1,1,1,0,1,2,0,0,1,1,0,0,0,0,0,0,1,1
113955.0,Da Silva Adenizia,MB,Brazil,35.0,185,2021,Japan,2021-06-24,True,0,0,0,0,0,0,0,0,0,0,0,0,0,0,0,0,0,0,0,0,0,0,0,0
152135.0,Alexandre Costa Nunes Nyeme Victoria,L,Brazil,23.0,175,2021,Canada,2021-05-25,True,0,0,0,0,0,0,0,0,0,0,0,0,0,0,0,0,0,0,0,0,0,0,0,0
152135.0,Alexandre Costa Nunes Nyeme Victoria,L,Brazil,23.0,175,2021,Dominican Republic,2021-05-26,True,0,0,0,0,0,0,0,0,0,0,0,0,0,0,0,0,0,0,0,0,0,0,0,0
152135.0,Alexandre Costa Nunes Nyeme Victoria,L,Brazil,23.0,175,2021,USA,2021-05-27,False,0,0,0,0,0,0,0,0,0,0,0,0,0,0,0,0,0,0,0,0,0,0,0,0
152135.0,Alexandre Costa Nunes Nyeme Victoria,L,Brazil,23.0,175,2021,Japan,2021-05-31,True,0,0,0,0,0,0,0,0,0,0,0,0,0,0,0,0,0,0,0,0,0,0,0,0
152135.0,Alexandre Costa Nunes Nyeme Victoria,L,Brazil,23.0,175,2021,Russia,2021-06-01,True,0,0,0,0,0,0,0,0,0,0,0,0,0,0,0,0,0,0,0,0,0,0,0,0
152135.0,Alexandre Costa Nunes Nyeme Victoria,L,Brazil,23.0,175,2021,Italy,2021-06-02,True,0,0,0,0,0,0,0,0,0,0,0,0,0,0,0,0,0,0,0,0,0,0,0,0
152135.0,Alexandre Costa Nunes Nyeme Victoria,L,Brazil,23.0,175,2021,Serbia,2021-06-06,True,0,0,0,0,0,0,2,2,0,0,0,0,0,0,0,0,1,0,2,3,3,2,1,6
152135.0,Alexandre Costa Nunes Nyeme Victoria,L,Brazil,23.0,175,2021,Belgium,2021-06-07,True,0,0,0,0,0,0,0,0,0,0,0,0,0,0,0,0,0,0,0,0,0,0,0,0
152135.0,Alexandre Costa Nunes Nyeme Victoria,L,Brazil,23.0,175,2021,China,2021-06-08,False,0,0,0,0,0,0,0,0,0,0,0,0,0,0,0,0,0,0,0,0,0,0,0,0
152135.0,Alexandre Costa Nunes Nyeme Victoria,L,Brazil,23.0,175,2021,Poland,2021-06-12,True,0,0,0,0,0,0,0,0,0,0,0,0,0,0,0,0,0,0,0,0,0,0,0,0
152135.0,Alexandre Costa Nunes Nyeme Victoria,L,Brazil,23.0,175,2021,Germany,2021-06-13,True,0,0,0,0,0,0,0,0,0,0,0,0,0,0,0,0,0,0,0,0,0,0,0,0
152135.0,Alexandre Costa Nunes Nyeme Victoria,L,Brazil,23.0,175,2021,Thailand,2021-06-14,True,0,0,0,0,0,0,0,0,0,0,0,0,0,0,0,0,0,0,2,2,2,0,0,2
152135.0,Alexandre Costa Nunes Nyeme Victoria,L,Brazil,23.0,175,2021,Netherlands,2021-06-19,True,0,0,0,0,0,0,0,0,0,0,0,0,0,0,0,0,0,0,0,0,0,0,0,0
152135.0,Alexandre Costa Nunes Nyeme Victoria,L,Brazil,23.0,175,2021,Japan,2021-06-24,True,0,0,0,0,0,0,0,0,0,0,0,0,0,0,0,0,0,0,0,0,0,0,0,0
152135.0,Alexandre Costa Nunes Nyeme Victoria,L,Brazil,23.0,175,2021,USA,2021-06-25,False,0,0,0,0,0,0,0,0,0,0,0,0,0,0,0,0,0,0,0,0,0,0,0,0
136897.0,Montibeller Rosamaria,OH,Brazil,27.0,185,2021,Japan,2021-05-31,True,0,0,0,0,0,0,0,0,3,1,2,6,0,0,1,1,0,0,0,0,0,0,0,0
136897.0,Montibeller Rosamaria,OH,Brazil,27.0,185,2021,Russia,2021-06-01,True,0,0,0,0,0,0,0,0,0,0,0,0,0,0,0,0,0,0,0,0,0,0,0,0
136897.0,Montibeller Rosamaria,OH,Brazil,27.0,185,2021,Italy,2021-06-02,True,1,2,11,14,0,0,1,1,15,2,16,33,1,1,3,5,5,0,12,17,10,5,1,16
136897.0,Montibeller Rosamaria,OH,Brazil,27.0,185,2021,Serbia,2021-06-06,True,0,0,0,0,0,0,0,0,0,0,0,0,0,0,0,0,0,0,0,0,0,0,0,0
136897.0,Montibeller Rosamaria,OH,Brazil,27.0,185,2021,Belgium,2021-06-07,True,0,0,1,1,0,0,0,0,4,0,1,5,0,0,1,1,0,0,0,0,0,0,1,1
136897.0,Montibeller Rosamaria,OH,Brazil,27.0,185,2021,China,2021-06-08,False,0,0,0,0,0,0,0,0,7,2,4,13,0,1,3,4,0,0,0,0,0,0,2,2
136897.0,Montibeller Rosamaria,OH,Brazil,27.0,185,2021,Poland,2021-06-12,True,0,0,0,0,0,0,0,0,3,0,0,3,0,0,1,1,0,0,0,0,0,0,0,0
136897.0,Montibeller Rosamaria,OH,Brazil,27.0,185,2021,Germany,2021-06-13,True,0,0,0,0,0,0,0,0,1,0,4,5,0,0,0,0,0,0,0,0,0,0,0,0
136897.0,Montibeller Rosamaria,OH,Brazil,27.0,185,2021,Thailand,2021-06-14,True,1,1,5,7,0,0,0,0,4,0,3,7,0,1,0,1,1,0,1,2,2,0,1,3
136897.0,Montibeller Rosamaria,OH,Brazil,27.0,185,2021,Netherlands,2021-06-19,True,0,0,0,0,0,0,0,0,0,0,0,0,0,0,0,0,0,0,0,0,0,0,0,0
136897.0,Montibeller Rosamaria,OH,Brazil,27.0,185,2021,Japan,2021-06-24,True,0,0,0,0,0,0,0,0,4,0,2,6,1,0,1,2,0,0,0,0,0,0,0,0
136897.0,Montibeller Rosamaria,OH,Brazil,27.0,185,2021,USA,2021-06-25,False,0,0,0,0,0,0,0,0,2,1,3,6,0,0,1,1,0,0,0,0,0,0,0,0
151187.0,Silva Carneiro Macris Fernanda,S,Brazil,33.0,178,2021,Canada,2021-05-25,True,0,0,10,10,0,1,20,21,0,0,0,0,0,2,0,2,0,0,1,1,1,1,0,2
151187.0,Silva Carneiro Macris Fernanda,S,Brazil,33.0,178,2021,Dominican Republic,2021-05-26,True,0,1,7,8,12,0,63,75,0,0,2,2,3,1,2,6,0,0,0,0,0,0,0,0
151187.0,Silva Carneiro Macris Fernanda,S,Brazil,33.0,178,2021,USA,2021-05-27,False,1,1,13,15,18,1,84,103,0,0,2,2,0,4,2,6,0,1,0,1,11,5,2,18
151187.0,Silva Carneiro Macris Fernanda,S,Brazil,33.0,178,2021,Japan,2021-05-31,True,0,0,14,14,27,0,55,82,1,0,0,1,2,3,1,6,0,0,0,0,6,2,0,8
151187.0,Silva Carneiro Macris Fernanda,S,Brazil,33.0,178,2021,Russia,2021-06-01,True,1,1,5,7,32,0,40,72,0,0,1,1,0,2,0,2,0,0,0,0,5,0,1,6
151187.0,Silva Carneiro Macris Fernanda,S,Brazil,33.0,178,2021,Italy,2021-06-02,True,0,0,2,2,9,0,21,30,0,0,0,0,0,1,0,1,0,0,0,0,1,1,0,2
151187.0,Silva Carneiro Macris Fernanda,S,Brazil,33.0,178,2021,Serbia,2021-06-06,True,0,0,3,3,4,0,27,31,0,0,0,0,0,0,1,1,0,0,0,0,4,0,0,4
151187.0,Silva Carneiro Macris Fernanda,S,Brazil,33.0,178,2021,Belgium,2021-06-07,True,0,1,11,12,25,0,39,64,0,0,0,0,1,1,2,4,0,0,0,0,2,0,0,2
151187.0,Silva Carneiro Macris Fernanda,S,Brazil,33.0,178,2021,China,2021-06-08,False,0,1,16,17,45,0,79,124,3,0,3,6,0,1,1,2,0,0,1,1,13,2,1,16
151187.0,Silva Carneiro Macris Fernanda,S,Brazil,33.0,178,2021,Poland,2021-06-12,True,1,0,15,16,10,1,53,64,0,0,0,0,0,0,2,2,0,0,0,0,4,1,0,5
151187.0,Silva Carneiro Macris Fernanda,S,Brazil,33.0,178,2021,Germany,2021-06-13,True,0,1,10,11,20,0,69,89,1,0,0,1,1,0,0,1,0,0,0,0,6,6,2,14
151187.0,Silva Carneiro Macris Fernanda,S,Brazil,33.0,178,2021,Thailand,2021-06-14,True,1,1,6,8,15,0,38,53,0,0,1,1,0,1,1,2,0,0,0,0,6,0,0,6
151187.0,Silva Carneiro Macris Fernanda,S,Brazil,33.0,178,2021,Netherlands,2021-06-19,True,0,0,10,10,15,0,73,88,0,0,3,3,0,3,1,4,0,0,1,1,9,4,0,13
151187.0,Silva Carneiro Macris Fernanda,S,Brazil,33.0,178,2021,Japan,2021-06-24,True,0,0,13,13,34,1,75,110,0,0,1,1,1,3,3,7,0,0,0,0,12,2,0,14
151187.0,Silva Carneiro Macris Fernanda,S,Brazil,33.0,178,2021,USA,2021-06-25,False,0,0,14,14,21,2,81,104,0,0,0,0,0,2,3,5,0,1,0,1,10,2,2,14
119575.0,Ratzke Roberta Silva,S,Brazil,31.0,185,2021,Dominican Republic,2021-05-26,True,0,1,4,5,0,0,14,14,0,0,0,0,0,0,0,0,0,0,0,0,0,0,0,0
119575.0,Ratzke Roberta Silva,S,Brazil,31.0,185,2021,Japan,2021-05-31,True,0,0,1,1,1,0,8,9,0,0,0,0,0,0,0,0,0,0,0,0,3,0,0,3
119575.0,Ratzke Roberta Silva,S,Brazil,31.0,185,2021,Italy,2021-06-02,True,0,1,10,11,20,0,63,83,0,0,1,1,0,1,3,4,0,0,1,1,7,3,2,12
119575.0,Ratzke Roberta Silva,S,Brazil,31.0,185,2021,Belgium,2021-06-07,True,0,0,1,1,2,0,9,11,0,0,0,0,0,0,0,0,0,0,0,0,1,0,0,1
119575.0,Ratzke Roberta Silva,S,Brazil,31.0,185,2021,Poland,2021-06-12,True,0,1,4,5,2,0,15,17,0,0,0,0,0,0,0,0,0,0,0,0,3,0,0,3
119575.0,Ratzke Roberta Silva,S,Brazil,31.0,185,2021,Thailand,2021-06-14,True,0,0,3,3,4,0,15,19,0,0,0,0,0,0,0,0,0,0,0,0,2,1,0,3
119575.0,Ratzke Roberta Silva,S,Brazil,31.0,185,2021,Netherlands,2021-06-19,True,0,0,2,2,1,0,2,3,0,0,0,0,0,0,0,0,0,0,0,0,1,0,0,1
119575.0,Ratzke Roberta Silva,S,Brazil,31.0,185,2021,Japan,2021-06-24,True,0,0,2,2,3,0,11,14,0,0,0,0,0,0,0,0,0,0,0,0,2,0,0,2
136896.0,Braga Guimaraes Gabriela,OH,Brazil,27.0,180,2021,Canada,2021-05-25,True,0,0,16,16,0,0,0,0,11,5,11,27,4,3,0,7,15,0,10,25,3,3,0,6
136896.0,Braga Guimaraes Gabriela,OH,Brazil,27.0,180,2021,Dominican Republic,2021-05-26,True,0,3,6,9,0,0,0,0,12,1,11,24,0,2,1,3,13,1,6,20,2,0,0,2
136896.0,Braga Guimaraes Gabriela,OH,Brazil,27.0,180,2021,USA,2021-05-27,False,0,1,14,15,0,0,2,2,13,8,18,39,2,3,1,6,5,1,7,13,13,1,1,15
136896.0,Braga Guimaraes Gabriela,OH,Brazil,27.0,180,2021,Japan,2021-05-31,True,1,1,15,17,0,0,3,3,8,5,6,19,1,2,4,7,1,0,5,6,14,1,0,15
136896.0,Braga Guimaraes Gabriela,OH,Brazil,27.0,180,2021,Russia,2021-06-01,True,0,0,10,10,0,0,0,0,1,4,11,16,1,1,2,4,4,1,11,16,16,2,1,19
136896.0,Braga Guimaraes Gabriela,OH,Brazil,27.0,180,2021,Italy,2021-06-02,True,1,1,10,12,0,0,2,2,7,4,11,22,0,1,1,2,12,0,10,22,14,1,2,17
136896.0,Braga Guimaraes Gabriela,OH,Brazil,27.0,180,2021,Serbia,2021-06-06,True,0,0,13,13,0,0,0,0,6,2,3,11,0,0,1,1,9,0,6,15,12,0,2,14
136896.0,Braga Guimaraes Gabriela,OH,Brazil,27.0,180,2021,Belgium,2021-06-07,True,2,1,11,14,0,0,1,1,8,4,9,21,1,0,2,3,5,0,8,13,10,1,3,14
136896.0,Braga Guimaraes Gabriela,OH,Brazil,27.0,180,2021,China,2021-06-08,False,1,1,15,17,0,0,3,3,15,5,10,30,3,1,3,7,11,0,21,32,21,3,4,28
136896.0,Braga Guimaraes Gabriela,OH,Brazil,27.0,180,2021,Poland,2021-06-12,True,0,1,11,12,0,0,0,0,12,3,10,25,3,3,1,7,5,2,9,16,7,2,0,9
136896.0,Braga Guimaraes Gabriela,OH,Brazil,27.0,180,2021,Germany,2021-06-13,True,0,1,11,12,0,0,0,0,19,5,10,34,2,5,2,9,7,2,17,26,8,3,1,12
136896.0,Braga Guimaraes Gabriela,OH,Brazil,27.0,180,2021,Thailand,2021-06-14,True,0,2,10,12,0,0,1,1,8,0,8,16,2,0,0,2,12,0,6,18,8,0,0,8
136896.0,Braga Guimaraes Gabriela,OH,Brazil,27.0,180,2021,Netherlands,2021-06-19,True,1,0,14,15,0,0,1,1,16,3,8,27,0,0,4,4,6,1,8,15,4,3,0,7
136896.0,Braga Guimaraes Gabriela,OH,Brazil,27.0,180,2021,Japan,2021-06-24,True,1,1,19,21,0,0,2,2,17,3,11,31,0,3,1,4,11,0,23,34,14,1,3,18
136896.0,Braga Guimaraes Gabriela,OH,Brazil,27.0,180,2021,USA,2021-06-25,False,0,2,22,24,0,0,0,0,16,6,19,41,2,4,2,8,7,0,8,15,10,4,2,16
115958.0,Caixeta Tandara,OH,Brazil,33.0,184,2021,Canada,2021-05-25,True,0,0,13,13,0,0,0,0,13,4,13,30,0,2,1,3,0,1,0,1,3,3,0,6
115958.0,Caixeta Tandara,OH,Brazil,33.0,184,2021,Dominican Republic,2021-05-26,True,0,1,9,10,0,0,0,0,14,4,4,22,0,0,0,0,0,0,0,0,4,0,0,4
115958.0,Caixeta Tandara,OH,Brazil,33.0,184,2021,USA,2021-05-27,False,0,1,8,9,0,0,2,2,11,4,21,36,2,2,6,10,0,0,0,0,5,1,2,8
115958.0,Caixeta Tandara,OH,Brazil,33.0,184,2021,Japan,2021-05-31,True,0,0,13,13,0,0,1,1,11,3,13,27,3,2,5,10,0,0,0,0,3,1,0,4
115958.0,Caixeta Tandara,OH,Brazil,33.0,184,2021,Russia,2021-06-01,True,1,1,6,8,0,0,0,0,11,3,10,24,2,0,1,3,0,0,0,0,3,1,1,5
115958.0,Caixeta Tandara,OH,Brazil,33.0,184,2021,Italy,2021-06-02,True,0,0,17,17,0,0,1,1,15,4,15,34,2,2,3,7,0,0,0,0,12,3,1,16
115958.0,Caixeta Tandara,OH,Brazil,33.0,184,2021,Serbia,2021-06-06,True,0,1,10,11,0,0,1,1,12,1,4,17,0,2,2,4,0,0,0,0,3,1,0,4
115958.0,Caixeta Tandara,OH,Brazil,33.0,184,2021,Belgium,2021-06-07,True,0,2,9,11,0,0,1,1,16,1,7,24,1,3,1,5,0,0,0,0,3,2,2,7
115958.0,Caixeta Tandara,OH,Brazil,33.0,184,2021,China,2021-06-08,False,0,0,17,17,0,0,2,2,22,5,31,58,4,6,3,13,0,0,0,0,9,1,2,12
115958.0,Caixeta Tandara,OH,Brazil,33.0,184,2021,Poland,2021-06-12,True,0,1,7,8,0,0,2,2,11,8,9,28,3,1,2,6,0,0,0,0,5,1,1,7
115958.0,Caixeta Tandara,OH,Brazil,33.0,184,2021,Germany,2021-06-13,True,1,0,18,19,0,1,0,1,12,5,14,31,1,2,1,4,0,0,0,0,6,1,6,13
115958.0,Caixeta Tandara,OH,Brazil,33.0,184,2021,Thailand,2021-06-14,True,2,1,10,13,0,0,0,0,7,2,7,16,2,1,0,3,0,0,0,0,3,0,0,3
115958.0,Caixeta Tandara,OH,Brazil,33.0,184,2021,Netherlands,2021-06-19,True,0,0,9,9,0,0,0,0,12,3,10,25,1,5,3,9,0,0,0,0,11,3,3,17
115958.0,Caixeta Tandara,OH,Brazil,33.0,184,2021,Japan,2021-06-24,True,0,0,15,15,0,0,2,2,22,4,21,47,1,3,9,13,0,0,0,0,15,3,2,20
115958.0,Caixeta Tandara,OH,Brazil,33.0,184,2021,USA,2021-06-25,False,0,0,12,12,0,0,2,2,15,7,14,36,2,6,1,9,0,0,1,1,6,3,4,13
115952.0,Pereira Natalia,OH,Brazil,32.0,186,2021,Netherlands,2021-06-19,True,0,0,1,1,0,0,0,0,1,0,3,4,1,1,1,3,0,0,0,0,1,0,0,1
115952.0,Pereira Natalia,OH,Brazil,32.0,186,2021,Japan,2021-06-24,True,0,0,3,3,0,0,2,2,5,1,6,12,1,3,0,4,6,0,3,9,3,0,2,5
115952.0,Pereira Natalia,OH,Brazil,32.0,186,2021,USA,2021-06-25,False,0,0,7,7,0,0,1,1,3,2,5,10,0,2,1,3,9,0,16,25,2,0,2,4
112366.0,Castro De Paula Blassioli Sheilla,O,Brazil,38.0,185,2021,Canada,2021-05-25,True,0,0,0,0,0,0,0,0,0,0,0,0,0,0,0,0,0,0,0,0,0,0,0,0
112366.0,Castro De Paula Blassioli Sheilla,O,Brazil,38.0,185,2021,Dominican Republic,2021-05-26,True,0,0,1,1,0,0,0,0,2,0,3,5,0,0,0,0,0,0,0,0,0,0,0,0
112366.0,Castro De Paula Blassioli Sheilla,O,Brazil,38.0,185,2021,USA,2021-05-27,False,0,1,0,1,0,0,0,0,0,0,0,0,0,0,0,0,0,0,0,0,0,0,0,0
112366.0,Castro De Paula Blassioli Sheilla,O,Brazil,38.0,185,2021,Japan,2021-05-31,True,0,0,0,0,0,0,0,0,0,0,0,0,0,0,0,0,0,0,0,0,0,0,0,0
112366.0,Castro De Paula Blassioli Sheilla,O,Brazil,38.0,185,2021,Russia,2021-06-01,True,0,0,1,1,0,0,0,0,3,2,1,6,0,1,1,2,0,0,0,0,1,0,0,1
112366.0,Castro De Paula Blassioli Sheilla,O,Brazil,38.0,185,2021,Serbia,2021-06-06,True,2,0,5,7,0,0,0,0,3,0,3,6,0,1,0,1,0,0,0,0,2,0,0,2
112366.0,Castro De Paula Blassioli Sheilla,O,Brazil,38.0,185,2021,Belgium,2021-06-07,True,0,0,0,0,0,0,0,0,0,0,0,0,0,0,0,0,0,0,0,0,0,0,0,0
112366.0,Castro De Paula Blassioli Sheilla,O,Brazil,38.0,185,2021,Poland,2021-06-12,True,0,1,0,1,0,0,0,0,1,0,4,5,0,0,1,1,0,0,0,0,0,0,0,0
112366.0,Castro De Paula Blassioli Sheilla,O,Brazil,38.0,185,2021,Thailand,2021-06-14,True,0,0,0,0,0,0,0,0,0,0,0,0,0,0,0,0,0,0,0,0,0,0,0,0
112366.0,Castro De Paula Blassioli Sheilla,O,Brazil,38.0,185,2021,Netherlands,2021-06-19,True,0,1,0,1,0,0,0,0,2,0,1,3,0,0,0,0,0,0,0,0,0,0,0,0
112366.0,Castro De Paula Blassioli Sheilla,O,Brazil,38.0,185,2021,Japan,2021-06-24,True,0,0,0,0,0,0,0,0,0,0,0,0,0,0,0,0,0,0,0,0,0,0,0,0
144866.0,Da Silva Ana Carolina,MB,Brazil,30.0,183,2021,Canada,2021-05-25,True,1,1,16,18,0,0,0,0,6,0,2,8,6,3,0,9,0,0,0,0,0,2,0,2
144866.0,Da Silva Ana Carolina,MB,Brazil,30.0,183,2021,Dominican Republic,2021-05-26,True,0,0,0,0,0,0,0,0,0,0,0,0,0,0,0,0,0,0,0,0,0,0,0,0
144866.0,Da Silva Ana Carolina,MB,Brazil,30.0,183,2021,Japan,2021-05-31,True,1,1,9,11,0,0,2,2,4,2,5,11,4,3,4,11,0,0,0,0,1,1,0,2
144866.0,Da Silva Ana Carolina,MB,Brazil,30.0,183,2021,Russia,2021-06-01,True,6,1,18,25,0,0,5,5,8,1,7,16,1,2,2,5,0,0,0,0,2,1,0,3
144866.0,Da Silva Ana Carolina,MB,Brazil,30.0,183,2021,Italy,2021-06-02,True,1,3,16,20,0,0,5,5,8,2,4,14,5,7,2,14,0,1,0,1,2,2,0,4
144866.0,Da Silva Ana Carolina,MB,Brazil,30.0,183,2021,Serbia,2021-06-06,True,0,2,6,8,0,0,2,2,1,0,0,1,1,4,1,6,0,0,0,0,2,0,0,2
144866.0,Da Silva Ana Carolina,MB,Brazil,30.0,183,2021,Belgium,2021-06-07,True,0,0,7,7,0,0,1,1,3,0,0,3,2,5,2,9,0,0,0,0,1,0,0,1
144866.0,Da Silva Ana Carolina,MB,Brazil,30.0,183,2021,China,2021-06-08,False,0,1,10,11,0,0,6,6,4,2,3,9,0,7,7,14,0,0,0,0,2,1,1,4
144866.0,Da Silva Ana Carolina,MB,Brazil,30.0,183,2021,Poland,2021-06-12,True,0,1,5,6,0,0,1,1,2,1,3,6,2,4,0,6,0,0,0,0,0,1,0,1
144866.0,Da Silva Ana Carolina,MB,Brazil,30.0,183,2021,Germany,2021-06-13,True,0,2,16,18,0,0,0,0,7,1,4,12,1,6,3,10,0,0,0,0,2,0,0,2
144866.0,Da Silva Ana Carolina,MB,Brazil,30.0,183,2021,Thailand,2021-06-14,True,0,0,4,4,0,0,1,1,1,0,1,2,2,1,1,4,0,0,0,0,0,0,0,0
144866.0,Da Silva Ana Carolina,MB,Brazil,30.0,183,2021,Japan,2021-06-24,True,0,0,4,4,0,0,0,0,2,0,1,3,2,1,1,4,0,0,0,0,0,0,0,0
144866.0,Da Silva Ana Carolina,MB,Brazil,30.0,183,2021,USA,2021-06-25,False,0,2,12,14,0,0,2,2,9,3,4,16,8,6,8,22,0,0,0,0,0,1,0,1
112641.0,Rodrigues Fernanda,OH,Brazil,35.0,179,2021,Canada,2021-05-25,True,1,0,18,19,0,0,1,1,10,0,14,24,3,2,1,6,8,0,3,11,5,2,1,8
112641.0,Rodrigues Fernanda,OH,Brazil,35.0,179,2021,Dominican Republic,2021-05-26,True,2,1,12,15,0,0,0,0,11,1,9,21,1,1,2,4,6,0,7,13,1,1,1,3
112641.0,Rodrigues Fernanda,OH,Brazil,35.0,179,2021,USA,2021-05-27,False,0,1,10,11,0,0,1,1,17,1,16,34,1,4,1,6,19,3,24,46,11,5,2,18
112641.0,Rodrigues Fernanda,OH,Brazil,35.0,179,2021,Japan,2021-05-31,True,0,1,8,9,0,0,0,0,21,4,13,38,0,4,6,10,12,1,11,24,7,4,1,12
112641.0,Rodrigues Fernanda,OH,Brazil,35.0,179,2021,Russia,2021-06-01,True,0,1,12,13,0,0,2,2,11,3,11,25,1,1,3,5,6,0,4,10,10,2,2,14
112641.0,Rodrigues Fernanda,OH,Brazil,35.0,179,2021,Italy,2021-06-02,True,0,0,0,0,0,0,0,0,0,0,0,0,0,0,0,0,0,0,0,0,0,0,0,0
112641.0,Rodrigues Fernanda,OH,Brazil,35.0,179,2021,Serbia,2021-06-06,True,0,1,4,5,0,0,3,3,10,0,9,19,1,1,2,4,4,0,1,5,6,0,0,6
112641.0,Rodrigues Fernanda,OH,Brazil,35.0,179,2021,Belgium,2021-06-07,True,0,2,13,15,0,0,1,1,9,3,10,22,0,2,3,5,7,1,10,18,6,2,1,9
112641.0,Rodrigues Fernanda,OH,Brazil,35.0,179,2021,China,2021-06-08,False,0,1,13,14,0,0,2,2,12,3,20,35,3,7,7,17,9,2,22,33,13,5,1,19
112641.0,Rodrigues Fernanda,OH,Brazil,35.0,179,2021,Poland,2021-06-12,True,0,2,10,12,0,0,5,5,4,3,10,17,2,2,6,10,8,1,15,24,8,4,1,13
112641.0,Rodrigues Fernanda,OH,Brazil,35.0,179,2021,Germany,2021-06-13,True,0,0,21,21,0,0,8,8,8,2,10,20,5,4,5,14,8,2,14,24,15,1,2,18
112641.0,Rodrigues Fernanda,OH,Brazil,35.0,179,2021,Thailand,2021-06-14,True,0,0,6,6,0,1,0,1,9,0,9,18,1,1,0,2,4,0,2,6,4,1,0,5
112641.0,Rodrigues Fernanda,OH,Brazil,35.0,179,2021,Netherlands,2021-06-19,True,0,0,8,8,0,0,1,1,6,2,17,25,0,4,4,8,9,0,12,21,9,3,2,14
112641.0,Rodrigues Fernanda,OH,Brazil,35.0,179,2021,Japan,2021-06-24,True,0,1,10,11,0,0,0,0,12,3,15,30,1,2,1,4,3,0,7,10,10,1,3,14
112641.0,Rodrigues Fernanda,OH,Brazil,35.0,179,2021,USA,2021-06-25,False,0,1,9,10,0,0,0,0,6,4,8,18,0,3,1,4,11,1,21,33,6,3,2,11
173849.0,Menezes Oliveira de Souza Ana Cristina,OH,Brazil,17.0,192,2021,Canada,2021-05-25,True,0,0,0,0,0,0,0,0,1,0,0,1,0,0,0,0,0,0,0,0,0,0,0,0
173849.0,Menezes Oliveira de Souza Ana Cristina,OH,Brazil,17.0,192,2021,Dominican Republic,2021-05-26,True,0,0,0,0,0,0,0,0,1,0,0,1,0,0,0,0,1,0,0,1,0,0,0,0
173849.0,Menezes Oliveira de Souza Ana Cristina,OH,Brazil,17.0,192,2021,USA,2021-05-27,False,0,0,0,0,0,0,0,0,0,0,0,0,0,0,0,0,0,0,0,0,0,0,0,0
173849.0,Menezes Oliveira de Souza Ana Cristina,OH,Brazil,17.0,192,2021,Italy,2021-06-02,True,0,0,3,3,0,0,0,0,0,0,5,5,0,0,0,0,2,3,2,7,0,0,1,1
173849.0,Menezes Oliveira de Souza Ana Cristina,OH,Brazil,17.0,192,2021,Serbia,2021-06-06,True,1,1,2,4,0,0,0,0,3,1,3,7,1,1,0,2,0,0,3,3,1,1,0,2
173849.0,Menezes Oliveira de Souza Ana Cristina,OH,Brazil,17.0,192,2021,China,2021-06-08,False,0,0,0,0,0,0,0,0,0,0,0,0,0,0,0,0,0,0,0,0,0,0,0,0
173849.0,Menezes Oliveira de Souza Ana Cristina,OH,Brazil,17.0,192,2021,Poland,2021-06-12,True,0,0,2,2,0,0,0,0,0,0,0,0,0,0,0,0,0,0,0,0,0,0,0,0
173849.0,Menezes Oliveira de Souza Ana Cristina,OH,Brazil,17.0,192,2021,Germany,2021-06-13,True,0,0,0,0,0,0,0,0,0,0,0,0,0,0,0,0,0,0,0,0,0,0,0,0
173849.0,Menezes Oliveira de Souza Ana Cristina,OH,Brazil,17.0,192,2021,USA,2021-06-25,False,0,0,0,0,0,0,1,1,0,0,0,0,0,1,0,1,0,0,0,0,0,0,0,0
119241.0,Brait Camila,L,Brazil,33.0,170,2021,Canada,2021-05-25,True,0,0,0,0,0,0,0,0,0,0,0,0,0,0,0,0,4,0,8,12,11,3,0,14
119241.0,Brait Camila,L,Brazil,33.0,170,2021,Dominican Republic,2021-05-26,True,0,0,0,0,0,0,2,2,0,0,0,0,0,0,0,0,8,0,5,13,6,1,0,7
119241.0,Brait Camila,L,Brazil,33.0,170,2021,USA,2021-05-27,False,0,0,0,0,0,0,12,12,0,0,0,0,0,0,0,0,9,1,18,28,16,1,2,19
119241.0,Brait Camila,L,Brazil,33.0,170,2021,Japan,2021-05-31,True,0,0,0,0,0,0,5,5,0,0,0,0,0,0,0,0,13,1,8,22,16,1,2,19
119241.0,Brait Camila,L,Brazil,33.0,170,2021,Russia,2021-06-01,True,0,0,0,0,0,0,4,4,0,0,0,0,0,0,0,0,10,0,10,20,13,2,1,16
119241.0,Brait Camila,L,Brazil,33.0,170,2021,Italy,2021-06-02,True,0,0,0,0,0,0,2,2,0,0,0,0,0,0,0,0,4,1,14,19,14,1,0,15
119241.0,Brait Camila,L,Brazil,33.0,170,2021,Serbia,2021-06-06,True,0,0,0,0,0,0,2,2,0,0,0,0,0,0,0,0,1,0,2,3,3,0,0,3
119241.0,Brait Camila,L,Brazil,33.0,170,2021,Belgium,2021-06-07,True,0,0,0,0,0,0,3,3,0,0,0,0,0,0,0,0,5,1,5,11,16,1,1,18
119241.0,Brait Camila,L,Brazil,33.0,170,2021,China,2021-06-08,False,0,0,0,0,0,0,12,12,0,0,0,0,0,0,0,0,8,0,18,26,21,5,4,30
119241.0,Brait Camila,L,Brazil,33.0,170,2021,Poland,2021-06-12,True,0,0,0,0,0,0,3,3,0,0,0,0,0,0,0,0,4,1,5,10,15,1,5,21
119241.0,Brait Camila,L,Brazil,33.0,170,2021,Germany,2021-06-13,True,0,0,0,0,0,0,8,8,0,0,0,0,0,0,0,0,8,1,13,22,16,5,0,21
119241.0,Brait Camila,L,Brazil,33.0,170,2021,Thailand,2021-06-14,True,0,0,0,0,0,0,6,6,0,0,0,0,0,0,0,0,3,0,1,4,8,1,0,9
119241.0,Brait Camila,L,Brazil,33.0,170,2021,Netherlands,2021-06-19,True,0,0,0,0,0,0,7,7,0,0,0,0,0,0,0,0,10,0,6,16,12,2,1,15
119241.0,Brait Camila,L,Brazil,33.0,170,2021,Japan,2021-06-24,True,0,0,0,0,0,0,15,15,0,0,0,0,0,0,0,0,8,4,17,29,10,3,1,14
119241.0,Brait Camila,L,Brazil,33.0,170,2021,USA,2021-06-25,False,0,0,0,0,0,0,13,13,0,0,0,0,0,0,0,0,4,1,12,17,17,1,1,19
119566.0,Correa Ana Beatriz,MB,Brazil,30.0,187,2021,Canada,2021-05-25,True,1,0,16,17,0,0,0,0,5,2,7,14,5,1,1,7,0,0,1,1,1,0,0,1
119566.0,Correa Ana Beatriz,MB,Brazil,30.0,187,2021,Dominican Republic,2021-05-26,True,0,0,0,0,0,0,0,0,0,0,0,0,0,0,0,0,0,0,0,0,0,0,0,0
119566.0,Correa Ana Beatriz,MB,Brazil,30.0,187,2021,USA,2021-05-27,False,0,0,4,4,0,0,1,1,1,0,2,3,0,3,3,6,0,0,1,1,2,1,0,3
119566.0,Correa Ana Beatriz,MB,Brazil,30.0,187,2021,Japan,2021-05-31,True,0,0,0,0,0,0,0,0,0,0,0,0,0,0,0,0,0,0,0,0,0,0,0,0
119566.0,Correa Ana Beatriz,MB,Brazil,30.0,187,2021,Russia,2021-06-01,True,0,0,0,0,0,0,0,0,0,0,0,0,0,0,0,0,0,0,0,0,0,0,0,0
119566.0,Correa Ana Beatriz,MB,Brazil,30.0,187,2021,Italy,2021-06-02,True,1,2,11,14,0,0,1,1,6,1,7,14,4,8,1,13,0,0,1,1,2,0,1,3
119566.0,Correa Ana Beatriz,MB,Brazil,30.0,187,2021,Belgium,2021-06-07,True,0,0,3,3,0,0,1,1,1,0,1,2,1,1,1,3,1,0,0,1,1,0,0,1
119566.0,Correa Ana Beatriz,MB,Brazil,30.0,187,2021,China,2021-06-08,False,0,1,8,9,0,0,1,1,2,0,2,4,0,2,7,9,0,0,1,1,2,0,1,3
119566.0,Correa Ana Beatriz,MB,Brazil,30.0,187,2021,Germany,2021-06-13,True,0,1,8,9,0,0,2,2,10,1,5,16,2,6,7,15,0,0,1,1,2,0,0,2
119566.0,Correa Ana Beatriz,MB,Brazil,30.0,187,2021,Thailand,2021-06-14,True,0,0,5,5,0,0,0,0,4,0,3,7,3,3,1,7,0,0,0,0,0,0,0,0
119566.0,Correa Ana Beatriz,MB,Brazil,30.0,187,2021,Netherlands,2021-06-19,True,1,0,10,11,0,0,1,1,3,1,5,9,3,3,6,12,0,0,0,0,4,0,0,4
119566.0,Correa Ana Beatriz,MB,Brazil,30.0,187,2021,Japan,2021-06-24,True,1,2,12,15,0,0,2,2,3,1,3,7,3,5,4,12,0,0,0,0,5,0,0,5
119566.0,Correa Ana Beatriz,MB,Brazil,30.0,187,2021,USA,2021-06-25,False,0,0,0,0,0,0,0,0,0,0,0,0,0,0,0,0,0,0,0,0,0,0,0,0
141658.0,Geraldo Teixeira Lorenne,O,Brazil,26.0,187,2021,Canada,2021-05-25,True,0,0,3,3,0,0,0,0,3,0,6,9,0,0,0,0,0,0,0,0,0,1,0,1
141658.0,Geraldo Teixeira Lorenne,O,Brazil,26.0,187,2021,Dominican Republic,2021-05-26,True,0,0,0,0,0,0,0,0,0,0,0,0,0,0,0,0,0,0,0,0,0,0,0,0
141658.0,Geraldo Teixeira Lorenne,O,Brazil,26.0,187,2021,USA,2021-05-27,False,0,0,4,4,0,0,0,0,2,2,3,7,0,0,0,0,0,0,0,0,0,0,0,0
141658.0,Geraldo Teixeira Lorenne,O,Brazil,26.0,187,2021,Japan,2021-05-31,True,0,0,0,0,0,0,0,0,0,0,0,0,0,0,0,0,0,0,0,0,0,0,0,0
141658.0,Geraldo Teixeira Lorenne,O,Brazil,26.0,187,2021,Russia,2021-06-01,True,0,1,3,4,0,0,0,0,1,0,0,1,0,0,0,0,0,0,0,0,0,0,1,1
141658.0,Geraldo Teixeira Lorenne,O,Brazil,26.0,187,2021,Italy,2021-06-02,True,0,0,0,0,0,0,0,0,1,0,3,4,0,0,1,1,0,0,0,0,1,0,0,1
141658.0,Geraldo Teixeira Lorenne,O,Brazil,26.0,187,2021,Belgium,2021-06-07,True,0,0,4,4,0,0,0,0,0,0,0,0,0,0,0,0,0,0,0,0,1,0,0,1
141658.0,Geraldo Teixeira Lorenne,O,Brazil,26.0,187,2021,China,2021-06-08,False,0,0,4,4,0,0,0,0,0,0,0,0,0,0,0,0,0,0,0,0,0,0,0,0
141658.0,Geraldo Teixeira Lorenne,O,Brazil,26.0,187,2021,Germany,2021-06-13,True,0,0,1,1,0,0,0,0,0,0,0,0,0,0,0,0,0,0,0,0,0,0,0,0
141658.0,Geraldo Teixeira Lorenne,O,Brazil,26.0,187,2021,Thailand,2021-06-14,True,1,0,4,5,0,0,0,0,6,0,4,10,0,0,0,0,0,0,0,0,0,0,0,0
164673.0,Araujo De Souza Mayany Cristina,MB,Brazil,25.0,185,2021,Dominican Republic,2021-05-26,True,0,3,10,13,0,0,0,0,2,2,2,6,1,2,0,3,0,0,0,0,0,0,0,0
164673.0,Araujo De Souza Mayany Cristina,MB,Brazil,25.0,185,2021,USA,2021-05-27,False,0,1,6,7,0,0,2,2,8,0,3,11,1,1,1,3,1,0,2,3,1,0,1,2
164673.0,Araujo De Souza Mayany Cristina,MB,Brazil,25.0,185,2021,Russia,2021-06-01,True,0,0,0,0,0,0,0,0,0,0,0,0,0,0,0,0,0,0,0,0,0,0,0,0
164673.0,Araujo De Souza Mayany Cristina,MB,Brazil,25.0,185,2021,Serbia,2021-06-06,True,2,0,7,9,0,0,0,0,2,0,4,6,0,1,3,4,0,0,0,0,1,0,0,1
164673.0,Araujo De Souza Mayany Cristina,MB,Brazil,25.0,185,2021,Belgium,2021-06-07,True,0,0,0,0,0,0,0,0,0,0,0,0,0,0,0,0,0,0,0,0,0,0,0,0
164673.0,Araujo De Souza Mayany Cristina,MB,Brazil,25.0,185,2021,Poland,2021-06-12,True,0,0,0,0,0,0,0,0,0,0,0,0,0,0,0,0,0,0,0,0,0,0,0,0
164673.0,Araujo De Souza Mayany Cristina,MB,Brazil,25.0,185,2021,Germany,2021-06-13,True,0,0,0,0,0,0,0,0,0,0,0,0,0,0,0,0,0,0,0,0,0,0,0,0
164673.0,Araujo De Souza Mayany Cristina,MB,Brazil,25.0,185,2021,Thailand,2021-06-14,True,0,1,0,1,0,0,0,0,0,0,1,1,0,0,0,0,0,0,0,0,0,0,0,0
164673.0,Araujo De Souza Mayany Cristina,MB,Brazil,25.0,185,2021,Netherlands,2021-06-19,True,0,0,2,2,0,0,0,0,1,0,0,1,0,1,1,2,0,0,0,0,0,0,0,0
164673.0,Araujo De Souza Mayany Cristina,MB,Brazil,25.0,185,2021,USA,2021-06-25,False,0,0,0,0,0,0,0,0,0,0,0,0,0,0,0,0,0,0,0,0,0,0,0,0
174677.0,Bujan Cassandra,L,Canada,25.0,186,2021,Brazil,2021-05-25,False,0,0,0,0,0,1,10,11,0,0,0,0,0,0,0,0,2,1,14,17,3,3,0,6
174677.0,Bujan Cassandra,L,Canada,25.0,186,2021,USA,2021-05-26,False,0,0,0,0,0,0,0,0,0,0,0,0,0,0,0,0,0,0,1,1,0,0,0,0
174677.0,Bujan Cassandra,L,Canada,25.0,186,2021,Dominican Republic,2021-05-27,False,0,0,0,0,0,0,0,0,0,0,0,0,0,0,0,0,0,0,0,0,0,0,0,0
174677.0,Bujan Cassandra,L,Canada,25.0,186,2021,China,2021-06-01,True,0,0,0,0,0,0,11,11,0,0,0,0,0,0,0,0,8,2,15,25,12,10,3,25
174677.0,Bujan Cassandra,L,Canada,25.0,186,2021,Germany,2021-06-02,True,0,0,0,0,0,0,5,5,0,0,0,0,0,0,0,0,9,1,12,22,6,3,2,11
174677.0,Bujan Cassandra,L,Canada,25.0,186,2021,Poland,2021-06-06,False,0,0,0,0,0,0,9,9,0,0,0,0,0,0,0,0,6,1,6,13,11,6,1,18
174677.0,Bujan Cassandra,L,Canada,25.0,186,2021,Japan,2021-06-07,False,0,0,0,0,0,0,7,7,0,0,0,0,0,0,0,0,4,1,8,13,6,4,1,11
174677.0,Bujan Cassandra,L,Canada,25.0,186,2021,Netherlands,2021-06-08,False,0,0,0,0,0,0,3,3,0,0,0,0,0,0,0,0,1,2,15,18,8,4,0,12
174677.0,Bujan Cassandra,L,Canada,25.0,186,2021,Serbia,2021-06-12,True,0,0,0,0,0,0,9,9,0,0,0,0,0,0,0,0,3,0,8,11,13,5,1,19
174677.0,Bujan Cassandra,L,Canada,25.0,186,2021,Russia,2021-06-13,False,0,0,0,0,0,1,4,5,0,0,0,0,0,0,0,0,0,2,3,5,4,0,1,5
174677.0,Bujan Cassandra,L,Canada,25.0,186,2021,Italy,2021-06-18,False,0,0,0,0,0,0,8,8,0,0,0,0,0,0,0,0,2,1,13,16,10,4,1,15
174677.0,Bujan Cassandra,L,Canada,25.0,186,2021,Thailand,2021-06-19,False,0,0,0,0,0,0,4,4,0,0,0,0,0,0,0,0,2,1,16,19,8,3,1,12
174677.0,Bujan Cassandra,L,Canada,25.0,186,2021,Belgium,2021-06-20,False,0,0,0,0,0,0,6,6,0,0,0,0,0,0,0,0,2,1,6,9,9,2,0,11
168355.0,Van Ryk Kiera,OH,Canada,23.0,188,2021,Brazil,2021-05-25,False,0,3,6,9,0,0,3,3,12,12,14,38,1,1,0,2,4,0,3,7,3,5,0,8
168355.0,Van Ryk Kiera,OH,Canada,23.0,188,2021,USA,2021-05-26,False,0,1,3,4,0,0,2,2,13,6,7,26,0,1,0,1,0,0,1,1,0,0,0,0
168355.0,Van Ryk Kiera,OH,Canada,23.0,188,2021,Dominican Republic,2021-05-27,False,1,2,10,13,0,0,0,0,20,6,21,47,4,1,1,6,6,3,14,23,12,3,0,15
168355.0,Van Ryk Kiera,OH,Canada,23.0,188,2021,China,2021-06-01,True,2,4,11,17,1,0,1,2,18,10,25,53,5,3,4,12,0,0,0,0,7,0,0,7
168355.0,Van Ryk Kiera,OH,Canada,23.0,188,2021,Germany,2021-06-02,True,2,3,7,12,0,0,3,3,16,8,11,35,0,2,1,3,0,0,1,1,2,0,1,3
168355.0,Van Ryk Kiera,OH,Canada,23.0,188,2021,Poland,2021-06-06,False,2,6,6,14,0,1,2,3,23,8,21,52,3,4,2,9,0,0,0,0,6,7,0,13
168355.0,Van Ryk Kiera,OH,Canada,23.0,188,2021,Japan,2021-06-07,False,1,1,2,4,0,0,2,2,6,1,7,14,2,3,2,7,0,1,5,6,1,0,2,3
168355.0,Van Ryk Kiera,OH,Canada,23.0,188,2021,Netherlands,2021-06-08,False,0,2,5,7,0,0,0,0,6,4,7,17,0,1,0,1,1,0,0,1,2,2,0,4
168355.0,Van Ryk Kiera,OH,Canada,23.0,188,2021,Serbia,2021-06-12,True,3,6,8,17,0,0,2,2,17,5,17,39,1,3,5,9,0,0,0,0,9,3,2,14
168355.0,Van Ryk Kiera,OH,Canada,23.0,188,2021,Italy,2021-06-18,False,0,1,11,12,0,0,2,2,12,8,16,36,2,1,3,6,1,0,9,10,4,4,6,14
168355.0,Van Ryk Kiera,OH,Canada,23.0,188,2021,Thailand,2021-06-19,False,0,2,5,7,0,0,3,3,8,1,14,23,0,2,3,5,2,1,5,8,5,1,1,7
168355.0,Van Ryk Kiera,OH,Canada,23.0,188,2021,Belgium,2021-06-20,False,3,5,4,12,0,0,2,2,15,2,10,27,0,5,1,6,5,0,8,13,9,2,0,11
139517.0,Smith Danielle,S,Canada,31.0,178,2021,Brazil,2021-05-25,False,0,1,0,1,0,0,0,0,0,0,0,0,0,0,0,0,0,0,0,0,0,0,0,0
139517.0,Smith Danielle,S,Canada,31.0,178,2021,USA,2021-05-26,False,0,0,2,2,1,1,29,31,0,0,0,0,0,1,1,2,0,0,0,0,1,0,0,1
139517.0,Smith Danielle,S,Canada,31.0,178,2021,Dominican Republic,2021-05-27,False,0,0,0,0,0,0,0,0,0,0,0,0,0,0,0,0,0,0,0,0,0,0,0,0
139517.0,Smith Danielle,S,Canada,31.0,178,2021,China,2021-06-01,True,0,0,0,0,1,0,9,10,0,0,0,0,0,0,0,0,0,0,0,0,0,0,0,0
139517.0,Smith Danielle,S,Canada,31.0,178,2021,Germany,2021-06-02,True,0,0,0,0,0,0,0,0,0,0,0,0,0,0,0,0,0,0,0,0,0,0,0,0
139517.0,Smith Danielle,S,Canada,31.0,178,2021,Poland,2021-06-06,False,0,0,0,0,1,0,2,3,0,0,0,0,0,0,0,0,0,0,0,0,0,1,0,1
139517.0,Smith Danielle,S,Canada,31.0,178,2021,Serbia,2021-06-12,True,0,0,0,0,0,0,0,0,0,0,0,0,0,0,0,0,0,0,0,0,0,0,0,0
139517.0,Smith Danielle,S,Canada,31.0,178,2021,Russia,2021-06-13,False,0,1,1,2,7,0,28,35,0,0,2,2,0,2,0,2,0,0,0,0,4,0,0,4
139517.0,Smith Danielle,S,Canada,31.0,178,2021,Italy,2021-06-18,False,0,0,0,0,0,0,0,0,0,0,0,0,0,0,0,0,0,0,0,0,0,0,0,0
139517.0,Smith Danielle,S,Canada,31.0,178,2021,Belgium,2021-06-20,False,0,0,0,0,4,0,8,12,0,0,0,0,0,2,0,2,0,0,0,0,4,0,0,4
153629.0,White Jazmine Ruth,MB,Canada,28.0,186,2021,Brazil,2021-05-25,False,0,0,1,1,0,0,0,0,0,0,1,1,0,0,0,0,0,0,0,0,0,0,0,0
153629.0,White Jazmine Ruth,MB,Canada,28.0,186,2021,USA,2021-05-26,False,0,0,1,1,0,0,0,0,0,1,2,3,0,0,0,0,0,0,0,0,0,0,0,0
153629.0,White Jazmine Ruth,MB,Canada,28.0,186,2021,Dominican Republic,2021-05-27,False,0,0,0,0,0,0,0,0,0,0,0,0,0,0,0,0,0,0,0,0,0,0,0,0
153629.0,White Jazmine Ruth,MB,Canada,28.0,186,2021,Germany,2021-06-02,True,0,0,0,0,0,0,0,0,0,0,0,0,0,0,0,0,0,0,0,0,0,0,0,0
153629.0,White Jazmine Ruth,MB,Canada,28.0,186,2021,Poland,2021-06-06,False,0,0,0,0,0,0,0,0,0,0,0,0,0,0,0,0,0,0,0,0,0,0,0,0
153629.0,White Jazmine Ruth,MB,Canada,28.0,186,2021,Netherlands,2021-06-08,False,0,0,0,0,0,0,0,0,0,0,0,0,0,0,0,0,0,0,0,0,0,0,0,0
153629.0,White Jazmine Ruth,MB,Canada,28.0,186,2021,Serbia,2021-06-12,True,0,0,0,0,0,0,0,0,0,0,0,0,0,0,0,0,0,0,0,0,0,0,0,0
153629.0,White Jazmine Ruth,MB,Canada,28.0,186,2021,Russia,2021-06-13,False,0,0,4,4,0,0,1,1,1,0,2,3,0,3,6,9,0,0,0,0,0,0,0,0
153629.0,White Jazmine Ruth,MB,Canada,28.0,186,2021,Italy,2021-06-18,False,0,0,0,0,0,0,0,0,0,0,0,0,0,0,0,0,0,0,0,0,0,0,0,0
163360.0,Van Buskirk Layne,MB,Canada,24.0,191,2021,Brazil,2021-05-25,False,0,0,0,0,0,0,0,0,0,0,0,0,0,0,0,0,0,0,0,0,0,0,0,0
163360.0,Van Buskirk Layne,MB,Canada,24.0,191,2021,China,2021-06-01,True,0,0,0,0,0,0,0,0,0,0,0,0,0,0,0,0,0,0,0,0,0,0,0,0
163360.0,Van Buskirk Layne,MB,Canada,24.0,191,2021,Japan,2021-06-07,False,0,1,1,2,0,0,0,0,0,0,2,2,0,0,0,0,0,0,0,0,1,0,0,1
163360.0,Van Buskirk Layne,MB,Canada,24.0,191,2021,Netherlands,2021-06-08,False,0,0,0,0,0,0,0,0,0,0,0,0,0,0,0,0,0,0,0,0,0,0,0,0
163360.0,Van Buskirk Layne,MB,Canada,24.0,191,2021,Russia,2021-06-13,False,0,1,4,5,0,0,0,0,3,0,4,7,1,3,6,10,0,0,1,1,1,1,0,2
163360.0,Van Buskirk Layne,MB,Canada,24.0,191,2021,Thailand,2021-06-19,False,0,0,0,0,0,0,0,0,0,0,0,0,0,0,0,0,0,0,0,0,0,0,0,0
163360.0,Van Buskirk Layne,MB,Canada,24.0,191,2021,Belgium,2021-06-20,False,0,0,0,0,0,0,0,0,0,0,0,0,0,0,0,0,0,0,0,0,0,0,0,0
142777.0,Ogoms Alicia,MB,Canada,27.0,194,2021,China,2021-06-01,True,0,0,0,0,0,0,0,0,0,0,0,0,0,0,0,0,0,0,0,0,0,0,0,0
142777.0,Ogoms Alicia,MB,Canada,27.0,194,2021,Germany,2021-06-02,True,0,0,0,0,0,0,0,0,0,0,0,0,0,0,0,0,0,0,0,0,0,0,0,0
142777.0,Ogoms Alicia,MB,Canada,27.0,194,2021,Poland,2021-06-06,False,0,0,0,0,0,0,0,0,0,0,0,0,0,0,0,0,0,0,0,0,0,0,0,0
142777.0,Ogoms Alicia,MB,Canada,27.0,194,2021,Japan,2021-06-07,False,0,0,3,3,0,0,0,0,2,0,0,2,1,2,0,3,0,0,0,0,0,0,0,0
142777.0,Ogoms Alicia,MB,Canada,27.0,194,2021,Netherlands,2021-06-08,False,0,0,10,10,0,0,0,0,2,0,0,2,0,0,0,0,0,0,0,0,1,1,0,2
142777.0,Ogoms Alicia,MB,Canada,27.0,194,2021,Serbia,2021-06-12,True,0,0,0,0,0,0,0,0,0,0,0,0,0,0,0,0,0,0,0,0,0,0,0,0
142777.0,Ogoms Alicia,MB,Canada,27.0,194,2021,Russia,2021-06-13,False,0,1,5,6,0,0,0,0,4,1,1,6,2,1,0,3,0,0,0,0,1,1,0,2
142777.0,Ogoms Alicia,MB,Canada,27.0,194,2021,Italy,2021-06-18,False,0,0,6,6,0,0,0,0,1,0,0,1,1,2,4,7,0,0,1,1,2,2,0,4
142777.0,Ogoms Alicia,MB,Canada,27.0,194,2021,Thailand,2021-06-19,False,0,0,0,0,0,0,0,0,0,0,0,0,0,0,0,0,0,0,0,0,0,0,0,0
142777.0,Ogoms Alicia,MB,Canada,27.0,194,2021,Belgium,2021-06-20,False,0,0,0,0,0,0,0,0,0,0,0,0,0,0,0,0,0,0,0,0,0,0,0,0
132236.0,Gray Alexa,OH,Canada,27.0,185,2021,Brazil,2021-05-25,False,0,0,0,0,0,0,0,0,0,0,0,0,0,0,0,0,0,0,0,0,0,0,0,0
132236.0,Gray Alexa,OH,Canada,27.0,185,2021,USA,2021-05-26,False,0,0,0,0,0,0,8,8,0,0,0,0,0,0,0,0,1,1,16,18,3,1,0,4
132236.0,Gray Alexa,OH,Canada,27.0,185,2021,Dominican Republic,2021-05-27,False,0,0,0,0,0,0,16,16,0,0,0,0,0,0,0,0,7,6,16,29,12,4,0,16
132236.0,Gray Alexa,OH,Canada,27.0,185,2021,China,2021-06-01,True,0,0,0,0,0,0,0,0,0,0,0,0,0,0,0,0,0,0,2,2,0,1,0,1
132236.0,Gray Alexa,OH,Canada,27.0,185,2021,Germany,2021-06-02,True,0,0,0,0,0,0,0,0,0,0,0,0,0,0,0,0,1,0,1,2,1,1,0,2
132236.0,Gray Alexa,OH,Canada,27.0,185,2021,Serbia,2021-06-12,True,0,0,0,0,0,0,0,0,0,0,0,0,0,0,0,0,1,2,3,6,0,0,0,0
132236.0,Gray Alexa,OH,Canada,27.0,185,2021,Russia,2021-06-13,False,0,0,0,0,0,0,0,0,0,0,0,0,0,0,0,0,0,0,2,2,0,0,0,0
132236.0,Gray Alexa,OH,Canada,27.0,185,2021,Italy,2021-06-18,False,0,0,0,0,0,0,0,0,0,0,0,0,0,0,0,0,0,0,0,0,0,0,0,0
132236.0,Gray Alexa,OH,Canada,27.0,185,2021,Thailand,2021-06-19,False,0,0,0,0,0,0,0,0,0,0,0,0,0,0,0,0,1,0,0,1,0,0,0,0
132236.0,Gray Alexa,OH,Canada,27.0,185,2021,Belgium,2021-06-20,False,0,0,0,0,0,0,0,0,0,0,0,0,0,0,0,0,0,0,1,1,2,0,0,2
173581.0,Mitrovic Andrea,OH,Canada,22.0,187,2021,Brazil,2021-05-25,False,0,0,5,5,0,0,0,0,8,6,13,27,0,3,2,5,9,2,24,35,2,0,0,2
173581.0,Mitrovic Andrea,OH,Canada,22.0,187,2021,USA,2021-05-26,False,0,0,6,6,0,0,2,2,3,2,16,21,0,0,2,2,4,1,16,21,2,0,0,2
173581.0,Mitrovic Andrea,OH,Canada,22.0,187,2021,Dominican Republic,2021-05-27,False,0,0,4,4,0,0,1,1,3,3,2,8,1,0,0,1,0,0,5,5,1,1,0,2
173581.0,Mitrovic Andrea,OH,Canada,22.0,187,2021,China,2021-06-01,True,0,2,10,12,0,0,1,1,17,4,24,45,0,3,2,5,12,2,20,34,4,3,2,9
173581.0,Mitrovic Andrea,OH,Canada,22.0,187,2021,Germany,2021-06-02,True,2,1,12,15,0,0,2,2,7,6,9,22,0,0,2,2,5,1,9,15,6,0,0,6
173581.0,Mitrovic Andrea,OH,Canada,22.0,187,2021,Poland,2021-06-06,False,0,2,13,15,0,0,0,0,13,6,14,33,0,5,0,5,7,2,36,45,1,3,0,4
173581.0,Mitrovic Andrea,OH,Canada,22.0,187,2021,Japan,2021-06-07,False,1,2,5,8,0,0,1,1,3,3,11,17,0,2,3,5,10,2,18,30,5,1,1,7
173581.0,Mitrovic Andrea,OH,Canada,22.0,187,2021,Netherlands,2021-06-08,False,0,1,6,7,0,1,3,4,8,5,11,24,0,1,0,1,4,1,16,21,2,2,0,4
173581.0,Mitrovic Andrea,OH,Canada,22.0,187,2021,Serbia,2021-06-12,True,2,3,14,19,0,0,1,1,13,2,18,33,0,3,2,5,4,1,21,26,5,1,1,7
173581.0,Mitrovic Andrea,OH,Canada,22.0,187,2021,Russia,2021-06-13,False,0,0,3,3,0,0,0,0,3,2,3,8,0,0,1,1,0,3,7,10,2,0,0,2
173581.0,Mitrovic Andrea,OH,Canada,22.0,187,2021,Italy,2021-06-18,False,0,0,10,10,0,0,4,4,12,0,11,23,0,5,1,6,1,1,15,17,4,2,2,8
173581.0,Mitrovic Andrea,OH,Canada,22.0,187,2021,Thailand,2021-06-19,False,0,0,8,8,0,0,1,1,2,2,8,12,0,1,0,1,1,1,7,9,2,1,0,3
173581.0,Mitrovic Andrea,OH,Canada,22.0,187,2021,Belgium,2021-06-20,False,0,0,7,7,0,0,4,4,7,3,13,23,1,1,3,5,5,3,16,24,4,0,0,4
139522.0,Cross Jennifer,MB,Canada,29.0,194,2021,Brazil,2021-05-25,False,1,1,14,16,0,0,1,1,6,2,5,13,1,4,2,7,0,0,0,0,2,2,0,4
139522.0,Cross Jennifer,MB,Canada,29.0,194,2021,USA,2021-05-26,False,0,1,9,10,0,0,1,1,1,0,3,4,0,1,0,1,0,0,1,1,0,0,0,0
139522.0,Cross Jennifer,MB,Canada,29.0,194,2021,Dominican Republic,2021-05-27,False,0,3,14,17,0,0,1,1,6,2,6,14,1,4,2,7,0,0,0,0,4,0,0,4
139522.0,Cross Jennifer,MB,Canada,29.0,194,2021,China,2021-06-01,True,2,2,14,18,0,0,0,0,7,3,4,14,4,3,5,12,0,0,1,1,0,0,0,0
139522.0,Cross Jennifer,MB,Canada,29.0,194,2021,Germany,2021-06-02,True,1,0,12,13,0,0,4,4,7,1,1,9,4,3,4,11,0,0,1,1,5,0,0,5
139522.0,Cross Jennifer,MB,Canada,29.0,194,2021,Poland,2021-06-06,False,1,1,16,18,0,0,2,2,4,4,6,14,4,3,4,11,1,1,0,2,5,0,1,6
139522.0,Cross Jennifer,MB,Canada,29.0,194,2021,Japan,2021-06-07,False,0,1,5,6,0,0,1,1,1,2,3,6,2,1,3,6,0,0,0,0,4,1,0,5
139522.0,Cross Jennifer,MB,Canada,29.0,194,2021,Netherlands,2021-06-08,False,0,0,4,4,0,0,0,0,1,1,5,7,0,0,1,1,0,0,0,0,0,1,0,1
139522.0,Cross Jennifer,MB,Canada,29.0,194,2021,Serbia,2021-06-12,True,1,0,19,20,0,0,1,1,1,0,6,7,4,2,3,9,0,1,3,4,10,2,1,13
139522.0,Cross Jennifer,MB,Canada,29.0,194,2021,Russia,2021-06-13,False,0,0,0,0,0,0,0,0,0,0,0,0,0,0,0,0,0,0,0,0,0,0,0,0
139522.0,Cross Jennifer,MB,Canada,29.0,194,2021,Italy,2021-06-18,False,0,0,11,11,0,0,2,2,5,0,6,11,1,9,8,18,0,0,2,2,2,1,1,4
139522.0,Cross Jennifer,MB,Canada,29.0,194,2021,Thailand,2021-06-19,False,0,0,8,8,0,0,0,0,6,1,0,7,0,1,9,10,0,0,0,0,2,1,0,3
139522.0,Cross Jennifer,MB,Canada,29.0,194,2021,Belgium,2021-06-20,False,0,0,11,11,0,0,2,2,3,1,4,8,2,4,4,10,0,0,0,0,3,1,1,5
173585.0,King Brie,S,Canada,24.0,183,2021,Brazil,2021-05-25,False,0,1,5,6,0,1,44,45,0,0,4,4,1,1,0,2,0,0,0,0,9,3,1,13
173585.0,King Brie,S,Canada,24.0,183,2021,USA,2021-05-26,False,0,1,2,3,2,1,48,51,0,1,2,3,1,1,1,3,0,0,0,0,4,1,0,5
173585.0,King Brie,S,Canada,24.0,183,2021,Dominican Republic,2021-05-27,False,2,4,11,17,16,3,101,120,0,0,3,3,1,3,3,7,0,0,0,0,13,2,0,15
173585.0,King Brie,S,Canada,24.0,183,2021,China,2021-06-01,True,3,1,13,17,12,0,116,128,2,1,3,6,1,0,3,4,0,1,0,1,10,6,0,16
173585.0,King Brie,S,Canada,24.0,183,2021,Germany,2021-06-02,True,1,0,14,15,10,2,62,74,3,0,1,4,0,5,1,6,0,0,0,0,12,2,2,16
173585.0,King Brie,S,Canada,24.0,183,2021,Poland,2021-06-06,False,1,1,12,14,21,3,98,122,1,0,0,1,2,2,1,5,0,1,0,1,7,4,3,14
173585.0,King Brie,S,Canada,24.0,183,2021,Japan,2021-06-07,False,0,0,6,6,3,1,35,39,0,0,1,1,0,2,0,2,0,0,0,0,3,1,2,6
173585.0,King Brie,S,Canada,24.0,183,2021,Netherlands,2021-06-08,False,1,0,4,5,5,0,40,45,0,1,1,2,0,0,1,1,0,0,0,0,0,4,1,5
173585.0,King Brie,S,Canada,24.0,183,2021,Serbia,2021-06-12,True,0,2,6,8,24,0,86,110,1,0,2,3,2,2,0,4,0,1,0,1,12,6,2,20
173585.0,King Brie,S,Canada,24.0,183,2021,Italy,2021-06-18,False,0,0,8,8,16,0,63,79,1,0,1,2,1,4,1,6,0,0,1,1,4,0,5,9
173585.0,King Brie,S,Canada,24.0,183,2021,Thailand,2021-06-19,False,0,1,2,3,12,0,52,64,0,1,0,1,0,2,2,4,0,0,0,0,2,0,2,4
173585.0,King Brie,S,Canada,24.0,183,2021,Belgium,2021-06-20,False,1,0,6,7,19,1,48,68,1,0,3,4,1,1,1,3,0,0,0,0,8,1,1,10
174676.0,Howe Hilary,OH,Canada,23.0,185,2021,Brazil,2021-05-25,False,0,3,6,9,0,0,0,0,9,7,11,27,0,3,0,3,7,0,22,29,0,5,0,5
174676.0,Howe Hilary,OH,Canada,23.0,185,2021,USA,2021-05-26,False,0,0,8,8,0,0,4,4,4,3,10,17,0,3,0,3,3,2,17,22,0,0,1,1
174676.0,Howe Hilary,OH,Canada,23.0,185,2021,Dominican Republic,2021-05-27,False,0,3,10,13,0,1,2,3,9,3,13,25,1,0,1,2,6,4,23,33,10,5,0,15
174676.0,Howe Hilary,OH,Canada,23.0,185,2021,China,2021-06-01,True,1,0,20,21,0,0,3,3,11,2,18,31,2,3,0,5,15,3,15,33,6,3,2,11
174676.0,Howe Hilary,OH,Canada,23.0,185,2021,Germany,2021-06-02,True,0,2,7,9,0,0,3,3,4,1,5,10,2,1,3,6,1,1,13,15,1,3,1,5
174676.0,Howe Hilary,OH,Canada,23.0,185,2021,Poland,2021-06-06,False,1,3,15,19,0,0,1,1,9,5,10,24,1,4,0,5,7,3,25,35,3,6,0,9
174676.0,Howe Hilary,OH,Canada,23.0,185,2021,Japan,2021-06-07,False,0,2,2,4,0,0,2,2,4,5,10,19,2,1,0,3,2,2,13,17,7,2,0,9
174676.0,Howe Hilary,OH,Canada,23.0,185,2021,Netherlands,2021-06-08,False,0,2,5,7,0,0,0,0,8,5,10,23,1,3,0,4,5,1,21,27,4,2,1,7
174676.0,Howe Hilary,OH,Canada,23.0,185,2021,Serbia,2021-06-12,True,1,1,9,11,0,0,1,1,15,5,11,31,1,1,1,3,2,1,26,29,6,3,2,11
174676.0,Howe Hilary,OH,Canada,23.0,185,2021,Russia,2021-06-13,False,0,1,0,1,0,0,0,0,4,2,4,10,0,0,0,0,1,1,10,12,1,1,1,3
174676.0,Howe Hilary,OH,Canada,23.0,185,2021,Italy,2021-06-18,False,1,1,3,5,0,0,0,0,1,6,4,11,0,1,0,1,3,2,12,17,3,1,1,5
174676.0,Howe Hilary,OH,Canada,23.0,185,2021,Thailand,2021-06-19,False,0,3,5,8,0,0,1,1,8,6,9,23,1,1,1,3,1,1,19,21,4,5,2,11
174676.0,Howe Hilary,OH,Canada,23.0,185,2021,Belgium,2021-06-20,False,0,2,7,9,0,0,2,2,5,3,15,23,1,3,3,7,2,6,10,18,7,1,1,9
166581.0,Joseph Shainah,O,Canada,26.0,183,2021,Brazil,2021-05-25,False,0,0,4,4,0,0,0,0,1,2,6,9,0,1,0,1,0,0,0,0,6,2,0,8
166581.0,Joseph Shainah,O,Canada,26.0,183,2021,USA,2021-05-26,False,0,0,3,3,0,0,1,1,4,1,3,8,0,0,0,0,0,0,0,0,1,0,0,1
166581.0,Joseph Shainah,O,Canada,26.0,183,2021,Dominican Republic,2021-05-27,False,1,1,8,10,0,1,1,2,4,2,15,21,1,6,2,9,0,0,0,0,10,1,1,12
166581.0,Joseph Shainah,O,Canada,26.0,183,2021,China,2021-06-01,True,0,0,0,0,0,0,0,0,0,0,0,0,0,0,0,0,0,0,0,0,0,0,0,0
166581.0,Joseph Shainah,O,Canada,26.0,183,2021,Germany,2021-06-02,True,0,0,0,0,0,0,0,0,0,0,0,0,0,0,0,0,0,0,0,0,0,0,0,0
166581.0,Joseph Shainah,O,Canada,26.0,183,2021,Poland,2021-06-06,False,0,0,0,0,0,0,0,0,0,0,0,0,0,0,0,0,0,0,0,0,0,0,0,0
166581.0,Joseph Shainah,O,Canada,26.0,183,2021,Japan,2021-06-07,False,0,1,4,5,0,0,0,0,6,3,9,18,1,3,4,8,0,0,0,0,3,0,0,3
166581.0,Joseph Shainah,O,Canada,26.0,183,2021,Netherlands,2021-06-08,False,0,0,2,2,0,0,0,0,4,2,9,15,0,0,2,2,0,0,0,0,3,1,0,4
166581.0,Joseph Shainah,O,Canada,26.0,183,2021,Serbia,2021-06-12,True,0,0,0,0,0,0,0,0,0,0,0,0,0,0,0,0,0,0,0,0,0,0,0,0
166581.0,Joseph Shainah,O,Canada,26.0,183,2021,Russia,2021-06-13,False,2,1,7,10,0,1,1,2,8,2,7,17,0,2,2,4,0,0,0,0,4,1,1,6
166581.0,Joseph Shainah,O,Canada,26.0,183,2021,Italy,2021-06-18,False,0,0,2,2,0,0,0,0,6,0,3,9,0,2,1,3,0,0,0,0,2,2,1,5
166581.0,Joseph Shainah,O,Canada,26.0,183,2021,Thailand,2021-06-19,False,0,1,5,6,0,0,0,0,1,1,6,8,1,1,1,3,0,0,0,0,2,0,0,2
166581.0,Joseph Shainah,O,Canada,26.0,183,2021,Belgium,2021-06-20,False,0,0,2,2,0,0,0,0,2,0,2,4,0,1,0,1,0,0,0,0,1,0,0,1
174680.0,Livingston Caroline,OH,Canada,25.0,188,2021,Brazil,2021-05-25,False,0,0,1,1,0,0,0,0,0,2,2,4,0,0,0,0,2,0,2,4,1,0,0,1
174680.0,Livingston Caroline,OH,Canada,25.0,188,2021,USA,2021-05-26,False,0,0,4,4,0,0,0,0,1,2,2,5,0,2,0,2,0,0,1,1,0,0,0,0
174680.0,Livingston Caroline,OH,Canada,25.0,188,2021,Dominican Republic,2021-05-27,False,0,0,0,0,0,0,0,0,0,0,0,0,0,0,0,0,0,0,0,0,0,0,0,0
174680.0,Livingston Caroline,OH,Canada,25.0,188,2021,China,2021-06-01,True,0,0,0,0,0,0,0,0,0,0,0,0,0,0,0,0,0,0,0,0,0,0,0,0
174680.0,Livingston Caroline,OH,Canada,25.0,188,2021,Germany,2021-06-02,True,0,0,0,0,0,0,0,0,0,0,0,0,0,0,0,0,0,0,0,0,0,0,0,0
174680.0,Livingston Caroline,OH,Canada,25.0,188,2021,Poland,2021-06-06,False,0,0,0,0,0,0,0,0,0,0,1,1,0,0,0,0,1,0,0,1,0,0,0,0
174680.0,Livingston Caroline,OH,Canada,25.0,188,2021,Japan,2021-06-07,False,0,0,0,0,0,0,0,0,0,0,0,0,0,0,0,0,2,0,3,5,1,0,0,1
174680.0,Livingston Caroline,OH,Canada,25.0,188,2021,Serbia,2021-06-12,True,0,0,2,2,0,0,0,0,0,0,0,0,0,0,0,0,2,0,1,3,0,0,0,0
174680.0,Livingston Caroline,OH,Canada,25.0,188,2021,Russia,2021-06-13,False,0,3,5,8,0,0,0,0,6,4,7,17,0,4,0,4,5,2,14,21,2,3,3,8
174680.0,Livingston Caroline,OH,Canada,25.0,188,2021,Italy,2021-06-18,False,0,0,2,2,0,0,0,0,0,0,0,0,0,0,0,0,0,0,4,4,1,1,0,2
174680.0,Livingston Caroline,OH,Canada,25.0,188,2021,Thailand,2021-06-19,False,1,1,2,4,0,0,0,0,0,0,0,0,0,0,0,0,2,0,3,5,1,1,0,2
174680.0,Livingston Caroline,OH,Canada,25.0,188,2021,Belgium,2021-06-20,False,0,1,0,1,0,0,1,1,0,0,0,0,0,0,0,0,0,1,2,3,1,1,0,2
156485.0,Robitaille Kim,S,Canada,30.0,180,2021,USA,2021-05-26,False,0,0,0,0,0,0,0,0,0,0,0,0,0,0,0,0,0,0,0,0,0,0,0,0
156485.0,Robitaille Kim,S,Canada,30.0,180,2021,Dominican Republic,2021-05-27,False,0,0,0,0,0,0,0,0,0,0,0,0,0,0,0,0,0,0,0,0,0,0,0,0
156485.0,Robitaille Kim,S,Canada,30.0,180,2021,Japan,2021-06-07,False,0,0,2,2,4,1,36,41,0,0,0,0,0,1,4,5,0,0,0,0,1,2,1,4
156485.0,Robitaille Kim,S,Canada,30.0,180,2021,Netherlands,2021-06-08,False,0,1,1,2,3,0,42,45,0,0,1,1,1,0,0,1,0,0,0,0,2,1,0,3
156485.0,Robitaille Kim,S,Canada,30.0,180,2021,Russia,2021-06-13,False,0,0,2,2,7,1,16,24,0,0,1,1,0,0,0,0,0,0,2,2,1,1,0,2
156485.0,Robitaille Kim,S,Canada,30.0,180,2021,Thailand,2021-06-19,False,0,1,0,1,2,0,11,13,0,0,0,0,1,0,0,1,0,0,0,0,0,1,0,1
168354.0,Maglio Emily,MB,Canada,25.0,191,2021,Brazil,2021-05-25,False,0,0,8,8,0,0,0,0,8,4,9,21,2,1,2,5,2,0,2,4,0,1,0,1
168354.0,Maglio Emily,MB,Canada,25.0,191,2021,USA,2021-05-26,False,0,0,8,8,0,0,0,0,3,2,7,12,1,2,4,7,1,0,0,1,1,0,0,1
168354.0,Maglio Emily,MB,Canada,25.0,191,2021,Dominican Republic,2021-05-27,False,1,2,11,14,0,0,0,0,9,1,9,19,2,4,3,9,0,0,1,1,9,2,0,11
168354.0,Maglio Emily,MB,Canada,25.0,191,2021,China,2021-06-01,True,1,3,11,15,0,0,2,2,4,2,6,12,2,6,4,12,0,0,1,1,1,1,0,2
168354.0,Maglio Emily,MB,Canada,25.0,191,2021,Germany,2021-06-02,True,0,0,16,16,0,0,2,2,7,0,4,11,1,6,4,11,0,0,0,0,4,1,1,6
168354.0,Maglio Emily,MB,Canada,25.0,191,2021,Poland,2021-06-06,False,0,1,14,15,0,0,2,2,9,2,3,14,4,0,2,6,0,0,0,0,3,2,1,6
168354.0,Maglio Emily,MB,Canada,25.0,191,2021,Japan,2021-06-07,False,0,2,5,7,0,0,2,2,3,0,7,10,1,6,3,10,0,0,0,0,0,0,1,1
168354.0,Maglio Emily,MB,Canada,25.0,191,2021,Netherlands,2021-06-08,False,1,0,8,9,0,0,2,2,4,1,7,12,2,1,2,5,0,0,1,1,2,2,0,4
168354.0,Maglio Emily,MB,Canada,25.0,191,2021,Serbia,2021-06-12,True,1,4,14,19,0,0,3,3,12,1,5,18,4,6,4,14,0,0,0,0,7,3,0,10
168354.0,Maglio Emily,MB,Canada,25.0,191,2021,Italy,2021-06-18,False,0,1,2,3,0,0,0,0,3,3,0,6,0,2,4,6,0,0,0,0,0,0,0,0
168354.0,Maglio Emily,MB,Canada,25.0,191,2021,Thailand,2021-06-19,False,0,0,6,6,0,0,1,1,11,0,7,18,2,11,6,19,0,0,1,1,4,2,3,9
168354.0,Maglio Emily,MB,Canada,25.0,191,2021,Belgium,2021-06-20,False,0,0,10,10,0,0,4,4,5,2,7,14,3,5,4,12,0,0,0,0,7,1,0,8
181178.0,Snape Kennedy Brooklyn,L,Canada,24.0,175,2021,China,2021-06-01,True,0,0,0,0,0,0,0,0,0,0,0,0,0,0,0,0,0,0,0,0,0,0,0,0
181178.0,Snape Kennedy Brooklyn,L,Canada,24.0,175,2021,Germany,2021-06-02,True,0,0,0,0,0,0,0,0,0,0,0,0,0,0,0,0,0,0,0,0,0,0,0,0
181178.0,Snape Kennedy Brooklyn,L,Canada,24.0,175,2021,Poland,2021-06-06,False,0,0,0,0,0,0,0,0,0,0,0,0,0,0,0,0,0,0,0,0,0,0,0,0
181178.0,Snape Kennedy Brooklyn,L,Canada,24.0,175,2021,Japan,2021-06-07,False,0,0,0,0,0,0,0,0,0,0,0,0,0,0,0,0,0,0,0,0,0,1,0,1
181178.0,Snape Kennedy Brooklyn,L,Canada,24.0,175,2021,Netherlands,2021-06-08,False,0,0,0,0,0,0,0,0,0,0,0,0,0,0,0,0,0,0,0,0,0,0,0,0
181178.0,Snape Kennedy Brooklyn,L,Canada,24.0,175,2021,Serbia,2021-06-12,True,0,0,0,0,0,0,0,0,0,0,0,0,0,0,0,0,0,0,0,0,0,0,0,0
181178.0,Snape Kennedy Brooklyn,L,Canada,24.0,175,2021,Russia,2021-06-13,False,0,0,0,0,0,0,2,2,0,0,0,0,0,0,0,0,2,1,8,11,2,1,2,5
181178.0,Snape Kennedy Brooklyn,L,Canada,24.0,175,2021,Italy,2021-06-18,False,0,0,0,0,0,0,0,0,0,0,0,0,0,0,0,0,0,0,0,0,0,0,0,0
181178.0,Snape Kennedy Brooklyn,L,Canada,24.0,175,2021,Thailand,2021-06-19,False,0,0,0,0,0,0,2,2,0,0,0,0,0,0,0,0,1,1,3,5,2,0,1,3
181178.0,Snape Kennedy Brooklyn,L,Canada,24.0,175,2021,Belgium,2021-06-20,False,0,0,0,0,0,0,5,5,0,0,0,0,0,0,0,0,0,0,0,0,1,3,1,5
181177.0,Austin Parker Jane,OH,Canada,20.0,188,2021,Brazil,2021-05-25,False,0,0,0,0,0,0,0,0,0,0,0,0,0,0,0,0,0,0,0,0,0,0,0,0
181177.0,Austin Parker Jane,OH,Canada,20.0,188,2021,USA,2021-05-26,False,0,1,0,1,0,0,0,0,0,0,0,0,0,0,0,0,0,0,1,1,0,0,0,0
181177.0,Austin Parker Jane,OH,Canada,20.0,188,2021,Dominican Republic,2021-05-27,False,0,0,0,0,0,0,0,0,0,0,0,0,0,0,0,0,0,0,0,0,0,0,0,0
181177.0,Austin Parker Jane,OH,Canada,20.0,188,2021,Poland,2021-06-06,False,0,0,0,0,0,0,0,0,0,0,0,0,0,0,0,0,0,0,1,1,0,0,0,0
181177.0,Austin Parker Jane,OH,Canada,20.0,188,2021,Japan,2021-06-07,False,0,0,0,0,0,0,0,0,0,0,0,0,0,0,0,0,0,0,0,0,0,0,0,0
181177.0,Austin Parker Jane,OH,Canada,20.0,188,2021,Netherlands,2021-06-08,False,0,0,0,0,0,0,0,0,0,0,0,0,0,0,0,0,0,0,0,0,0,0,0,0
181177.0,Austin Parker Jane,OH,Canada,20.0,188,2021,Russia,2021-06-13,False,0,0,1,1,0,0,0,0,0,2,1,3,0,0,1,1,0,1,2,3,1,0,0,1
135746.0,Yuan Xinyue,MB,China,25.0,202,2021,Netherlands,2021-06-12,True,1,2,13,16,0,0,4,4,11,1,7,19,2,2,3,7,0,0,0,0,3,1,0,4
135746.0,Yuan Xinyue,MB,China,25.0,202,2021,Dominican Republic,2021-06-13,True,1,0,24,25,0,0,1,1,6,1,9,16,4,11,4,19,0,0,0,0,2,0,0,2
135746.0,Yuan Xinyue,MB,China,25.0,202,2021,Italy,2021-06-14,True,3,1,13,17,0,0,1,1,7,0,6,13,1,2,3,6,0,0,0,0,0,0,0,0
135746.0,Yuan Xinyue,MB,China,25.0,202,2021,Russia,2021-06-18,True,0,0,17,17,0,0,7,7,4,0,6,10,2,6,3,11,3,0,5,8,2,2,0,4
135746.0,Yuan Xinyue,MB,China,25.0,202,2021,Poland,2021-06-19,True,2,1,6,9,0,0,0,0,8,0,3,11,2,5,7,14,0,0,0,0,2,2,1,5
135746.0,Yuan Xinyue,MB,China,25.0,202,2021,USA,2021-06-20,True,0,2,6,8,0,0,0,0,5,0,6,11,2,2,5,9,0,0,0,0,2,1,0,3
133588.0,Zhu Ting,OH,China,27.0,198,2021,Netherlands,2021-06-12,True,0,0,5,5,0,0,8,8,10,1,7,18,0,1,1,2,0,0,2,2,9,2,0,11
133588.0,Zhu Ting,OH,China,27.0,198,2021,Dominican Republic,2021-06-13,True,0,0,14,14,0,0,2,2,14,1,14,29,2,5,2,9,3,0,6,9,7,1,1,9
133588.0,Zhu Ting,OH,China,27.0,198,2021,Italy,2021-06-14,True,0,0,0,0,0,0,0,0,0,0,0,0,0,0,0,0,0,0,0,0,0,0,0,0
133588.0,Zhu Ting,OH,China,27.0,198,2021,Russia,2021-06-18,True,0,0,10,10,0,1,6,7,14,0,15,29,1,2,1,4,3,1,6,10,4,2,1,7
133588.0,Zhu Ting,OH,China,27.0,198,2021,Poland,2021-06-19,True,0,0,0,0,0,0,0,0,0,0,0,0,0,0,0,0,0,0,0,0,0,0,0,0
133588.0,Zhu Ting,OH,China,27.0,198,2021,USA,2021-06-20,True,2,0,13,15,0,0,2,2,13,1,4,18,1,1,1,3,1,0,3,4,2,4,0,6
152337.0,Yang Hanyu,MB,China,22.0,196,2021,Japan,2021-05-26,False,0,0,5,5,0,0,0,0,2,0,5,7,3,4,0,7,0,0,0,0,0,0,0,0
152337.0,Yang Hanyu,MB,China,22.0,196,2021,Thailand,2021-05-27,True,0,2,7,9,0,0,1,1,5,0,2,7,3,3,4,10,0,0,0,0,1,1,0,2
152337.0,Yang Hanyu,MB,China,22.0,196,2021,Germany,2021-05-31,True,0,2,14,16,0,0,0,0,10,2,5,17,4,7,1,12,1,0,1,2,1,1,0,2
152337.0,Yang Hanyu,MB,China,22.0,196,2021,Canada,2021-06-01,False,1,2,8,11,1,0,1,2,3,1,8,12,1,5,2,8,0,0,0,0,0,0,0,0
152337.0,Yang Hanyu,MB,China,22.0,196,2021,Belgium,2021-06-06,False,0,1,9,10,0,1,2,3,12,7,5,24,3,8,5,16,1,0,0,1,2,0,0,2
152337.0,Yang Hanyu,MB,China,22.0,196,2021,Serbia,2021-06-07,False,0,1,14,15,0,0,0,0,7,0,4,11,5,1,0,6,0,0,0,0,0,1,0,1
152337.0,Yang Hanyu,MB,China,22.0,196,2021,Brazil,2021-06-08,True,0,0,15,15,0,0,3,3,13,1,7,21,1,5,9,15,0,0,0,0,0,2,0,2
152337.0,Yang Hanyu,MB,China,22.0,196,2021,Netherlands,2021-06-12,True,0,0,0,0,0,0,0,0,0,0,0,0,0,0,0,0,0,0,0,0,0,0,0,0
152337.0,Yang Hanyu,MB,China,22.0,196,2021,Dominican Republic,2021-06-13,True,0,0,1,1,0,0,0,0,0,0,1,1,0,2,1,3,0,0,0,0,0,1,0,1
152337.0,Yang Hanyu,MB,China,22.0,196,2021,Russia,2021-06-18,True,0,0,0,0,0,0,0,0,0,0,0,0,0,0,0,0,0,0,0,0,0,0,0,0
152337.0,Yang Hanyu,MB,China,22.0,196,2021,Poland,2021-06-19,True,0,0,0,0,0,0,0,0,0,0,0,0,0,0,0,0,0,0,0,0,0,0,0,0
152337.0,Yang Hanyu,MB,China,22.0,196,2021,USA,2021-06-20,True,0,0,0,0,0,0,0,0,0,0,0,0,0,0,0,0,0,0,0,0,0,0,0,0
143206.0,Gong Xiangyu,O,China,24.0,189,2021,Netherlands,2021-06-12,True,1,0,19,20,0,0,2,2,15,6,16,37,1,3,1,5,5,0,8,13,12,4,1,17
143206.0,Gong Xiangyu,O,China,24.0,189,2021,Dominican Republic,2021-06-13,True,0,2,11,13,0,0,1,1,9,6,13,28,1,1,4,6,4,1,6,11,9,4,2,15
143206.0,Gong Xiangyu,O,China,24.0,189,2021,Italy,2021-06-14,True,1,1,7,9,0,0,1,1,9,1,5,15,0,0,0,0,3,1,8,12,12,3,1,16
143206.0,Gong Xiangyu,O,China,24.0,189,2021,Russia,2021-06-18,True,0,0,10,10,0,1,2,3,11,0,6,17,2,2,3,7,1,0,6,7,12,2,4,18
143206.0,Gong Xiangyu,O,China,24.0,189,2021,Poland,2021-06-19,True,0,1,14,15,0,0,1,1,10,2,7,19,1,3,1,5,2,1,5,8,9,2,0,11
143206.0,Gong Xiangyu,O,China,24.0,189,2021,USA,2021-06-20,True,1,1,13,15,0,0,4,4,11,1,5,17,0,2,1,3,10,0,7,17,4,4,0,8
143201.0,Wang Yuanyuan,MB,China,24.0,196,2021,Japan,2021-05-26,False,0,1,6,7,0,0,1,1,6,0,8,14,1,0,0,1,0,1,0,1,1,0,0,1
143201.0,Wang Yuanyuan,MB,China,24.0,196,2021,Thailand,2021-05-27,True,1,0,10,11,0,0,0,0,10,2,5,17,3,5,8,16,0,0,1,1,3,0,1,4
143201.0,Wang Yuanyuan,MB,China,24.0,196,2021,Germany,2021-05-31,True,0,1,6,7,0,0,0,0,2,0,2,4,0,1,0,1,0,0,0,0,0,2,0,2
143201.0,Wang Yuanyuan,MB,China,24.0,196,2021,Canada,2021-06-01,False,1,0,11,12,0,0,0,0,8,1,8,17,0,4,0,4,0,0,0,0,1,1,0,2
143201.0,Wang Yuanyuan,MB,China,24.0,196,2021,Belgium,2021-06-06,False,0,1,17,18,0,0,5,5,14,1,5,20,1,8,3,12,0,1,0,1,4,0,0,4
143201.0,Wang Yuanyuan,MB,China,24.0,196,2021,Serbia,2021-06-07,False,0,0,8,8,0,0,1,1,7,2,3,12,2,2,1,5,0,0,0,0,0,0,0,0
143201.0,Wang Yuanyuan,MB,China,24.0,196,2021,Brazil,2021-06-08,True,0,1,15,16,0,0,3,3,8,1,10,19,3,5,8,16,0,0,0,0,3,2,0,5
143201.0,Wang Yuanyuan,MB,China,24.0,196,2021,Netherlands,2021-06-12,True,0,0,0,0,0,0,0,0,0,0,0,0,0,0,0,0,0,0,0,0,0,0,0,0
143201.0,Wang Yuanyuan,MB,China,24.0,196,2021,Dominican Republic,2021-06-13,True,0,0,0,0,0,0,0,0,0,0,0,0,0,0,0,0,0,0,0,0,0,0,0,0
143201.0,Wang Yuanyuan,MB,China,24.0,196,2021,Italy,2021-06-14,True,0,0,0,0,0,0,0,0,0,0,0,0,0,0,0,0,0,0,0,0,0,0,0,0
143201.0,Wang Yuanyuan,MB,China,24.0,196,2021,Russia,2021-06-18,True,0,0,0,0,0,0,0,0,0,0,0,0,0,0,0,0,0,0,0,0,0,0,0,0
143201.0,Wang Yuanyuan,MB,China,24.0,196,2021,Poland,2021-06-19,True,1,0,12,13,0,0,2,2,3,0,3,6,2,2,8,12,0,0,0,0,0,1,1,2
143201.0,Wang Yuanyuan,MB,China,24.0,196,2021,USA,2021-06-20,True,0,0,0,0,0,0,0,0,0,0,0,0,0,0,0,0,0,0,0,0,0,0,0,0
152486.0,Li Yao,OH,China,26.0,186,2021,Japan,2021-05-26,False,0,0,7,7,0,1,0,1,5,2,9,16,1,3,0,4,0,0,1,1,2,0,0,2
152486.0,Li Yao,OH,China,26.0,186,2021,Thailand,2021-05-27,True,2,0,15,17,0,0,1,1,9,1,11,21,1,3,1,5,2,0,0,2,9,4,2,15
152486.0,Li Yao,OH,China,26.0,186,2021,Germany,2021-05-31,True,0,3,10,13,0,0,0,0,9,4,20,33,2,1,0,3,1,0,0,1,3,2,0,5
152486.0,Li Yao,OH,China,26.0,186,2021,Canada,2021-06-01,False,0,0,10,10,0,0,3,3,9,4,15,28,0,2,3,5,0,0,1,1,6,2,0,8
152486.0,Li Yao,OH,China,26.0,186,2021,Belgium,2021-06-06,False,0,3,9,12,0,0,6,6,12,7,22,41,0,5,2,7,5,3,6,14,16,1,2,19
152486.0,Li Yao,OH,China,26.0,186,2021,Serbia,2021-06-07,False,1,0,11,12,0,0,1,1,8,4,15,27,4,2,2,8,3,2,12,17,2,2,1,5
152486.0,Li Yao,OH,China,26.0,186,2021,Brazil,2021-06-08,True,0,0,16,16,0,0,4,4,4,3,15,22,0,6,3,9,5,0,14,19,9,8,7,24
152486.0,Li Yao,OH,China,26.0,186,2021,Netherlands,2021-06-12,True,0,0,0,0,0,0,0,0,0,0,1,1,0,0,0,0,0,0,0,0,0,0,0,0
152486.0,Li Yao,OH,China,26.0,186,2021,Dominican Republic,2021-06-13,True,0,0,0,0,0,0,0,0,0,0,0,0,0,0,0,0,0,0,0,0,0,0,0,0
152486.0,Li Yao,OH,China,26.0,186,2021,Italy,2021-06-14,True,0,0,0,0,0,0,0,0,0,0,0,0,0,0,0,0,0,0,0,0,0,0,0,0
152486.0,Li Yao,OH,China,26.0,186,2021,Poland,2021-06-19,True,0,1,0,1,0,0,0,0,1,0,2,3,0,0,0,0,0,0,2,2,0,0,0,0
152486.0,Li Yao,OH,China,26.0,186,2021,USA,2021-06-20,True,0,0,0,0,0,0,0,0,0,0,0,0,0,0,0,0,0,0,0,0,0,0,0,0
131973.0,Zhang Changning,OH,China,26.0,193,2021,Japan,2021-05-26,False,0,0,0,0,0,0,0,0,0,2,4,6,0,0,0,0,0,0,0,0,0,0,0,0
131973.0,Zhang Changning,OH,China,26.0,193,2021,Thailand,2021-05-27,True,1,2,6,9,0,0,0,0,15,3,7,25,2,2,0,4,9,1,7,17,3,1,2,6
131973.0,Zhang Changning,OH,China,26.0,193,2021,Germany,2021-05-31,True,2,1,16,19,0,0,0,0,16,8,22,46,5,2,3,10,6,1,17,24,11,4,1,16
131973.0,Zhang Changning,OH,China,26.0,193,2021,Canada,2021-06-01,False,2,1,15,18,0,0,1,1,18,10,21,49,2,2,0,4,9,1,12,22,8,2,2,12
131973.0,Zhang Changning,OH,China,26.0,193,2021,Belgium,2021-06-06,False,0,1,21,22,0,0,6,6,35,9,33,77,2,6,5,13,1,1,12,14,9,1,3,13
131973.0,Zhang Changning,OH,China,26.0,193,2021,Serbia,2021-06-07,False,0,0,0,0,0,0,0,0,0,0,0,0,0,0,0,0,0,0,0,0,0,0,0,0
131973.0,Zhang Changning,OH,China,26.0,193,2021,Brazil,2021-06-08,True,2,0,15,17,0,0,4,4,32,4,24,60,2,4,3,9,5,1,10,16,10,2,5,17
131973.0,Zhang Changning,OH,China,26.0,193,2021,Netherlands,2021-06-12,True,0,0,5,5,0,0,1,1,7,1,5,13,0,0,1,1,8,1,5,14,5,4,1,10
131973.0,Zhang Changning,OH,China,26.0,193,2021,Dominican Republic,2021-06-13,True,2,0,6,8,0,0,3,3,11,2,7,20,1,0,3,4,5,0,6,11,9,1,0,10
131973.0,Zhang Changning,OH,China,26.0,193,2021,Italy,2021-06-14,True,0,2,14,16,0,0,2,2,9,0,17,26,2,1,1,4,10,0,7,17,4,2,0,6
131973.0,Zhang Changning,OH,China,26.0,193,2021,Russia,2021-06-18,True,0,0,0,0,0,0,0,0,0,0,0,0,0,0,0,0,0,0,0,0,0,0,0,0
131973.0,Zhang Changning,OH,China,26.0,193,2021,Poland,2021-06-19,True,0,0,14,14,0,0,2,2,18,2,4,24,3,3,4,10,6,0,9,15,5,2,0,7
131973.0,Zhang Changning,OH,China,26.0,193,2021,USA,2021-06-20,True,1,1,8,10,0,0,0,0,10,2,11,23,2,0,0,2,4,1,5,10,3,2,0,5
124132.0,Liu Xiaotong,OH,China,32.0,188,2021,Japan,2021-05-26,False,0,1,3,4,0,0,1,1,4,1,5,10,0,2,0,2,7,2,8,17,1,3,0,4
124132.0,Liu Xiaotong,OH,China,32.0,188,2021,Thailand,2021-05-27,True,0,0,0,0,0,0,0,0,0,0,0,0,0,0,0,0,0,0,0,0,0,0,0,0
124132.0,Liu Xiaotong,OH,China,32.0,188,2021,Germany,2021-05-31,True,0,2,15,17,0,0,0,0,9,2,24,35,0,4,0,4,12,2,17,31,4,3,0,7
124132.0,Liu Xiaotong,OH,China,32.0,188,2021,Canada,2021-06-01,False,1,0,8,9,0,0,0,0,3,4,11,18,0,3,1,4,2,3,11,16,2,7,0,9
124132.0,Liu Xiaotong,OH,China,32.0,188,2021,Belgium,2021-06-06,False,0,1,3,4,0,0,2,2,1,2,6,9,0,1,0,1,3,1,11,15,6,0,0,6
124132.0,Liu Xiaotong,OH,China,32.0,188,2021,Serbia,2021-06-07,False,0,1,11,12,0,0,2,2,12,4,17,33,0,0,3,3,15,1,19,35,4,1,0,5
124132.0,Liu Xiaotong,OH,China,32.0,188,2021,Brazil,2021-06-08,True,0,0,12,12,0,0,6,6,8,6,21,35,1,6,1,8,7,1,29,37,15,2,2,19
124132.0,Liu Xiaotong,OH,China,32.0,188,2021,Netherlands,2021-06-12,True,0,0,0,0,0,0,0,0,0,0,0,0,0,0,0,0,0,0,0,0,0,0,0,0
124132.0,Liu Xiaotong,OH,China,32.0,188,2021,Italy,2021-06-14,True,0,0,0,0,0,0,0,0,0,0,0,0,0,0,0,0,0,0,0,0,0,0,0,0
124132.0,Liu Xiaotong,OH,China,32.0,188,2021,Russia,2021-06-18,True,0,0,0,0,0,0,0,0,0,0,0,0,0,0,0,0,0,0,0,0,0,0,0,0
124132.0,Liu Xiaotong,OH,China,32.0,188,2021,Poland,2021-06-19,True,0,0,0,0,0,0,0,0,0,0,0,0,0,0,0,0,0,0,0,0,0,0,0,0
123841.0,Yao Di,S,China,29.0,182,2021,Japan,2021-05-26,False,0,0,0,0,0,0,9,9,0,0,0,0,0,0,0,0,0,0,0,0,1,1,0,2
123841.0,Yao Di,S,China,29.0,182,2021,Thailand,2021-05-27,True,0,1,12,13,37,0,44,81,0,0,1,1,0,1,0,1,0,0,0,0,0,1,1,2
123841.0,Yao Di,S,China,29.0,182,2021,Germany,2021-05-31,True,1,1,12,14,13,1,1,15,0,1,2,3,2,2,0,4,0,0,0,0,2,2,0,4
123841.0,Yao Di,S,China,29.0,182,2021,Canada,2021-06-01,False,1,2,10,13,11,0,105,116,1,0,1,2,0,4,1,5,0,0,0,0,10,3,0,13
123841.0,Yao Di,S,China,29.0,182,2021,Belgium,2021-06-06,False,0,1,23,24,50,1,90,141,0,0,1,1,0,3,4,7,0,0,0,0,16,2,1,19
123841.0,Yao Di,S,China,29.0,182,2021,Serbia,2021-06-07,False,0,0,0,0,0,0,5,5,0,0,0,0,0,1,0,1,0,0,0,0,0,0,0,0
123841.0,Yao Di,S,China,29.0,182,2021,Brazil,2021-06-08,True,0,1,14,15,52,2,64,118,0,0,0,0,2,1,6,9,0,0,0,0,13,2,1,16
123841.0,Yao Di,S,China,29.0,182,2021,Netherlands,2021-06-12,True,0,0,0,0,0,0,9,9,0,0,0,0,0,0,0,0,0,0,0,0,1,0,0,1
123841.0,Yao Di,S,China,29.0,182,2021,Dominican Republic,2021-06-13,True,0,0,5,5,10,0,36,46,0,0,1,1,1,2,1,4,0,0,0,0,8,0,3,11
123841.0,Yao Di,S,China,29.0,182,2021,Italy,2021-06-14,True,0,0,0,0,0,0,0,0,0,0,0,0,0,0,0,0,0,0,0,0,0,0,0,0
123841.0,Yao Di,S,China,29.0,182,2021,Russia,2021-06-18,True,0,0,0,0,8,0,6,14,0,0,0,0,0,0,0,0,0,0,0,0,3,0,0,3
123841.0,Yao Di,S,China,29.0,182,2021,Poland,2021-06-19,True,0,0,8,8,18,1,39,58,0,0,0,0,0,2,4,6,0,0,0,0,4,1,0,5
123841.0,Yao Di,S,China,29.0,182,2021,USA,2021-06-20,True,0,0,0,0,0,0,0,0,0,0,0,0,0,0,0,0,0,0,0,0,0,0,0,0
152318.0,Li Yingying,OH,China,22.0,192,2021,Netherlands,2021-06-12,True,2,1,8,11,0,0,0,0,17,5,15,37,0,2,1,3,9,1,13,23,6,0,1,7
152318.0,Li Yingying,OH,China,22.0,192,2021,Dominican Republic,2021-06-13,True,0,1,6,7,0,0,1,1,12,0,1,13,1,0,0,1,5,0,6,11,4,1,0,5
152318.0,Li Yingying,OH,China,22.0,192,2021,Italy,2021-06-14,True,2,2,8,12,0,0,1,1,15,1,10,26,2,1,0,3,4,0,4,8,5,1,0,6
152318.0,Li Yingying,OH,China,22.0,192,2021,Russia,2021-06-18,True,1,1,15,17,0,0,3,3,18,5,8,31,0,1,4,5,2,2,7,11,7,1,2,10
152318.0,Li Yingying,OH,China,22.0,192,2021,Poland,2021-06-19,True,1,1,10,12,0,0,4,4,17,1,5,23,0,0,1,1,7,1,14,22,4,2,1,7
152318.0,Li Yingying,OH,China,22.0,192,2021,USA,2021-06-20,True,0,0,0,0,0,0,0,0,0,0,0,0,0,0,0,0,0,0,0,0,0,0,0,0
133146.0,Lin Li,L,China,29.0,171,2021,Japan,2021-05-26,False,0,0,0,0,0,0,0,0,0,0,0,0,0,0,0,0,0,0,0,0,0,0,0,0
133146.0,Lin Li,L,China,29.0,171,2021,Thailand,2021-05-27,True,0,0,0,0,0,0,0,0,0,0,0,0,0,0,0,0,0,0,0,0,1,0,0,1
133146.0,Lin Li,L,China,29.0,171,2021,Germany,2021-05-31,True,0,0,0,0,1,0,1,2,0,0,0,0,0,0,0,0,9,1,8,18,9,4,0,13
133146.0,Lin Li,L,China,29.0,171,2021,Canada,2021-06-01,False,0,0,0,0,0,0,0,0,0,0,0,0,0,0,0,0,0,0,0,0,0,0,0,0
133146.0,Lin Li,L,China,29.0,171,2021,Belgium,2021-06-06,False,0,0,0,0,0,0,4,4,0,0,0,0,0,0,0,0,0,2,6,8,3,1,0,4
133146.0,Lin Li,L,China,29.0,171,2021,Serbia,2021-06-07,False,0,0,0,0,0,0,8,8,0,0,0,0,0,0,0,0,8,1,6,15,9,5,2,16
133146.0,Lin Li,L,China,29.0,171,2021,Brazil,2021-06-08,True,0,0,0,0,0,0,0,0,0,0,0,0,0,0,0,0,0,0,0,0,0,0,0,0
133146.0,Lin Li,L,China,29.0,171,2021,Netherlands,2021-06-12,True,0,0,0,0,0,0,0,0,0,0,0,0,0,0,0,0,0,0,0,0,0,0,0,0
133146.0,Lin Li,L,China,29.0,171,2021,Dominican Republic,2021-06-13,True,0,0,0,0,0,0,0,0,0,0,0,0,0,0,0,0,2,0,4,6,1,0,0,1
133146.0,Lin Li,L,China,29.0,171,2021,Italy,2021-06-14,True,0,0,0,0,0,0,3,3,0,0,0,0,0,0,0,0,1,2,3,6,8,1,1,10
133146.0,Lin Li,L,China,29.0,171,2021,Russia,2021-06-18,True,0,0,0,0,0,0,0,0,0,0,0,0,0,0,0,0,0,0,0,0,0,0,0,0
133146.0,Lin Li,L,China,29.0,171,2021,Poland,2021-06-19,True,0,0,0,0,0,0,5,5,0,0,0,0,0,0,0,0,1,1,6,8,3,2,0,5
133146.0,Lin Li,L,China,29.0,171,2021,USA,2021-06-20,True,0,0,0,0,0,0,0,0,0,0,0,0,0,0,0,0,0,0,0,0,0,0,0,0
124130.0,Ding Xia,S,China,32.0,180,2021,Netherlands,2021-06-12,True,0,2,8,10,12,0,87,99,0,1,0,1,1,0,0,1,0,0,0,0,12,2,1,15
124130.0,Ding Xia,S,China,32.0,180,2021,Dominican Republic,2021-06-13,True,0,0,6,6,22,1,23,46,2,0,0,2,1,3,2,6,0,0,0,0,5,0,1,6
124130.0,Ding Xia,S,China,32.0,180,2021,Italy,2021-06-14,True,0,1,6,7,12,0,64,76,0,0,2,2,0,1,0,1,0,0,0,0,3,4,0,7
124130.0,Ding Xia,S,China,32.0,180,2021,Russia,2021-06-18,True,0,1,4,5,22,1,40,63,0,2,1,3,1,4,3,8,0,0,0,0,3,1,1,5
124130.0,Ding Xia,S,China,32.0,180,2021,Poland,2021-06-19,True,0,0,2,2,1,0,10,11,0,0,0,0,0,0,0,0,0,0,0,0,1,0,0,1
124130.0,Ding Xia,S,China,32.0,180,2021,USA,2021-06-20,True,0,1,11,12,5,0,60,65,0,1,1,2,1,0,1,2,0,0,0,0,4,5,0,9
138748.0,Yan Ni,MB,China,35.0,192,2021,Netherlands,2021-06-12,True,0,0,15,15,0,0,3,3,3,1,6,10,4,1,2,7,0,0,0,0,8,0,0,8
138748.0,Yan Ni,MB,China,35.0,192,2021,Dominican Republic,2021-06-13,True,0,1,13,14,1,0,5,6,2,1,5,8,6,6,7,19,1,0,1,2,1,0,0,1
138748.0,Yan Ni,MB,China,35.0,192,2021,Italy,2021-06-14,True,0,0,13,13,0,0,1,1,7,0,2,9,1,2,0,3,0,0,0,0,1,2,0,3
138748.0,Yan Ni,MB,China,35.0,192,2021,Russia,2021-06-18,True,0,0,12,12,0,0,3,3,4,1,4,9,4,4,6,14,2,0,2,4,4,0,0,4
138748.0,Yan Ni,MB,China,35.0,192,2021,USA,2021-06-20,True,3,0,11,14,0,0,0,0,6,0,3,9,3,1,0,4,0,0,0,0,0,1,1,2
135745.0,Wang Mengjie,L,China,26.0,173,2021,Japan,2021-05-26,False,0,0,0,0,0,0,3,3,0,0,0,0,0,0,0,0,10,1,8,19,7,2,0,9
135745.0,Wang Mengjie,L,China,26.0,173,2021,Thailand,2021-05-27,True,0,0,0,0,0,0,3,3,0,0,0,0,0,0,0,0,10,1,6,17,13,2,1,16
135745.0,Wang Mengjie,L,China,26.0,173,2021,Germany,2021-05-31,True,0,0,0,0,1,0,0,1,0,0,0,0,0,0,0,0,5,2,7,14,6,5,0,11
135745.0,Wang Mengjie,L,China,26.0,173,2021,Canada,2021-06-01,False,0,0,0,0,0,1,11,12,0,0,0,0,0,0,0,0,10,0,12,22,15,4,0,19
135745.0,Wang Mengjie,L,China,26.0,173,2021,Belgium,2021-06-06,False,0,0,0,0,0,0,13,13,0,0,0,0,0,0,0,0,8,0,16,24,28,4,4,36
135745.0,Wang Mengjie,L,China,26.0,173,2021,Serbia,2021-06-07,False,0,0,0,0,0,0,0,0,0,0,0,0,0,0,0,0,0,0,0,0,0,0,0,0
135745.0,Wang Mengjie,L,China,26.0,173,2021,Brazil,2021-06-08,True,0,0,0,0,0,0,10,10,0,0,0,0,0,0,0,0,12,0,10,22,21,5,3,29
135745.0,Wang Mengjie,L,China,26.0,173,2021,Netherlands,2021-06-12,True,0,0,0,0,1,0,7,8,0,0,0,0,0,0,0,0,3,0,5,8,8,3,0,11
135745.0,Wang Mengjie,L,China,26.0,173,2021,Dominican Republic,2021-06-13,True,0,0,0,0,0,0,7,7,0,0,0,0,0,0,0,0,6,2,12,20,4,3,0,7
135745.0,Wang Mengjie,L,China,26.0,173,2021,Italy,2021-06-14,True,0,0,0,0,0,0,0,0,0,0,0,0,0,0,0,0,0,0,0,0,0,0,0,0
135745.0,Wang Mengjie,L,China,26.0,173,2021,Russia,2021-06-18,True,0,0,0,0,0,0,0,0,0,0,0,0,0,0,0,0,6,1,7,14,12,1,1,14
135745.0,Wang Mengjie,L,China,26.0,173,2021,Poland,2021-06-19,True,0,0,0,0,0,0,5,5,0,0,0,0,0,0,0,0,1,0,3,4,5,2,1,8
135745.0,Wang Mengjie,L,China,26.0,173,2021,USA,2021-06-20,True,0,0,0,0,0,0,3,3,0,0,0,0,0,0,0,0,6,0,6,12,10,4,1,15
133141.0,Liu Yanhan,OH,China,29.0,188,2021,Japan,2021-05-26,False,0,1,8,9,0,0,0,0,6,3,14,23,3,1,0,4,5,2,16,23,7,1,0,8
133141.0,Liu Yanhan,OH,China,29.0,188,2021,Thailand,2021-05-27,True,0,0,0,0,0,0,0,0,0,0,0,0,0,0,0,0,0,0,0,0,0,0,0,0
133141.0,Liu Yanhan,OH,China,29.0,188,2021,Germany,2021-05-31,True,0,0,8,8,0,0,0,0,5,1,7,13,0,2,0,2,1,1,0,2,0,1,0,1
133141.0,Liu Yanhan,OH,China,29.0,188,2021,Canada,2021-06-01,False,0,0,4,4,0,1,0,1,4,1,14,19,0,2,2,4,0,0,0,0,1,0,0,1
133141.0,Liu Yanhan,OH,China,29.0,188,2021,Belgium,2021-06-06,False,0,1,0,1,0,0,0,0,2,0,4,6,0,0,0,0,0,0,0,0,1,1,0,2
133141.0,Liu Yanhan,OH,China,29.0,188,2021,Serbia,2021-06-07,False,0,0,9,9,0,0,1,1,5,2,13,20,0,3,0,3,0,1,3,4,1,3,0,4
133141.0,Liu Yanhan,OH,China,29.0,188,2021,Brazil,2021-06-08,True,0,0,2,2,0,0,0,0,2,1,9,12,0,1,1,2,0,0,0,0,6,1,1,8
133141.0,Liu Yanhan,OH,China,29.0,188,2021,Dominican Republic,2021-06-13,True,0,0,0,0,0,0,0,0,0,0,0,0,0,0,0,0,0,0,0,0,0,0,0,0
133141.0,Liu Yanhan,OH,China,29.0,188,2021,Italy,2021-06-14,True,0,0,0,0,0,0,0,0,0,0,0,0,0,0,0,0,0,0,0,0,0,0,0,0
133141.0,Liu Yanhan,OH,China,29.0,188,2021,Russia,2021-06-18,True,0,0,2,2,0,0,0,0,0,0,3,3,1,1,3,5,0,0,0,0,0,0,0,0
133141.0,Liu Yanhan,OH,China,29.0,188,2021,Poland,2021-06-19,True,0,0,1,1,0,0,0,0,0,0,0,0,0,0,0,0,0,0,0,0,0,0,0,0
133141.0,Liu Yanhan,OH,China,29.0,188,2021,USA,2021-06-20,True,0,0,0,0,0,0,0,0,0,0,0,0,0,0,0,0,0,0,0,0,0,0,0,0
113454.0,Vargas Valdez Annerys Victoria,MB,Dominican Republic,40.0,196,2021,USA,2021-05-25,False,0,1,1,2,0,0,0,0,1,1,0,2,0,0,1,1,0,1,0,1,0,0,0,0
113454.0,Vargas Valdez Annerys Victoria,MB,Dominican Republic,40.0,196,2021,Brazil,2021-05-26,False,0,1,3,4,0,0,0,0,2,2,6,10,0,1,2,3,0,0,0,0,1,0,0,1
113454.0,Vargas Valdez Annerys Victoria,MB,Dominican Republic,40.0,196,2021,Canada,2021-05-27,True,0,0,0,0,0,0,0,0,0,0,0,0,0,2,0,2,0,0,0,0,0,0,0,0
113454.0,Vargas Valdez Annerys Victoria,MB,Dominican Republic,40.0,196,2021,Belgium,2021-05-31,False,0,0,0,0,0,0,0,0,0,0,0,0,0,2,0,2,0,0,0,0,0,0,0,0
113454.0,Vargas Valdez Annerys Victoria,MB,Dominican Republic,40.0,196,2021,Poland,2021-06-02,True,0,2,6,8,0,0,1,1,5,0,6,11,4,5,3,12,0,0,0,0,4,2,0,6
113454.0,Vargas Valdez Annerys Victoria,MB,Dominican Republic,40.0,196,2021,Russia,2021-06-06,False,0,1,5,6,0,0,1,1,7,3,6,16,4,9,4,17,0,0,0,0,3,0,0,3
113454.0,Vargas Valdez Annerys Victoria,MB,Dominican Republic,40.0,196,2021,Thailand,2021-06-08,True,0,1,14,15,0,0,0,0,2,0,9,11,5,6,1,12,1,0,0,1,0,2,0,2
113454.0,Vargas Valdez Annerys Victoria,MB,Dominican Republic,40.0,196,2021,Italy,2021-06-12,True,2,4,4,10,0,0,1,1,5,1,3,9,1,8,0,9,0,0,0,0,1,0,0,1
113454.0,Vargas Valdez Annerys Victoria,MB,Dominican Republic,40.0,196,2021,China,2021-06-13,False,0,0,0,0,0,0,0,0,0,0,0,0,0,0,0,0,0,0,0,0,0,0,0,0
113454.0,Vargas Valdez Annerys Victoria,MB,Dominican Republic,40.0,196,2021,Netherlands,2021-06-14,True,0,0,0,0,0,0,0,0,0,0,0,0,0,0,0,0,0,0,0,0,0,0,0,0
119591.0,Eve Mejia Lisvel Elisa,MB,Dominican Republic,30.0,194,2021,USA,2021-05-25,False,0,1,8,9,0,0,0,0,1,2,1,4,1,7,0,8,0,0,4,4,4,3,0,7
119591.0,Eve Mejia Lisvel Elisa,MB,Dominican Republic,30.0,194,2021,Brazil,2021-05-26,False,0,1,3,4,0,0,0,0,2,2,0,4,2,0,1,3,3,0,4,7,0,2,0,2
119591.0,Eve Mejia Lisvel Elisa,MB,Dominican Republic,30.0,194,2021,Canada,2021-05-27,True,1,2,9,12,0,0,0,0,4,0,7,11,3,3,2,8,3,1,7,11,8,1,0,9
119591.0,Eve Mejia Lisvel Elisa,MB,Dominican Republic,30.0,194,2021,Belgium,2021-05-31,False,0,2,19,21,0,0,0,0,3,2,1,6,2,6,7,15,9,6,7,22,15,3,1,19
119591.0,Eve Mejia Lisvel Elisa,MB,Dominican Republic,30.0,194,2021,Poland,2021-06-02,True,0,0,0,0,0,0,0,0,0,0,0,0,0,0,0,0,0,0,0,0,0,0,0,0
119591.0,Eve Mejia Lisvel Elisa,MB,Dominican Republic,30.0,194,2021,Thailand,2021-06-08,True,0,0,0,0,0,0,0,0,0,0,0,0,0,0,0,0,0,0,0,0,0,0,0,0
119591.0,Eve Mejia Lisvel Elisa,MB,Dominican Republic,30.0,194,2021,Italy,2021-06-12,True,0,0,4,4,0,0,0,0,0,0,0,0,0,0,0,0,1,1,3,5,0,0,0,0
119591.0,Eve Mejia Lisvel Elisa,MB,Dominican Republic,30.0,194,2021,China,2021-06-13,False,0,0,4,4,0,0,1,1,0,0,0,0,0,0,0,0,0,0,2,2,0,1,0,1
119591.0,Eve Mejia Lisvel Elisa,MB,Dominican Republic,30.0,194,2021,Netherlands,2021-06-14,True,0,1,13,14,0,0,2,2,7,0,2,9,0,5,6,11,1,2,6,9,5,1,1,7
119591.0,Eve Mejia Lisvel Elisa,MB,Dominican Republic,30.0,194,2021,Japan,2021-06-18,False,0,1,14,15,0,0,0,0,1,1,5,7,1,5,6,12,0,1,4,5,4,2,3,9
119591.0,Eve Mejia Lisvel Elisa,MB,Dominican Republic,30.0,194,2021,Serbia,2021-06-19,True,0,0,0,0,0,0,0,0,0,0,0,0,0,0,0,0,0,0,0,0,0,0,0,0
119591.0,Eve Mejia Lisvel Elisa,MB,Dominican Republic,30.0,194,2021,Germany,2021-06-20,True,1,3,8,12,0,0,1,1,7,1,4,12,2,4,6,12,0,0,0,0,3,1,3,7
119039.0,Castillo Brenda,L,Dominican Republic,29.0,167,2021,USA,2021-05-25,False,0,0,0,0,1,0,3,4,0,0,0,0,0,0,0,0,8,0,8,16,9,5,0,14
119039.0,Castillo Brenda,L,Dominican Republic,29.0,167,2021,Brazil,2021-05-26,False,0,0,0,0,0,0,10,10,0,0,0,0,0,0,0,0,10,0,5,15,5,0,1,6
119039.0,Castillo Brenda,L,Dominican Republic,29.0,167,2021,Canada,2021-05-27,True,0,0,0,0,0,0,12,12,0,0,0,0,0,0,0,0,5,3,17,25,27,3,0,30
119039.0,Castillo Brenda,L,Dominican Republic,29.0,167,2021,Belgium,2021-05-31,False,0,0,0,0,0,0,0,0,0,0,0,0,0,0,0,0,8,0,22,30,23,5,2,30
119039.0,Castillo Brenda,L,Dominican Republic,29.0,167,2021,Poland,2021-06-02,True,0,0,0,0,0,0,21,21,0,0,0,0,0,0,0,0,6,1,7,14,26,8,4,38
119039.0,Castillo Brenda,L,Dominican Republic,29.0,167,2021,Russia,2021-06-06,False,0,0,0,0,0,0,12,12,0,0,0,0,0,0,0,0,7,1,18,26,18,4,3,25
119039.0,Castillo Brenda,L,Dominican Republic,29.0,167,2021,Thailand,2021-06-08,True,0,0,0,0,0,0,11,11,0,0,0,0,0,0,0,0,12,0,6,18,16,1,1,18
119039.0,Castillo Brenda,L,Dominican Republic,29.0,167,2021,Italy,2021-06-12,True,0,0,0,0,0,0,9,9,0,0,0,0,0,0,0,0,11,0,15,26,22,3,0,25
119039.0,Castillo Brenda,L,Dominican Republic,29.0,167,2021,China,2021-06-13,False,0,0,0,0,1,0,23,24,0,0,0,0,0,0,0,0,7,0,12,19,15,4,2,21
119039.0,Castillo Brenda,L,Dominican Republic,29.0,167,2021,Netherlands,2021-06-14,True,0,0,0,0,0,0,26,26,0,0,0,0,0,0,0,0,10,1,15,26,21,7,5,33
119039.0,Castillo Brenda,L,Dominican Republic,29.0,167,2021,Japan,2021-06-18,False,0,0,0,0,0,0,40,40,0,0,0,0,0,0,0,0,6,1,9,16,19,5,6,30
119039.0,Castillo Brenda,L,Dominican Republic,29.0,167,2021,Serbia,2021-06-19,True,0,0,0,0,0,0,5,5,0,0,0,0,0,0,0,0,3,0,9,12,14,5,1,20
119039.0,Castillo Brenda,L,Dominican Republic,29.0,167,2021,Germany,2021-06-20,True,0,0,0,0,1,0,25,26,0,0,0,0,0,0,0,0,9,3,22,34,25,4,3,32
119545.0,Dominguez Martinez Camil Inmaculada,S,Dominican Republic,30.0,176,2021,USA,2021-05-25,False,0,0,0,0,0,0,0,0,0,0,0,0,0,0,0,0,0,0,0,0,1,1,0,2
119545.0,Dominguez Martinez Camil Inmaculada,S,Dominican Republic,30.0,176,2021,Canada,2021-05-27,True,0,0,0,0,0,0,0,0,0,0,0,0,0,0,0,0,0,0,0,0,0,0,0,0
119545.0,Dominguez Martinez Camil Inmaculada,S,Dominican Republic,30.0,176,2021,Belgium,2021-05-31,False,0,0,0,0,0,0,0,0,0,0,0,0,0,0,0,0,0,0,0,0,1,0,0,1
119545.0,Dominguez Martinez Camil Inmaculada,S,Dominican Republic,30.0,176,2021,Poland,2021-06-02,True,0,0,0,0,0,0,0,0,0,0,0,0,0,0,0,0,0,0,0,0,0,0,0,0
119545.0,Dominguez Martinez Camil Inmaculada,S,Dominican Republic,30.0,176,2021,Russia,2021-06-06,False,0,0,2,2,0,0,5,5,0,0,0,0,0,0,0,0,0,0,0,0,0,0,0,0
119545.0,Dominguez Martinez Camil Inmaculada,S,Dominican Republic,30.0,176,2021,Thailand,2021-06-08,True,0,0,0,0,0,0,11,11,0,0,0,0,0,0,0,0,0,0,0,0,0,0,0,0
119545.0,Dominguez Martinez Camil Inmaculada,S,Dominican Republic,30.0,176,2021,Italy,2021-06-12,True,0,0,6,6,3,1,35,39,0,0,0,0,0,1,0,1,0,0,0,0,3,1,0,4
119545.0,Dominguez Martinez Camil Inmaculada,S,Dominican Republic,30.0,176,2021,China,2021-06-13,False,1,1,7,9,13,1,77,91,1,1,1,3,0,0,2,2,0,0,0,0,3,3,0,6
119545.0,Dominguez Martinez Camil Inmaculada,S,Dominican Republic,30.0,176,2021,Netherlands,2021-06-14,True,0,0,10,10,3,1,56,60,0,0,0,0,0,3,2,5,0,0,0,0,5,1,3,9
119545.0,Dominguez Martinez Camil Inmaculada,S,Dominican Republic,30.0,176,2021,Japan,2021-06-18,False,0,0,2,2,0,0,6,6,0,0,0,0,0,1,0,1,0,0,0,0,3,0,0,3
119545.0,Dominguez Martinez Camil Inmaculada,S,Dominican Republic,30.0,176,2021,Serbia,2021-06-19,True,0,0,0,0,1,0,6,7,0,0,0,0,0,0,0,0,0,0,0,0,0,0,0,0
119545.0,Dominguez Martinez Camil Inmaculada,S,Dominican Republic,30.0,176,2021,Germany,2021-06-20,True,0,0,0,0,1,0,15,16,0,0,0,0,0,0,2,2,0,0,0,0,2,0,0,2
119585.0,Marte Frica Niverka Dharlenis,S,Dominican Republic,31.0,178,2021,USA,2021-05-25,False,0,0,10,10,0,0,0,0,0,1,1,2,0,1,0,1,0,0,0,0,3,4,0,7
119585.0,Marte Frica Niverka Dharlenis,S,Dominican Republic,31.0,178,2021,Brazil,2021-05-26,False,0,0,9,9,2,0,82,84,1,0,0,1,0,0,1,1,0,0,0,0,2,0,0,2
119585.0,Marte Frica Niverka Dharlenis,S,Dominican Republic,31.0,178,2021,Canada,2021-05-27,True,3,3,11,17,12,1,116,129,0,0,2,2,0,3,0,3,0,0,0,0,9,5,0,14
119585.0,Marte Frica Niverka Dharlenis,S,Dominican Republic,31.0,178,2021,Belgium,2021-05-31,False,0,1,14,15,15,2,1,18,0,0,4,4,0,2,2,4,0,0,0,0,6,3,1,10
119585.0,Marte Frica Niverka Dharlenis,S,Dominican Republic,31.0,178,2021,Poland,2021-06-02,True,0,2,14,16,13,1,97,111,1,0,4,5,0,3,0,3,0,0,0,0,12,3,1,16
119585.0,Marte Frica Niverka Dharlenis,S,Dominican Republic,31.0,178,2021,Russia,2021-06-06,False,1,0,10,11,47,2,93,142,1,0,2,3,0,2,9,11,0,0,0,0,3,3,0,6
119585.0,Marte Frica Niverka Dharlenis,S,Dominican Republic,31.0,178,2021,Thailand,2021-06-08,True,1,1,10,12,21,4,75,100,0,0,2,2,1,1,3,5,0,0,0,0,4,1,0,5
119585.0,Marte Frica Niverka Dharlenis,S,Dominican Republic,31.0,178,2021,Italy,2021-06-12,True,0,1,8,9,8,2,84,94,2,0,5,7,1,0,1,2,0,0,0,0,4,1,0,5
119585.0,Marte Frica Niverka Dharlenis,S,Dominican Republic,31.0,178,2021,China,2021-06-13,False,0,0,0,0,0,0,0,0,0,0,0,0,0,0,0,0,0,0,0,0,0,0,0,0
119585.0,Marte Frica Niverka Dharlenis,S,Dominican Republic,31.0,178,2021,Netherlands,2021-06-14,True,0,1,4,5,11,0,42,53,0,1,1,2,0,0,2,2,0,0,0,0,8,2,4,14
119585.0,Marte Frica Niverka Dharlenis,S,Dominican Republic,31.0,178,2021,Japan,2021-06-18,False,0,0,13,13,20,0,102,122,0,0,0,0,0,6,2,8,0,0,0,0,15,2,1,18
119585.0,Marte Frica Niverka Dharlenis,S,Dominican Republic,31.0,178,2021,Serbia,2021-06-19,True,0,0,6,6,14,0,46,60,2,0,1,3,0,2,4,6,0,0,0,0,2,0,1,3
119585.0,Marte Frica Niverka Dharlenis,S,Dominican Republic,31.0,178,2021,Germany,2021-06-20,True,0,1,14,15,10,0,88,98,1,1,1,3,0,1,2,3,0,0,0,0,14,6,1,21
115386.0,Rodriguez Marifranchi,MB,Dominican Republic,31.0,190,2021,USA,2021-05-25,False,0,0,0,0,0,0,0,0,0,0,0,0,0,0,0,0,0,0,0,0,0,0,0,0
115386.0,Rodriguez Marifranchi,MB,Dominican Republic,31.0,190,2021,Brazil,2021-05-26,False,0,0,0,0,0,0,0,0,0,0,0,0,0,0,0,0,0,0,0,0,0,0,0,0
115386.0,Rodriguez Marifranchi,MB,Dominican Republic,31.0,190,2021,Canada,2021-05-27,True,0,0,0,0,0,0,0,0,0,0,0,0,0,0,0,0,0,0,0,0,0,0,0,0
115386.0,Rodriguez Marifranchi,MB,Dominican Republic,31.0,190,2021,Belgium,2021-05-31,False,0,0,0,0,0,0,0,0,0,0,0,0,0,0,0,0,0,0,0,0,0,0,0,0
115386.0,Rodriguez Marifranchi,MB,Dominican Republic,31.0,190,2021,Poland,2021-06-02,True,0,0,0,0,0,0,0,0,0,0,1,1,0,0,0,0,0,0,0,0,0,0,0,0
115386.0,Rodriguez Marifranchi,MB,Dominican Republic,31.0,190,2021,Russia,2021-06-06,False,0,0,1,1,0,0,1,1,0,0,0,0,0,0,1,1,0,0,0,0,0,0,0,0
115386.0,Rodriguez Marifranchi,MB,Dominican Republic,31.0,190,2021,Thailand,2021-06-08,True,0,0,3,3,0,0,0,0,1,1,5,7,0,0,4,4,0,0,0,0,1,1,0,2
115386.0,Rodriguez Marifranchi,MB,Dominican Republic,31.0,190,2021,Italy,2021-06-12,True,0,0,0,0,0,0,0,0,0,0,0,0,0,0,0,0,0,0,0,0,0,0,0,0
115386.0,Rodriguez Marifranchi,MB,Dominican Republic,31.0,190,2021,China,2021-06-13,False,0,3,9,12,0,0,0,0,3,0,5,8,0,1,0,1,1,0,1,2,1,0,0,1
115386.0,Rodriguez Marifranchi,MB,Dominican Republic,31.0,190,2021,Netherlands,2021-06-14,True,0,0,0,0,0,0,0,0,0,0,0,0,0,0,0,0,0,0,0,0,0,0,0,0
115386.0,Rodriguez Marifranchi,MB,Dominican Republic,31.0,190,2021,Japan,2021-06-18,False,0,1,6,7,0,0,1,1,0,0,2,2,0,1,1,2,0,0,0,0,3,0,0,3
115386.0,Rodriguez Marifranchi,MB,Dominican Republic,31.0,190,2021,Serbia,2021-06-19,True,0,0,8,8,0,0,0,0,3,2,1,6,1,3,1,5,0,0,0,0,2,2,0,4
115386.0,Rodriguez Marifranchi,MB,Dominican Republic,31.0,190,2021,Germany,2021-06-20,True,0,0,0,0,0,0,0,0,0,0,0,0,0,0,0,0,0,0,0,0,0,0,0,0
139912.0,Perez Javier Yokaty,S,Dominican Republic,23.0,178,2021,Brazil,2021-05-26,False,0,0,0,0,0,0,0,0,0,0,0,0,0,0,0,0,0,0,0,0,0,0,0,0
139912.0,Perez Javier Yokaty,S,Dominican Republic,23.0,178,2021,Thailand,2021-06-08,True,0,0,0,0,0,0,0,0,0,0,0,0,0,0,0,0,0,0,0,0,0,0,0,0
139912.0,Perez Javier Yokaty,S,Dominican Republic,23.0,178,2021,China,2021-06-13,False,0,0,0,0,0,0,10,10,0,0,0,0,0,0,0,0,0,0,0,0,1,0,0,1
139912.0,Perez Javier Yokaty,S,Dominican Republic,23.0,178,2021,Japan,2021-06-18,False,0,0,0,0,0,0,0,0,0,0,0,0,0,0,0,0,0,0,0,0,0,0,0,0
139912.0,Perez Javier Yokaty,S,Dominican Republic,23.0,178,2021,Serbia,2021-06-19,True,0,0,0,0,0,0,0,0,0,0,0,0,0,0,0,0,0,0,0,0,0,0,0,0
139912.0,Perez Javier Yokaty,S,Dominican Republic,23.0,178,2021,Germany,2021-06-20,True,0,0,0,0,0,0,0,0,0,0,0,0,0,0,0,0,0,0,0,0,0,0,0,0
112468.0,Rivera Brens Prisilla,OH,Dominican Republic,37.0,184,2021,USA,2021-05-25,False,0,1,8,9,0,0,1,1,8,3,17,28,0,0,0,0,7,1,26,34,2,5,1,8
112468.0,Rivera Brens Prisilla,OH,Dominican Republic,37.0,184,2021,Brazil,2021-05-26,False,0,0,4,4,0,0,0,0,4,1,7,12,0,1,1,2,0,1,13,14,0,1,0,1
112468.0,Rivera Brens Prisilla,OH,Dominican Republic,37.0,184,2021,Canada,2021-05-27,True,3,3,15,21,0,0,0,0,18,3,12,33,0,3,0,3,5,1,16,22,5,1,0,6
112468.0,Rivera Brens Prisilla,OH,Dominican Republic,37.0,184,2021,Belgium,2021-05-31,False,1,4,8,13,0,0,0,0,16,7,15,38,1,3,3,7,0,3,15,18,5,3,1,9
112468.0,Rivera Brens Prisilla,OH,Dominican Republic,37.0,184,2021,Poland,2021-06-02,True,0,2,16,18,0,0,1,1,11,4,9,24,1,1,1,3,2,3,33,38,12,7,1,20
112468.0,Rivera Brens Prisilla,OH,Dominican Republic,37.0,184,2021,Russia,2021-06-06,False,0,1,7,8,0,0,3,3,6,2,20,28,2,3,3,8,4,0,22,26,5,1,1,7
112468.0,Rivera Brens Prisilla,OH,Dominican Republic,37.0,184,2021,Thailand,2021-06-08,True,0,1,10,11,0,0,0,0,10,3,13,26,1,3,2,6,2,0,8,10,6,4,0,10
112468.0,Rivera Brens Prisilla,OH,Dominican Republic,37.0,184,2021,Italy,2021-06-12,True,2,2,10,14,0,0,1,1,9,3,10,22,1,1,0,2,7,0,18,25,2,3,0,5
112468.0,Rivera Brens Prisilla,OH,Dominican Republic,37.0,184,2021,China,2021-06-13,False,2,3,8,13,0,0,1,1,17,6,11,34,1,2,1,4,4,2,17,23,9,1,4,14
112468.0,Rivera Brens Prisilla,OH,Dominican Republic,37.0,184,2021,Netherlands,2021-06-14,True,1,0,13,14,0,0,1,1,3,1,10,14,1,1,1,3,1,0,12,13,4,1,1,6
112468.0,Rivera Brens Prisilla,OH,Dominican Republic,37.0,184,2021,Japan,2021-06-18,False,0,1,12,13,0,0,3,3,12,3,14,29,1,6,3,10,2,2,26,30,12,1,1,14
112468.0,Rivera Brens Prisilla,OH,Dominican Republic,37.0,184,2021,Serbia,2021-06-19,True,0,0,17,17,0,0,2,2,11,1,5,17,1,1,0,2,0,0,8,8,7,2,1,10
112468.0,Rivera Brens Prisilla,OH,Dominican Republic,37.0,184,2021,Germany,2021-06-20,True,2,1,17,20,0,0,2,2,11,5,17,33,0,1,2,3,2,1,19,22,12,6,3,21
123978.0,Peña Isabel Yonkaira Paola,OH,Dominican Republic,28.0,190,2021,USA,2021-05-25,False,0,0,2,2,0,0,0,0,1,2,7,10,0,0,0,0,2,0,1,3,1,0,0,1
123978.0,Peña Isabel Yonkaira Paola,OH,Dominican Republic,28.0,190,2021,Brazil,2021-05-26,False,0,1,3,4,0,0,0,0,5,3,3,11,0,0,1,1,3,0,7,10,2,0,0,2
123978.0,Peña Isabel Yonkaira Paola,OH,Dominican Republic,28.0,190,2021,Canada,2021-05-27,True,0,0,1,1,0,0,0,0,0,0,0,0,0,0,0,0,0,0,1,1,1,0,0,1
123978.0,Peña Isabel Yonkaira Paola,OH,Dominican Republic,28.0,190,2021,Belgium,2021-05-31,False,0,0,0,0,0,0,0,0,0,0,2,2,0,0,0,0,1,1,5,7,1,1,0,2
123978.0,Peña Isabel Yonkaira Paola,OH,Dominican Republic,28.0,190,2021,Poland,2021-06-02,True,0,0,6,6,0,0,2,2,0,0,1,1,0,0,0,0,2,0,6,8,1,0,2,3
123978.0,Peña Isabel Yonkaira Paola,OH,Dominican Republic,28.0,190,2021,Russia,2021-06-06,False,0,0,10,10,0,0,0,0,9,2,13,24,3,0,1,4,6,0,14,20,13,2,2,17
123978.0,Peña Isabel Yonkaira Paola,OH,Dominican Republic,28.0,190,2021,Thailand,2021-06-08,True,2,1,15,18,0,0,0,0,16,1,18,35,0,2,4,6,12,1,12,25,12,2,0,14
123978.0,Peña Isabel Yonkaira Paola,OH,Dominican Republic,28.0,190,2021,Italy,2021-06-12,True,0,2,7,9,0,0,0,0,9,2,14,25,0,2,0,2,2,0,12,14,5,1,0,6
123978.0,Peña Isabel Yonkaira Paola,OH,Dominican Republic,28.0,190,2021,China,2021-06-13,False,0,2,16,18,0,0,0,0,16,7,15,38,1,0,1,2,9,1,33,43,10,3,1,14
123978.0,Peña Isabel Yonkaira Paola,OH,Dominican Republic,28.0,190,2021,Netherlands,2021-06-14,True,0,0,10,10,0,0,1,1,7,3,8,18,1,0,0,1,1,0,6,7,12,1,0,13
123978.0,Peña Isabel Yonkaira Paola,OH,Dominican Republic,28.0,190,2021,Japan,2021-06-18,False,0,1,2,3,0,0,1,1,2,0,3,5,0,0,0,0,1,0,12,13,2,1,1,4
123978.0,Peña Isabel Yonkaira Paola,OH,Dominican Republic,28.0,190,2021,Serbia,2021-06-19,True,0,0,8,8,0,0,3,3,11,7,6,24,1,0,0,1,12,0,9,21,3,2,2,7
123978.0,Peña Isabel Yonkaira Paola,OH,Dominican Republic,28.0,190,2021,Germany,2021-06-20,True,0,1,14,15,0,0,2,2,8,7,11,26,0,2,3,5,4,4,10,18,5,2,1,8
115391.0,Mambru Casilla Gina Altagracia,O,Dominican Republic,36.0,182,2021,USA,2021-05-25,False,0,0,2,2,0,0,0,0,2,2,0,4,0,1,0,1,0,0,0,0,0,0,0,0
115391.0,Mambru Casilla Gina Altagracia,O,Dominican Republic,36.0,182,2021,Brazil,2021-05-26,False,0,0,2,2,0,0,0,0,2,0,0,2,0,0,0,0,0,0,0,0,0,0,0,0
115391.0,Mambru Casilla Gina Altagracia,O,Dominican Republic,36.0,182,2021,Canada,2021-05-27,True,0,0,0,0,0,0,0,0,0,0,0,0,0,0,0,0,0,0,0,0,0,0,0,0
115391.0,Mambru Casilla Gina Altagracia,O,Dominican Republic,36.0,182,2021,Belgium,2021-05-31,False,0,0,0,0,0,0,0,0,0,0,0,0,0,0,0,0,0,0,0,0,0,0,0,0
115391.0,Mambru Casilla Gina Altagracia,O,Dominican Republic,36.0,182,2021,Poland,2021-06-02,True,0,0,2,2,0,0,0,0,0,0,0,0,0,0,0,0,0,0,0,0,0,0,0,0
115391.0,Mambru Casilla Gina Altagracia,O,Dominican Republic,36.0,182,2021,Russia,2021-06-06,False,0,0,1,1,0,0,0,0,0,1,0,1,0,0,1,1,0,0,0,0,1,0,0,1
115391.0,Mambru Casilla Gina Altagracia,O,Dominican Republic,36.0,182,2021,Thailand,2021-06-08,True,0,0,3,3,0,0,0,0,2,2,4,8,1,0,1,2,0,0,0,0,0,1,0,1
115391.0,Mambru Casilla Gina Altagracia,O,Dominican Republic,36.0,182,2021,Italy,2021-06-12,True,1,0,1,2,0,0,0,0,0,0,0,0,0,1,0,1,0,0,0,0,0,0,0,0
115391.0,Mambru Casilla Gina Altagracia,O,Dominican Republic,36.0,182,2021,China,2021-06-13,False,0,0,13,13,0,0,3,3,10,5,12,27,0,4,0,4,0,0,0,0,7,2,1,10
115391.0,Mambru Casilla Gina Altagracia,O,Dominican Republic,36.0,182,2021,Netherlands,2021-06-14,True,0,0,1,1,0,0,0,0,0,0,0,0,0,0,0,0,0,0,0,0,0,0,0,0
115391.0,Mambru Casilla Gina Altagracia,O,Dominican Republic,36.0,182,2021,Japan,2021-06-18,False,0,0,0,0,0,0,0,0,0,0,0,0,0,0,0,0,0,0,0,0,0,0,0,0
115391.0,Mambru Casilla Gina Altagracia,O,Dominican Republic,36.0,182,2021,Serbia,2021-06-19,True,0,0,2,2,0,0,0,0,2,1,1,4,0,0,0,0,0,0,0,0,0,0,0,0
115391.0,Mambru Casilla Gina Altagracia,O,Dominican Republic,36.0,182,2021,Germany,2021-06-20,True,0,0,0,0,0,0,0,0,0,0,0,0,0,0,0,0,0,0,0,0,0,0,0,0
114294.0,De La Cruz De Peña Bethania,OH,Dominican Republic,34.0,188,2021,USA,2021-05-25,False,1,2,4,7,0,0,0,0,9,1,14,24,0,1,0,1,2,0,4,6,1,2,0,3
114294.0,De La Cruz De Peña Bethania,OH,Dominican Republic,34.0,188,2021,Brazil,2021-05-26,False,0,1,8,9,0,0,3,3,5,7,14,26,0,1,0,1,2,1,14,17,1,0,0,1
114294.0,De La Cruz De Peña Bethania,OH,Dominican Republic,34.0,188,2021,Canada,2021-05-27,True,2,1,13,16,0,0,2,2,17,8,25,50,0,0,0,0,3,0,11,14,14,4,0,18
114294.0,De La Cruz De Peña Bethania,OH,Dominican Republic,34.0,188,2021,Belgium,2021-05-31,False,1,2,13,16,0,0,0,0,16,3,23,42,0,3,3,6,5,1,20,26,9,4,2,15
114294.0,De La Cruz De Peña Bethania,OH,Dominican Republic,34.0,188,2021,Poland,2021-06-02,True,3,1,16,20,0,0,3,3,21,9,24,54,2,3,2,7,4,1,20,25,11,3,0,14
114294.0,De La Cruz De Peña Bethania,OH,Dominican Republic,34.0,188,2021,Russia,2021-06-06,False,1,3,17,21,0,0,1,1,8,5,20,33,0,1,3,4,2,0,16,18,14,4,2,20
114294.0,De La Cruz De Peña Bethania,OH,Dominican Republic,34.0,188,2021,Thailand,2021-06-08,True,0,0,0,0,0,0,0,0,0,0,0,0,0,0,0,0,0,0,0,0,0,0,0,0
114294.0,De La Cruz De Peña Bethania,OH,Dominican Republic,34.0,188,2021,Italy,2021-06-12,True,3,2,14,19,0,0,0,0,15,5,26,46,1,1,0,2,1,0,2,3,10,2,1,13
114294.0,De La Cruz De Peña Bethania,OH,Dominican Republic,34.0,188,2021,China,2021-06-13,False,0,1,1,2,0,0,0,0,2,0,2,4,0,0,0,0,0,0,0,0,2,0,0,2
114294.0,De La Cruz De Peña Bethania,OH,Dominican Republic,34.0,188,2021,Netherlands,2021-06-14,True,0,2,12,14,0,0,4,4,12,4,15,31,1,0,3,4,4,1,19,24,9,6,2,17
114294.0,De La Cruz De Peña Bethania,OH,Dominican Republic,34.0,188,2021,Japan,2021-06-18,False,0,1,16,17,0,0,6,6,26,2,22,50,0,2,2,4,3,2,29,34,18,3,1,22
114294.0,De La Cruz De Peña Bethania,OH,Dominican Republic,34.0,188,2021,Serbia,2021-06-19,True,0,0,0,0,0,0,0,0,0,0,0,0,0,0,0,0,0,0,0,0,0,0,0,0
114294.0,De La Cruz De Peña Bethania,OH,Dominican Republic,34.0,188,2021,Germany,2021-06-20,True,0,2,14,16,0,0,4,4,20,4,17,41,2,2,1,5,2,2,10,14,15,3,0,18
123982.0,Martinez Brayelin Elizabeth,OH,Dominican Republic,25.0,201,2021,USA,2021-05-25,False,0,0,0,0,0,0,0,0,0,0,0,0,0,0,0,0,0,0,0,0,0,0,0,0
123982.0,Martinez Brayelin Elizabeth,OH,Dominican Republic,25.0,201,2021,Brazil,2021-05-26,False,0,0,0,0,0,0,0,0,0,0,0,0,0,0,0,0,0,0,0,0,0,0,0,0
123982.0,Martinez Brayelin Elizabeth,OH,Dominican Republic,25.0,201,2021,Canada,2021-05-27,True,0,0,0,0,0,0,0,0,0,0,0,0,0,0,0,0,0,0,0,0,0,0,0,0
123982.0,Martinez Brayelin Elizabeth,OH,Dominican Republic,25.0,201,2021,Belgium,2021-05-31,False,0,0,1,1,0,0,0,0,3,1,5,9,0,0,0,0,0,0,3,3,2,0,0,2
123982.0,Martinez Brayelin Elizabeth,OH,Dominican Republic,25.0,201,2021,Poland,2021-06-02,True,2,2,8,12,0,0,7,7,18,5,23,46,1,0,4,5,0,0,1,1,7,2,1,10
123982.0,Martinez Brayelin Elizabeth,OH,Dominican Republic,25.0,201,2021,Russia,2021-06-06,False,1,1,13,15,0,0,1,1,22,6,19,47,0,5,1,6,1,0,0,1,16,5,5,26
123982.0,Martinez Brayelin Elizabeth,OH,Dominican Republic,25.0,201,2021,Thailand,2021-06-08,True,0,1,6,7,0,0,0,0,9,1,13,23,3,0,0,3,0,0,0,0,6,1,2,9
123982.0,Martinez Brayelin Elizabeth,OH,Dominican Republic,25.0,201,2021,Italy,2021-06-12,True,0,0,6,6,0,1,0,1,8,2,15,25,1,0,0,1,1,1,2,4,3,1,0,4
123982.0,Martinez Brayelin Elizabeth,OH,Dominican Republic,25.0,201,2021,China,2021-06-13,False,0,0,0,0,0,0,0,0,0,1,1,2,0,0,0,0,0,0,0,0,0,0,0,0
123982.0,Martinez Brayelin Elizabeth,OH,Dominican Republic,25.0,201,2021,Netherlands,2021-06-14,True,0,4,11,15,0,0,1,1,18,5,28,51,0,6,5,11,1,1,2,4,13,3,3,19
123982.0,Martinez Brayelin Elizabeth,OH,Dominican Republic,25.0,201,2021,Japan,2021-06-18,False,0,1,10,11,0,0,1,1,29,7,32,68,2,6,6,14,0,0,4,4,18,3,3,24
123982.0,Martinez Brayelin Elizabeth,OH,Dominican Republic,25.0,201,2021,Serbia,2021-06-19,True,0,0,0,0,0,0,0,0,0,0,0,0,0,0,0,0,0,0,0,0,0,0,0,0
123982.0,Martinez Brayelin Elizabeth,OH,Dominican Republic,25.0,201,2021,Germany,2021-06-20,True,0,0,0,0,0,0,1,1,0,0,2,2,0,1,1,2,0,0,0,0,0,0,0,0
139910.0,Martinez Jineiry,MB,Dominican Republic,24.0,192,2021,USA,2021-05-25,False,0,0,6,6,0,0,0,0,3,0,6,9,1,0,0,1,0,0,2,2,1,1,0,2
139910.0,Martinez Jineiry,MB,Dominican Republic,24.0,192,2021,Brazil,2021-05-26,False,0,1,9,10,0,0,1,1,4,0,5,9,2,3,0,5,0,0,0,0,2,0,0,2
139910.0,Martinez Jineiry,MB,Dominican Republic,24.0,192,2021,Canada,2021-05-27,True,0,1,14,15,0,0,2,2,8,2,10,20,3,5,1,9,0,0,0,0,8,2,0,10
139910.0,Martinez Jineiry,MB,Dominican Republic,24.0,192,2021,Belgium,2021-05-31,False,0,3,14,17,0,0,0,0,11,3,8,22,4,6,11,21,0,0,1,1,5,0,1,6
139910.0,Martinez Jineiry,MB,Dominican Republic,24.0,192,2021,Poland,2021-06-02,True,1,2,14,17,0,0,3,3,5,2,3,10,2,6,11,19,0,0,0,0,3,2,0,5
139910.0,Martinez Jineiry,MB,Dominican Republic,24.0,192,2021,Russia,2021-06-06,False,0,0,19,19,0,0,3,3,8,4,7,19,1,11,11,23,0,0,0,0,2,2,1,5
139910.0,Martinez Jineiry,MB,Dominican Republic,24.0,192,2021,Thailand,2021-06-08,True,0,0,5,5,0,0,1,1,5,0,3,8,0,1,0,1,0,0,0,0,1,0,0,1
139910.0,Martinez Jineiry,MB,Dominican Republic,24.0,192,2021,Italy,2021-06-12,True,2,1,14,17,0,0,0,0,5,1,8,14,3,4,0,7,0,0,1,1,1,1,0,2
139910.0,Martinez Jineiry,MB,Dominican Republic,24.0,192,2021,China,2021-06-13,False,0,2,9,11,0,0,2,2,12,2,8,22,1,3,3,7,0,0,0,0,6,2,0,8
139910.0,Martinez Jineiry,MB,Dominican Republic,24.0,192,2021,Netherlands,2021-06-14,True,1,2,14,17,0,0,1,1,11,1,8,20,3,12,12,27,0,0,0,0,1,0,0,1
139910.0,Martinez Jineiry,MB,Dominican Republic,24.0,192,2021,Japan,2021-06-18,False,1,4,12,17,0,0,5,5,5,1,8,14,3,3,6,12,0,0,0,0,7,0,0,7
139910.0,Martinez Jineiry,MB,Dominican Republic,24.0,192,2021,Serbia,2021-06-19,True,0,0,15,15,0,0,2,2,8,0,2,10,2,7,6,15,0,0,1,1,6,1,0,7
139910.0,Martinez Jineiry,MB,Dominican Republic,24.0,192,2021,Germany,2021-06-20,True,0,1,13,14,0,0,1,1,7,1,9,17,2,4,8,14,0,0,0,0,3,0,0,3
139927.0,Gonzalez Lopez Gaila Ceneida,O,Dominican Republic,24.0,190,2021,USA,2021-05-25,False,0,1,7,8,0,0,0,0,9,4,12,25,1,4,1,6,0,0,0,0,1,2,0,3
139927.0,Gonzalez Lopez Gaila Ceneida,O,Dominican Republic,24.0,190,2021,Brazil,2021-05-26,False,1,0,5,6,0,0,0,0,5,4,12,21,0,4,0,4,0,0,0,0,5,1,0,6
139927.0,Gonzalez Lopez Gaila Ceneida,O,Dominican Republic,24.0,190,2021,Canada,2021-05-27,True,4,2,15,21,0,0,1,1,6,5,20,31,0,3,1,4,0,0,0,0,10,2,0,12
139927.0,Gonzalez Lopez Gaila Ceneida,O,Dominican Republic,24.0,190,2021,Belgium,2021-05-31,False,1,4,17,22,0,0,0,0,25,3,20,48,2,4,1,7,0,0,0,0,14,4,0,18
139927.0,Gonzalez Lopez Gaila Ceneida,O,Dominican Republic,24.0,190,2021,Poland,2021-06-02,True,0,0,0,0,0,0,0,0,0,0,0,0,0,0,0,0,0,0,0,0,0,0,0,0
139927.0,Gonzalez Lopez Gaila Ceneida,O,Dominican Republic,24.0,190,2021,Italy,2021-06-12,True,0,0,0,0,0,0,0,0,0,0,0,0,0,0,0,0,0,0,0,0,0,0,0,0
139927.0,Gonzalez Lopez Gaila Ceneida,O,Dominican Republic,24.0,190,2021,Netherlands,2021-06-14,True,0,1,0,1,0,0,0,0,3,1,2,6,0,1,1,2,0,0,0,0,1,0,0,1
139927.0,Gonzalez Lopez Gaila Ceneida,O,Dominican Republic,24.0,190,2021,Japan,2021-06-18,False,0,0,1,1,0,0,3,3,2,2,6,10,0,2,2,4,0,0,0,0,1,1,0,2
139927.0,Gonzalez Lopez Gaila Ceneida,O,Dominican Republic,24.0,190,2021,Serbia,2021-06-19,True,4,1,12,17,0,0,0,0,8,4,8,20,0,0,1,1,0,0,0,0,7,2,1,10
139927.0,Gonzalez Lopez Gaila Ceneida,O,Dominican Republic,24.0,190,2021,Germany,2021-06-20,True,1,3,7,11,0,0,1,1,7,1,10,18,0,0,0,0,0,0,1,1,4,0,1,5
139913.0,Martinez Caro Larysmer,L,Dominican Republic,25.0,174,2021,USA,2021-05-25,False,0,0,0,0,0,0,0,0,0,0,0,0,0,0,0,0,0,0,0,0,0,0,0,0
139913.0,Martinez Caro Larysmer,L,Dominican Republic,25.0,174,2021,Brazil,2021-05-26,False,0,0,0,0,0,0,0,0,0,0,0,0,0,0,0,0,0,0,0,0,0,0,0,0
139913.0,Martinez Caro Larysmer,L,Dominican Republic,25.0,174,2021,Canada,2021-05-27,True,0,0,0,0,0,0,0,0,0,0,0,0,0,0,0,0,0,0,0,0,0,0,0,0
139913.0,Martinez Caro Larysmer,L,Dominican Republic,25.0,174,2021,Belgium,2021-05-31,False,0,0,0,0,0,0,0,0,0,0,0,0,0,0,0,0,0,0,0,0,0,0,0,0
139913.0,Martinez Caro Larysmer,L,Dominican Republic,25.0,174,2021,Poland,2021-06-02,True,0,0,0,0,0,0,0,0,0,0,0,0,0,0,0,0,0,0,0,0,0,0,0,0
139913.0,Martinez Caro Larysmer,L,Dominican Republic,25.0,174,2021,Russia,2021-06-06,False,0,0,3,3,0,0,0,0,0,0,0,0,0,0,0,0,1,0,7,8,0,0,1,1
139913.0,Martinez Caro Larysmer,L,Dominican Republic,25.0,174,2021,Thailand,2021-06-08,True,0,0,0,0,0,0,0,0,0,0,0,0,0,0,0,0,0,0,0,0,0,0,0,0
139913.0,Martinez Caro Larysmer,L,Dominican Republic,25.0,174,2021,Italy,2021-06-12,True,0,0,0,0,0,0,0,0,0,0,0,0,0,0,0,0,0,0,0,0,0,0,0,0
139913.0,Martinez Caro Larysmer,L,Dominican Republic,25.0,174,2021,China,2021-06-13,False,0,0,0,0,0,0,0,0,0,0,0,0,0,0,0,0,0,0,0,0,0,0,0,0
139913.0,Martinez Caro Larysmer,L,Dominican Republic,25.0,174,2021,Netherlands,2021-06-14,True,0,0,0,0,0,0,0,0,0,0,0,0,0,0,0,0,0,0,0,0,0,0,0,0
139913.0,Martinez Caro Larysmer,L,Dominican Republic,25.0,174,2021,Japan,2021-06-18,False,0,0,0,0,0,0,0,0,0,0,0,0,0,0,0,0,0,0,0,0,0,0,0,0
139913.0,Martinez Caro Larysmer,L,Dominican Republic,25.0,174,2021,Serbia,2021-06-19,True,0,0,0,0,0,0,0,0,0,0,0,0,0,0,0,0,0,0,0,0,0,0,0,0
139913.0,Martinez Caro Larysmer,L,Dominican Republic,25.0,174,2021,Germany,2021-06-20,True,0,0,0,0,0,0,0,0,0,0,0,0,0,0,0,0,0,0,0,0,0,0,0,0
152140.0,Bock Linda,L,Germany,21.0,172,2021,Russia,2021-05-25,False,0,0,0,0,0,0,0,0,0,0,0,0,0,0,0,0,1,0,0,1,0,0,0,0
152140.0,Bock Linda,L,Germany,21.0,172,2021,Netherlands,2021-05-26,True,0,0,0,0,0,0,0,0,0,0,0,0,0,0,0,0,0,0,0,0,0,0,0,0
152140.0,Bock Linda,L,Germany,21.0,172,2021,Belgium,2021-05-27,True,0,0,0,0,0,0,0,0,0,0,0,0,0,0,0,0,0,0,0,0,0,0,1,1
152140.0,Bock Linda,L,Germany,21.0,172,2021,China,2021-05-31,False,0,0,0,0,0,0,0,0,0,0,0,0,0,0,0,0,0,0,0,0,0,0,0,0
152140.0,Bock Linda,L,Germany,21.0,172,2021,Canada,2021-06-02,False,0,0,0,0,0,0,0,0,0,0,0,0,0,0,0,0,0,0,0,0,0,0,0,0
152140.0,Bock Linda,L,Germany,21.0,172,2021,USA,2021-06-06,False,0,0,0,0,0,0,0,0,0,0,0,0,0,0,0,0,0,0,0,0,0,0,0,0
152140.0,Bock Linda,L,Germany,21.0,172,2021,Italy,2021-06-07,False,0,0,0,0,0,0,0,0,0,0,0,0,0,0,0,0,5,0,3,8,3,1,0,4
152140.0,Bock Linda,L,Germany,21.0,172,2021,Thailand,2021-06-12,False,0,0,0,0,0,0,0,0,0,0,0,0,0,0,0,0,0,0,0,0,0,0,0,0
152140.0,Bock Linda,L,Germany,21.0,172,2021,Brazil,2021-06-13,False,0,0,1,1,0,0,0,0,0,0,0,0,0,0,0,0,0,0,0,0,0,0,0,0
152140.0,Bock Linda,L,Germany,21.0,172,2021,Poland,2021-06-14,True,0,0,0,0,0,0,0,0,0,0,0,0,0,0,0,0,1,0,1,2,0,0,0,0
152140.0,Bock Linda,L,Germany,21.0,172,2021,Serbia,2021-06-18,True,1,0,1,2,0,0,0,0,0,0,0,0,0,0,0,0,0,0,0,0,0,1,0,1
152140.0,Bock Linda,L,Germany,21.0,172,2021,Japan,2021-06-19,False,0,1,0,1,0,0,0,0,0,0,0,0,0,0,0,0,3,0,1,4,0,0,0,0
152140.0,Bock Linda,L,Germany,21.0,172,2021,Dominican Republic,2021-06-20,False,0,1,5,6,0,0,1,1,0,0,0,0,0,0,0,0,0,0,0,0,0,0,1,1
150973.0,Kästner Pia,S,Germany,23.0,182,2021,Russia,2021-05-25,False,1,0,2,3,2,1,15,18,0,0,0,0,0,0,1,1,0,0,0,0,1,0,0,1
150973.0,Kästner Pia,S,Germany,23.0,182,2021,Netherlands,2021-05-26,True,0,0,5,5,11,0,41,52,0,1,2,3,0,0,1,1,0,0,0,0,2,0,0,2
150973.0,Kästner Pia,S,Germany,23.0,182,2021,Belgium,2021-05-27,True,2,0,1,3,0,0,9,9,0,0,0,0,0,1,0,1,0,0,0,0,0,0,0,0
150973.0,Kästner Pia,S,Germany,23.0,182,2021,China,2021-05-31,False,0,0,4,4,4,0,0,4,0,0,0,0,0,0,0,0,0,0,0,0,0,2,0,2
150973.0,Kästner Pia,S,Germany,23.0,182,2021,Canada,2021-06-02,False,1,0,9,10,3,1,41,45,0,0,0,0,0,0,0,0,0,1,0,1,2,1,0,3
150973.0,Kästner Pia,S,Germany,23.0,182,2021,USA,2021-06-06,False,0,0,6,6,1,2,24,27,2,0,0,2,0,0,0,0,0,0,1,1,1,0,0,1
150973.0,Kästner Pia,S,Germany,23.0,182,2021,Italy,2021-06-07,False,0,0,9,9,16,0,39,55,1,0,0,1,2,1,1,4,0,0,0,0,6,2,1,9
150973.0,Kästner Pia,S,Germany,23.0,182,2021,Thailand,2021-06-12,False,0,1,5,6,6,0,39,45,1,0,0,1,2,1,0,3,0,0,0,0,4,0,1,5
150973.0,Kästner Pia,S,Germany,23.0,182,2021,Brazil,2021-06-13,False,0,0,8,8,0,0,8,8,0,0,0,0,0,0,0,0,0,0,0,0,2,0,0,2
150973.0,Kästner Pia,S,Germany,23.0,182,2021,Poland,2021-06-14,True,0,0,2,2,0,0,1,1,1,0,0,1,0,0,0,0,0,0,0,0,0,0,0,0
150973.0,Kästner Pia,S,Germany,23.0,182,2021,Serbia,2021-06-18,True,0,0,3,3,5,0,24,29,1,0,0,1,0,1,0,1,0,0,0,0,2,2,0,4
150973.0,Kästner Pia,S,Germany,23.0,182,2021,Japan,2021-06-19,False,0,0,1,1,3,0,9,12,0,0,1,1,0,2,1,3,0,0,0,0,1,0,0,1
150973.0,Kästner Pia,S,Germany,23.0,182,2021,Dominican Republic,2021-06-20,False,0,0,2,2,2,0,11,13,0,0,0,0,0,0,0,0,0,0,0,0,0,0,0,0
136668.0,Imoudu Denise,S,Germany,26.0,180,2021,Russia,2021-05-25,False,1,0,5,6,15,3,58,76,1,0,0,1,0,1,2,3,0,0,0,0,11,0,0,11
136668.0,Imoudu Denise,S,Germany,26.0,180,2021,Netherlands,2021-05-26,True,0,2,8,10,23,1,58,82,4,0,2,6,0,0,0,0,0,0,0,0,3,3,0,6
136668.0,Imoudu Denise,S,Germany,26.0,180,2021,Belgium,2021-05-27,True,0,1,7,8,7,1,63,71,2,1,1,4,0,0,0,0,0,0,0,0,4,0,0,4
136668.0,Imoudu Denise,S,Germany,26.0,180,2021,China,2021-05-31,False,0,2,13,15,10,1,0,11,3,0,3,6,0,2,2,4,0,0,0,0,8,2,0,10
136668.0,Imoudu Denise,S,Germany,26.0,180,2021,Canada,2021-06-02,False,0,0,2,2,3,2,37,42,1,0,2,3,1,0,0,1,0,0,0,0,2,2,1,5
136668.0,Imoudu Denise,S,Germany,26.0,180,2021,USA,2021-06-06,False,0,0,4,4,1,1,31,33,0,0,1,1,0,1,1,2,0,0,0,0,1,1,0,2
136668.0,Imoudu Denise,S,Germany,26.0,180,2021,Italy,2021-06-07,False,0,1,1,2,9,0,15,24,0,0,0,0,0,0,0,0,0,0,0,0,0,0,0,0
136668.0,Imoudu Denise,S,Germany,26.0,180,2021,Thailand,2021-06-12,False,1,2,5,8,14,0,57,71,0,0,1,1,0,1,2,3,0,0,0,0,3,3,2,8
136668.0,Imoudu Denise,S,Germany,26.0,180,2021,Brazil,2021-06-13,False,0,3,9,12,27,2,72,101,3,0,3,6,2,4,1,7,0,0,0,0,8,1,1,10
136668.0,Imoudu Denise,S,Germany,26.0,180,2021,Poland,2021-06-14,True,0,2,9,11,16,0,69,85,2,0,1,3,0,1,1,2,0,0,0,0,7,2,3,12
136668.0,Imoudu Denise,S,Germany,26.0,180,2021,Serbia,2021-06-18,True,0,0,7,7,13,0,43,56,1,0,0,1,1,0,0,1,0,0,0,0,2,1,0,3
136668.0,Imoudu Denise,S,Germany,26.0,180,2021,Japan,2021-06-19,False,0,2,9,11,39,0,66,105,2,1,0,3,2,4,5,11,0,0,0,0,11,1,1,13
136668.0,Imoudu Denise,S,Germany,26.0,180,2021,Dominican Republic,2021-06-20,False,1,2,10,13,22,1,88,111,2,0,4,6,2,5,3,10,0,1,0,1,16,4,2,22
141676.0,Poll Jana Franziska,OH,Germany,33.0,185,2021,Russia,2021-05-25,False,0,0,1,1,0,0,1,1,0,0,0,0,0,0,0,0,1,0,1,2,1,0,0,1
141676.0,Poll Jana Franziska,OH,Germany,33.0,185,2021,Netherlands,2021-05-26,True,0,0,7,7,0,0,0,0,0,0,0,0,0,0,0,0,1,0,1,2,1,0,0,1
141676.0,Poll Jana Franziska,OH,Germany,33.0,185,2021,Belgium,2021-05-27,True,0,0,0,0,0,0,0,0,1,0,0,1,0,0,0,0,0,0,0,0,0,0,0,0
141676.0,Poll Jana Franziska,OH,Germany,33.0,185,2021,Canada,2021-06-02,False,0,0,5,5,0,0,0,0,3,1,6,10,0,0,1,1,11,3,8,22,3,2,1,6
141676.0,Poll Jana Franziska,OH,Germany,33.0,185,2021,USA,2021-06-06,False,1,0,2,3,0,0,0,0,1,0,1,2,0,0,0,0,1,0,4,5,0,1,0,1
141676.0,Poll Jana Franziska,OH,Germany,33.0,185,2021,Italy,2021-06-07,False,0,0,1,1,0,0,0,0,0,2,1,3,0,1,0,1,2,0,2,4,1,1,1,3
141676.0,Poll Jana Franziska,OH,Germany,33.0,185,2021,Thailand,2021-06-12,False,0,0,3,3,0,0,0,0,2,0,1,3,0,0,0,0,0,0,2,2,0,1,0,1
141676.0,Poll Jana Franziska,OH,Germany,33.0,185,2021,Brazil,2021-06-13,False,0,0,3,3,0,0,0,0,0,0,0,0,0,0,0,0,0,0,0,0,1,0,0,1
141676.0,Poll Jana Franziska,OH,Germany,33.0,185,2021,Poland,2021-06-14,True,0,0,0,0,0,0,0,0,0,0,0,0,0,0,0,0,0,0,0,0,0,0,0,0
141676.0,Poll Jana Franziska,OH,Germany,33.0,185,2021,Serbia,2021-06-18,True,1,0,4,5,0,0,1,1,3,2,2,7,1,1,2,4,4,0,6,10,1,2,0,3
141676.0,Poll Jana Franziska,OH,Germany,33.0,185,2021,Japan,2021-06-19,False,3,1,20,24,0,0,2,2,7,2,13,22,1,3,4,8,10,1,15,26,12,0,0,12
141676.0,Poll Jana Franziska,OH,Germany,33.0,185,2021,Dominican Republic,2021-06-20,False,0,0,0,0,0,0,0,0,0,0,0,0,0,0,0,0,2,0,3,5,2,0,1,3
168102.0,Vanjak Ivana,OH,Germany,26.0,193,2021,Russia,2021-05-25,False,0,0,1,1,0,0,0,0,5,3,3,11,0,1,1,2,0,0,0,0,0,2,0,2
168102.0,Vanjak Ivana,OH,Germany,26.0,193,2021,Netherlands,2021-05-26,True,1,1,9,11,0,0,0,0,9,1,9,19,1,0,0,1,1,0,0,1,1,0,0,1
168102.0,Vanjak Ivana,OH,Germany,26.0,193,2021,Belgium,2021-05-27,True,0,0,2,2,0,0,0,0,0,0,1,1,0,0,0,0,0,0,0,0,0,0,0,0
168102.0,Vanjak Ivana,OH,Germany,26.0,193,2021,China,2021-05-31,False,0,0,0,0,0,0,0,0,1,3,0,4,0,1,0,1,0,0,0,0,0,0,0,0
168102.0,Vanjak Ivana,OH,Germany,26.0,193,2021,Canada,2021-06-02,False,1,2,11,14,0,0,0,0,12,4,12,28,3,1,1,5,0,0,0,0,5,0,1,6
168102.0,Vanjak Ivana,OH,Germany,26.0,193,2021,USA,2021-06-06,False,0,1,2,3,0,0,0,0,3,1,3,7,0,2,0,2,0,0,0,0,0,0,0,0
168102.0,Vanjak Ivana,OH,Germany,26.0,193,2021,Italy,2021-06-07,False,0,1,1,2,0,0,1,1,3,3,4,10,0,0,0,0,0,1,0,1,2,0,1,3
168102.0,Vanjak Ivana,OH,Germany,26.0,193,2021,Thailand,2021-06-12,False,0,0,0,0,0,0,0,0,0,0,0,0,0,0,0,0,0,0,0,0,0,0,0,0
156295.0,Drewniok Kimberly,O,Germany,24.0,188,2021,Russia,2021-05-25,False,0,1,6,7,0,0,0,0,9,4,11,24,0,3,2,5,0,0,0,0,4,1,0,5
156295.0,Drewniok Kimberly,O,Germany,24.0,188,2021,Netherlands,2021-05-26,True,0,1,11,12,0,0,0,0,9,7,12,28,0,0,0,0,0,0,0,0,5,0,0,5
156295.0,Drewniok Kimberly,O,Germany,24.0,188,2021,Belgium,2021-05-27,True,0,2,12,14,0,0,2,2,8,2,9,19,0,0,0,0,0,0,0,0,2,0,0,2
156295.0,Drewniok Kimberly,O,Germany,24.0,188,2021,China,2021-05-31,False,0,3,7,10,1,0,0,1,10,7,11,28,0,2,2,4,0,0,0,0,6,2,0,8
156295.0,Drewniok Kimberly,O,Germany,24.0,188,2021,Canada,2021-06-02,False,0,0,0,0,0,0,0,0,1,1,1,3,0,0,0,0,0,0,0,0,0,0,0,0
156295.0,Drewniok Kimberly,O,Germany,24.0,188,2021,USA,2021-06-06,False,0,0,5,5,0,0,0,0,4,2,7,13,0,0,1,1,0,0,0,0,3,1,0,4
156295.0,Drewniok Kimberly,O,Germany,24.0,188,2021,Italy,2021-06-07,False,0,1,4,5,0,0,1,1,7,2,13,22,1,1,2,4,0,0,0,0,5,1,0,6
156295.0,Drewniok Kimberly,O,Germany,24.0,188,2021,Thailand,2021-06-12,False,0,2,12,14,0,0,4,4,9,5,12,26,1,1,1,3,0,0,0,0,8,3,4,15
156295.0,Drewniok Kimberly,O,Germany,24.0,188,2021,Brazil,2021-06-13,False,3,0,10,13,0,0,1,1,13,5,16,34,1,4,2,7,0,0,0,0,9,3,1,13
156295.0,Drewniok Kimberly,O,Germany,24.0,188,2021,Poland,2021-06-14,True,2,3,7,12,0,0,1,1,13,2,9,24,0,3,3,6,0,0,0,0,4,1,0,5
156295.0,Drewniok Kimberly,O,Germany,24.0,188,2021,Serbia,2021-06-18,True,0,0,0,0,0,0,0,0,0,0,0,0,0,0,0,0,0,0,0,0,0,0,0,0
156295.0,Drewniok Kimberly,O,Germany,24.0,188,2021,Japan,2021-06-19,False,0,0,1,1,0,0,0,0,1,0,4,5,0,2,0,2,0,0,0,0,2,0,0,2
156295.0,Drewniok Kimberly,O,Germany,24.0,188,2021,Dominican Republic,2021-06-20,False,1,2,10,13,0,0,1,1,23,8,18,49,1,3,4,8,0,0,0,0,7,5,1,13
163658.0,Alsmeier Lina,OH,Germany,21.0,189,2021,Russia,2021-05-25,False,0,0,0,0,0,0,0,0,0,0,2,2,0,0,0,0,0,0,0,0,0,0,0,0
163658.0,Alsmeier Lina,OH,Germany,21.0,189,2021,Netherlands,2021-05-26,True,2,5,7,14,0,0,1,1,14,3,25,42,2,0,0,2,8,2,19,29,7,2,0,9
163658.0,Alsmeier Lina,OH,Germany,21.0,189,2021,Belgium,2021-05-27,True,3,1,9,13,0,0,1,1,11,1,12,24,0,0,0,0,11,1,6,18,1,0,1,2
163658.0,Alsmeier Lina,OH,Germany,21.0,189,2021,China,2021-05-31,False,1,1,19,21,1,0,0,1,13,7,14,34,2,3,0,5,21,1,13,35,7,3,0,10
163658.0,Alsmeier Lina,OH,Germany,21.0,189,2021,Canada,2021-06-02,False,0,2,3,5,0,0,0,0,2,1,4,7,0,0,1,1,3,1,4,8,2,1,0,3
163658.0,Alsmeier Lina,OH,Germany,21.0,189,2021,USA,2021-06-06,False,0,1,5,6,0,0,1,1,6,2,11,19,1,3,1,5,4,1,7,12,1,1,0,2
163658.0,Alsmeier Lina,OH,Germany,21.0,189,2021,Italy,2021-06-07,False,0,2,4,6,0,0,3,3,11,5,7,23,2,3,2,7,6,1,10,17,1,2,0,3
163658.0,Alsmeier Lina,OH,Germany,21.0,189,2021,Thailand,2021-06-12,False,2,2,16,20,0,0,2,2,13,5,17,35,3,0,1,4,13,3,21,37,4,1,0,5
163658.0,Alsmeier Lina,OH,Germany,21.0,189,2021,Brazil,2021-06-13,False,0,3,13,16,0,0,2,2,9,4,7,20,0,1,0,1,15,1,21,37,6,3,0,9
163658.0,Alsmeier Lina,OH,Germany,21.0,189,2021,Poland,2021-06-14,True,0,2,11,13,0,0,2,2,10,1,14,25,1,1,1,3,8,1,10,19,6,0,1,7
163658.0,Alsmeier Lina,OH,Germany,21.0,189,2021,Serbia,2021-06-18,True,0,2,3,5,0,0,2,2,11,3,8,22,0,0,1,1,7,0,9,16,4,2,0,6
163658.0,Alsmeier Lina,OH,Germany,21.0,189,2021,Japan,2021-06-19,False,0,3,9,12,0,0,1,1,11,1,18,30,0,1,3,4,19,4,22,45,8,2,2,12
163658.0,Alsmeier Lina,OH,Germany,21.0,189,2021,Dominican Republic,2021-06-20,False,0,2,12,14,0,0,2,2,12,2,18,32,0,2,2,4,10,0,13,23,11,3,2,16
144980.0,Stigrot Lena,OH,Germany,27.0,184,2021,China,2021-05-31,False,0,0,6,6,0,0,0,0,9,3,9,21,1,0,1,2,6,1,6,13,2,1,0,3
144980.0,Stigrot Lena,OH,Germany,27.0,184,2021,Canada,2021-06-02,False,0,1,3,4,0,0,0,0,5,2,0,7,0,1,1,2,5,0,6,11,0,0,1,1
144980.0,Stigrot Lena,OH,Germany,27.0,184,2021,USA,2021-06-06,False,1,0,1,2,0,0,1,1,1,2,4,7,0,1,1,2,1,1,5,7,1,0,0,1
144980.0,Stigrot Lena,OH,Germany,27.0,184,2021,Italy,2021-06-07,False,0,0,4,4,0,0,1,1,2,1,6,9,0,2,0,2,6,3,12,21,1,2,2,5
144980.0,Stigrot Lena,OH,Germany,27.0,184,2021,Thailand,2021-06-12,False,0,0,5,5,0,1,1,2,8,4,6,18,1,1,0,2,2,0,5,7,3,2,1,6
144980.0,Stigrot Lena,OH,Germany,27.0,184,2021,Brazil,2021-06-13,False,0,0,0,0,0,0,0,0,2,1,2,5,0,0,1,1,0,0,0,0,0,0,0,0
144980.0,Stigrot Lena,OH,Germany,27.0,184,2021,Poland,2021-06-14,True,0,0,0,0,0,0,0,0,1,0,0,1,0,0,0,0,0,0,0,0,0,0,0,0
144980.0,Stigrot Lena,OH,Germany,27.0,184,2021,Serbia,2021-06-18,True,2,0,15,17,0,0,2,2,7,2,9,18,0,1,1,2,7,2,10,19,8,0,2,10
144980.0,Stigrot Lena,OH,Germany,27.0,184,2021,Japan,2021-06-19,False,0,0,1,1,0,0,3,3,1,2,3,6,0,2,0,2,0,0,3,3,4,1,0,5
144980.0,Stigrot Lena,OH,Germany,27.0,184,2021,Dominican Republic,2021-06-20,False,0,0,2,2,0,0,0,0,1,0,2,3,0,1,1,2,0,0,0,0,0,0,0,0
151016.0,Orthmann Hanna,OH,Germany,23.0,-,2021,Russia,2021-05-25,False,1,1,6,8,0,0,0,0,8,6,12,26,1,1,2,4,5,0,7,12,2,2,0,4
151016.0,Orthmann Hanna,OH,Germany,23.0,-,2021,Netherlands,2021-05-26,True,0,0,2,2,0,0,0,0,1,1,4,6,0,0,1,1,2,1,0,3,0,0,0,0
151016.0,Orthmann Hanna,OH,Germany,23.0,-,2021,Belgium,2021-05-27,True,0,0,1,1,0,0,0,0,0,1,2,3,0,0,0,0,1,0,0,1,0,0,0,0
151016.0,Orthmann Hanna,OH,Germany,23.0,-,2021,China,2021-05-31,False,3,3,7,13,0,0,0,0,18,5,12,35,2,1,3,6,6,1,14,21,4,5,0,9
151016.0,Orthmann Hanna,OH,Germany,23.0,-,2021,Canada,2021-06-02,False,0,4,2,6,0,0,0,0,8,1,6,15,0,2,0,2,3,1,10,14,4,1,0,5
151016.0,Orthmann Hanna,OH,Germany,23.0,-,2021,USA,2021-06-06,False,0,2,4,6,0,0,1,1,7,2,5,14,0,3,0,3,7,4,15,26,2,1,1,4
151016.0,Orthmann Hanna,OH,Germany,23.0,-,2021,Italy,2021-06-07,False,0,0,2,2,0,0,0,0,6,3,2,11,0,0,1,1,1,1,6,8,2,0,0,2
151016.0,Orthmann Hanna,OH,Germany,23.0,-,2021,Thailand,2021-06-12,False,0,4,1,5,0,0,0,0,8,4,9,21,1,0,1,2,3,0,13,16,7,1,0,8
151016.0,Orthmann Hanna,OH,Germany,23.0,-,2021,Brazil,2021-06-13,False,2,3,5,10,0,0,1,1,16,7,22,45,3,3,1,7,11,0,21,32,6,0,1,7
151016.0,Orthmann Hanna,OH,Germany,23.0,-,2021,Poland,2021-06-14,True,4,2,8,14,0,1,0,1,7,5,11,23,2,1,0,3,7,2,25,34,6,4,2,12
151016.0,Orthmann Hanna,OH,Germany,23.0,-,2021,Serbia,2021-06-18,True,1,4,5,10,0,0,1,1,14,5,12,31,0,0,1,1,0,0,0,0,8,3,0,11
151016.0,Orthmann Hanna,OH,Germany,23.0,-,2021,Japan,2021-06-19,False,1,3,9,13,0,0,1,1,17,6,19,42,2,5,3,10,0,0,0,0,4,2,3,9
151016.0,Orthmann Hanna,OH,Germany,23.0,-,2021,Dominican Republic,2021-06-20,False,5,5,12,22,0,0,3,3,11,6,16,33,1,0,5,6,11,1,19,31,11,1,2,14
150812.0,Schölzel Marie,MB,Germany,24.0,190,2021,Russia,2021-05-25,False,1,0,6,7,0,1,1,2,3,1,7,11,0,6,2,8,0,0,0,0,0,1,1,2
150812.0,Schölzel Marie,MB,Germany,24.0,190,2021,Netherlands,2021-05-26,True,0,1,6,7,0,0,0,0,7,3,4,14,2,3,0,5,0,0,0,0,2,0,0,2
150812.0,Schölzel Marie,MB,Germany,24.0,190,2021,Belgium,2021-05-27,True,0,1,7,8,0,0,1,1,5,0,6,11,3,1,1,5,0,0,0,0,0,0,0,0
150812.0,Schölzel Marie,MB,Germany,24.0,190,2021,China,2021-05-31,False,1,1,10,12,0,0,0,0,5,3,7,15,3,0,4,7,3,1,0,4,2,0,1,3
150812.0,Schölzel Marie,MB,Germany,24.0,190,2021,Canada,2021-06-02,False,0,1,6,7,0,0,1,1,3,3,4,10,2,3,2,7,0,0,0,0,2,1,1,4
150812.0,Schölzel Marie,MB,Germany,24.0,190,2021,USA,2021-06-06,False,0,0,4,4,0,0,1,1,1,1,2,4,0,2,1,3,0,0,0,0,1,1,0,2
150812.0,Schölzel Marie,MB,Germany,24.0,190,2021,Italy,2021-06-07,False,0,1,12,13,0,0,1,1,1,1,3,5,1,2,0,3,0,1,0,1,1,0,0,1
150812.0,Schölzel Marie,MB,Germany,24.0,190,2021,Thailand,2021-06-12,False,0,1,10,11,0,0,0,0,7,0,8,15,1,8,4,13,0,0,1,1,2,2,0,4
150812.0,Schölzel Marie,MB,Germany,24.0,190,2021,Brazil,2021-06-13,False,0,0,9,9,0,0,1,1,8,2,6,16,1,1,5,7,0,0,0,0,2,2,1,5
150812.0,Schölzel Marie,MB,Germany,24.0,190,2021,Poland,2021-06-14,True,0,0,10,10,0,0,0,0,5,2,4,11,2,5,1,8,0,0,0,0,3,0,1,4
150812.0,Schölzel Marie,MB,Germany,24.0,190,2021,Serbia,2021-06-18,True,0,1,6,7,0,0,2,2,9,3,2,14,1,0,0,1,0,0,0,0,0,1,0,1
150812.0,Schölzel Marie,MB,Germany,24.0,190,2021,Japan,2021-06-19,False,1,0,9,10,0,0,0,0,9,1,9,19,5,6,4,15,0,0,0,0,1,1,0,2
150812.0,Schölzel Marie,MB,Germany,24.0,190,2021,Dominican Republic,2021-06-20,False,3,1,14,18,0,0,1,1,4,1,11,16,0,8,3,11,0,0,0,0,3,0,0,3
163989.0,Ambrosius Lea,MB,Germany,21.0,189,2021,Russia,2021-05-25,False,0,0,0,0,0,0,0,0,0,0,0,0,0,0,0,0,0,0,0,0,0,0,0,0
163989.0,Ambrosius Lea,MB,Germany,21.0,189,2021,Netherlands,2021-05-26,True,0,0,0,0,0,0,0,0,0,0,0,0,0,0,0,0,0,0,0,0,0,0,0,0
163989.0,Ambrosius Lea,MB,Germany,21.0,189,2021,Belgium,2021-05-27,True,0,0,0,0,0,0,0,0,0,0,0,0,0,0,0,0,0,0,0,0,0,0,0,0
163989.0,Ambrosius Lea,MB,Germany,21.0,189,2021,USA,2021-06-06,False,0,1,1,2,0,0,1,1,2,0,1,3,0,2,0,2,1,0,0,1,0,0,0,0
163989.0,Ambrosius Lea,MB,Germany,21.0,189,2021,Italy,2021-06-07,False,0,0,0,0,0,0,0,0,0,0,0,0,0,0,0,0,0,0,0,0,0,0,0,0
136671.0,Pogany Anna,L,Germany,27.0,170,2021,Russia,2021-05-25,False,0,0,0,0,1,0,6,7,0,0,0,0,0,0,0,0,13,3,12,28,12,4,0,16
136671.0,Pogany Anna,L,Germany,27.0,170,2021,Netherlands,2021-05-26,True,0,0,0,0,0,0,8,8,0,0,0,0,0,0,0,0,11,2,10,23,20,3,1,24
136671.0,Pogany Anna,L,Germany,27.0,170,2021,Belgium,2021-05-27,True,0,0,0,0,0,0,3,3,0,0,0,0,0,0,0,0,4,1,5,10,1,0,0,1
136671.0,Pogany Anna,L,Germany,27.0,170,2021,China,2021-05-31,False,0,0,0,0,0,1,3,4,0,0,0,0,0,0,0,0,9,0,9,18,20,9,1,30
136671.0,Pogany Anna,L,Germany,27.0,170,2021,Canada,2021-06-02,False,0,0,0,0,0,0,5,5,0,0,0,0,0,0,0,0,10,0,8,18,6,6,1,13
136671.0,Pogany Anna,L,Germany,27.0,170,2021,USA,2021-06-06,False,0,0,0,0,0,0,7,7,0,0,0,0,0,0,0,0,1,2,8,11,0,6,1,7
136671.0,Pogany Anna,L,Germany,27.0,170,2021,Italy,2021-06-07,False,0,0,0,0,0,0,6,6,0,0,0,0,0,0,0,0,6,1,1,8,5,2,0,7
136671.0,Pogany Anna,L,Germany,27.0,170,2021,Thailand,2021-06-12,False,0,0,0,0,0,1,10,11,0,0,0,0,0,0,0,0,9,0,13,22,24,6,4,34
136671.0,Pogany Anna,L,Germany,27.0,170,2021,Brazil,2021-06-13,False,0,0,0,0,0,0,13,13,0,0,0,0,0,0,0,0,10,0,10,20,12,7,1,20
136671.0,Pogany Anna,L,Germany,27.0,170,2021,Poland,2021-06-14,True,0,0,0,0,0,0,4,4,0,0,0,0,0,0,0,0,3,0,4,7,11,1,1,13
136671.0,Pogany Anna,L,Germany,27.0,170,2021,Serbia,2021-06-18,True,0,0,0,0,0,0,7,7,0,0,0,0,0,0,0,0,3,1,7,11,11,7,2,20
136671.0,Pogany Anna,L,Germany,27.0,170,2021,Japan,2021-06-19,False,0,0,0,0,0,0,14,14,0,0,0,0,0,0,0,0,6,1,5,12,18,3,2,23
136671.0,Pogany Anna,L,Germany,27.0,170,2021,Dominican Republic,2021-06-20,False,0,0,0,0,0,0,21,21,0,0,0,0,0,0,0,0,15,2,13,30,17,5,3,25
163674.0,Bock Josepha,MB,Germany,22.0,187,2021,Russia,2021-05-25,False,0,0,0,0,0,0,0,0,0,0,0,0,0,0,0,0,0,0,0,0,0,0,0,0
163674.0,Bock Josepha,MB,Germany,22.0,187,2021,Netherlands,2021-05-26,True,0,0,0,0,0,0,0,0,0,0,0,0,0,0,0,0,0,0,0,0,0,0,0,0
163674.0,Bock Josepha,MB,Germany,22.0,187,2021,Belgium,2021-05-27,True,0,0,1,1,0,0,0,0,0,0,0,0,0,0,0,0,0,0,0,0,0,0,0,0
163674.0,Bock Josepha,MB,Germany,22.0,187,2021,China,2021-05-31,False,0,0,0,0,0,0,0,0,0,0,0,0,0,0,0,0,0,0,0,0,0,0,0,0
163674.0,Bock Josepha,MB,Germany,22.0,187,2021,Canada,2021-06-02,False,0,0,1,1,0,0,0,0,0,1,0,1,0,0,0,0,0,0,0,0,0,0,0,0
163674.0,Bock Josepha,MB,Germany,22.0,187,2021,Thailand,2021-06-12,False,0,0,0,0,0,0,0,0,0,0,0,0,0,0,0,0,0,0,0,0,0,0,0,0
163674.0,Bock Josepha,MB,Germany,22.0,187,2021,Brazil,2021-06-13,False,0,0,0,0,0,0,0,0,0,0,0,0,0,0,0,0,0,0,0,0,0,0,0,0
163674.0,Bock Josepha,MB,Germany,22.0,187,2021,Poland,2021-06-14,True,0,0,0,0,0,0,0,0,0,0,0,0,0,0,0,0,0,0,0,0,0,0,0,0
163674.0,Bock Josepha,MB,Germany,22.0,187,2021,Serbia,2021-06-18,True,0,0,0,0,0,0,0,0,0,0,0,0,0,0,0,0,0,0,0,0,0,0,0,0
163674.0,Bock Josepha,MB,Germany,22.0,187,2021,Japan,2021-06-19,False,0,0,0,0,0,0,0,0,1,0,0,1,1,0,0,1,0,0,0,0,0,0,0,0
163674.0,Bock Josepha,MB,Germany,22.0,187,2021,Dominican Republic,2021-06-20,False,0,0,0,0,0,0,0,0,0,0,0,0,0,0,0,0,0,0,0,0,0,0,0,0
153929.0,Weitzel Camilla,MB,Germany,21.0,195,2021,Russia,2021-05-25,False,2,2,12,16,2,0,0,2,4,0,4,8,1,2,2,5,0,0,0,0,1,0,0,1
153929.0,Weitzel Camilla,MB,Germany,21.0,195,2021,Netherlands,2021-05-26,True,2,4,16,22,0,0,2,2,8,2,2,12,1,6,1,8,0,0,0,0,4,0,0,4
153929.0,Weitzel Camilla,MB,Germany,21.0,195,2021,Belgium,2021-05-27,True,2,2,10,14,0,0,0,0,6,0,1,7,1,1,0,2,0,0,0,0,2,0,0,2
153929.0,Weitzel Camilla,MB,Germany,21.0,195,2021,China,2021-05-31,False,2,3,17,22,0,0,0,0,7,2,2,11,4,4,4,12,0,0,0,0,0,2,0,2
153929.0,Weitzel Camilla,MB,Germany,21.0,195,2021,Canada,2021-06-02,False,1,3,11,15,0,0,1,1,5,1,5,11,1,8,3,12,0,0,0,0,2,0,0,2
153929.0,Weitzel Camilla,MB,Germany,21.0,195,2021,USA,2021-06-06,False,1,2,7,10,0,0,2,2,0,0,2,2,3,2,1,6,0,0,0,0,1,0,0,1
153929.0,Weitzel Camilla,MB,Germany,21.0,195,2021,Italy,2021-06-07,False,1,2,5,8,0,0,0,0,3,0,8,11,1,7,6,14,0,0,0,0,4,0,0,4
153929.0,Weitzel Camilla,MB,Germany,21.0,195,2021,Thailand,2021-06-12,False,1,2,10,13,0,0,3,3,6,1,11,18,1,9,13,23,0,0,5,5,3,1,0,4
153929.0,Weitzel Camilla,MB,Germany,21.0,195,2021,Brazil,2021-06-13,False,0,4,10,14,0,0,2,2,7,2,3,12,1,6,5,12,0,0,1,1,0,0,0,0
153929.0,Weitzel Camilla,MB,Germany,21.0,195,2021,Poland,2021-06-14,True,2,1,9,12,0,0,0,0,7,0,2,9,3,7,4,14,0,0,0,0,0,1,0,1
153929.0,Weitzel Camilla,MB,Germany,21.0,195,2021,Serbia,2021-06-18,True,1,4,13,18,0,0,1,1,2,0,5,7,2,1,2,5,0,0,0,0,4,1,0,5
153929.0,Weitzel Camilla,MB,Germany,21.0,195,2021,Japan,2021-06-19,False,2,3,9,14,0,0,0,0,7,1,5,13,2,5,3,10,0,0,1,1,0,0,0,0
153929.0,Weitzel Camilla,MB,Germany,21.0,195,2021,Dominican Republic,2021-06-20,False,0,3,12,15,0,0,0,0,7,0,11,18,5,3,9,17,1,0,0,1,3,2,0,5
177765.0,Cekulaev Anastasia,MB,Germany,18.0,187,2021,China,2021-05-31,False,0,0,0,0,0,0,0,0,0,0,0,0,0,0,0,0,0,0,0,0,0,0,0,0
177765.0,Cekulaev Anastasia,MB,Germany,18.0,187,2021,Canada,2021-06-02,False,0,0,0,0,0,0,0,0,0,0,0,0,0,0,0,0,0,0,0,0,0,0,0,0
177765.0,Cekulaev Anastasia,MB,Germany,18.0,187,2021,USA,2021-06-06,False,0,0,0,0,0,0,0,0,0,0,0,0,0,0,0,0,0,0,0,0,0,0,0,0
177765.0,Cekulaev Anastasia,MB,Germany,18.0,187,2021,Italy,2021-06-07,False,0,0,0,0,0,0,0,0,0,0,0,0,0,0,0,0,0,0,0,0,0,0,0,0
151986.0,Bosio Francesca,S,Italy,24.0,-,2021,Poland,2021-05-25,False,0,0,15,15,35,1,111,147,0,0,0,0,0,1,1,2,0,0,0,0,8,1,0,9
151986.0,Bosio Francesca,S,Italy,24.0,-,2021,Serbia,2021-05-27,False,0,0,8,8,8,0,37,45,0,0,0,0,0,1,1,2,0,0,0,0,2,0,0,2
151986.0,Bosio Francesca,S,Italy,24.0,-,2021,Russia,2021-05-31,False,1,0,8,9,23,1,62,86,0,0,1,1,0,5,1,6,0,0,0,0,3,2,0,5
151986.0,Bosio Francesca,S,Italy,24.0,-,2021,Japan,2021-06-01,False,1,1,19,21,14,0,124,138,1,0,2,3,2,2,4,8,0,0,0,0,7,1,0,8
151986.0,Bosio Francesca,S,Italy,24.0,-,2021,Brazil,2021-06-02,False,2,1,11,14,24,0,75,99,1,0,1,2,0,5,2,7,0,0,0,0,5,3,2,10
151986.0,Bosio Francesca,S,Italy,24.0,-,2021,Germany,2021-06-07,True,2,0,16,18,15,1,52,68,1,0,0,1,0,1,1,2,0,0,0,0,8,1,0,9
151986.0,Bosio Francesca,S,Italy,24.0,-,2021,USA,2021-06-08,False,1,0,16,17,12,0,82,94,0,0,1,1,0,0,4,4,0,0,0,0,6,2,0,8
151986.0,Bosio Francesca,S,Italy,24.0,-,2021,Dominican Republic,2021-06-12,False,2,0,17,19,19,0,117,136,0,0,0,0,0,5,1,6,0,1,0,1,3,2,0,5
151986.0,Bosio Francesca,S,Italy,24.0,-,2021,Netherlands,2021-06-13,False,1,0,19,20,9,0,120,129,0,0,0,0,0,3,4,7,0,0,0,0,7,5,0,12
151986.0,Bosio Francesca,S,Italy,24.0,-,2021,China,2021-06-14,False,0,0,7,7,9,1,62,72,0,0,0,0,0,0,0,0,0,0,0,0,1,1,0,2
151986.0,Bosio Francesca,S,Italy,24.0,-,2021,Canada,2021-06-18,True,0,0,18,18,23,0,58,81,1,0,0,1,1,3,2,6,0,0,0,0,6,0,0,6
151986.0,Bosio Francesca,S,Italy,24.0,-,2021,Belgium,2021-06-19,False,1,0,14,15,10,1,96,107,0,0,1,1,1,2,1,4,0,0,0,0,9,5,0,14
151986.0,Bosio Francesca,S,Italy,24.0,-,2021,Thailand,2021-06-20,True,0,0,0,0,0,0,0,0,0,0,0,0,0,0,0,0,0,0,0,0,0,0,0,0
142391.0,Bonifacio Sara,MB,Italy,25.0,-,2021,Poland,2021-05-25,False,0,0,0,0,0,0,0,0,0,0,0,0,0,0,0,0,0,0,0,0,0,0,0,0
142391.0,Bonifacio Sara,MB,Italy,25.0,-,2021,Serbia,2021-05-27,False,0,0,0,0,0,0,0,0,0,0,0,0,0,0,0,0,0,0,0,0,0,0,0,0
142391.0,Bonifacio Sara,MB,Italy,25.0,-,2021,Russia,2021-05-31,False,1,1,7,9,0,0,1,1,5,0,1,6,1,2,2,5,0,0,0,0,2,0,0,2
142391.0,Bonifacio Sara,MB,Italy,25.0,-,2021,Japan,2021-06-01,False,0,0,20,20,0,0,2,2,7,1,6,14,2,4,2,8,0,0,0,0,2,2,0,4
142391.0,Bonifacio Sara,MB,Italy,25.0,-,2021,Brazil,2021-06-02,False,0,2,9,11,0,0,2,2,6,2,1,9,2,4,6,12,0,0,0,0,5,0,0,5
142391.0,Bonifacio Sara,MB,Italy,25.0,-,2021,Germany,2021-06-07,True,1,0,7,8,0,0,2,2,4,0,2,6,0,2,1,3,0,0,0,0,1,0,0,1
142391.0,Bonifacio Sara,MB,Italy,25.0,-,2021,USA,2021-06-08,False,0,0,0,0,0,0,0,0,0,0,0,0,0,0,0,0,0,0,0,0,0,0,0,0
142391.0,Bonifacio Sara,MB,Italy,25.0,-,2021,Dominican Republic,2021-06-12,False,0,2,2,4,0,0,0,0,3,0,2,5,0,1,1,2,0,0,0,0,1,1,0,2
142391.0,Bonifacio Sara,MB,Italy,25.0,-,2021,Netherlands,2021-06-13,False,2,1,17,20,0,0,2,2,5,0,12,17,1,7,1,9,0,0,0,0,3,3,0,6
142391.0,Bonifacio Sara,MB,Italy,25.0,-,2021,China,2021-06-14,False,0,0,0,0,0,0,0,0,0,0,0,0,0,0,0,0,0,0,0,0,0,0,0,0
142391.0,Bonifacio Sara,MB,Italy,25.0,-,2021,Canada,2021-06-18,True,1,1,12,14,0,0,0,0,5,1,6,12,1,5,6,12,0,0,0,0,3,1,0,4
142391.0,Bonifacio Sara,MB,Italy,25.0,-,2021,Belgium,2021-06-19,False,1,2,11,14,0,0,0,0,5,1,5,11,1,4,0,5,0,0,0,0,0,1,0,1
142391.0,Bonifacio Sara,MB,Italy,25.0,-,2021,Thailand,2021-06-20,True,0,0,0,0,0,0,0,0,0,0,0,0,0,0,0,0,0,0,0,0,0,0,0,0
143393.0,Guerra Anastasia,OH,Italy,25.0,183,2021,Poland,2021-05-25,False,2,1,17,20,0,0,1,1,12,9,16,37,2,0,1,3,11,4,33,48,11,3,0,14
143393.0,Guerra Anastasia,OH,Italy,25.0,183,2021,Serbia,2021-05-27,False,0,0,0,0,0,0,0,0,0,0,0,0,0,0,0,0,0,0,0,0,0,0,0,0
143393.0,Guerra Anastasia,OH,Italy,25.0,183,2021,Russia,2021-05-31,False,0,1,8,9,0,0,4,4,9,6,6,21,0,0,1,1,11,1,25,37,11,3,1,15
143393.0,Guerra Anastasia,OH,Italy,25.0,183,2021,Japan,2021-06-01,False,1,1,8,10,0,0,1,1,20,5,25,50,5,1,0,6,3,2,12,17,9,3,0,12
143393.0,Guerra Anastasia,OH,Italy,25.0,183,2021,Brazil,2021-06-02,False,0,0,0,0,0,0,0,0,0,0,1,1,0,0,0,0,0,0,1,1,1,0,0,1
143393.0,Guerra Anastasia,OH,Italy,25.0,183,2021,Germany,2021-06-07,True,1,1,13,15,0,0,0,0,8,4,6,18,1,3,0,4,2,1,7,10,6,2,0,8
143393.0,Guerra Anastasia,OH,Italy,25.0,183,2021,USA,2021-06-08,False,0,0,0,0,0,0,0,0,0,0,0,0,0,0,0,0,0,0,0,0,0,0,0,0
143393.0,Guerra Anastasia,OH,Italy,25.0,183,2021,Netherlands,2021-06-13,False,0,0,0,0,1,0,0,1,0,0,0,0,0,0,0,0,0,0,0,0,0,0,0,0
143393.0,Guerra Anastasia,OH,Italy,25.0,183,2021,China,2021-06-14,False,0,0,0,0,0,0,0,0,0,0,0,0,0,0,0,0,0,0,0,0,0,0,0,0
143393.0,Guerra Anastasia,OH,Italy,25.0,183,2021,Canada,2021-06-18,True,0,0,0,0,0,0,0,0,0,1,0,1,0,0,0,0,2,0,0,2,1,0,0,1
143393.0,Guerra Anastasia,OH,Italy,25.0,183,2021,Belgium,2021-06-19,False,0,2,11,13,0,0,0,0,7,2,12,21,0,2,0,2,2,3,23,28,7,4,1,12
143393.0,Guerra Anastasia,OH,Italy,25.0,183,2021,Thailand,2021-06-20,True,0,0,0,0,0,0,0,0,0,0,0,0,0,0,0,0,0,0,0,0,0,0,0,0
151664.0,Nwakalor Sylvia Chinelo,O,Italy,22.0,176,2021,Poland,2021-05-25,False,1,2,0,3,0,0,0,0,2,1,1,4,0,1,1,2,0,0,0,0,4,0,0,4
151664.0,Nwakalor Sylvia Chinelo,O,Italy,22.0,176,2021,Serbia,2021-05-27,False,0,3,8,11,0,0,1,1,21,6,17,44,3,2,0,5,0,0,0,0,5,1,1,7
151664.0,Nwakalor Sylvia Chinelo,O,Italy,22.0,176,2021,Russia,2021-05-31,False,2,6,7,15,0,0,1,1,18,6,9,33,2,3,2,7,0,0,0,0,2,3,1,6
151664.0,Nwakalor Sylvia Chinelo,O,Italy,22.0,176,2021,Japan,2021-06-01,False,1,2,11,14,0,0,4,4,22,11,20,53,1,6,1,8,0,0,0,0,6,6,2,14
151664.0,Nwakalor Sylvia Chinelo,O,Italy,22.0,176,2021,Brazil,2021-06-02,False,0,0,0,0,0,0,0,0,0,0,0,0,0,0,0,0,0,0,0,0,0,0,0,0
151664.0,Nwakalor Sylvia Chinelo,O,Italy,22.0,176,2021,Germany,2021-06-07,True,0,0,0,0,0,0,0,0,0,0,0,0,0,0,0,0,0,0,0,0,0,0,0,0
151664.0,Nwakalor Sylvia Chinelo,O,Italy,22.0,176,2021,USA,2021-06-08,False,0,4,2,6,0,0,2,2,6,7,6,19,2,5,2,9,0,0,0,0,8,1,0,9
151664.0,Nwakalor Sylvia Chinelo,O,Italy,22.0,176,2021,Dominican Republic,2021-06-12,False,0,0,0,0,0,0,0,0,0,0,0,0,0,0,0,0,0,0,0,0,0,0,0,0
151664.0,Nwakalor Sylvia Chinelo,O,Italy,22.0,176,2021,Netherlands,2021-06-13,False,1,4,11,16,0,0,1,1,25,8,25,58,1,1,1,3,0,0,0,0,15,6,0,21
151664.0,Nwakalor Sylvia Chinelo,O,Italy,22.0,176,2021,China,2021-06-14,False,0,0,0,0,0,0,0,0,0,0,1,1,0,1,0,1,0,0,0,0,0,0,0,0
151664.0,Nwakalor Sylvia Chinelo,O,Italy,22.0,176,2021,Canada,2021-06-18,True,0,3,3,6,0,0,0,0,18,3,10,31,0,3,3,6,0,0,0,0,5,2,1,8
151664.0,Nwakalor Sylvia Chinelo,O,Italy,22.0,176,2021,Belgium,2021-06-19,False,0,4,3,7,0,0,2,2,19,9,13,41,3,4,0,7,0,0,0,0,6,3,0,9
151664.0,Nwakalor Sylvia Chinelo,O,Italy,22.0,176,2021,Thailand,2021-06-20,True,0,0,0,0,0,0,0,0,0,0,0,0,0,0,0,0,0,0,0,0,0,0,0,0
143401.0,Mingardi Camilla,OH,Italy,24.0,182,2021,Poland,2021-05-25,False,1,0,15,16,0,0,1,1,13,8,21,42,2,2,4,8,0,0,0,0,12,4,0,16
143401.0,Mingardi Camilla,OH,Italy,24.0,182,2021,Serbia,2021-05-27,False,0,1,2,3,0,0,1,1,4,2,5,11,1,1,0,2,0,0,0,0,2,0,0,2
143401.0,Mingardi Camilla,OH,Italy,24.0,182,2021,Russia,2021-05-31,False,0,0,0,0,0,0,0,0,0,0,0,0,0,0,0,0,0,0,0,0,0,0,0,0
143401.0,Mingardi Camilla,OH,Italy,24.0,182,2021,Japan,2021-06-01,False,0,0,1,1,0,0,0,0,1,0,1,2,0,0,0,0,0,0,0,0,0,1,0,1
143401.0,Mingardi Camilla,OH,Italy,24.0,182,2021,Brazil,2021-06-02,False,0,1,13,14,0,0,3,3,11,10,20,41,2,2,3,7,0,0,0,0,14,5,4,23
143401.0,Mingardi Camilla,OH,Italy,24.0,182,2021,Germany,2021-06-07,True,1,1,8,10,0,0,3,3,17,3,15,35,1,0,1,2,0,0,0,0,9,1,0,10
143401.0,Mingardi Camilla,OH,Italy,24.0,182,2021,USA,2021-06-08,False,0,1,3,4,0,0,0,0,9,1,10,20,0,2,2,4,0,0,0,0,5,3,2,10
143401.0,Mingardi Camilla,OH,Italy,24.0,182,2021,Dominican Republic,2021-06-12,False,0,4,10,14,0,0,0,0,25,6,29,60,1,3,1,5,0,0,0,0,11,3,0,14
143401.0,Mingardi Camilla,OH,Italy,24.0,182,2021,Netherlands,2021-06-13,False,0,1,1,2,0,0,0,0,0,0,4,4,0,0,0,0,0,0,1,1,2,0,0,2
143401.0,Mingardi Camilla,OH,Italy,24.0,182,2021,China,2021-06-14,False,2,1,7,10,0,0,1,1,9,5,12,26,1,0,1,2,0,0,0,0,11,2,0,13
143401.0,Mingardi Camilla,OH,Italy,24.0,182,2021,Canada,2021-06-18,True,0,1,0,1,0,0,0,0,0,0,0,0,0,0,0,0,0,0,0,0,0,0,0,0
151658.0,Lubian Marina,MB,Italy,21.0,193,2021,Poland,2021-05-25,False,4,6,10,20,0,0,2,2,6,4,6,16,1,8,9,18,0,0,0,0,0,1,0,1
151658.0,Lubian Marina,MB,Italy,21.0,193,2021,Serbia,2021-05-27,False,0,3,4,7,0,0,1,1,1,2,3,6,2,3,2,7,0,0,0,0,1,0,0,1
151658.0,Lubian Marina,MB,Italy,21.0,193,2021,Russia,2021-05-31,False,0,0,3,3,0,0,0,0,2,1,2,5,2,0,2,4,0,0,0,0,1,0,0,1
151658.0,Lubian Marina,MB,Italy,21.0,193,2021,Japan,2021-06-01,False,0,0,0,0,0,0,0,0,0,0,0,0,0,0,0,0,0,0,0,0,0,0,0,0
151658.0,Lubian Marina,MB,Italy,21.0,193,2021,Brazil,2021-06-02,False,3,2,10,15,0,0,3,3,7,1,7,15,0,6,7,13,0,0,0,0,2,0,0,2
151658.0,Lubian Marina,MB,Italy,21.0,193,2021,Germany,2021-06-07,True,0,0,0,0,0,0,0,0,0,0,0,0,0,0,0,0,0,0,1,1,0,0,0,0
151658.0,Lubian Marina,MB,Italy,21.0,193,2021,USA,2021-06-08,False,4,2,10,16,0,0,2,2,7,0,4,11,1,4,2,7,0,0,0,0,2,0,0,2
151658.0,Lubian Marina,MB,Italy,21.0,193,2021,Dominican Republic,2021-06-12,False,0,2,6,8,0,0,1,1,2,2,4,8,1,1,1,3,0,0,1,1,2,0,0,2
151658.0,Lubian Marina,MB,Italy,21.0,193,2021,Netherlands,2021-06-13,False,0,0,1,1,0,0,0,0,0,1,1,2,0,0,1,1,0,0,0,0,0,0,0,0
151658.0,Lubian Marina,MB,Italy,21.0,193,2021,China,2021-06-14,False,1,2,4,7,0,0,1,1,7,1,4,12,0,2,1,3,0,0,0,0,0,1,1,2
151658.0,Lubian Marina,MB,Italy,21.0,193,2021,Canada,2021-06-18,True,0,0,0,0,0,0,0,0,0,0,0,0,0,0,0,0,0,0,0,0,0,0,0,0
151658.0,Lubian Marina,MB,Italy,21.0,193,2021,Belgium,2021-06-19,False,0,0,1,1,0,0,0,0,0,2,1,3,0,0,0,0,0,0,0,0,0,0,0,0
151658.0,Lubian Marina,MB,Italy,21.0,193,2021,Thailand,2021-06-20,True,1,3,18,22,0,0,1,1,7,2,7,16,2,4,11,17,0,0,0,0,3,1,0,4
156091.0,Morello Rachele,S,Italy,21.0,182,2021,Dominican Republic,2021-06-12,False,0,0,0,0,1,0,6,7,0,0,0,0,0,0,0,0,0,0,0,0,0,0,0,0
156091.0,Morello Rachele,S,Italy,21.0,182,2021,Netherlands,2021-06-13,False,0,0,0,0,0,0,8,8,0,0,0,0,0,0,0,0,0,0,0,0,0,0,0,0
156091.0,Morello Rachele,S,Italy,21.0,182,2021,China,2021-06-14,False,0,0,0,0,0,0,9,9,0,0,0,0,0,0,0,0,0,0,0,0,0,1,1,2
156091.0,Morello Rachele,S,Italy,21.0,182,2021,Belgium,2021-06-19,False,0,0,1,1,0,0,13,13,0,0,0,0,0,0,0,0,0,0,0,0,0,0,0,0
156091.0,Morello Rachele,S,Italy,21.0,182,2021,Thailand,2021-06-20,True,1,0,22,23,24,4,108,136,0,0,3,3,1,3,5,9,0,0,0,0,9,2,0,11
150445.0,De Bortoli Chiara,L,Italy,24.0,175,2021,Poland,2021-05-25,False,0,0,0,0,0,0,0,0,0,0,0,0,0,0,0,0,0,0,0,0,0,0,0,0
150445.0,De Bortoli Chiara,L,Italy,24.0,175,2021,Serbia,2021-05-27,False,0,0,0,0,0,0,3,3,0,0,0,0,0,0,0,0,4,0,6,10,3,1,0,4
150445.0,De Bortoli Chiara,L,Italy,24.0,175,2021,Russia,2021-05-31,False,0,0,0,0,0,0,1,1,0,0,0,0,0,0,0,0,0,0,2,2,0,0,1,1
150445.0,De Bortoli Chiara,L,Italy,24.0,175,2021,Japan,2021-06-01,False,0,0,0,0,0,0,4,4,0,0,0,0,0,0,0,0,4,0,3,7,2,2,0,4
150445.0,De Bortoli Chiara,L,Italy,24.0,175,2021,Brazil,2021-06-02,False,0,0,0,0,0,0,14,14,0,0,0,0,0,0,0,0,6,1,18,25,17,7,1,25
150445.0,De Bortoli Chiara,L,Italy,24.0,175,2021,Germany,2021-06-07,True,0,0,0,0,0,0,0,0,0,0,0,0,0,0,0,0,0,0,2,2,0,1,0,1
150445.0,De Bortoli Chiara,L,Italy,24.0,175,2021,USA,2021-06-08,False,0,0,0,0,0,0,6,6,0,0,0,0,0,0,0,0,1,3,6,10,13,3,2,18
150445.0,De Bortoli Chiara,L,Italy,24.0,175,2021,Dominican Republic,2021-06-12,False,0,0,0,0,0,0,1,1,0,0,0,0,0,0,0,0,3,1,1,5,2,0,0,2
150445.0,De Bortoli Chiara,L,Italy,24.0,175,2021,Netherlands,2021-06-13,False,0,0,0,0,0,0,24,24,0,0,0,0,0,0,0,0,6,2,15,23,22,5,0,27
150445.0,De Bortoli Chiara,L,Italy,24.0,175,2021,China,2021-06-14,False,0,0,0,0,0,0,2,2,0,0,0,0,0,0,0,0,1,0,0,1,0,0,0,0
150445.0,De Bortoli Chiara,L,Italy,24.0,175,2021,Canada,2021-06-18,True,0,0,0,0,0,0,0,0,0,0,0,0,0,0,0,0,0,0,0,0,0,0,0,0
150445.0,De Bortoli Chiara,L,Italy,24.0,175,2021,Belgium,2021-06-19,False,0,0,0,0,0,0,0,0,0,0,0,0,0,0,0,0,1,0,2,3,2,0,0,2
150445.0,De Bortoli Chiara,L,Italy,24.0,175,2021,Thailand,2021-06-20,True,0,0,0,0,1,0,14,15,0,0,0,0,0,0,0,0,12,1,14,27,18,6,2,26
151661.0,Mazzaro Alessia,MB,Italy,23.0,184,2021,Poland,2021-05-25,False,0,0,16,16,0,0,0,0,7,2,9,18,2,3,1,6,0,0,0,0,4,0,0,4
151661.0,Mazzaro Alessia,MB,Italy,23.0,184,2021,Serbia,2021-05-27,False,1,1,18,20,0,0,0,0,2,0,4,6,3,1,0,4,0,0,0,0,3,1,1,5
151661.0,Mazzaro Alessia,MB,Italy,23.0,184,2021,Russia,2021-05-31,False,1,0,17,18,0,0,2,2,4,2,0,6,0,2,1,3,0,0,0,0,4,2,0,6
151661.0,Mazzaro Alessia,MB,Italy,23.0,184,2021,Japan,2021-06-01,False,1,1,15,17,0,0,0,0,8,2,6,16,0,1,1,2,0,0,1,1,1,4,0,5
151661.0,Mazzaro Alessia,MB,Italy,23.0,184,2021,Brazil,2021-06-02,False,0,0,0,0,0,0,0,0,0,0,0,0,0,0,0,0,0,0,0,0,0,0,0,0
151661.0,Mazzaro Alessia,MB,Italy,23.0,184,2021,Germany,2021-06-07,True,3,1,10,14,0,0,3,3,3,1,4,8,2,0,2,4,0,0,0,0,3,2,0,5
151661.0,Mazzaro Alessia,MB,Italy,23.0,184,2021,USA,2021-06-08,False,0,0,7,7,0,0,0,0,2,0,3,5,1,2,0,3,0,0,0,0,1,1,0,2
151661.0,Mazzaro Alessia,MB,Italy,23.0,184,2021,Dominican Republic,2021-06-12,False,0,0,13,13,0,0,1,1,10,1,5,16,4,3,3,10,0,0,0,0,4,2,0,6
151661.0,Mazzaro Alessia,MB,Italy,23.0,184,2021,Netherlands,2021-06-13,False,1,1,12,14,0,0,0,0,6,1,4,11,4,4,1,9,0,0,0,0,0,2,0,2
151661.0,Mazzaro Alessia,MB,Italy,23.0,184,2021,China,2021-06-14,False,0,0,0,0,0,0,0,0,0,0,0,0,0,0,0,0,0,0,0,0,0,0,0,0
151661.0,Mazzaro Alessia,MB,Italy,23.0,184,2021,Canada,2021-06-18,True,0,0,9,9,0,0,0,0,4,1,5,10,2,2,5,9,0,0,0,0,2,1,1,4
151661.0,Mazzaro Alessia,MB,Italy,23.0,184,2021,Belgium,2021-06-19,False,1,0,25,26,0,0,2,2,9,1,5,15,3,2,1,6,0,0,0,0,3,3,0,6
151661.0,Mazzaro Alessia,MB,Italy,23.0,184,2021,Thailand,2021-06-20,True,0,0,3,3,0,0,0,0,0,0,0,0,0,0,0,0,0,0,0,0,1,0,0,1
181258.0,Piva Rebecca,OH,Italy,20.0,183,2021,Dominican Republic,2021-06-12,False,0,1,1,2,0,0,0,0,0,2,6,8,0,0,0,0,1,0,6,7,2,1,0,3
181258.0,Piva Rebecca,OH,Italy,20.0,183,2021,Netherlands,2021-06-13,False,0,3,10,13,0,0,1,1,8,5,6,19,2,1,0,3,6,1,17,24,7,4,0,11
181258.0,Piva Rebecca,OH,Italy,20.0,183,2021,China,2021-06-14,False,0,1,3,4,0,0,0,0,5,1,8,14,0,0,1,1,4,1,5,10,4,2,0,6
181258.0,Piva Rebecca,OH,Italy,20.0,183,2021,Canada,2021-06-18,True,0,0,0,0,0,0,0,0,0,0,0,0,0,0,0,0,1,0,2,3,0,0,0,0
181258.0,Piva Rebecca,OH,Italy,20.0,183,2021,Belgium,2021-06-19,False,0,0,4,4,0,0,0,0,0,0,0,0,0,0,0,0,0,0,0,0,1,1,0,2
181258.0,Piva Rebecca,OH,Italy,20.0,183,2021,Thailand,2021-06-20,True,2,3,10,15,0,0,2,2,4,3,7,14,1,3,8,12,5,0,11,16,15,3,1,19
180478.0,Battistoni Ilaria,S,Italy,25.0,174,2021,Poland,2021-05-25,False,0,0,0,0,1,0,2,3,0,0,0,0,0,0,0,0,0,0,0,0,0,0,0,0
180478.0,Battistoni Ilaria,S,Italy,25.0,174,2021,Serbia,2021-05-27,False,0,3,4,7,16,2,63,81,0,0,0,0,1,3,2,6,0,0,0,0,7,3,0,10
180478.0,Battistoni Ilaria,S,Italy,25.0,174,2021,Russia,2021-05-31,False,0,0,0,0,0,0,0,0,0,0,0,0,0,0,0,0,0,0,0,0,0,0,0,0
180478.0,Battistoni Ilaria,S,Italy,25.0,174,2021,Japan,2021-06-01,False,0,0,0,0,0,0,4,4,0,0,0,0,0,0,0,0,0,0,0,0,0,0,0,0
180478.0,Battistoni Ilaria,S,Italy,25.0,174,2021,Brazil,2021-06-02,False,0,0,0,0,1,0,7,8,0,0,0,0,0,0,0,0,0,0,0,0,0,0,0,0
180478.0,Battistoni Ilaria,S,Italy,25.0,174,2021,Germany,2021-06-07,True,0,0,0,0,0,0,0,0,0,0,0,0,0,0,0,0,0,0,0,0,0,0,0,0
180478.0,Battistoni Ilaria,S,Italy,25.0,174,2021,USA,2021-06-08,False,0,0,0,0,0,0,6,6,0,0,0,0,0,0,0,0,0,0,0,0,0,0,0,0
180478.0,Battistoni Ilaria,S,Italy,25.0,174,2021,Canada,2021-06-18,True,0,0,0,0,0,0,0,0,0,0,0,0,0,0,0,0,0,0,0,0,0,0,0,0
136692.0,Furlan Eleonora,MB,Italy,27.0,189,2021,Poland,2021-05-25,False,0,0,0,0,0,0,0,0,0,0,0,0,0,0,0,0,0,0,0,0,0,0,0,0
136692.0,Furlan Eleonora,MB,Italy,27.0,189,2021,Serbia,2021-05-27,False,0,0,6,6,0,0,0,0,3,0,5,8,1,4,1,6,0,0,0,0,1,0,0,1
136692.0,Furlan Eleonora,MB,Italy,27.0,189,2021,Russia,2021-05-31,False,0,0,0,0,0,0,0,0,0,0,0,0,0,0,0,0,0,0,0,0,0,0,0,0
136692.0,Furlan Eleonora,MB,Italy,27.0,189,2021,Japan,2021-06-01,False,0,0,0,0,0,0,0,0,0,0,0,0,0,0,0,0,0,0,0,0,0,0,0,0
136692.0,Furlan Eleonora,MB,Italy,27.0,189,2021,Brazil,2021-06-02,False,0,0,1,1,0,0,0,0,0,0,0,0,0,0,0,0,0,0,0,0,0,1,0,1
136692.0,Furlan Eleonora,MB,Italy,27.0,189,2021,Germany,2021-06-07,True,0,0,0,0,0,0,0,0,0,0,0,0,0,0,0,0,0,0,0,0,0,0,0,0
136692.0,Furlan Eleonora,MB,Italy,27.0,189,2021,USA,2021-06-08,False,0,1,7,8,0,0,0,0,3,0,4,7,2,2,3,7,0,0,0,0,0,0,1,1
136692.0,Furlan Eleonora,MB,Italy,27.0,189,2021,Dominican Republic,2021-06-12,False,0,0,0,0,0,0,0,0,0,0,0,0,0,0,0,0,0,0,0,0,0,0,0,0
136692.0,Furlan Eleonora,MB,Italy,27.0,189,2021,Netherlands,2021-06-13,False,0,0,0,0,0,0,0,0,0,0,0,0,0,0,0,0,0,0,0,0,0,0,0,0
136692.0,Furlan Eleonora,MB,Italy,27.0,189,2021,China,2021-06-14,False,0,3,8,11,0,0,1,1,1,1,4,6,1,2,0,3,0,1,0,1,3,2,0,5
136692.0,Furlan Eleonora,MB,Italy,27.0,189,2021,Belgium,2021-06-19,False,0,0,0,0,0,0,0,0,0,0,0,0,0,0,0,0,0,0,0,0,0,0,0,0
136692.0,Furlan Eleonora,MB,Italy,27.0,189,2021,Thailand,2021-06-20,True,1,3,6,10,0,0,2,2,11,1,6,18,8,10,10,28,0,0,0,0,6,2,0,8
151663.0,Melli Giulia,OH,Italy,24.0,184,2021,Poland,2021-05-25,False,0,0,0,0,0,0,0,0,0,2,0,2,0,0,1,1,0,1,0,1,0,0,0,0
151663.0,Melli Giulia,OH,Italy,24.0,184,2021,Serbia,2021-05-27,False,0,0,5,5,0,0,0,0,3,1,1,5,0,0,0,0,0,0,1,1,3,0,0,3
151663.0,Melli Giulia,OH,Italy,24.0,184,2021,Russia,2021-05-31,False,0,0,1,1,0,0,0,0,0,0,0,0,0,0,0,0,0,0,0,0,0,0,0,0
151663.0,Melli Giulia,OH,Italy,24.0,184,2021,Japan,2021-06-01,False,1,0,6,7,0,0,0,0,3,1,4,8,1,0,0,1,4,0,5,9,3,1,0,4
151663.0,Melli Giulia,OH,Italy,24.0,184,2021,Brazil,2021-06-02,False,0,2,8,10,0,0,1,1,18,10,14,42,1,0,0,1,4,1,20,25,2,4,2,8
151663.0,Melli Giulia,OH,Italy,24.0,184,2021,Germany,2021-06-07,True,0,0,2,2,0,0,0,0,1,0,0,1,1,0,1,2,0,0,0,0,0,0,0,0
151663.0,Melli Giulia,OH,Italy,24.0,184,2021,USA,2021-06-08,False,0,2,7,9,0,0,3,3,10,3,7,20,2,1,0,3,8,2,38,48,3,1,1,5
151663.0,Melli Giulia,OH,Italy,24.0,184,2021,Dominican Republic,2021-06-12,False,0,1,12,13,0,0,1,1,11,6,13,30,2,1,0,3,9,3,8,20,10,3,0,13
151663.0,Melli Giulia,OH,Italy,24.0,184,2021,Netherlands,2021-06-13,False,0,0,15,15,0,0,3,3,19,2,26,47,2,1,0,3,8,3,24,35,6,7,1,14
151663.0,Melli Giulia,OH,Italy,24.0,184,2021,China,2021-06-14,False,0,0,8,8,0,0,3,3,11,5,17,33,0,0,0,0,6,1,21,28,4,3,0,7
151663.0,Melli Giulia,OH,Italy,24.0,184,2021,Canada,2021-06-18,True,0,0,9,9,0,0,1,1,9,1,8,18,2,0,0,2,4,1,20,25,7,2,1,10
151663.0,Melli Giulia,OH,Italy,24.0,184,2021,Belgium,2021-06-19,False,0,0,2,2,0,0,2,2,2,1,7,10,0,0,0,0,2,2,10,14,1,0,0,1
151663.0,Melli Giulia,OH,Italy,24.0,184,2021,Thailand,2021-06-20,True,1,1,17,19,0,0,2,2,17,3,23,43,2,2,0,4,7,0,8,15,7,2,2,11
143391.0,D'Odorico Sofia,OH,Italy,25.0,186,2021,Poland,2021-05-25,False,2,2,16,20,0,0,1,1,13,4,25,42,4,5,3,12,4,2,9,15,10,1,1,12
143391.0,D'Odorico Sofia,OH,Italy,25.0,186,2021,Serbia,2021-05-27,False,0,1,8,9,0,0,1,1,10,7,15,32,0,0,2,2,4,0,13,17,6,1,0,7
143391.0,D'Odorico Sofia,OH,Italy,25.0,186,2021,Russia,2021-05-31,False,0,2,3,5,0,0,0,0,2,4,13,19,0,0,0,0,0,0,3,3,4,1,0,5
143391.0,D'Odorico Sofia,OH,Italy,25.0,186,2021,Japan,2021-06-01,False,2,4,12,18,0,0,0,0,7,1,9,17,0,1,0,1,15,4,17,36,8,5,0,13
143391.0,D'Odorico Sofia,OH,Italy,25.0,186,2021,Brazil,2021-06-02,False,0,3,10,13,0,0,3,3,7,4,17,28,0,1,1,2,5,1,18,24,6,4,1,11
143391.0,D'Odorico Sofia,OH,Italy,25.0,186,2021,Germany,2021-06-07,True,0,3,4,7,0,0,1,1,7,0,10,17,0,3,3,6,6,0,8,14,7,1,0,8
143391.0,D'Odorico Sofia,OH,Italy,25.0,186,2021,USA,2021-06-08,False,1,3,9,13,0,0,1,1,10,4,19,33,0,3,3,6,6,2,10,18,4,1,1,6
143391.0,D'Odorico Sofia,OH,Italy,25.0,186,2021,Dominican Republic,2021-06-12,False,0,2,11,13,0,0,0,0,2,3,13,18,0,0,0,0,6,2,4,12,3,3,0,6
143391.0,D'Odorico Sofia,OH,Italy,25.0,186,2021,Canada,2021-06-18,True,3,1,13,17,0,0,3,3,10,2,9,21,0,4,3,7,4,0,8,12,9,1,2,12
143391.0,D'Odorico Sofia,OH,Italy,25.0,186,2021,Belgium,2021-06-19,False,1,3,6,10,0,0,0,0,10,4,24,38,2,2,0,4,9,5,12,26,10,2,1,13
143391.0,D'Odorico Sofia,OH,Italy,25.0,186,2021,Thailand,2021-06-20,True,0,1,0,1,0,0,0,0,0,0,0,0,0,0,0,0,2,0,2,4,1,0,0,1
173402.0,Fersino Eleonora,L,Italy,22.0,-,2021,Poland,2021-05-25,False,0,0,0,0,0,0,7,7,0,0,0,0,0,0,0,0,12,1,14,27,24,4,0,28
173402.0,Fersino Eleonora,L,Italy,22.0,-,2021,Serbia,2021-05-27,False,0,0,0,0,0,1,7,8,0,0,0,0,0,0,0,0,11,0,6,17,9,6,0,15
173402.0,Fersino Eleonora,L,Italy,22.0,-,2021,Russia,2021-05-31,False,0,0,0,0,0,0,5,5,0,0,0,0,0,0,0,0,4,0,14,18,9,5,2,16
173402.0,Fersino Eleonora,L,Italy,22.0,-,2021,Japan,2021-06-01,False,0,0,0,0,0,0,9,9,0,0,0,0,0,0,0,0,11,0,15,26,18,7,1,26
173402.0,Fersino Eleonora,L,Italy,22.0,-,2021,Brazil,2021-06-02,False,0,0,0,0,0,0,1,1,0,0,0,0,0,0,0,0,3,1,3,7,2,0,1,3
173402.0,Fersino Eleonora,L,Italy,22.0,-,2021,Germany,2021-06-07,True,0,0,0,0,0,0,10,10,0,0,0,0,0,0,0,0,9,0,8,17,13,2,3,18
173402.0,Fersino Eleonora,L,Italy,22.0,-,2021,USA,2021-06-08,False,0,0,0,0,0,0,0,0,0,0,0,0,0,0,0,0,1,0,1,2,4,1,0,5
173402.0,Fersino Eleonora,L,Italy,22.0,-,2021,Dominican Republic,2021-06-12,False,0,0,0,0,0,0,6,6,0,0,0,0,0,0,0,0,17,3,12,32,18,3,4,25
173402.0,Fersino Eleonora,L,Italy,22.0,-,2021,Netherlands,2021-06-13,False,0,0,0,0,0,0,0,0,0,0,0,0,0,0,0,0,1,0,5,6,0,0,0,0
173402.0,Fersino Eleonora,L,Italy,22.0,-,2021,China,2021-06-14,False,0,0,0,0,0,0,9,9,0,0,0,0,0,0,0,0,9,1,3,13,7,6,0,13
173402.0,Fersino Eleonora,L,Italy,22.0,-,2021,Canada,2021-06-18,True,0,0,0,0,0,0,7,7,0,0,0,0,0,0,0,0,4,0,10,14,11,0,3,14
173402.0,Fersino Eleonora,L,Italy,22.0,-,2021,Belgium,2021-06-19,False,0,0,0,0,0,1,13,14,0,0,0,0,0,0,0,0,9,0,14,23,10,12,2,24
173402.0,Fersino Eleonora,L,Italy,22.0,-,2021,Thailand,2021-06-20,True,0,0,0,0,0,0,1,1,0,0,1,1,0,0,0,0,8,0,1,9,1,0,0,1
173730.0,Omoruyi Oghosasere Loveth,OH,Italy,19.0,184,2021,Poland,2021-05-25,False,0,0,0,0,0,0,0,0,0,0,0,0,0,0,0,0,0,0,0,0,0,0,0,0
173730.0,Omoruyi Oghosasere Loveth,OH,Italy,19.0,184,2021,Serbia,2021-05-27,False,0,1,11,12,0,1,0,1,3,7,15,25,1,0,0,1,9,2,29,40,9,2,1,12
173730.0,Omoruyi Oghosasere Loveth,OH,Italy,19.0,184,2021,Russia,2021-05-31,False,0,0,4,4,0,0,1,1,5,3,4,12,0,0,0,0,2,3,2,7,4,2,0,6
173730.0,Omoruyi Oghosasere Loveth,OH,Italy,19.0,184,2021,Japan,2021-06-01,False,0,0,0,0,0,0,0,0,0,0,0,0,0,0,0,0,0,0,0,0,0,0,0,0
173730.0,Omoruyi Oghosasere Loveth,OH,Italy,19.0,184,2021,Brazil,2021-06-02,False,0,0,1,1,0,0,0,0,0,0,0,0,0,0,0,0,1,0,1,2,1,0,2,3
173730.0,Omoruyi Oghosasere Loveth,OH,Italy,19.0,184,2021,Germany,2021-06-07,True,0,0,0,0,0,0,0,0,0,0,0,0,0,0,0,0,0,0,0,0,0,0,0,0
173730.0,Omoruyi Oghosasere Loveth,OH,Italy,19.0,184,2021,USA,2021-06-08,False,0,0,1,1,0,0,2,2,0,1,0,1,0,0,0,0,0,0,5,5,0,2,0,2
173730.0,Omoruyi Oghosasere Loveth,OH,Italy,19.0,184,2021,Dominican Republic,2021-06-12,False,0,0,4,4,0,0,0,0,3,2,2,7,0,0,0,0,3,0,3,6,0,0,0,0
173730.0,Omoruyi Oghosasere Loveth,OH,Italy,19.0,184,2021,Netherlands,2021-06-13,False,1,1,3,5,0,0,0,0,3,3,7,13,0,1,0,1,2,0,4,6,3,2,0,5
173730.0,Omoruyi Oghosasere Loveth,OH,Italy,19.0,184,2021,China,2021-06-14,False,0,0,3,3,0,0,0,0,4,1,1,6,0,0,0,0,1,2,11,14,0,2,1,3
173730.0,Omoruyi Oghosasere Loveth,OH,Italy,19.0,184,2021,Canada,2021-06-18,True,0,0,0,0,0,0,0,0,0,0,0,0,0,0,0,0,0,0,0,0,0,0,0,0
173730.0,Omoruyi Oghosasere Loveth,OH,Italy,19.0,184,2021,Belgium,2021-06-19,False,0,0,1,1,0,0,0,0,2,0,2,4,0,0,0,0,0,0,1,1,1,0,0,1
173730.0,Omoruyi Oghosasere Loveth,OH,Italy,19.0,184,2021,Thailand,2021-06-20,True,1,0,15,16,0,0,2,2,28,5,27,60,4,4,4,12,5,3,14,22,15,3,1,19
146401.0,Kurogo Ai,OH,Japan,23.0,180,2021,Thailand,2021-05-25,True,1,1,6,8,0,0,0,0,9,0,15,24,3,5,2,10,0,0,0,0,9,1,1,11
146401.0,Kurogo Ai,OH,Japan,23.0,180,2021,China,2021-05-26,True,1,2,6,9,0,0,0,0,16,3,16,35,0,0,0,0,1,0,3,4,9,0,0,9
146401.0,Kurogo Ai,OH,Japan,23.0,180,2021,Brazil,2021-05-31,False,0,1,7,8,0,0,0,0,8,4,20,32,0,2,1,3,4,1,7,12,6,3,2,11
146401.0,Kurogo Ai,OH,Japan,23.0,180,2021,Italy,2021-06-01,True,1,4,11,16,0,0,0,0,14,6,19,39,0,0,0,0,10,0,11,21,11,4,1,16
146401.0,Kurogo Ai,OH,Japan,23.0,180,2021,Russia,2021-06-02,True,2,2,7,11,0,1,2,3,9,5,12,26,0,1,1,2,0,0,1,1,2,3,0,5
146401.0,Kurogo Ai,OH,Japan,23.0,180,2021,Netherlands,2021-06-06,False,1,0,10,11,0,0,2,2,18,2,16,36,0,1,1,2,0,0,1,1,9,3,2,14
146401.0,Kurogo Ai,OH,Japan,23.0,180,2021,Canada,2021-06-07,True,1,0,22,23,0,0,1,1,12,3,5,20,0,2,2,4,0,0,0,0,15,3,0,18
146401.0,Kurogo Ai,OH,Japan,23.0,180,2021,Poland,2021-06-08,True,2,1,18,21,1,0,2,3,19,7,22,48,0,4,2,6,0,0,0,0,13,5,2,20
146401.0,Kurogo Ai,OH,Japan,23.0,180,2021,USA,2021-06-13,False,3,2,12,17,0,0,1,1,12,4,14,30,0,2,3,5,0,0,2,2,14,5,0,19
146401.0,Kurogo Ai,OH,Japan,23.0,180,2021,Belgium,2021-06-14,True,0,1,20,21,0,0,7,7,9,8,15,32,0,3,1,4,0,0,0,0,20,3,1,24
146401.0,Kurogo Ai,OH,Japan,23.0,180,2021,Dominican Republic,2021-06-18,True,2,0,20,22,0,0,6,6,16,3,24,43,1,2,1,4,1,0,1,2,27,1,1,29
146401.0,Kurogo Ai,OH,Japan,23.0,180,2021,Germany,2021-06-19,True,0,1,14,15,0,1,1,2,12,6,17,35,1,3,2,6,0,0,2,2,14,4,2,20
146401.0,Kurogo Ai,OH,Japan,23.0,180,2021,Serbia,2021-06-20,True,0,0,0,0,0,0,0,0,0,0,0,0,0,0,0,0,0,0,0,0,0,0,0,0
146401.0,Kurogo Ai,OH,Japan,23.0,180,2021,Brazil,2021-06-24,False,2,2,13,17,0,0,6,6,15,6,22,43,0,3,3,6,2,0,6,8,19,3,3,25
143437.0,Nishida Sarina,OH,Japan,25.0,180,2021,Thailand,2021-05-25,True,2,1,11,14,0,0,0,0,8,2,7,17,2,1,2,5,11,1,5,17,5,0,0,5
143437.0,Nishida Sarina,OH,Japan,25.0,180,2021,China,2021-05-26,True,2,1,11,14,0,0,0,0,11,5,11,27,0,0,1,1,11,0,9,20,10,1,0,11
143437.0,Nishida Sarina,OH,Japan,25.0,180,2021,Brazil,2021-05-31,False,0,2,6,8,0,0,4,4,12,3,18,33,1,5,2,8,5,0,9,14,6,0,0,6
143437.0,Nishida Sarina,OH,Japan,25.0,180,2021,Italy,2021-06-01,True,1,1,21,23,0,0,1,1,21,7,22,50,1,1,0,2,12,3,6,21,1,1,0,2
143437.0,Nishida Sarina,OH,Japan,25.0,180,2021,Russia,2021-06-02,True,3,2,12,17,0,0,1,1,18,3,20,41,0,1,1,2,8,1,9,18,6,4,1,11
143437.0,Nishida Sarina,OH,Japan,25.0,180,2021,Netherlands,2021-06-06,False,0,2,9,11,0,0,1,1,10,5,14,29,0,1,3,4,2,0,6,8,10,1,2,13
143437.0,Nishida Sarina,OH,Japan,25.0,180,2021,Canada,2021-06-07,True,0,0,9,9,0,0,2,2,9,3,13,25,0,1,5,6,9,0,8,17,11,1,0,12
143437.0,Nishida Sarina,OH,Japan,25.0,180,2021,Poland,2021-06-08,True,0,2,16,18,0,0,2,2,24,5,14,43,2,4,3,9,17,0,22,39,13,2,1,16
143437.0,Nishida Sarina,OH,Japan,25.0,180,2021,Belgium,2021-06-14,True,0,1,11,12,0,0,0,0,21,6,25,52,0,1,3,4,6,1,22,29,16,3,3,22
143437.0,Nishida Sarina,OH,Japan,25.0,180,2021,Dominican Republic,2021-06-18,True,2,1,20,23,0,0,3,3,19,6,32,57,2,4,3,9,20,0,14,34,13,9,2,24
143437.0,Nishida Sarina,OH,Japan,25.0,180,2021,Germany,2021-06-19,True,4,0,15,19,0,0,2,2,11,2,19,32,1,3,3,7,4,2,15,21,9,2,1,12
143437.0,Nishida Sarina,OH,Japan,25.0,180,2021,Serbia,2021-06-20,True,0,0,1,1,0,0,0,0,0,0,0,0,0,0,0,0,0,0,0,0,0,0,0,0
143437.0,Nishida Sarina,OH,Japan,25.0,180,2021,Brazil,2021-06-24,False,2,0,15,17,0,0,3,3,16,6,28,50,0,3,4,7,20,1,17,38,13,3,5,21
141953.0,Shimamura Haruyo,MB,Japan,30.0,182,2021,Thailand,2021-05-25,True,0,1,10,11,0,0,0,0,9,0,8,17,2,5,6,13,0,0,0,0,1,0,0,1
141953.0,Shimamura Haruyo,MB,Japan,30.0,182,2021,China,2021-05-26,True,0,1,15,16,0,0,0,0,7,0,5,12,0,2,2,4,0,0,0,0,2,1,0,3
141953.0,Shimamura Haruyo,MB,Japan,30.0,182,2021,Brazil,2021-05-31,False,1,0,6,7,1,0,3,4,1,1,6,8,2,3,1,6,1,0,0,1,2,0,1,3
141953.0,Shimamura Haruyo,MB,Japan,30.0,182,2021,Italy,2021-06-01,True,0,0,3,3,0,0,1,1,1,1,2,4,0,4,0,4,0,1,0,1,1,0,0,1
141953.0,Shimamura Haruyo,MB,Japan,30.0,182,2021,Canada,2021-06-07,True,0,0,0,0,0,0,0,0,0,0,0,0,0,0,0,0,0,0,0,0,0,0,0,0
141953.0,Shimamura Haruyo,MB,Japan,30.0,182,2021,Poland,2021-06-08,True,0,0,0,0,0,0,0,0,0,0,0,0,0,0,0,0,0,0,0,0,0,0,0,0
141953.0,Shimamura Haruyo,MB,Japan,30.0,182,2021,USA,2021-06-13,False,1,0,5,6,0,0,2,2,5,0,7,12,0,6,5,11,1,0,1,2,4,0,1,5
141953.0,Shimamura Haruyo,MB,Japan,30.0,182,2021,Belgium,2021-06-14,True,0,0,0,0,0,0,0,0,0,0,0,0,0,0,0,0,0,0,0,0,0,0,0,0
141953.0,Shimamura Haruyo,MB,Japan,30.0,182,2021,Dominican Republic,2021-06-18,True,0,0,11,11,0,0,2,2,9,1,12,22,4,6,15,25,0,0,0,0,9,1,0,10
141953.0,Shimamura Haruyo,MB,Japan,30.0,182,2021,Germany,2021-06-19,True,1,0,6,7,0,0,1,1,12,1,9,22,0,3,3,6,1,0,1,2,4,1,0,5
141953.0,Shimamura Haruyo,MB,Japan,30.0,182,2021,Brazil,2021-06-24,False,0,0,8,8,0,0,2,2,7,3,8,18,1,4,8,13,0,0,0,0,4,0,2,6
112717.0,Araki Erika,MB,Japan,37.0,186,2021,Thailand,2021-05-25,True,2,2,7,11,0,0,0,0,9,1,4,14,3,2,5,10,3,0,0,3,1,0,0,1
112717.0,Araki Erika,MB,Japan,37.0,186,2021,China,2021-05-26,True,2,0,10,12,0,0,1,1,3,1,7,11,1,4,1,6,0,0,0,0,1,0,0,1
112717.0,Araki Erika,MB,Japan,37.0,186,2021,Brazil,2021-05-31,False,0,0,0,0,0,0,0,0,0,0,0,0,0,0,0,0,0,0,0,0,0,0,0,0
112717.0,Araki Erika,MB,Japan,37.0,186,2021,Italy,2021-06-01,True,3,0,18,21,0,1,0,1,11,3,6,20,2,8,3,13,0,0,0,0,2,1,0,3
112717.0,Araki Erika,MB,Japan,37.0,186,2021,Russia,2021-06-02,True,1,1,12,14,0,0,2,2,2,2,4,8,2,0,1,3,1,0,0,1,1,1,0,2
112717.0,Araki Erika,MB,Japan,37.0,186,2021,Netherlands,2021-06-06,False,1,0,13,14,0,0,2,2,6,1,8,15,3,5,3,11,0,0,0,0,1,1,4,6
112717.0,Araki Erika,MB,Japan,37.0,186,2021,Canada,2021-06-07,True,0,0,0,0,0,0,0,0,0,0,0,0,0,0,0,0,0,0,0,0,0,0,0,0
112717.0,Araki Erika,MB,Japan,37.0,186,2021,Poland,2021-06-08,True,0,1,19,20,0,0,0,0,8,2,9,19,1,4,6,11,0,0,1,1,6,0,0,6
112717.0,Araki Erika,MB,Japan,37.0,186,2021,USA,2021-06-13,False,0,0,0,0,0,0,0,0,0,0,0,0,0,0,0,0,0,0,0,0,0,0,0,0
112717.0,Araki Erika,MB,Japan,37.0,186,2021,Belgium,2021-06-14,True,1,1,14,16,0,0,0,0,6,1,7,14,2,8,9,19,0,0,1,1,4,0,0,4
112717.0,Araki Erika,MB,Japan,37.0,186,2021,Dominican Republic,2021-06-18,True,1,2,15,18,0,0,4,4,6,3,6,15,0,5,6,11,0,0,1,1,4,1,0,5
112717.0,Araki Erika,MB,Japan,37.0,186,2021,Germany,2021-06-19,True,0,0,0,0,0,0,0,0,0,0,0,0,0,0,0,0,0,0,0,0,0,0,0,0
112717.0,Araki Erika,MB,Japan,37.0,186,2021,Serbia,2021-06-20,True,0,0,0,0,0,0,0,0,0,0,0,0,0,0,0,0,0,0,0,0,0,0,0,0
112717.0,Araki Erika,MB,Japan,37.0,186,2021,Brazil,2021-06-24,False,0,1,12,13,0,0,2,2,5,1,4,10,1,8,3,12,0,0,0,0,1,0,0,1
135416.0,Ishii Yuki,OH,Japan,30.0,180,2021,Thailand,2021-05-25,True,0,0,2,2,0,0,0,0,0,0,0,0,0,0,0,0,0,0,0,0,0,0,0,0
135416.0,Ishii Yuki,OH,Japan,30.0,180,2021,China,2021-05-26,True,0,0,1,1,0,0,0,0,0,0,0,0,0,0,0,0,0,0,0,0,0,0,0,0
135416.0,Ishii Yuki,OH,Japan,30.0,180,2021,Brazil,2021-05-31,False,0,0,1,1,0,0,0,0,0,0,0,0,0,0,0,0,1,0,1,2,0,0,0,0
135416.0,Ishii Yuki,OH,Japan,30.0,180,2021,Italy,2021-06-01,True,0,0,0,0,0,0,1,1,1,1,0,2,0,0,0,0,3,1,2,6,0,0,0,0
135416.0,Ishii Yuki,OH,Japan,30.0,180,2021,Russia,2021-06-02,True,0,0,0,0,0,0,0,0,0,0,0,0,0,0,0,0,0,0,0,0,0,0,0,0
135416.0,Ishii Yuki,OH,Japan,30.0,180,2021,Netherlands,2021-06-06,False,0,0,1,1,0,0,0,0,0,1,3,4,0,0,0,0,2,1,2,5,0,1,0,1
135416.0,Ishii Yuki,OH,Japan,30.0,180,2021,Canada,2021-06-07,True,0,0,0,0,0,0,0,0,0,0,0,0,0,0,0,0,0,0,0,0,0,0,0,0
135416.0,Ishii Yuki,OH,Japan,30.0,180,2021,Poland,2021-06-08,True,0,0,0,0,0,0,0,0,0,0,0,0,0,0,0,0,0,0,6,6,2,1,0,3
135416.0,Ishii Yuki,OH,Japan,30.0,180,2021,USA,2021-06-13,False,0,0,12,12,0,0,6,6,11,5,23,39,1,1,2,4,12,4,15,31,8,3,1,12
135416.0,Ishii Yuki,OH,Japan,30.0,180,2021,Belgium,2021-06-14,True,0,0,0,0,0,0,0,0,0,0,0,0,0,0,0,0,0,0,0,0,0,0,0,0
135416.0,Ishii Yuki,OH,Japan,30.0,180,2021,Dominican Republic,2021-06-18,True,0,0,0,0,0,0,0,0,0,0,0,0,0,0,0,0,0,0,0,0,0,0,0,0
135416.0,Ishii Yuki,OH,Japan,30.0,180,2021,Germany,2021-06-19,True,0,0,1,1,0,0,0,0,0,0,0,0,0,0,0,0,0,2,0,2,0,0,0,0
135416.0,Ishii Yuki,OH,Japan,30.0,180,2021,Serbia,2021-06-20,True,0,1,8,9,0,0,0,0,12,3,17,32,2,1,0,3,0,0,0,0,7,1,0,8
135416.0,Ishii Yuki,OH,Japan,30.0,180,2021,Brazil,2021-06-24,False,0,0,0,0,0,0,0,0,0,0,0,0,0,0,0,0,0,0,0,0,0,0,0,0
162218.0,Ishikawa Mayu,OH,Japan,21.0,174,2021,Thailand,2021-05-25,True,0,0,11,11,0,0,0,0,8,1,5,14,1,2,2,5,11,0,6,17,3,1,0,4
162218.0,Ishikawa Mayu,OH,Japan,21.0,174,2021,China,2021-05-26,True,2,1,9,12,0,0,2,2,15,3,10,28,1,0,0,1,13,0,6,19,8,1,0,9
162218.0,Ishikawa Mayu,OH,Japan,21.0,174,2021,Brazil,2021-05-31,False,1,1,9,11,0,0,1,1,10,7,6,23,0,1,1,2,17,2,11,30,8,1,0,9
162218.0,Ishikawa Mayu,OH,Japan,21.0,174,2021,Italy,2021-06-01,True,1,0,12,13,0,0,0,0,17,2,23,42,2,3,0,5,15,2,10,27,9,5,0,14
162218.0,Ishikawa Mayu,OH,Japan,21.0,174,2021,Russia,2021-06-02,True,1,0,12,13,0,0,2,2,19,1,12,32,0,1,0,1,11,0,4,15,7,1,0,8
162218.0,Ishikawa Mayu,OH,Japan,21.0,174,2021,Netherlands,2021-06-06,False,0,1,7,8,0,0,2,2,5,5,7,17,0,0,1,1,6,1,20,27,9,4,2,15
162218.0,Ishikawa Mayu,OH,Japan,21.0,174,2021,Canada,2021-06-07,True,5,0,13,18,0,0,1,1,8,5,12,25,0,2,2,4,4,1,1,6,9,0,1,10
162218.0,Ishikawa Mayu,OH,Japan,21.0,174,2021,Poland,2021-06-08,True,1,3,14,18,0,0,1,1,19,7,16,42,1,2,4,7,20,0,14,34,10,5,0,15
162218.0,Ishikawa Mayu,OH,Japan,21.0,174,2021,USA,2021-06-13,False,0,1,2,3,0,0,2,2,2,2,5,9,0,1,0,1,2,1,1,4,1,0,0,1
162218.0,Ishikawa Mayu,OH,Japan,21.0,174,2021,Belgium,2021-06-14,True,1,1,17,19,0,0,0,0,11,7,19,37,0,0,1,1,12,1,21,34,16,4,2,22
162218.0,Ishikawa Mayu,OH,Japan,21.0,174,2021,Dominican Republic,2021-06-18,True,0,1,11,12,0,0,6,6,23,2,27,52,1,1,3,5,16,1,12,29,18,3,2,23
162218.0,Ishikawa Mayu,OH,Japan,21.0,174,2021,Germany,2021-06-19,True,0,0,10,10,0,0,4,4,16,5,16,37,1,2,1,4,8,3,23,34,11,3,1,15
162218.0,Ishikawa Mayu,OH,Japan,21.0,174,2021,Serbia,2021-06-20,True,0,0,0,0,0,0,0,0,0,0,0,0,0,0,0,0,0,0,0,0,0,0,0,0
162218.0,Ishikawa Mayu,OH,Japan,21.0,174,2021,Brazil,2021-06-24,False,0,1,14,15,0,0,5,5,17,8,17,42,1,2,1,4,17,0,21,38,9,4,0,13
143376.0,Tashiro Kanami,S,Japan,31.0,173,2021,Thailand,2021-05-25,True,0,0,3,3,1,0,14,15,0,0,0,0,0,0,0,0,0,0,0,0,2,0,1,3
143376.0,Tashiro Kanami,S,Japan,31.0,173,2021,China,2021-05-26,True,0,0,0,0,0,0,0,0,0,0,0,0,0,0,0,0,0,0,0,0,0,0,0,0
143376.0,Tashiro Kanami,S,Japan,31.0,173,2021,Brazil,2021-05-31,False,0,0,0,0,1,0,4,5,0,0,0,0,0,0,0,0,0,0,0,0,3,0,0,3
143376.0,Tashiro Kanami,S,Japan,31.0,173,2021,Italy,2021-06-01,True,0,0,2,2,1,0,19,20,0,0,1,1,1,0,0,1,0,0,0,0,1,0,0,1
143376.0,Tashiro Kanami,S,Japan,31.0,173,2021,Russia,2021-06-02,True,0,0,1,1,0,0,6,6,0,0,0,0,0,0,0,0,0,0,0,0,0,0,0,0
143376.0,Tashiro Kanami,S,Japan,31.0,173,2021,Netherlands,2021-06-06,False,0,0,0,0,0,0,0,0,0,0,0,0,0,0,0,0,0,0,0,0,0,0,0,0
143376.0,Tashiro Kanami,S,Japan,31.0,173,2021,USA,2021-06-13,False,0,0,7,7,10,1,76,87,1,0,2,3,0,3,0,3,0,0,0,0,14,2,2,18
143376.0,Tashiro Kanami,S,Japan,31.0,173,2021,Belgium,2021-06-14,True,0,0,3,3,6,0,16,22,1,0,0,1,0,0,0,0,0,0,0,0,0,1,0,1
143376.0,Tashiro Kanami,S,Japan,31.0,173,2021,Dominican Republic,2021-06-18,True,0,0,2,2,0,0,0,0,0,0,0,0,0,0,0,0,0,0,0,0,0,0,0,0
143376.0,Tashiro Kanami,S,Japan,31.0,173,2021,Germany,2021-06-19,True,0,1,6,7,0,0,8,8,0,0,0,0,0,0,0,0,0,0,0,0,0,0,0,0
143376.0,Tashiro Kanami,S,Japan,31.0,173,2021,Brazil,2021-06-24,False,0,0,3,3,2,0,3,5,0,0,0,0,0,0,0,0,0,0,0,0,1,1,0,2
119378.0,Akutagawa Aika,MB,Japan,30.0,180,2021,Brazil,2021-05-31,False,0,0,0,0,0,0,0,0,0,0,0,0,0,0,0,0,0,0,0,0,0,0,0,0
119378.0,Akutagawa Aika,MB,Japan,30.0,180,2021,Italy,2021-06-01,True,0,0,0,0,0,0,0,0,0,0,0,0,0,0,0,0,0,0,0,0,0,0,0,0
119378.0,Akutagawa Aika,MB,Japan,30.0,180,2021,Russia,2021-06-02,True,0,0,0,0,0,0,0,0,0,0,0,0,0,0,0,0,0,0,0,0,0,0,0,0
119378.0,Akutagawa Aika,MB,Japan,30.0,180,2021,Netherlands,2021-06-06,False,0,0,0,0,0,0,0,0,0,0,0,0,0,0,0,0,0,0,0,0,0,0,0,0
119378.0,Akutagawa Aika,MB,Japan,30.0,180,2021,Canada,2021-06-07,True,0,1,2,3,0,0,0,0,2,0,4,6,0,0,0,0,0,0,0,0,3,0,0,3
119378.0,Akutagawa Aika,MB,Japan,30.0,180,2021,Poland,2021-06-08,True,0,0,0,0,0,0,0,0,0,0,0,0,0,0,0,0,0,0,0,0,0,0,0,0
119378.0,Akutagawa Aika,MB,Japan,30.0,180,2021,USA,2021-06-13,False,0,1,1,2,0,0,0,0,0,0,1,1,0,0,0,0,0,0,0,0,0,0,0,0
119378.0,Akutagawa Aika,MB,Japan,30.0,180,2021,Serbia,2021-06-20,True,1,1,9,11,0,0,0,0,4,2,4,10,2,1,1,4,1,0,0,1,2,2,0,4
141956.0,Nabeya Yurie,OH,Japan,28.0,176,2021,Italy,2021-06-01,True,0,0,1,1,0,0,0,0,0,0,0,0,0,0,0,0,0,0,0,0,0,0,0,0
141956.0,Nabeya Yurie,OH,Japan,28.0,176,2021,Russia,2021-06-02,True,0,0,0,0,0,0,0,0,0,0,0,0,0,0,0,0,0,0,0,0,0,0,0,0
141956.0,Nabeya Yurie,OH,Japan,28.0,176,2021,Netherlands,2021-06-06,False,0,0,0,0,0,0,0,0,0,0,0,0,0,0,0,0,0,0,0,0,0,0,0,0
141956.0,Nabeya Yurie,OH,Japan,28.0,176,2021,Canada,2021-06-07,True,0,0,3,3,0,0,0,0,1,0,0,1,0,0,0,0,0,0,0,0,0,0,0,0
141956.0,Nabeya Yurie,OH,Japan,28.0,176,2021,Poland,2021-06-08,True,1,0,5,6,0,0,0,0,0,0,0,0,0,0,0,0,0,0,0,0,0,2,1,3
141956.0,Nabeya Yurie,OH,Japan,28.0,176,2021,USA,2021-06-13,False,0,0,3,3,0,0,1,1,2,1,2,5,0,0,0,0,1,0,1,2,0,1,1,2
141956.0,Nabeya Yurie,OH,Japan,28.0,176,2021,Belgium,2021-06-14,True,0,1,1,2,0,0,0,0,0,0,0,0,0,0,0,0,0,0,0,0,0,0,0,0
141956.0,Nabeya Yurie,OH,Japan,28.0,176,2021,Dominican Republic,2021-06-18,True,0,0,3,3,0,0,0,0,0,0,0,0,0,0,0,0,0,0,0,0,0,1,0,1
141956.0,Nabeya Yurie,OH,Japan,28.0,176,2021,Germany,2021-06-19,True,0,0,0,0,0,0,0,0,0,0,0,0,0,0,0,0,0,0,0,0,0,0,0,0
141956.0,Nabeya Yurie,OH,Japan,28.0,176,2021,Serbia,2021-06-20,True,2,2,13,17,0,0,0,0,8,3,8,19,1,0,0,1,8,1,9,18,7,2,0,9
141956.0,Nabeya Yurie,OH,Japan,28.0,176,2021,Brazil,2021-06-24,False,0,0,3,3,0,0,0,0,0,0,0,0,0,0,0,0,0,0,0,0,0,0,0,0
138802.0,Okumura Mai,MB,Japan,31.0,177,2021,Thailand,2021-05-25,True,0,0,0,0,0,0,0,0,0,0,0,0,0,0,0,0,0,0,0,0,0,0,0,0
138802.0,Okumura Mai,MB,Japan,31.0,177,2021,China,2021-05-26,True,0,0,0,0,0,0,0,0,0,0,0,0,0,0,0,0,0,0,0,0,0,0,0,0
138802.0,Okumura Mai,MB,Japan,31.0,177,2021,Brazil,2021-05-31,False,0,0,12,12,0,0,2,2,2,1,9,12,2,4,0,6,0,0,1,1,1,0,2,3
138802.0,Okumura Mai,MB,Japan,31.0,177,2021,Italy,2021-06-01,True,0,0,7,7,0,0,0,0,1,0,5,6,0,5,3,8,0,0,0,0,0,2,0,2
138802.0,Okumura Mai,MB,Japan,31.0,177,2021,Russia,2021-06-02,True,0,0,0,0,0,0,0,0,0,0,0,0,0,0,0,0,0,0,0,0,0,0,0,0
138802.0,Okumura Mai,MB,Japan,31.0,177,2021,Netherlands,2021-06-06,False,0,0,0,0,0,0,0,0,0,0,0,0,0,0,0,0,0,0,0,0,0,0,0,0
138802.0,Okumura Mai,MB,Japan,31.0,177,2021,USA,2021-06-13,False,0,0,10,10,0,0,1,1,0,0,6,6,0,3,5,8,0,0,2,2,8,1,0,9
138802.0,Okumura Mai,MB,Japan,31.0,177,2021,Belgium,2021-06-14,True,0,0,0,0,0,0,0,0,0,0,0,0,0,0,0,0,0,0,0,0,0,0,0,0
138802.0,Okumura Mai,MB,Japan,31.0,177,2021,Dominican Republic,2021-06-18,True,0,0,0,0,0,0,0,0,0,0,0,0,0,0,0,0,0,0,0,0,0,0,0,0
138802.0,Okumura Mai,MB,Japan,31.0,177,2021,Germany,2021-06-19,True,0,0,0,0,0,0,0,0,0,0,0,0,0,0,0,0,0,0,0,0,0,0,0,0
138802.0,Okumura Mai,MB,Japan,31.0,177,2021,Serbia,2021-06-20,True,2,0,13,15,0,0,2,2,3,1,1,5,1,2,2,5,0,0,1,1,1,2,0,3
138802.0,Okumura Mai,MB,Japan,31.0,177,2021,Brazil,2021-06-24,False,0,0,0,0,0,0,0,0,0,0,0,0,0,0,0,0,0,0,0,0,0,0,0,0
162767.0,Kobata Mako,L,Japan,29.0,164,2021,Thailand,2021-05-25,True,0,0,0,0,0,0,1,1,0,0,0,0,0,0,0,0,1,1,4,6,16,0,1,17
162767.0,Kobata Mako,L,Japan,29.0,164,2021,China,2021-05-26,True,0,0,0,0,1,0,5,6,0,0,0,0,0,0,0,0,2,0,1,3,14,5,0,19
162767.0,Kobata Mako,L,Japan,29.0,164,2021,Brazil,2021-05-31,False,0,0,0,0,0,0,7,7,0,0,0,0,0,0,0,0,1,0,3,4,8,1,1,10
162767.0,Kobata Mako,L,Japan,29.0,164,2021,Italy,2021-06-01,True,0,0,0,0,0,0,5,5,0,0,0,0,0,0,0,0,18,0,5,23,9,10,1,20
162767.0,Kobata Mako,L,Japan,29.0,164,2021,Russia,2021-06-02,True,0,0,0,0,0,0,1,1,0,0,0,0,0,0,0,0,0,0,0,0,0,0,0,0
162767.0,Kobata Mako,L,Japan,29.0,164,2021,Netherlands,2021-06-06,False,0,0,0,0,0,0,3,3,0,0,0,0,0,0,0,0,4,1,8,13,13,2,0,15
162767.0,Kobata Mako,L,Japan,29.0,164,2021,Canada,2021-06-07,True,0,0,0,0,0,0,4,4,0,0,0,0,0,0,0,0,6,1,7,14,14,1,3,18
162767.0,Kobata Mako,L,Japan,29.0,164,2021,Poland,2021-06-08,True,0,0,0,0,0,0,7,7,0,0,0,0,0,0,0,0,8,0,6,14,10,3,0,13
162767.0,Kobata Mako,L,Japan,29.0,164,2021,USA,2021-06-13,False,0,0,0,0,0,0,0,0,0,0,0,0,0,0,0,0,0,0,0,0,0,0,0,0
162767.0,Kobata Mako,L,Japan,29.0,164,2021,Belgium,2021-06-14,True,0,0,0,0,0,0,17,17,0,0,0,0,0,0,0,0,4,0,6,10,15,1,2,18
162767.0,Kobata Mako,L,Japan,29.0,164,2021,Dominican Republic,2021-06-18,True,0,0,0,0,0,0,8,8,0,0,0,0,0,0,0,0,13,0,10,23,6,2,0,8
162767.0,Kobata Mako,L,Japan,29.0,164,2021,Germany,2021-06-19,True,0,0,0,0,0,0,6,6,0,0,0,0,0,0,0,0,5,0,7,12,4,2,0,6
162767.0,Kobata Mako,L,Japan,29.0,164,2021,Serbia,2021-06-20,True,0,0,0,0,0,0,2,2,0,0,0,0,0,0,0,0,0,0,0,0,6,1,0,7
162767.0,Kobata Mako,L,Japan,29.0,164,2021,Brazil,2021-06-24,False,0,0,0,0,0,0,9,9,0,0,0,0,0,0,0,0,7,2,6,15,15,2,2,19
124327.0,Inoue Kotoe,L,Japan,32.0,163,2021,Thailand,2021-05-25,True,0,0,0,0,0,0,0,0,0,0,0,0,0,0,0,0,0,0,0,0,0,0,0,0
124327.0,Inoue Kotoe,L,Japan,32.0,163,2021,China,2021-05-26,True,0,0,0,0,0,0,0,0,0,0,0,0,0,0,0,0,0,0,0,0,0,0,0,0
124327.0,Inoue Kotoe,L,Japan,32.0,163,2021,Brazil,2021-05-31,False,0,0,0,0,0,0,5,5,0,0,0,0,0,0,0,0,0,0,1,1,1,3,0,4
124327.0,Inoue Kotoe,L,Japan,32.0,163,2021,Italy,2021-06-01,True,0,0,0,0,0,0,0,0,0,0,0,0,0,0,0,0,0,0,0,0,0,0,0,0
124327.0,Inoue Kotoe,L,Japan,32.0,163,2021,Russia,2021-06-02,True,0,0,0,0,0,0,7,7,0,0,0,0,0,0,0,0,10,1,8,19,13,5,2,20
124327.0,Inoue Kotoe,L,Japan,32.0,163,2021,Netherlands,2021-06-06,False,0,0,0,0,0,0,5,5,0,0,0,0,0,0,0,0,3,0,3,6,3,1,0,4
124327.0,Inoue Kotoe,L,Japan,32.0,163,2021,Canada,2021-06-07,True,0,0,0,0,0,0,0,0,0,0,0,0,0,0,0,0,0,0,0,0,0,0,0,0
124327.0,Inoue Kotoe,L,Japan,32.0,163,2021,Poland,2021-06-08,True,0,0,0,0,0,0,0,0,0,0,0,0,0,0,0,0,0,0,0,0,4,2,0,6
124327.0,Inoue Kotoe,L,Japan,32.0,163,2021,USA,2021-06-13,False,0,0,0,0,0,0,14,14,0,0,0,0,0,0,0,0,1,0,5,6,10,5,1,16
124327.0,Inoue Kotoe,L,Japan,32.0,163,2021,Belgium,2021-06-14,True,0,0,0,0,0,0,0,0,0,0,0,0,0,0,0,0,0,0,0,0,0,0,0,0
124327.0,Inoue Kotoe,L,Japan,32.0,163,2021,Dominican Republic,2021-06-18,True,0,0,0,0,0,0,3,3,0,0,0,0,0,0,0,0,0,0,0,0,10,4,3,17
124327.0,Inoue Kotoe,L,Japan,32.0,163,2021,Germany,2021-06-19,True,0,0,0,0,0,0,6,6,0,0,0,0,0,0,0,0,0,0,0,0,16,2,5,23
124327.0,Inoue Kotoe,L,Japan,32.0,163,2021,Serbia,2021-06-20,True,0,0,0,0,0,0,6,6,0,0,0,0,0,0,0,0,6,0,4,10,4,0,0,4
124327.0,Inoue Kotoe,L,Japan,32.0,163,2021,Brazil,2021-06-24,False,0,0,0,0,0,0,0,0,0,0,0,0,0,0,0,0,0,0,0,0,0,0,0,0
162227.0,Yamada Nichika,MB,Japan,22.0,184,2021,Thailand,2021-05-25,True,0,0,0,0,0,0,0,0,0,0,0,0,0,0,0,0,0,0,0,0,0,0,0,0
162227.0,Yamada Nichika,MB,Japan,22.0,184,2021,China,2021-05-26,True,0,0,0,0,0,0,0,0,0,0,0,0,0,0,0,0,0,0,0,0,0,0,0,0
162227.0,Yamada Nichika,MB,Japan,22.0,184,2021,Russia,2021-06-02,True,0,0,7,7,0,0,0,0,5,2,8,15,1,0,1,2,1,0,1,2,1,3,0,4
162227.0,Yamada Nichika,MB,Japan,22.0,184,2021,Netherlands,2021-06-06,False,0,0,8,8,0,0,0,0,3,3,7,13,1,5,5,11,0,0,0,0,2,2,1,5
162227.0,Yamada Nichika,MB,Japan,22.0,184,2021,Canada,2021-06-07,True,0,1,8,9,0,0,0,0,9,3,7,19,1,1,1,3,0,0,0,0,7,0,0,7
162227.0,Yamada Nichika,MB,Japan,22.0,184,2021,Poland,2021-06-08,True,1,0,12,13,0,0,0,0,3,4,4,11,3,5,2,10,0,0,2,2,3,0,2,5
162227.0,Yamada Nichika,MB,Japan,22.0,184,2021,USA,2021-06-13,False,0,0,0,0,0,0,0,0,0,0,0,0,0,0,0,0,0,0,0,0,0,0,0,0
162227.0,Yamada Nichika,MB,Japan,22.0,184,2021,Belgium,2021-06-14,True,0,1,10,11,0,0,1,1,12,0,7,19,0,5,7,12,0,0,0,0,4,2,1,7
162227.0,Yamada Nichika,MB,Japan,22.0,184,2021,Dominican Republic,2021-06-18,True,0,0,0,0,0,0,0,0,0,0,0,0,0,0,0,0,0,0,0,0,0,0,0,0
162227.0,Yamada Nichika,MB,Japan,22.0,184,2021,Germany,2021-06-19,True,1,0,16,17,0,0,1,1,5,2,3,10,0,6,2,8,0,0,2,2,4,1,2,7
162227.0,Yamada Nichika,MB,Japan,22.0,184,2021,Serbia,2021-06-20,True,0,0,0,0,0,0,0,0,0,0,0,0,0,0,0,0,0,0,0,0,0,0,0,0
162227.0,Yamada Nichika,MB,Japan,22.0,184,2021,Brazil,2021-06-24,False,0,0,0,0,0,0,0,0,0,0,0,0,0,0,0,0,0,0,0,0,0,0,0,0
151944.0,Seki Nanami,S,Japan,22.0,171,2021,Thailand,2021-05-25,True,0,0,0,0,0,0,0,0,0,0,0,0,0,0,0,0,0,0,0,0,0,0,0,0
151944.0,Seki Nanami,S,Japan,22.0,171,2021,China,2021-05-26,True,0,0,0,0,0,0,0,0,0,0,0,0,0,0,0,0,0,0,0,0,0,0,0,0
151944.0,Seki Nanami,S,Japan,22.0,171,2021,Brazil,2021-05-31,False,0,0,1,1,1,0,1,2,0,0,2,2,0,1,0,1,1,0,0,1,2,0,0,2
151944.0,Seki Nanami,S,Japan,22.0,171,2021,Canada,2021-06-07,True,0,0,4,4,3,0,3,6,0,0,0,0,0,0,0,0,0,0,0,0,0,1,0,1
151944.0,Seki Nanami,S,Japan,22.0,171,2021,Poland,2021-06-08,True,0,1,0,1,0,0,0,0,0,0,0,0,0,0,0,0,0,0,0,0,0,0,0,0
151944.0,Seki Nanami,S,Japan,22.0,171,2021,USA,2021-06-13,False,0,0,2,2,1,0,9,10,0,0,0,0,0,0,0,0,0,0,0,0,2,1,0,3
151944.0,Seki Nanami,S,Japan,22.0,171,2021,Serbia,2021-06-20,True,1,1,5,7,2,1,83,86,2,0,0,2,1,1,0,2,0,0,1,1,5,0,1,6
151953.0,Hayashi Kotona,OH,Japan,22.0,173,2021,Thailand,2021-05-25,True,0,0,0,0,0,0,0,0,1,0,5,6,1,0,0,1,0,0,0,0,0,0,1,1
151953.0,Hayashi Kotona,OH,Japan,22.0,173,2021,China,2021-05-26,True,0,0,1,1,0,0,0,0,0,0,0,0,0,0,0,0,0,0,0,0,0,0,0,0
151953.0,Hayashi Kotona,OH,Japan,22.0,173,2021,Brazil,2021-05-31,False,0,0,0,0,0,0,0,0,1,0,0,1,0,0,1,1,3,0,1,4,0,0,0,0
151953.0,Hayashi Kotona,OH,Japan,22.0,173,2021,Italy,2021-06-01,True,0,1,2,3,0,0,0,0,0,0,1,1,0,0,0,0,0,0,0,0,0,1,0,1
151953.0,Hayashi Kotona,OH,Japan,22.0,173,2021,Russia,2021-06-02,True,0,0,0,0,0,0,0,0,0,0,0,0,0,0,1,1,0,0,2,2,0,0,0,0
151953.0,Hayashi Kotona,OH,Japan,22.0,173,2021,Netherlands,2021-06-06,False,0,0,1,1,0,0,1,1,0,0,0,0,0,0,0,0,0,1,4,5,1,0,0,1
151953.0,Hayashi Kotona,OH,Japan,22.0,173,2021,Canada,2021-06-07,True,0,0,2,2,0,0,0,0,0,0,0,0,0,0,0,0,0,0,0,0,0,0,0,0
151953.0,Hayashi Kotona,OH,Japan,22.0,173,2021,Poland,2021-06-08,True,0,0,0,0,0,0,0,0,0,0,0,0,0,0,0,0,0,0,0,0,0,0,0,0
151953.0,Hayashi Kotona,OH,Japan,22.0,173,2021,USA,2021-06-13,False,0,1,6,7,0,0,3,3,8,3,12,23,0,1,1,2,2,0,9,11,10,3,0,13
151953.0,Hayashi Kotona,OH,Japan,22.0,173,2021,Belgium,2021-06-14,True,0,0,0,0,0,0,0,0,0,0,0,0,0,0,0,0,0,1,0,1,0,0,0,0
151953.0,Hayashi Kotona,OH,Japan,22.0,173,2021,Dominican Republic,2021-06-18,True,1,0,6,7,0,0,1,1,0,0,0,0,0,0,0,0,0,0,0,0,0,0,1,1
151953.0,Hayashi Kotona,OH,Japan,22.0,173,2021,Germany,2021-06-19,True,0,0,8,8,0,0,0,0,0,0,0,0,0,0,0,0,0,0,0,0,1,0,0,1
151953.0,Hayashi Kotona,OH,Japan,22.0,173,2021,Serbia,2021-06-20,True,1,2,10,13,0,0,1,1,12,6,12,30,0,0,1,1,6,1,6,13,6,1,0,7
151953.0,Hayashi Kotona,OH,Japan,22.0,173,2021,Brazil,2021-06-24,False,0,0,3,3,0,0,0,0,0,0,0,0,0,0,0,0,0,0,0,0,0,0,0,0
181033.0,Momii Aki,S,Japan,21.0,176,2021,Thailand,2021-05-25,True,0,2,12,14,21,1,52,74,0,0,0,0,0,1,1,2,0,0,0,0,1,2,3,6
181033.0,Momii Aki,S,Japan,21.0,176,2021,China,2021-05-26,True,0,1,8,9,43,1,61,105,1,0,3,4,1,2,0,3,0,0,0,0,6,1,0,7
181033.0,Momii Aki,S,Japan,21.0,176,2021,Brazil,2021-05-31,False,0,1,8,9,18,0,67,85,0,1,1,2,0,2,0,2,0,0,0,0,9,1,1,11
181033.0,Momii Aki,S,Japan,21.0,176,2021,Italy,2021-06-01,True,0,1,13,14,8,0,127,135,2,2,3,7,0,2,1,3,0,0,0,0,0,4,0,4
181033.0,Momii Aki,S,Japan,21.0,176,2021,Russia,2021-06-02,True,0,1,10,11,14,0,86,100,0,0,0,0,0,0,2,2,0,0,0,0,4,2,0,6
181033.0,Momii Aki,S,Japan,21.0,176,2021,Netherlands,2021-06-06,False,0,0,12,12,35,2,61,98,0,0,2,2,0,1,1,2,0,0,0,0,7,1,1,9
181033.0,Momii Aki,S,Japan,21.0,176,2021,Canada,2021-06-07,True,0,1,2,3,13,1,70,84,0,0,2,2,3,2,2,7,0,0,0,0,4,0,0,4
181033.0,Momii Aki,S,Japan,21.0,176,2021,Poland,2021-06-08,True,0,1,11,12,57,0,94,151,0,0,0,0,0,3,3,6,0,0,0,0,5,7,1,13
181033.0,Momii Aki,S,Japan,21.0,176,2021,Belgium,2021-06-14,True,0,2,11,13,33,1,70,104,0,0,1,1,1,4,3,8,0,0,0,0,9,4,3,16
181033.0,Momii Aki,S,Japan,21.0,176,2021,Dominican Republic,2021-06-18,True,0,1,8,9,70,1,87,158,0,0,4,4,2,6,2,10,0,0,0,0,16,2,0,18
181033.0,Momii Aki,S,Japan,21.0,176,2021,Germany,2021-06-19,True,0,1,9,10,14,2,86,102,1,0,2,3,0,3,2,5,0,0,0,0,12,5,1,18
181033.0,Momii Aki,S,Japan,21.0,176,2021,Serbia,2021-06-20,True,0,0,0,0,0,0,0,0,0,0,0,0,0,0,0,0,0,0,0,0,0,0,0,0
181033.0,Momii Aki,S,Japan,21.0,176,2021,Brazil,2021-06-24,False,0,0,7,7,38,2,93,133,2,1,1,4,2,6,3,11,0,0,0,0,13,3,0,16
124071.0,Knip Kirsten,L,Netherlands,29.0,175,2021,Belgium,2021-05-25,True,0,0,0,0,0,0,0,0,0,0,0,0,0,0,0,0,0,0,0,0,0,0,0,0
124071.0,Knip Kirsten,L,Netherlands,29.0,175,2021,Germany,2021-05-26,False,0,0,0,0,0,0,0,0,0,0,0,0,0,0,0,0,0,0,0,0,0,0,0,0
124071.0,Knip Kirsten,L,Netherlands,29.0,175,2021,Russia,2021-05-27,True,0,0,0,0,0,0,0,0,0,0,0,0,0,0,0,0,0,0,0,0,0,0,0,0
124071.0,Knip Kirsten,L,Netherlands,29.0,175,2021,Thailand,2021-05-31,True,0,0,0,0,0,0,0,0,0,0,0,0,0,0,0,0,2,0,1,3,5,0,0,5
124071.0,Knip Kirsten,L,Netherlands,29.0,175,2021,USA,2021-06-01,False,0,0,0,0,0,0,0,0,0,0,0,0,0,0,0,0,0,0,0,0,0,0,0,0
124071.0,Knip Kirsten,L,Netherlands,29.0,175,2021,Serbia,2021-06-02,True,0,0,0,0,0,0,0,0,0,0,0,0,0,0,0,0,0,0,0,0,0,0,0,0
124071.0,Knip Kirsten,L,Netherlands,29.0,175,2021,Japan,2021-06-06,True,0,0,0,0,0,0,0,0,0,0,0,0,0,0,0,0,0,0,0,0,0,0,0,0
124071.0,Knip Kirsten,L,Netherlands,29.0,175,2021,Poland,2021-06-07,True,0,0,0,0,0,0,2,2,0,0,0,0,0,0,0,0,1,0,5,6,10,4,2,16
124071.0,Knip Kirsten,L,Netherlands,29.0,175,2021,Dominican Republic,2021-06-14,False,0,0,0,0,0,0,3,3,0,0,0,0,0,0,0,0,0,0,0,0,3,1,1,5
124071.0,Knip Kirsten,L,Netherlands,29.0,175,2021,Brazil,2021-06-19,False,0,0,0,0,0,0,0,0,0,0,0,0,0,0,0,0,0,0,0,0,0,0,0,0
150828.0,Savelkoel Fleur,OH,Netherlands,26.0,184,2021,Belgium,2021-05-25,True,0,0,0,0,0,0,0,0,0,0,0,0,0,0,0,0,0,0,0,0,0,0,0,0
150828.0,Savelkoel Fleur,OH,Netherlands,26.0,184,2021,Germany,2021-05-26,False,0,0,0,0,0,0,0,0,0,0,0,0,0,0,0,0,0,0,0,0,0,0,0,0
150828.0,Savelkoel Fleur,OH,Netherlands,26.0,184,2021,Russia,2021-05-27,True,0,0,0,0,0,0,0,0,0,0,0,0,0,0,0,0,0,0,0,0,0,0,0,0
150828.0,Savelkoel Fleur,OH,Netherlands,26.0,184,2021,Thailand,2021-05-31,True,0,0,0,0,0,0,0,0,1,0,2,3,0,0,0,0,0,0,0,0,0,0,0,0
150828.0,Savelkoel Fleur,OH,Netherlands,26.0,184,2021,USA,2021-06-01,False,0,0,0,0,0,0,0,0,0,0,0,0,0,0,0,0,0,0,0,0,0,0,0,0
150828.0,Savelkoel Fleur,OH,Netherlands,26.0,184,2021,Serbia,2021-06-02,True,0,0,0,0,0,0,0,0,0,0,0,0,0,0,0,0,0,0,0,0,0,0,0,0
150828.0,Savelkoel Fleur,OH,Netherlands,26.0,184,2021,Japan,2021-06-06,True,0,0,0,0,0,0,0,0,0,0,0,0,0,0,0,0,0,0,0,0,0,0,0,0
150828.0,Savelkoel Fleur,OH,Netherlands,26.0,184,2021,Canada,2021-06-08,True,0,0,0,0,0,0,0,0,0,0,0,0,0,0,0,0,0,0,0,0,0,0,0,0
150828.0,Savelkoel Fleur,OH,Netherlands,26.0,184,2021,China,2021-06-12,False,0,0,0,0,0,0,0,0,0,0,0,0,0,0,0,0,0,0,0,0,0,0,0,0
150828.0,Savelkoel Fleur,OH,Netherlands,26.0,184,2021,Italy,2021-06-13,True,0,0,0,0,0,0,0,0,0,0,0,0,0,0,0,0,0,0,0,0,0,0,0,0
150828.0,Savelkoel Fleur,OH,Netherlands,26.0,184,2021,Dominican Republic,2021-06-14,False,0,0,0,0,0,0,0,0,0,0,0,0,0,0,0,0,0,0,0,0,0,0,0,0
142880.0,Plak Celeste,O,Netherlands,26.0,190,2021,Serbia,2021-06-02,True,0,0,1,1,0,0,0,0,0,0,2,2,0,0,0,0,0,0,0,0,2,0,0,2
142880.0,Plak Celeste,O,Netherlands,26.0,190,2021,Japan,2021-06-06,True,0,1,1,2,0,0,0,0,0,0,2,2,0,0,0,0,0,0,0,0,3,1,0,4
142880.0,Plak Celeste,O,Netherlands,26.0,190,2021,Poland,2021-06-07,True,0,1,0,1,0,0,0,0,0,0,0,0,0,0,0,0,0,0,0,0,0,0,0,0
142880.0,Plak Celeste,O,Netherlands,26.0,190,2021,Canada,2021-06-08,True,0,0,9,9,0,0,0,0,4,1,5,10,0,2,0,2,0,0,0,0,3,1,0,4
142880.0,Plak Celeste,O,Netherlands,26.0,190,2021,China,2021-06-12,False,0,1,6,7,0,0,2,2,9,1,12,22,1,1,0,2,0,0,0,0,3,3,0,6
142880.0,Plak Celeste,O,Netherlands,26.0,190,2021,Italy,2021-06-13,True,0,1,5,6,0,0,0,0,12,3,3,18,0,2,1,3,0,0,0,0,2,1,1,4
142880.0,Plak Celeste,O,Netherlands,26.0,190,2021,Dominican Republic,2021-06-14,False,0,2,15,17,0,1,0,1,11,4,15,30,0,2,4,6,0,0,1,1,8,3,2,13
142880.0,Plak Celeste,O,Netherlands,26.0,190,2021,Brazil,2021-06-19,False,1,0,12,13,0,0,1,1,15,4,16,35,1,3,4,8,0,0,0,0,13,2,1,16
151194.0,Lohuis Juliet,MB,Netherlands,25.0,190,2021,Thailand,2021-05-31,True,1,4,13,18,0,0,0,0,3,0,0,3,0,1,2,3,0,0,0,0,1,1,1,3
151194.0,Lohuis Juliet,MB,Netherlands,25.0,190,2021,USA,2021-06-01,False,0,1,6,7,0,0,0,0,0,0,2,2,0,0,0,0,0,0,0,0,1,0,0,1
151194.0,Lohuis Juliet,MB,Netherlands,25.0,190,2021,Serbia,2021-06-02,True,3,1,17,21,0,0,2,2,9,3,4,16,5,4,6,15,0,0,0,0,3,2,0,5
151194.0,Lohuis Juliet,MB,Netherlands,25.0,190,2021,Japan,2021-06-06,True,0,1,6,7,0,0,0,0,5,2,9,16,3,3,7,13,0,0,1,1,1,0,2,3
151194.0,Lohuis Juliet,MB,Netherlands,25.0,190,2021,Poland,2021-06-07,True,1,2,14,17,0,0,1,1,6,1,4,11,1,5,8,14,0,0,0,0,2,2,1,5
151194.0,Lohuis Juliet,MB,Netherlands,25.0,190,2021,Canada,2021-06-08,True,1,0,10,11,0,0,0,0,10,0,2,12,1,3,1,5,0,0,0,0,3,1,0,4
151194.0,Lohuis Juliet,MB,Netherlands,25.0,190,2021,China,2021-06-12,False,0,0,8,8,0,0,0,0,1,3,6,10,1,2,1,4,0,0,0,0,0,0,0,0
151194.0,Lohuis Juliet,MB,Netherlands,25.0,190,2021,Italy,2021-06-13,True,3,3,20,26,0,0,2,2,11,1,8,20,1,5,3,9,0,0,0,0,4,1,1,6
151194.0,Lohuis Juliet,MB,Netherlands,25.0,190,2021,Dominican Republic,2021-06-14,False,1,2,15,18,0,0,1,1,7,1,6,14,3,8,7,18,0,0,0,0,7,0,1,8
151194.0,Lohuis Juliet,MB,Netherlands,25.0,190,2021,Brazil,2021-06-19,False,0,1,5,6,0,0,2,2,3,0,5,8,0,2,2,4,0,0,1,1,2,0,1,3
167777.0,Korevaar Demi,MB,Netherlands,21.0,187,2021,Belgium,2021-05-25,True,0,0,5,5,0,0,0,0,0,0,0,0,0,0,0,0,0,0,0,0,0,0,0,0
167777.0,Korevaar Demi,MB,Netherlands,21.0,187,2021,Germany,2021-05-26,False,0,1,2,3,0,0,0,0,0,0,0,0,0,0,0,0,0,0,0,0,0,0,0,0
167777.0,Korevaar Demi,MB,Netherlands,21.0,187,2021,Russia,2021-05-27,True,1,0,4,5,0,0,0,0,0,0,0,0,0,0,0,0,0,0,0,0,0,0,0,0
167777.0,Korevaar Demi,MB,Netherlands,21.0,187,2021,Thailand,2021-05-31,True,0,0,0,0,0,0,0,0,0,0,0,0,0,0,2,2,0,0,0,0,0,0,0,0
167777.0,Korevaar Demi,MB,Netherlands,21.0,187,2021,USA,2021-06-01,False,0,0,1,1,0,0,0,0,0,0,0,0,0,0,0,0,0,0,0,0,0,0,0,0
167777.0,Korevaar Demi,MB,Netherlands,21.0,187,2021,Serbia,2021-06-02,True,0,0,3,3,0,0,0,0,0,0,0,0,0,0,0,0,0,0,0,0,0,1,0,1
167777.0,Korevaar Demi,MB,Netherlands,21.0,187,2021,Poland,2021-06-07,True,0,0,0,0,0,0,0,0,0,0,0,0,0,0,0,0,0,0,0,0,0,0,0,0
167777.0,Korevaar Demi,MB,Netherlands,21.0,187,2021,Canada,2021-06-08,True,0,0,2,2,0,0,0,0,0,0,1,1,1,0,1,2,0,0,0,0,1,0,0,1
167777.0,Korevaar Demi,MB,Netherlands,21.0,187,2021,China,2021-06-12,False,0,0,0,0,0,0,0,0,0,0,0,0,0,0,0,0,0,0,0,0,0,0,0,0
167777.0,Korevaar Demi,MB,Netherlands,21.0,187,2021,Italy,2021-06-13,True,0,0,1,1,0,0,0,0,0,0,0,0,0,0,0,0,0,0,0,0,0,0,0,0
167777.0,Korevaar Demi,MB,Netherlands,21.0,187,2021,Dominican Republic,2021-06-14,False,0,0,2,2,0,0,0,0,0,0,0,0,0,0,0,0,0,0,0,0,0,0,0,0
167777.0,Korevaar Demi,MB,Netherlands,21.0,187,2021,Brazil,2021-06-19,False,0,0,5,5,0,0,0,0,2,0,3,5,1,1,1,3,0,0,0,0,2,1,0,3
123468.0,Schoot Myrthe,L,Netherlands,33.0,182,2021,Belgium,2021-05-25,True,0,0,0,0,0,0,2,2,0,0,0,0,0,0,0,0,4,0,6,10,15,2,1,18
123468.0,Schoot Myrthe,L,Netherlands,33.0,182,2021,Germany,2021-05-26,False,0,0,0,0,0,0,6,6,0,0,0,0,0,0,0,0,12,3,27,42,18,0,0,18
123468.0,Schoot Myrthe,L,Netherlands,33.0,182,2021,Russia,2021-05-27,True,0,0,0,0,0,0,3,3,0,0,0,0,0,0,0,0,10,0,8,18,18,1,0,19
123468.0,Schoot Myrthe,L,Netherlands,33.0,182,2021,Thailand,2021-05-31,True,0,0,0,0,0,1,0,1,0,0,0,0,0,0,0,0,3,0,1,4,7,1,2,10
123468.0,Schoot Myrthe,L,Netherlands,33.0,182,2021,USA,2021-06-01,False,0,0,0,0,0,0,11,11,0,0,0,0,0,0,0,0,4,0,5,9,13,6,0,19
123468.0,Schoot Myrthe,L,Netherlands,33.0,182,2021,Serbia,2021-06-02,True,0,0,0,0,0,0,6,6,0,0,0,0,0,0,0,0,6,0,8,14,21,5,4,30
123468.0,Schoot Myrthe,L,Netherlands,33.0,182,2021,Japan,2021-06-06,True,0,0,0,0,0,0,14,14,0,0,0,0,0,0,0,0,4,1,2,7,13,2,2,17
123468.0,Schoot Myrthe,L,Netherlands,33.0,182,2021,Poland,2021-06-07,True,0,0,0,0,0,0,7,7,0,0,0,0,0,0,0,0,0,0,3,3,5,1,1,7
123468.0,Schoot Myrthe,L,Netherlands,33.0,182,2021,Canada,2021-06-08,True,0,0,0,0,0,0,6,6,0,0,0,0,0,0,0,0,6,1,9,16,10,1,0,11
123468.0,Schoot Myrthe,L,Netherlands,33.0,182,2021,China,2021-06-12,False,0,0,0,0,0,0,10,10,0,0,0,0,0,0,0,0,6,1,5,12,12,8,2,22
123468.0,Schoot Myrthe,L,Netherlands,33.0,182,2021,Italy,2021-06-13,True,0,0,0,0,0,0,11,11,0,0,0,0,0,0,0,0,9,0,6,15,18,5,1,24
123468.0,Schoot Myrthe,L,Netherlands,33.0,182,2021,Dominican Republic,2021-06-14,False,0,0,0,0,0,0,7,7,0,0,0,0,0,0,0,0,7,0,14,21,9,7,1,17
123468.0,Schoot Myrthe,L,Netherlands,33.0,182,2021,Brazil,2021-06-19,False,0,0,0,0,0,0,11,11,0,0,0,0,0,0,0,0,4,1,4,9,4,1,6,11
162356.0,van Aalen Sarah,S,Netherlands,22.0,186,2021,Belgium,2021-05-25,True,0,0,0,0,0,0,0,0,0,0,0,0,0,0,0,0,0,0,0,0,0,0,0,0
162356.0,van Aalen Sarah,S,Netherlands,22.0,186,2021,Germany,2021-05-26,False,0,0,0,0,0,0,0,0,0,0,0,0,0,0,0,0,0,0,0,0,0,0,0,0
162356.0,van Aalen Sarah,S,Netherlands,22.0,186,2021,Russia,2021-05-27,True,0,0,0,0,0,0,0,0,0,0,0,0,0,0,0,0,0,0,0,0,0,0,0,0
162356.0,van Aalen Sarah,S,Netherlands,22.0,186,2021,Thailand,2021-05-31,True,0,0,1,1,0,0,0,0,0,0,0,0,0,0,0,0,0,0,0,0,0,0,0,0
162356.0,van Aalen Sarah,S,Netherlands,22.0,186,2021,USA,2021-06-01,False,0,0,0,0,0,0,0,0,0,0,0,0,0,0,0,0,0,0,0,0,0,0,0,0
162356.0,van Aalen Sarah,S,Netherlands,22.0,186,2021,Serbia,2021-06-02,True,0,0,0,0,0,0,0,0,0,0,0,0,0,0,0,0,0,0,0,0,0,0,0,0
162356.0,van Aalen Sarah,S,Netherlands,22.0,186,2021,Japan,2021-06-06,True,0,0,0,0,0,0,0,0,0,0,0,0,0,0,0,0,0,0,0,0,0,0,0,0
162356.0,van Aalen Sarah,S,Netherlands,22.0,186,2021,Poland,2021-06-07,True,0,0,0,0,0,0,0,0,0,0,0,0,0,0,0,0,0,0,0,0,0,0,0,0
162356.0,van Aalen Sarah,S,Netherlands,22.0,186,2021,Canada,2021-06-08,True,0,0,0,0,0,0,0,0,0,0,0,0,0,0,0,0,0,0,0,0,0,0,0,0
162356.0,van Aalen Sarah,S,Netherlands,22.0,186,2021,China,2021-06-12,False,0,0,0,0,1,0,0,1,0,0,0,0,0,0,0,0,0,0,0,0,0,0,0,0
162356.0,van Aalen Sarah,S,Netherlands,22.0,186,2021,Italy,2021-06-13,True,0,0,0,0,0,0,0,0,0,0,0,0,0,0,0,0,0,0,0,0,0,0,0,0
162356.0,van Aalen Sarah,S,Netherlands,22.0,186,2021,Dominican Republic,2021-06-14,False,0,0,0,0,0,0,0,0,0,0,0,0,0,0,0,0,0,0,0,0,0,0,0,0
162356.0,van Aalen Sarah,S,Netherlands,22.0,186,2021,Brazil,2021-06-19,False,0,0,0,0,1,0,5,6,0,0,0,0,0,0,0,0,0,0,0,0,0,0,0,0
120503.0,Buijs Anne,OH,Netherlands,30.0,-,2021,Belgium,2021-05-25,True,0,1,10,11,0,0,1,1,12,4,11,27,0,3,4,7,13,2,12,27,10,0,0,10
120503.0,Buijs Anne,OH,Netherlands,30.0,-,2021,Germany,2021-05-26,False,0,1,15,16,0,0,0,0,13,6,21,40,1,0,0,1,13,3,19,35,9,1,0,10
120503.0,Buijs Anne,OH,Netherlands,30.0,-,2021,Russia,2021-05-27,True,0,0,17,17,0,0,1,1,12,2,12,26,3,3,0,6,8,4,15,27,15,2,0,17
120503.0,Buijs Anne,OH,Netherlands,30.0,-,2021,Thailand,2021-05-31,True,3,0,16,19,0,0,0,0,10,1,8,19,0,1,0,1,5,1,11,17,5,2,3,10
120503.0,Buijs Anne,OH,Netherlands,30.0,-,2021,USA,2021-06-01,False,0,0,8,8,0,0,6,6,5,2,24,31,4,4,1,9,9,3,11,23,11,2,2,15
120503.0,Buijs Anne,OH,Netherlands,30.0,-,2021,Serbia,2021-06-02,True,0,0,0,0,0,0,0,0,0,0,0,0,0,0,0,0,0,0,0,0,0,0,0,0
120503.0,Buijs Anne,OH,Netherlands,30.0,-,2021,Japan,2021-06-06,True,0,1,4,5,0,0,1,1,3,3,7,13,0,2,0,2,4,0,11,15,4,1,1,6
120503.0,Buijs Anne,OH,Netherlands,30.0,-,2021,Poland,2021-06-07,True,0,0,21,21,0,0,2,2,16,7,22,45,1,4,3,8,15,2,30,47,11,3,1,15
120503.0,Buijs Anne,OH,Netherlands,30.0,-,2021,Canada,2021-06-08,True,1,0,13,14,0,0,0,0,11,2,10,23,3,2,0,5,6,0,10,16,2,1,0,3
120503.0,Buijs Anne,OH,Netherlands,30.0,-,2021,China,2021-06-12,False,0,0,8,8,0,0,0,0,8,4,23,35,1,3,0,4,12,2,12,26,3,2,0,5
120503.0,Buijs Anne,OH,Netherlands,30.0,-,2021,Italy,2021-06-13,True,0,3,6,9,0,0,2,2,14,4,25,43,1,2,1,4,12,2,19,33,1,2,0,3
120503.0,Buijs Anne,OH,Netherlands,30.0,-,2021,Dominican Republic,2021-06-14,False,0,3,7,10,0,0,0,0,16,9,23,48,0,4,5,9,11,1,20,32,13,2,3,18
120503.0,Buijs Anne,OH,Netherlands,30.0,-,2021,Brazil,2021-06-19,False,0,1,9,10,0,0,2,2,6,3,6,15,0,2,1,3,12,2,12,26,6,5,1,12
147432.0,Bongaerts Britt,S,Netherlands,25.0,185,2021,Belgium,2021-05-25,True,0,1,8,9,36,0,62,98,2,0,3,5,1,1,3,5,0,0,0,0,2,1,0,3
147432.0,Bongaerts Britt,S,Netherlands,25.0,185,2021,Germany,2021-05-26,False,3,1,14,18,33,0,103,136,2,0,3,5,0,4,1,5,0,0,0,0,7,0,0,7
147432.0,Bongaerts Britt,S,Netherlands,25.0,185,2021,Russia,2021-05-27,True,3,0,14,17,22,0,87,109,1,0,2,3,0,3,0,3,0,0,0,0,5,1,0,6
147432.0,Bongaerts Britt,S,Netherlands,25.0,185,2021,Thailand,2021-05-31,True,0,0,6,6,19,0,0,19,4,0,3,7,3,2,1,6,0,0,0,0,2,2,1,5
147432.0,Bongaerts Britt,S,Netherlands,25.0,185,2021,USA,2021-06-01,False,0,2,7,9,20,0,74,94,0,0,0,0,0,3,4,7,0,1,0,1,6,5,0,11
147432.0,Bongaerts Britt,S,Netherlands,25.0,185,2021,Serbia,2021-06-02,True,0,0,12,12,28,1,94,123,1,0,2,3,2,2,5,9,0,0,0,0,9,3,1,13
147432.0,Bongaerts Britt,S,Netherlands,25.0,185,2021,Japan,2021-06-06,True,0,2,11,13,35,0,60,95,1,0,3,4,0,3,5,8,0,0,0,0,6,1,3,10
147432.0,Bongaerts Britt,S,Netherlands,25.0,185,2021,Poland,2021-06-07,True,0,0,13,13,29,0,97,126,2,0,1,3,1,1,2,4,0,1,0,1,12,1,1,14
147432.0,Bongaerts Britt,S,Netherlands,25.0,185,2021,Canada,2021-06-08,True,1,1,6,8,10,1,67,78,1,0,2,3,2,1,3,6,0,0,0,0,4,3,1,8
147432.0,Bongaerts Britt,S,Netherlands,25.0,185,2021,China,2021-06-12,False,1,0,15,16,6,1,105,112,1,0,0,1,0,3,0,3,0,0,0,0,3,3,0,6
147432.0,Bongaerts Britt,S,Netherlands,25.0,185,2021,Italy,2021-06-13,True,0,1,10,11,22,1,118,141,4,1,3,8,3,3,4,10,0,0,0,0,6,5,0,11
147432.0,Bongaerts Britt,S,Netherlands,25.0,185,2021,Dominican Republic,2021-06-14,False,1,0,13,14,30,0,106,136,1,0,5,6,0,4,1,5,0,0,0,0,5,3,1,9
147432.0,Bongaerts Britt,S,Netherlands,25.0,185,2021,Brazil,2021-06-19,False,0,2,4,6,17,2,65,84,1,1,2,4,0,1,1,2,0,0,0,0,13,3,1,17
167778.0,Jasper Hester,OH,Netherlands,20.0,175,2021,Canada,2021-06-08,True,0,0,0,0,0,0,0,0,0,0,0,0,0,0,0,0,0,0,0,0,0,0,0,0
150807.0,Oude Luttikhuis Nicole,OH,Netherlands,24.0,191,2021,Brazil,2021-06-19,False,0,0,0,0,0,0,0,0,0,0,0,0,0,0,0,0,0,0,0,0,0,0,0,0
159904.0,Jasper Marrit,OH,Netherlands,26.0,180,2021,Belgium,2021-05-25,True,0,0,0,0,0,0,0,0,0,0,0,0,0,0,0,0,0,0,0,0,0,0,0,0
159904.0,Jasper Marrit,OH,Netherlands,26.0,180,2021,Germany,2021-05-26,False,0,0,5,5,0,0,0,0,0,0,0,0,0,0,0,0,0,0,0,0,1,0,0,1
159904.0,Jasper Marrit,OH,Netherlands,26.0,180,2021,Russia,2021-05-27,True,0,0,0,0,0,0,0,0,0,0,0,0,0,0,0,0,0,1,0,1,0,0,0,0
159904.0,Jasper Marrit,OH,Netherlands,26.0,180,2021,Thailand,2021-05-31,True,0,1,2,3,0,0,0,0,0,0,0,0,0,0,0,0,0,0,1,1,1,0,0,1
159904.0,Jasper Marrit,OH,Netherlands,26.0,180,2021,USA,2021-06-01,False,0,1,1,2,0,0,0,0,1,0,3,4,0,0,1,1,2,1,5,8,3,2,1,6
159904.0,Jasper Marrit,OH,Netherlands,26.0,180,2021,Serbia,2021-06-02,True,1,0,13,14,0,0,2,2,4,5,15,24,0,0,1,1,8,0,9,17,15,1,1,17
159904.0,Jasper Marrit,OH,Netherlands,26.0,180,2021,Japan,2021-06-06,True,0,1,9,10,0,0,0,0,5,3,9,17,0,1,3,4,7,0,4,11,10,1,0,11
159904.0,Jasper Marrit,OH,Netherlands,26.0,180,2021,Poland,2021-06-07,True,1,0,5,6,0,0,0,0,0,0,3,3,0,0,0,0,3,0,3,6,3,1,0,4
159904.0,Jasper Marrit,OH,Netherlands,26.0,180,2021,Canada,2021-06-08,True,0,0,1,1,0,0,1,1,0,1,1,2,0,0,0,0,0,0,4,4,2,2,0,4
159904.0,Jasper Marrit,OH,Netherlands,26.0,180,2021,China,2021-06-12,False,0,0,2,2,0,0,0,0,0,0,0,0,0,0,0,0,1,0,6,7,2,1,1,4
159904.0,Jasper Marrit,OH,Netherlands,26.0,180,2021,Italy,2021-06-13,True,1,0,8,9,0,0,0,0,0,0,0,0,0,0,0,0,2,1,0,3,2,1,0,3
159904.0,Jasper Marrit,OH,Netherlands,26.0,180,2021,Dominican Republic,2021-06-14,False,0,1,1,2,0,0,1,1,0,0,0,0,0,0,0,0,2,0,7,9,4,0,0,4
159904.0,Jasper Marrit,OH,Netherlands,26.0,180,2021,Brazil,2021-06-19,False,0,0,1,1,0,0,2,2,2,0,2,4,1,0,2,3,3,0,4,7,1,1,0,2
150809.0,Daalderop Nika,OH,Netherlands,23.0,189,2021,Belgium,2021-05-25,True,1,1,14,16,0,0,0,0,7,3,11,21,2,3,2,7,6,0,5,11,8,6,1,15
150809.0,Daalderop Nika,OH,Netherlands,23.0,189,2021,Germany,2021-05-26,False,1,4,16,21,0,0,1,1,21,5,20,46,3,1,0,4,7,0,10,17,13,2,0,15
150809.0,Daalderop Nika,OH,Netherlands,23.0,189,2021,Russia,2021-05-27,True,1,3,12,16,0,0,0,0,13,4,16,33,1,4,2,7,5,2,16,23,4,6,0,10
150809.0,Daalderop Nika,OH,Netherlands,23.0,189,2021,Thailand,2021-05-31,True,0,1,9,10,0,0,0,0,11,1,9,21,1,3,2,6,12,1,3,16,7,1,0,8
150809.0,Daalderop Nika,OH,Netherlands,23.0,189,2021,USA,2021-06-01,False,0,1,5,6,0,0,2,2,6,7,20,33,0,3,1,4,5,2,13,20,4,2,1,7
150809.0,Daalderop Nika,OH,Netherlands,23.0,189,2021,Serbia,2021-06-02,True,2,2,10,14,0,0,0,0,15,5,23,43,3,3,6,12,11,2,29,42,8,0,2,10
150809.0,Daalderop Nika,OH,Netherlands,23.0,189,2021,Japan,2021-06-06,True,2,2,9,13,0,0,0,0,19,3,14,36,1,2,1,4,4,1,24,29,4,2,4,10
150809.0,Daalderop Nika,OH,Netherlands,23.0,189,2021,Poland,2021-06-07,True,1,1,10,12,0,0,2,2,16,7,16,39,1,3,7,11,6,1,17,24,4,4,2,10
150809.0,Daalderop Nika,OH,Netherlands,23.0,189,2021,Canada,2021-06-08,True,1,1,13,15,0,0,0,0,7,3,11,21,1,0,1,2,3,1,7,11,3,4,1,8
150809.0,Daalderop Nika,OH,Netherlands,23.0,189,2021,China,2021-06-12,False,0,0,10,10,0,0,1,1,11,4,24,39,0,0,2,2,11,1,20,32,5,4,0,9
150809.0,Daalderop Nika,OH,Netherlands,23.0,189,2021,Italy,2021-06-13,True,2,3,13,18,0,0,0,0,16,1,26,43,2,6,2,10,18,3,22,43,13,3,0,16
150809.0,Daalderop Nika,OH,Netherlands,23.0,189,2021,Dominican Republic,2021-06-14,False,3,3,12,18,0,0,3,3,19,4,20,43,1,1,2,4,5,1,20,26,13,0,3,16
150809.0,Daalderop Nika,OH,Netherlands,23.0,189,2021,Brazil,2021-06-19,False,0,1,10,11,0,0,4,4,12,2,16,30,0,0,2,2,13,0,16,29,4,2,5,11
168147.0,Meijers Annick,OH,Netherlands,22.0,191,2021,Thailand,2021-05-31,True,0,0,0,0,0,0,0,0,1,0,1,2,0,0,0,0,0,0,0,0,0,0,0,0
168147.0,Meijers Annick,OH,Netherlands,22.0,191,2021,China,2021-06-12,False,0,0,2,2,0,0,0,0,0,0,2,2,0,0,0,0,0,0,0,0,1,0,0,1
168147.0,Meijers Annick,OH,Netherlands,22.0,191,2021,Italy,2021-06-13,True,0,0,0,0,0,0,0,0,0,0,0,0,0,0,0,0,0,0,0,0,0,0,0,0
168147.0,Meijers Annick,OH,Netherlands,22.0,191,2021,Dominican Republic,2021-06-14,False,0,0,1,1,0,0,0,0,0,0,0,0,0,0,0,0,0,0,0,0,0,1,0,1
168147.0,Meijers Annick,OH,Netherlands,22.0,191,2021,Brazil,2021-06-19,False,0,0,0,0,0,0,0,0,0,0,0,0,0,0,0,0,0,0,0,0,0,0,0,0
172894.0,Timmerman Eline,MB,Netherlands,23.0,192,2021,Belgium,2021-05-25,True,2,3,8,13,0,0,1,1,7,2,2,11,1,4,4,9,0,0,0,0,4,0,1,5
172894.0,Timmerman Eline,MB,Netherlands,23.0,192,2021,Germany,2021-05-26,False,1,2,15,18,0,0,1,1,7,4,10,21,1,2,2,5,0,0,1,1,5,0,0,5
172894.0,Timmerman Eline,MB,Netherlands,23.0,192,2021,Russia,2021-05-27,True,0,4,10,14,0,0,0,0,10,1,3,14,2,8,0,10,0,0,0,0,5,0,0,5
172894.0,Timmerman Eline,MB,Netherlands,23.0,192,2021,Thailand,2021-05-31,True,1,3,5,9,0,0,0,0,4,0,6,10,6,2,1,9,0,0,1,1,1,0,0,1
172894.0,Timmerman Eline,MB,Netherlands,23.0,192,2021,USA,2021-06-01,False,0,2,5,7,0,0,0,0,3,2,5,10,1,5,8,14,0,0,0,0,3,1,1,5
172894.0,Timmerman Eline,MB,Netherlands,23.0,192,2021,Serbia,2021-06-02,True,1,2,7,10,0,0,1,1,6,2,6,14,4,9,6,19,0,0,0,0,2,0,0,2
172894.0,Timmerman Eline,MB,Netherlands,23.0,192,2021,Japan,2021-06-06,True,2,0,9,11,0,0,0,0,7,1,2,10,3,2,6,11,0,0,0,0,3,0,0,3
172894.0,Timmerman Eline,MB,Netherlands,23.0,192,2021,Poland,2021-06-07,True,1,2,17,20,0,0,4,4,10,1,4,15,5,8,13,26,0,0,1,1,6,2,1,9
172894.0,Timmerman Eline,MB,Netherlands,23.0,192,2021,Canada,2021-06-08,True,0,3,5,8,0,0,1,1,6,1,4,11,4,2,1,7,0,0,0,0,3,1,1,5
172894.0,Timmerman Eline,MB,Netherlands,23.0,192,2021,China,2021-06-12,False,0,1,5,6,0,0,0,0,6,0,7,13,3,3,1,7,0,0,0,0,2,2,0,4
172894.0,Timmerman Eline,MB,Netherlands,23.0,192,2021,Italy,2021-06-13,True,0,4,11,15,0,0,4,4,7,3,6,16,0,4,1,5,1,0,0,1,1,0,1,2
172894.0,Timmerman Eline,MB,Netherlands,23.0,192,2021,Dominican Republic,2021-06-14,False,0,4,8,12,0,0,2,2,8,5,4,17,1,7,10,18,0,0,1,1,6,0,2,8
172894.0,Timmerman Eline,MB,Netherlands,23.0,192,2021,Brazil,2021-06-19,False,0,1,7,8,0,0,1,1,5,3,6,14,0,9,4,13,0,0,0,0,0,0,1,1
162357.0,de Zwart Laura,MB,Netherlands,23.0,199,2021,Belgium,2021-05-25,True,0,0,0,0,0,0,0,0,0,0,0,0,0,0,0,0,0,0,0,0,0,0,0,0
162357.0,de Zwart Laura,MB,Netherlands,23.0,199,2021,Germany,2021-05-26,False,0,0,0,0,0,0,0,0,0,0,0,0,0,0,0,0,0,0,0,0,0,0,0,0
162357.0,de Zwart Laura,MB,Netherlands,23.0,199,2021,Russia,2021-05-27,True,0,0,0,0,0,0,0,0,0,0,0,0,0,0,0,0,0,0,0,0,1,0,0,1
148581.0,Reesink Florien,L,Netherlands,23.0,174,2021,China,2021-06-12,False,0,0,0,0,0,0,0,0,0,0,0,0,0,0,0,0,0,0,0,0,0,0,0,0
148581.0,Reesink Florien,L,Netherlands,23.0,174,2021,Italy,2021-06-13,True,0,0,0,0,0,0,0,0,0,0,0,0,0,0,0,0,0,0,0,0,0,0,0,0
162372.0,Scholten Iris,O,Netherlands,22.0,191,2021,Belgium,2021-05-25,True,0,0,0,0,0,0,0,0,0,0,0,0,0,0,0,0,0,0,0,0,0,0,0,0
162372.0,Scholten Iris,O,Netherlands,22.0,191,2021,Germany,2021-05-26,False,0,0,0,0,0,0,0,0,0,0,0,0,0,0,0,0,0,0,0,0,0,0,0,0
162372.0,Scholten Iris,O,Netherlands,22.0,191,2021,Russia,2021-05-27,True,0,0,0,0,0,0,0,0,0,0,0,0,0,0,0,0,0,0,0,0,0,0,0,0
162372.0,Scholten Iris,O,Netherlands,22.0,191,2021,USA,2021-06-01,False,0,0,0,0,0,0,0,0,0,0,0,0,0,0,0,0,0,0,0,0,0,0,0,0
162372.0,Scholten Iris,O,Netherlands,22.0,191,2021,Japan,2021-06-06,True,0,0,0,0,0,0,0,0,0,0,0,0,0,0,0,0,0,0,0,0,0,0,0,0
162372.0,Scholten Iris,O,Netherlands,22.0,191,2021,Poland,2021-06-07,True,0,0,2,2,0,0,0,0,0,1,0,1,0,1,0,1,0,0,0,0,2,0,0,2
162372.0,Scholten Iris,O,Netherlands,22.0,191,2021,Canada,2021-06-08,True,0,0,0,0,0,0,0,0,0,0,0,0,0,0,0,0,0,0,0,0,0,0,0,0
162372.0,Scholten Iris,O,Netherlands,22.0,191,2021,China,2021-06-12,False,1,0,2,3,0,0,0,0,2,0,6,8,1,0,2,3,0,0,0,0,0,0,0,0
162372.0,Scholten Iris,O,Netherlands,22.0,191,2021,Italy,2021-06-13,True,0,0,15,15,0,0,1,1,5,2,11,18,2,1,0,3,0,0,0,0,6,1,0,7
162372.0,Scholten Iris,O,Netherlands,22.0,191,2021,Dominican Republic,2021-06-14,False,0,1,4,5,0,0,0,0,2,0,4,6,1,0,0,1,0,0,0,0,6,2,1,9
162372.0,Scholten Iris,O,Netherlands,22.0,191,2021,Brazil,2021-06-19,False,0,0,0,0,0,0,0,0,1,0,1,2,0,1,1,2,0,0,0,0,0,0,0,0
152216.0,Nowicka Julia,S,Poland,23.0,174,2021,Italy,2021-05-25,True,0,2,16,18,16,3,112,131,2,1,4,7,0,5,4,9,0,0,0,0,13,2,0,15
152216.0,Nowicka Julia,S,Poland,23.0,174,2021,Serbia,2021-05-26,False,0,0,8,8,10,1,50,61,1,1,2,4,2,2,3,7,0,0,1,1,1,2,1,4
152216.0,Nowicka Julia,S,Poland,23.0,174,2021,Belgium,2021-06-01,False,1,1,21,23,20,1,92,113,0,0,3,3,0,2,5,7,0,0,0,0,11,3,3,17
152216.0,Nowicka Julia,S,Poland,23.0,174,2021,Dominican Republic,2021-06-02,False,1,1,17,19,36,0,81,117,1,1,6,8,2,4,0,6,0,0,0,0,16,0,1,17
152216.0,Nowicka Julia,S,Poland,23.0,174,2021,Canada,2021-06-06,True,1,2,17,20,12,0,91,103,1,1,2,4,2,1,1,4,0,0,0,0,4,4,0,8
152216.0,Nowicka Julia,S,Poland,23.0,174,2021,Netherlands,2021-06-07,False,1,4,16,21,33,0,71,104,0,0,0,0,0,2,5,7,0,0,1,1,14,1,2,17
152216.0,Nowicka Julia,S,Poland,23.0,174,2021,Japan,2021-06-08,False,0,1,19,20,29,2,95,126,4,0,4,8,1,7,0,8,0,0,0,0,6,2,1,9
152216.0,Nowicka Julia,S,Poland,23.0,174,2021,Brazil,2021-06-12,False,0,0,3,3,0,0,4,4,0,0,0,0,0,0,0,0,0,0,0,0,3,1,1,5
152216.0,Nowicka Julia,S,Poland,23.0,174,2021,Thailand,2021-06-13,True,0,0,0,0,6,0,10,16,0,0,0,0,0,0,0,0,0,0,0,0,1,0,0,1
152216.0,Nowicka Julia,S,Poland,23.0,174,2021,Germany,2021-06-14,False,0,0,7,7,1,0,11,12,0,0,0,0,0,0,1,1,0,0,0,0,1,0,0,1
152216.0,Nowicka Julia,S,Poland,23.0,174,2021,USA,2021-06-18,False,0,1,2,3,1,0,15,16,0,0,0,0,0,0,0,0,0,0,0,0,3,1,0,4
152216.0,Nowicka Julia,S,Poland,23.0,174,2021,China,2021-06-19,False,0,0,0,0,2,0,2,4,0,0,0,0,0,0,0,0,0,0,0,0,1,0,0,1
152216.0,Nowicka Julia,S,Poland,23.0,174,2021,Russia,2021-06-20,True,0,0,7,7,2,0,5,7,0,0,1,1,0,0,0,0,0,0,0,0,3,0,0,3
162398.0,Alagierska-Szczepaniak Klaudia,MB,Poland,26.0,190,2021,Italy,2021-05-25,True,1,0,11,12,0,0,1,1,3,1,0,4,1,0,3,4,0,0,1,1,2,0,0,2
162398.0,Alagierska-Szczepaniak Klaudia,MB,Poland,26.0,190,2021,Serbia,2021-05-26,False,0,0,5,5,0,0,1,1,0,0,3,3,0,1,0,1,0,0,0,0,0,0,0,0
162398.0,Alagierska-Szczepaniak Klaudia,MB,Poland,26.0,190,2021,Belgium,2021-06-01,False,0,2,14,16,0,0,1,1,8,2,1,11,4,5,7,16,0,0,1,1,7,1,0,8
162398.0,Alagierska-Szczepaniak Klaudia,MB,Poland,26.0,190,2021,Dominican Republic,2021-06-02,False,0,2,20,22,0,0,1,1,9,1,4,14,0,3,4,7,0,0,1,1,5,2,0,7
162398.0,Alagierska-Szczepaniak Klaudia,MB,Poland,26.0,190,2021,Canada,2021-06-06,True,1,0,15,16,0,0,0,0,6,3,2,11,2,3,2,7,0,0,1,1,2,2,0,4
162398.0,Alagierska-Szczepaniak Klaudia,MB,Poland,26.0,190,2021,Netherlands,2021-06-07,False,0,0,4,4,0,0,1,1,2,0,1,3,0,0,2,2,0,0,0,0,2,0,0,2
162398.0,Alagierska-Szczepaniak Klaudia,MB,Poland,26.0,190,2021,Japan,2021-06-08,False,0,2,22,24,0,0,0,0,5,1,2,8,2,4,2,8,0,0,0,0,4,4,0,8
162398.0,Alagierska-Szczepaniak Klaudia,MB,Poland,26.0,190,2021,Brazil,2021-06-12,False,0,2,8,10,0,0,4,4,4,1,2,7,0,5,1,6,0,0,0,0,2,1,1,4
162398.0,Alagierska-Szczepaniak Klaudia,MB,Poland,26.0,190,2021,Thailand,2021-06-13,True,0,2,6,8,0,0,1,1,4,0,3,7,1,4,3,8,0,0,0,0,2,4,0,6
162398.0,Alagierska-Szczepaniak Klaudia,MB,Poland,26.0,190,2021,Germany,2021-06-14,False,1,0,12,13,0,0,1,1,4,1,2,7,2,3,4,9,0,0,0,0,3,0,0,3
162398.0,Alagierska-Szczepaniak Klaudia,MB,Poland,26.0,190,2021,USA,2021-06-18,False,1,0,12,13,0,0,0,0,6,1,1,8,0,0,5,5,0,0,1,1,4,0,0,4
162398.0,Alagierska-Szczepaniak Klaudia,MB,Poland,26.0,190,2021,China,2021-06-19,False,0,1,5,6,0,0,0,0,4,3,0,7,1,2,0,3,0,0,1,1,2,0,0,2
162398.0,Alagierska-Szczepaniak Klaudia,MB,Poland,26.0,190,2021,Russia,2021-06-20,True,2,0,11,13,0,0,1,1,0,3,2,5,2,0,1,3,0,0,0,0,3,1,0,4
136317.0,Korneluk Agnieszka,MB,Poland,27.0,200,2021,Italy,2021-05-25,True,2,2,6,10,0,0,1,1,2,0,7,9,1,1,7,9,0,0,0,0,1,0,0,1
136317.0,Korneluk Agnieszka,MB,Poland,27.0,200,2021,Serbia,2021-05-26,False,1,1,7,9,0,0,1,1,7,2,8,17,1,3,0,4,2,0,0,2,1,2,0,3
136317.0,Korneluk Agnieszka,MB,Poland,27.0,200,2021,Belgium,2021-06-01,False,0,0,0,0,0,0,0,0,0,0,0,0,0,0,0,0,0,0,0,0,0,0,0,0
136317.0,Korneluk Agnieszka,MB,Poland,27.0,200,2021,Dominican Republic,2021-06-02,False,0,1,10,11,0,0,1,1,3,2,2,7,6,4,3,13,0,0,0,0,5,3,3,11
136317.0,Korneluk Agnieszka,MB,Poland,27.0,200,2021,Canada,2021-06-06,True,0,0,0,0,0,0,0,0,0,0,0,0,0,0,0,0,0,0,0,0,0,0,0,0
136317.0,Korneluk Agnieszka,MB,Poland,27.0,200,2021,Netherlands,2021-06-07,False,1,2,11,14,0,0,1,1,7,4,5,16,0,3,10,13,0,1,0,1,4,1,3,8
136317.0,Korneluk Agnieszka,MB,Poland,27.0,200,2021,Japan,2021-06-08,False,0,1,12,13,0,0,1,1,5,1,8,14,2,5,4,11,0,0,0,0,3,0,0,3
136317.0,Korneluk Agnieszka,MB,Poland,27.0,200,2021,USA,2021-06-18,False,0,0,1,1,0,0,1,1,0,0,0,0,0,0,0,0,0,0,0,0,0,0,0,0
136317.0,Korneluk Agnieszka,MB,Poland,27.0,200,2021,China,2021-06-19,False,0,0,2,2,0,0,0,0,2,0,0,2,0,0,1,1,0,0,0,0,1,1,0,2
136317.0,Korneluk Agnieszka,MB,Poland,27.0,200,2021,Russia,2021-06-20,True,1,0,7,8,0,0,0,0,2,0,1,3,7,2,1,10,0,0,0,0,2,1,2,5
152233.0,Stenzel Maria,L,Poland,23.0,168,2021,Italy,2021-05-25,True,0,0,0,0,0,0,5,5,0,0,0,0,0,0,0,0,13,2,16,31,8,2,0,10
152233.0,Stenzel Maria,L,Poland,23.0,168,2021,Serbia,2021-05-26,False,0,0,0,0,0,0,8,8,0,0,0,0,0,0,0,0,18,0,14,32,5,3,0,8
152233.0,Stenzel Maria,L,Poland,23.0,168,2021,Belgium,2021-06-01,False,0,0,0,0,0,0,16,16,0,0,0,0,0,0,0,0,5,4,26,35,10,0,1,11
152233.0,Stenzel Maria,L,Poland,23.0,168,2021,Dominican Republic,2021-06-02,False,0,0,0,0,0,0,13,13,0,0,0,0,0,0,0,0,14,1,11,26,10,3,3,16
152233.0,Stenzel Maria,L,Poland,23.0,168,2021,Canada,2021-06-06,True,0,0,0,0,1,0,8,9,0,0,0,0,0,0,0,0,13,1,12,26,3,2,0,5
152233.0,Stenzel Maria,L,Poland,23.0,168,2021,Netherlands,2021-06-07,False,0,0,0,0,0,0,8,8,0,0,0,0,0,0,0,0,13,1,20,34,4,1,0,5
152233.0,Stenzel Maria,L,Poland,23.0,168,2021,Japan,2021-06-08,False,0,0,0,0,0,0,12,12,0,0,0,0,0,0,0,0,10,0,13,23,10,3,1,14
152233.0,Stenzel Maria,L,Poland,23.0,168,2021,Brazil,2021-06-12,False,0,0,0,0,0,0,9,9,0,0,0,0,0,0,0,0,10,0,7,17,10,1,0,11
152233.0,Stenzel Maria,L,Poland,23.0,168,2021,Thailand,2021-06-13,True,0,0,0,0,0,0,18,18,0,0,0,0,0,0,0,0,2,0,19,21,14,1,0,15
152233.0,Stenzel Maria,L,Poland,23.0,168,2021,Germany,2021-06-14,False,0,0,0,0,0,0,10,10,0,0,0,0,0,0,0,0,6,3,8,17,9,1,0,10
152233.0,Stenzel Maria,L,Poland,23.0,168,2021,USA,2021-06-18,False,0,0,0,0,0,0,11,11,0,0,0,0,0,0,0,0,8,1,5,14,6,3,0,9
152233.0,Stenzel Maria,L,Poland,23.0,168,2021,China,2021-06-19,False,0,0,0,0,0,0,8,8,0,0,0,0,0,0,0,0,10,1,6,17,3,0,0,3
152233.0,Stenzel Maria,L,Poland,23.0,168,2021,Russia,2021-06-20,True,0,0,0,0,0,0,7,7,0,0,0,0,0,0,0,0,12,3,13,28,5,0,0,5
152217.0,Stysiak Magdalena,O,Poland,21.0,203,2021,Italy,2021-05-25,True,1,6,9,16,0,0,2,2,21,6,25,52,3,3,2,8,6,1,10,17,6,2,0,8
152217.0,Stysiak Magdalena,O,Poland,21.0,203,2021,Serbia,2021-05-26,False,4,3,15,22,0,0,1,1,10,9,13,32,1,0,2,3,3,0,6,9,9,0,0,9
152217.0,Stysiak Magdalena,O,Poland,21.0,203,2021,Belgium,2021-06-01,False,0,2,13,15,0,0,1,1,19,11,17,47,2,3,1,6,0,2,11,13,4,4,1,9
152217.0,Stysiak Magdalena,O,Poland,21.0,203,2021,Dominican Republic,2021-06-02,False,1,4,7,12,0,0,2,2,21,12,27,60,4,7,5,16,0,0,0,0,14,1,1,16
152217.0,Stysiak Magdalena,O,Poland,21.0,203,2021,Canada,2021-06-06,True,1,3,3,7,0,0,0,0,7,3,7,17,0,1,0,1,1,1,3,5,3,1,1,5
152217.0,Stysiak Magdalena,O,Poland,21.0,203,2021,Netherlands,2021-06-07,False,0,1,0,1,0,0,1,1,8,2,5,15,0,2,0,2,0,0,0,0,0,0,0,0
152217.0,Stysiak Magdalena,O,Poland,21.0,203,2021,Japan,2021-06-08,False,0,4,12,16,0,0,2,2,33,8,17,58,2,4,1,7,0,0,0,0,14,3,2,19
152217.0,Stysiak Magdalena,O,Poland,21.0,203,2021,Brazil,2021-06-12,False,2,5,6,13,0,0,1,1,9,9,15,33,3,1,0,4,3,0,12,15,2,1,0,3
152217.0,Stysiak Magdalena,O,Poland,21.0,203,2021,Thailand,2021-06-13,True,1,2,12,15,0,0,1,1,14,2,11,27,1,2,2,5,0,0,0,0,10,1,2,13
152217.0,Stysiak Magdalena,O,Poland,21.0,203,2021,Germany,2021-06-14,False,0,3,5,8,0,0,0,0,13,7,3,23,0,1,0,1,1,0,4,5,2,2,0,4
152217.0,Stysiak Magdalena,O,Poland,21.0,203,2021,USA,2021-06-18,False,1,3,13,17,0,0,1,1,15,10,14,39,1,1,3,5,5,3,10,18,6,3,2,11
152217.0,Stysiak Magdalena,O,Poland,21.0,203,2021,China,2021-06-19,False,0,2,5,7,0,0,1,1,15,4,10,29,1,6,1,8,0,0,0,0,4,1,0,5
152217.0,Stysiak Magdalena,O,Poland,21.0,203,2021,Russia,2021-06-20,True,0,1,5,6,0,0,1,1,25,10,19,54,1,2,1,4,0,0,0,0,6,2,4,12
119138.0,Efimienko-Mlotkowska Zuzanna,MB,Poland,32.0,197,2021,Italy,2021-05-25,True,2,3,11,16,0,0,0,0,4,0,2,6,5,3,4,12,1,0,0,1,2,1,0,3
119138.0,Efimienko-Mlotkowska Zuzanna,MB,Poland,32.0,197,2021,Serbia,2021-05-26,False,0,2,4,6,0,0,1,1,4,0,1,5,0,1,0,1,0,0,0,0,2,0,0,2
119138.0,Efimienko-Mlotkowska Zuzanna,MB,Poland,32.0,197,2021,Belgium,2021-06-01,False,2,1,14,17,0,0,0,0,4,1,4,9,2,5,7,14,0,1,0,1,6,0,0,6
119138.0,Efimienko-Mlotkowska Zuzanna,MB,Poland,32.0,197,2021,Canada,2021-06-06,True,1,1,10,12,0,0,1,1,5,0,8,13,4,3,4,11,0,0,0,0,1,1,0,2
119138.0,Efimienko-Mlotkowska Zuzanna,MB,Poland,32.0,197,2021,Netherlands,2021-06-07,False,1,1,11,13,0,0,0,0,10,1,3,14,2,7,9,18,0,0,0,0,3,0,0,3
119138.0,Efimienko-Mlotkowska Zuzanna,MB,Poland,32.0,197,2021,Brazil,2021-06-12,False,1,2,4,7,0,0,0,0,2,0,5,7,0,2,3,5,0,0,0,0,1,1,0,2
119138.0,Efimienko-Mlotkowska Zuzanna,MB,Poland,32.0,197,2021,Thailand,2021-06-13,True,0,1,5,6,0,0,0,0,2,0,4,6,1,3,8,12,0,0,0,0,3,0,1,4
119138.0,Efimienko-Mlotkowska Zuzanna,MB,Poland,32.0,197,2021,Germany,2021-06-14,False,1,0,5,6,0,0,0,0,2,1,1,4,0,1,1,2,0,1,0,1,1,3,0,4
119138.0,Efimienko-Mlotkowska Zuzanna,MB,Poland,32.0,197,2021,USA,2021-06-18,False,0,1,6,7,0,0,0,0,5,1,6,12,1,5,2,8,0,0,0,0,1,1,0,2
119138.0,Efimienko-Mlotkowska Zuzanna,MB,Poland,32.0,197,2021,China,2021-06-19,False,0,0,7,7,0,0,2,2,2,0,1,3,0,2,0,2,0,0,3,3,1,0,0,1
119138.0,Efimienko-Mlotkowska Zuzanna,MB,Poland,32.0,197,2021,Russia,2021-06-20,True,0,0,11,11,0,0,0,0,5,1,2,8,3,4,5,12,0,0,0,0,3,1,0,4
163098.0,Lukasik Martyna,OH,Poland,22.0,189,2021,Italy,2021-05-25,True,0,0,1,1,0,0,0,0,1,0,3,4,0,0,0,0,1,0,0,1,1,0,0,1
163098.0,Lukasik Martyna,OH,Poland,22.0,189,2021,Serbia,2021-05-26,False,0,0,0,0,0,0,0,0,0,0,1,1,0,0,0,0,1,1,1,3,0,0,0,0
163098.0,Lukasik Martyna,OH,Poland,22.0,189,2021,Belgium,2021-06-01,False,0,1,12,13,0,0,0,0,7,5,11,23,1,2,2,5,6,1,27,34,7,2,3,12
163098.0,Lukasik Martyna,OH,Poland,22.0,189,2021,Dominican Republic,2021-06-02,False,2,1,15,18,0,0,3,3,10,6,11,27,0,3,1,4,3,1,16,20,10,0,1,11
163098.0,Lukasik Martyna,OH,Poland,22.0,189,2021,Canada,2021-06-06,True,1,2,18,21,0,0,2,2,10,1,15,26,6,1,0,7,5,2,9,16,10,4,1,15
163098.0,Lukasik Martyna,OH,Poland,22.0,189,2021,Netherlands,2021-06-07,False,2,4,13,19,0,0,3,3,13,2,19,34,3,5,3,11,3,4,28,35,14,0,1,15
163098.0,Lukasik Martyna,OH,Poland,22.0,189,2021,Japan,2021-06-08,False,0,2,7,9,0,0,1,1,3,0,4,7,0,0,3,3,3,0,3,6,4,1,0,5
163098.0,Lukasik Martyna,OH,Poland,22.0,189,2021,Brazil,2021-06-12,False,0,0,0,0,0,0,0,0,0,0,0,0,0,0,0,0,0,0,0,0,0,0,0,0
163098.0,Lukasik Martyna,OH,Poland,22.0,189,2021,Thailand,2021-06-13,True,0,3,12,15,0,0,0,0,12,1,12,25,1,3,1,5,3,2,13,18,8,1,2,11
163098.0,Lukasik Martyna,OH,Poland,22.0,189,2021,Germany,2021-06-14,False,0,0,5,5,0,0,0,0,4,2,4,10,1,0,0,1,2,1,3,6,1,2,1,4
163098.0,Lukasik Martyna,OH,Poland,22.0,189,2021,USA,2021-06-18,False,0,1,9,10,0,1,1,2,6,6,16,28,1,4,1,6,11,1,24,36,6,3,1,10
163098.0,Lukasik Martyna,OH,Poland,22.0,189,2021,China,2021-06-19,False,3,0,14,17,0,0,0,0,14,3,11,28,0,4,1,5,2,1,11,14,3,4,0,7
163098.0,Lukasik Martyna,OH,Poland,22.0,189,2021,Russia,2021-06-20,True,3,1,19,23,0,0,2,2,8,4,6,18,3,3,0,6,11,2,16,29,10,2,0,12
164106.0,Jagla Monika,L,Poland,22.0,177,2021,Italy,2021-05-25,True,0,0,0,0,0,0,5,5,0,0,0,0,0,0,0,0,0,0,0,0,9,7,1,17
164106.0,Jagla Monika,L,Poland,22.0,177,2021,Serbia,2021-05-26,False,0,0,0,0,0,0,1,1,0,0,0,0,0,0,0,0,0,0,0,0,11,5,0,16
164106.0,Jagla Monika,L,Poland,22.0,177,2021,Belgium,2021-06-01,False,0,0,0,0,0,0,6,6,0,0,0,0,0,0,0,0,0,0,0,0,6,8,1,15
164106.0,Jagla Monika,L,Poland,22.0,177,2021,Dominican Republic,2021-06-02,False,0,0,0,0,0,0,6,6,0,0,0,0,0,0,0,0,0,0,0,0,4,5,0,9
164106.0,Jagla Monika,L,Poland,22.0,177,2021,Canada,2021-06-06,True,0,0,0,0,0,0,3,3,0,0,0,0,0,0,0,0,0,0,0,0,9,13,0,22
164106.0,Jagla Monika,L,Poland,22.0,177,2021,Netherlands,2021-06-07,False,0,0,0,0,0,0,4,4,0,0,0,0,0,0,0,0,0,0,0,0,7,0,1,8
164106.0,Jagla Monika,L,Poland,22.0,177,2021,Japan,2021-06-08,False,0,0,0,0,0,0,4,4,0,0,0,0,0,0,0,0,0,0,0,0,6,4,1,11
164106.0,Jagla Monika,L,Poland,22.0,177,2021,Brazil,2021-06-12,False,0,0,0,0,0,0,3,3,0,0,0,0,0,0,0,0,0,0,0,0,6,0,1,7
164106.0,Jagla Monika,L,Poland,22.0,177,2021,Thailand,2021-06-13,True,0,0,0,0,0,0,0,0,0,0,0,0,0,0,0,0,0,0,0,0,0,0,0,0
164106.0,Jagla Monika,L,Poland,22.0,177,2021,Germany,2021-06-14,False,0,0,0,0,0,0,0,0,0,0,0,0,0,0,0,0,0,0,0,0,0,0,0,0
164106.0,Jagla Monika,L,Poland,22.0,177,2021,USA,2021-06-18,False,0,0,0,0,0,0,6,6,0,0,0,0,0,0,0,0,0,0,0,0,3,1,1,5
164106.0,Jagla Monika,L,Poland,22.0,177,2021,China,2021-06-19,False,0,0,0,0,0,0,1,1,0,0,0,0,0,0,0,0,0,0,0,0,9,0,1,10
164106.0,Jagla Monika,L,Poland,22.0,177,2021,Russia,2021-06-20,True,0,0,0,0,0,0,5,5,0,0,0,0,0,0,0,0,0,0,0,0,9,0,2,11
143463.0,Smarzek Malwina,O,Poland,25.0,191,2021,Italy,2021-05-25,True,1,1,17,19,0,0,2,2,17,12,22,51,0,4,3,7,0,0,0,0,5,1,1,7
143463.0,Smarzek Malwina,O,Poland,25.0,191,2021,Serbia,2021-05-26,False,0,1,8,9,0,0,1,1,10,2,12,24,0,3,2,5,0,0,1,1,8,1,0,9
143463.0,Smarzek Malwina,O,Poland,25.0,191,2021,Belgium,2021-06-01,False,0,0,8,8,0,0,1,1,17,5,28,50,2,4,4,10,0,0,1,1,6,2,4,12
143463.0,Smarzek Malwina,O,Poland,25.0,191,2021,Canada,2021-06-06,True,1,0,12,13,0,0,0,0,21,6,19,46,1,2,2,5,0,0,3,3,9,4,1,14
143463.0,Smarzek Malwina,O,Poland,25.0,191,2021,Netherlands,2021-06-07,False,0,1,7,8,1,0,2,3,16,8,23,47,3,3,2,8,0,0,0,0,5,1,0,6
143463.0,Smarzek Malwina,O,Poland,25.0,191,2021,Japan,2021-06-08,False,0,0,0,0,0,0,0,0,0,0,0,0,0,0,0,0,0,0,0,0,0,0,0,0
143463.0,Smarzek Malwina,O,Poland,25.0,191,2021,Brazil,2021-06-12,False,0,1,9,10,0,0,3,3,13,4,22,39,0,3,1,4,0,0,3,3,7,1,2,10
143463.0,Smarzek Malwina,O,Poland,25.0,191,2021,Thailand,2021-06-13,True,0,0,0,0,0,0,0,0,0,0,0,0,0,0,0,0,0,0,0,0,0,0,0,0
143463.0,Smarzek Malwina,O,Poland,25.0,191,2021,Germany,2021-06-14,False,0,0,5,5,0,0,1,1,7,4,11,22,2,1,6,9,0,1,2,3,5,1,0,6
143463.0,Smarzek Malwina,O,Poland,25.0,191,2021,USA,2021-06-18,False,0,1,4,5,0,0,3,3,7,4,7,18,1,3,5,9,1,0,2,3,8,1,1,10
152231.0,Fedusio Monika,OH,Poland,22.0,183,2021,Italy,2021-05-25,True,0,1,0,1,0,0,0,0,0,0,0,0,0,0,0,0,0,0,0,0,0,0,0,0
152231.0,Fedusio Monika,OH,Poland,22.0,183,2021,Serbia,2021-05-26,False,0,0,8,8,0,0,0,0,5,2,8,15,0,2,1,3,9,1,7,17,5,2,0,7
152231.0,Fedusio Monika,OH,Poland,22.0,183,2021,Belgium,2021-06-01,False,0,0,1,1,0,0,0,0,0,0,3,3,0,1,0,1,1,0,8,9,2,2,0,4
152231.0,Fedusio Monika,OH,Poland,22.0,183,2021,Dominican Republic,2021-06-02,False,0,0,0,0,0,0,0,0,0,0,0,0,0,0,0,0,0,0,0,0,0,0,0,0
152231.0,Fedusio Monika,OH,Poland,22.0,183,2021,Canada,2021-06-06,True,0,0,0,0,0,0,0,0,0,0,0,0,0,0,0,0,0,0,0,0,0,0,0,0
152231.0,Fedusio Monika,OH,Poland,22.0,183,2021,Japan,2021-06-08,False,0,0,0,0,0,0,0,0,0,0,0,0,0,0,0,0,0,0,0,0,0,0,0,0
152231.0,Fedusio Monika,OH,Poland,22.0,183,2021,Brazil,2021-06-12,False,0,0,0,0,0,0,0,0,0,0,0,0,0,0,0,0,0,0,0,0,0,0,0,0
152231.0,Fedusio Monika,OH,Poland,22.0,183,2021,Thailand,2021-06-13,True,0,0,0,0,0,0,0,0,0,0,0,0,0,0,0,0,0,0,0,0,0,0,0,0
152231.0,Fedusio Monika,OH,Poland,22.0,183,2021,Germany,2021-06-14,False,0,0,0,0,0,0,0,0,0,0,0,0,0,0,0,0,0,0,0,0,0,0,0,0
152231.0,Fedusio Monika,OH,Poland,22.0,183,2021,USA,2021-06-18,False,0,0,0,0,0,0,0,0,0,0,0,0,0,0,0,0,0,0,0,0,0,0,0,0
152231.0,Fedusio Monika,OH,Poland,22.0,183,2021,China,2021-06-19,False,0,0,0,0,0,0,0,0,0,0,0,0,0,0,0,0,0,0,0,0,0,0,0,0
152231.0,Fedusio Monika,OH,Poland,22.0,183,2021,Russia,2021-06-20,True,0,0,0,0,0,0,0,0,0,0,0,0,0,0,0,0,0,0,0,0,0,0,0,0
181268.0,Czyrnianska Martyna,OH,Poland,18.0,191,2021,Italy,2021-05-25,True,0,0,0,0,0,0,0,0,0,0,0,0,0,0,0,0,0,0,0,0,0,0,0,0
181268.0,Czyrnianska Martyna,OH,Poland,18.0,191,2021,Serbia,2021-05-26,False,0,0,1,1,0,0,0,0,3,1,1,5,0,0,0,0,0,0,0,0,0,1,0,1
181268.0,Czyrnianska Martyna,OH,Poland,18.0,191,2021,Belgium,2021-06-01,False,0,0,0,0,0,0,0,0,1,0,4,5,0,2,0,2,0,0,0,0,0,0,0,0
181268.0,Czyrnianska Martyna,OH,Poland,18.0,191,2021,Dominican Republic,2021-06-02,False,0,0,0,0,0,0,0,0,0,0,0,0,0,0,0,0,0,0,0,0,0,0,0,0
181268.0,Czyrnianska Martyna,OH,Poland,18.0,191,2021,Canada,2021-06-06,True,0,0,0,0,0,0,0,0,0,0,0,0,0,0,0,0,0,0,0,0,0,0,0,0
181268.0,Czyrnianska Martyna,OH,Poland,18.0,191,2021,Netherlands,2021-06-07,False,0,0,17,17,0,0,2,2,11,3,12,26,1,2,6,9,3,1,19,23,14,5,4,23
181268.0,Czyrnianska Martyna,OH,Poland,18.0,191,2021,Japan,2021-06-08,False,0,0,0,0,0,0,0,0,0,0,0,0,0,0,0,0,0,0,0,0,0,0,0,0
181268.0,Czyrnianska Martyna,OH,Poland,18.0,191,2021,Brazil,2021-06-12,False,0,1,6,7,0,0,0,0,3,4,9,16,4,1,3,8,6,1,17,24,4,3,0,7
181268.0,Czyrnianska Martyna,OH,Poland,18.0,191,2021,Thailand,2021-06-13,True,0,0,0,0,0,0,0,0,1,1,1,3,1,0,0,1,0,0,0,0,2,1,0,3
181268.0,Czyrnianska Martyna,OH,Poland,18.0,191,2021,Germany,2021-06-14,False,0,1,0,1,0,0,0,0,1,0,2,3,0,1,0,1,1,0,1,2,0,1,0,1
181268.0,Czyrnianska Martyna,OH,Poland,18.0,191,2021,USA,2021-06-18,False,0,0,0,0,0,0,1,1,3,0,5,8,0,1,0,1,0,0,1,1,1,0,0,1
181268.0,Czyrnianska Martyna,OH,Poland,18.0,191,2021,China,2021-06-19,False,0,0,0,0,0,0,0,0,2,0,1,3,0,0,0,0,0,0,0,0,0,0,0,0
181268.0,Czyrnianska Martyna,OH,Poland,18.0,191,2021,Russia,2021-06-20,True,0,0,0,0,0,0,1,1,4,1,4,9,0,0,0,0,0,0,0,0,0,0,0,0
181267.0,Druzkowska Karolina,OH,Poland,20.0,194,2021,Dominican Republic,2021-06-02,False,0,0,0,0,0,0,3,3,0,0,0,0,0,0,0,0,0,0,0,0,0,0,0,0
181267.0,Druzkowska Karolina,OH,Poland,20.0,194,2021,Netherlands,2021-06-07,False,0,0,0,0,0,0,0,0,0,0,0,0,0,0,0,0,0,0,0,0,0,0,0,0
181267.0,Druzkowska Karolina,OH,Poland,20.0,194,2021,China,2021-06-19,False,0,0,0,0,0,0,0,0,0,0,0,0,0,0,0,0,0,0,0,0,0,0,0,0
181263.0,Wenerska Katarzyna,S,Poland,29.0,180,2021,Brazil,2021-06-12,False,1,4,10,15,11,0,73,84,1,0,0,1,0,0,0,0,0,0,0,0,9,3,0,12
181263.0,Wenerska Katarzyna,S,Poland,29.0,180,2021,Thailand,2021-06-13,True,0,1,11,12,24,1,44,69,1,0,1,2,0,2,2,4,0,0,0,0,7,4,2,13
181263.0,Wenerska Katarzyna,S,Poland,29.0,180,2021,Germany,2021-06-14,False,0,1,9,10,10,1,51,62,1,0,1,2,0,0,2,2,0,0,0,0,3,4,2,9
181263.0,Wenerska Katarzyna,S,Poland,29.0,180,2021,USA,2021-06-18,False,1,1,11,13,10,0,63,73,1,0,1,2,1,0,3,4,0,0,0,0,7,4,2,13
181263.0,Wenerska Katarzyna,S,Poland,29.0,180,2021,China,2021-06-19,False,0,0,15,15,11,0,64,75,0,0,2,2,0,1,0,1,0,0,0,0,4,0,0,4
181263.0,Wenerska Katarzyna,S,Poland,29.0,180,2021,Russia,2021-06-20,True,1,1,23,25,23,1,72,96,1,0,1,2,0,4,2,6,0,0,0,0,1,2,0,3
173996.0,Łazowska Martyna,S,Poland,19.0,176,2021,Italy,2021-05-25,True,0,0,1,1,1,0,10,11,0,0,0,0,0,0,0,0,0,0,0,0,0,0,0,0
173996.0,Łazowska Martyna,S,Poland,19.0,176,2021,Serbia,2021-05-26,False,0,0,7,7,4,2,40,46,2,1,0,3,0,2,1,3,0,0,0,0,2,3,0,5
173996.0,Łazowska Martyna,S,Poland,19.0,176,2021,Belgium,2021-06-01,False,0,1,1,2,3,0,6,9,0,0,0,0,0,0,0,0,0,0,0,0,2,0,0,2
173996.0,Łazowska Martyna,S,Poland,19.0,176,2021,Dominican Republic,2021-06-02,False,0,0,1,1,0,0,0,0,0,0,0,0,0,0,0,0,0,0,0,0,0,0,0,0
173996.0,Łazowska Martyna,S,Poland,19.0,176,2021,Canada,2021-06-06,True,0,1,0,1,3,0,16,19,1,0,1,2,0,0,0,0,0,0,0,0,1,1,0,2
173996.0,Łazowska Martyna,S,Poland,19.0,176,2021,Netherlands,2021-06-07,False,0,0,7,7,3,0,19,22,0,0,0,0,0,1,0,1,0,0,0,0,0,1,0,1
173996.0,Łazowska Martyna,S,Poland,19.0,176,2021,Japan,2021-06-08,False,0,0,0,0,0,0,2,2,0,0,0,0,1,1,1,3,0,0,0,0,0,0,0,0
151231.0,Rozanski Olivia,OH,Poland,24.0,185,2021,Italy,2021-05-25,True,0,0,0,0,0,0,0,0,0,0,0,0,0,0,0,0,0,1,1,2,0,0,0,0
151231.0,Rozanski Olivia,OH,Poland,24.0,185,2021,Serbia,2021-05-26,False,0,0,0,0,0,0,0,0,0,0,0,0,0,0,0,0,0,0,0,0,0,0,0,0
151231.0,Rozanski Olivia,OH,Poland,24.0,185,2021,Belgium,2021-06-01,False,0,0,0,0,0,0,0,0,0,1,0,1,0,0,0,0,0,0,0,0,0,0,0,0
151231.0,Rozanski Olivia,OH,Poland,24.0,185,2021,Dominican Republic,2021-06-02,False,0,0,0,0,0,0,0,0,0,2,1,3,0,0,0,0,0,0,0,0,1,0,0,1
151231.0,Rozanski Olivia,OH,Poland,24.0,185,2021,Netherlands,2021-06-07,False,0,0,0,0,0,0,0,0,0,0,0,0,0,0,0,0,0,0,0,0,0,0,0,0
151231.0,Rozanski Olivia,OH,Poland,24.0,185,2021,Japan,2021-06-08,False,0,2,7,9,0,0,0,0,9,3,14,26,3,0,2,5,1,1,12,14,5,3,2,10
151231.0,Rozanski Olivia,OH,Poland,24.0,185,2021,Brazil,2021-06-12,False,0,0,0,0,0,0,0,0,0,1,1,2,0,0,0,0,0,0,0,0,0,0,0,0
151231.0,Rozanski Olivia,OH,Poland,24.0,185,2021,Thailand,2021-06-13,True,0,0,0,0,0,0,0,0,0,0,0,0,0,0,0,0,0,0,0,0,0,0,0,0
151231.0,Rozanski Olivia,OH,Poland,24.0,185,2021,Germany,2021-06-14,False,0,0,0,0,0,0,0,0,0,0,0,0,0,0,0,0,0,0,0,0,0,0,0,0
151231.0,Rozanski Olivia,OH,Poland,24.0,185,2021,China,2021-06-19,False,0,0,0,0,0,0,0,0,0,0,2,2,0,0,1,1,0,0,1,1,0,0,1,1
151231.0,Rozanski Olivia,OH,Poland,24.0,185,2021,Russia,2021-06-20,True,0,0,0,0,0,0,0,0,0,0,0,0,0,0,0,0,0,0,0,0,0,0,0,0
163097.0,Gryka Aleksandra,MB,Poland,22.0,190,2021,Dominican Republic,2021-06-02,False,0,0,0,0,0,0,0,0,0,0,0,0,0,0,0,0,0,0,0,0,0,0,0,0
163097.0,Gryka Aleksandra,MB,Poland,22.0,190,2021,Canada,2021-06-06,True,0,0,0,0,0,0,0,0,0,0,0,0,0,0,0,0,0,0,0,0,0,0,0,0
163097.0,Gryka Aleksandra,MB,Poland,22.0,190,2021,Japan,2021-06-08,False,0,0,0,0,0,0,0,0,0,0,0,0,0,1,0,1,0,0,0,0,0,0,0,0
163097.0,Gryka Aleksandra,MB,Poland,22.0,190,2021,Brazil,2021-06-12,False,0,0,0,0,0,0,0,0,0,0,0,0,0,0,0,0,0,0,0,0,0,0,0,0
163097.0,Gryka Aleksandra,MB,Poland,22.0,190,2021,Thailand,2021-06-13,True,1,1,3,5,0,0,0,0,3,0,3,6,0,1,4,5,0,0,1,1,0,0,0,0
163097.0,Gryka Aleksandra,MB,Poland,22.0,190,2021,Germany,2021-06-14,False,0,0,3,3,0,0,0,0,2,0,2,4,1,2,2,5,0,0,0,0,1,1,0,2
163097.0,Gryka Aleksandra,MB,Poland,22.0,190,2021,USA,2021-06-18,False,0,0,0,0,0,0,0,0,0,0,0,0,0,0,0,0,0,0,0,0,0,0,0,0
163097.0,Gryka Aleksandra,MB,Poland,22.0,190,2021,Russia,2021-06-20,True,0,0,0,0,0,0,0,0,0,0,0,0,0,0,0,0,0,0,0,0,0,0,0,0
152223.0,Gorecka Zuzanna,OH,Poland,21.0,181,2021,Italy,2021-05-25,True,1,2,11,14,0,0,0,0,9,5,10,24,1,0,3,4,10,6,30,46,14,3,3,20
152223.0,Gorecka Zuzanna,OH,Poland,21.0,181,2021,Serbia,2021-05-26,False,0,1,4,5,0,0,0,0,2,4,8,14,0,4,1,5,5,1,11,17,2,1,0,3
152223.0,Gorecka Zuzanna,OH,Poland,21.0,181,2021,Belgium,2021-06-01,False,0,0,1,1,0,0,0,0,1,0,1,2,0,0,0,0,0,0,4,4,2,0,1,3
152223.0,Gorecka Zuzanna,OH,Poland,21.0,181,2021,Dominican Republic,2021-06-02,False,1,0,11,12,0,0,1,1,11,0,21,32,0,1,4,5,13,4,24,41,9,1,2,12
152223.0,Gorecka Zuzanna,OH,Poland,21.0,181,2021,Canada,2021-06-06,True,2,1,15,18,0,0,0,0,6,6,10,22,1,1,0,2,13,1,16,30,3,3,0,6
152223.0,Gorecka Zuzanna,OH,Poland,21.0,181,2021,Netherlands,2021-06-07,False,0,0,0,0,0,0,0,0,0,0,0,0,0,0,0,0,0,1,2,3,0,0,0,0
152223.0,Gorecka Zuzanna,OH,Poland,21.0,181,2021,Japan,2021-06-08,False,0,1,17,18,0,0,4,4,15,2,19,36,4,1,1,6,14,4,39,57,13,4,1,18
152223.0,Gorecka Zuzanna,OH,Poland,21.0,181,2021,Brazil,2021-06-12,False,0,0,1,1,0,0,1,1,1,2,0,3,0,0,0,0,0,0,6,6,2,0,0,2
152223.0,Gorecka Zuzanna,OH,Poland,21.0,181,2021,Thailand,2021-06-13,True,1,2,9,12,0,0,1,1,15,0,15,30,2,2,1,5,5,0,9,14,11,1,1,13
152223.0,Gorecka Zuzanna,OH,Poland,21.0,181,2021,Germany,2021-06-14,False,1,0,8,9,0,0,4,4,6,0,6,12,2,1,0,3,9,2,19,30,9,3,1,13
152223.0,Gorecka Zuzanna,OH,Poland,21.0,181,2021,USA,2021-06-18,False,0,0,0,0,0,0,0,0,0,0,0,0,0,0,0,0,0,0,0,0,0,0,0,0
152223.0,Gorecka Zuzanna,OH,Poland,21.0,181,2021,China,2021-06-19,False,0,1,8,9,0,0,2,2,8,1,13,22,0,4,0,4,14,2,19,35,4,4,1,9
152223.0,Gorecka Zuzanna,OH,Poland,21.0,181,2021,Russia,2021-06-20,True,1,0,12,13,1,0,2,3,13,4,10,27,3,4,3,10,5,1,18,24,7,3,2,12
142377.0,Malygina Daria,O,Russia,27.0,202,2021,Germany,2021-05-25,True,0,0,0,0,0,0,0,0,0,0,0,0,0,0,0,0,0,0,0,0,0,0,0,0
142377.0,Malygina Daria,O,Russia,27.0,202,2021,Belgium,2021-05-26,True,0,1,0,1,0,0,0,0,0,0,1,1,0,1,2,3,0,0,0,0,0,0,0,0
142377.0,Malygina Daria,O,Russia,27.0,202,2021,Netherlands,2021-05-27,False,1,2,7,10,0,0,0,0,2,1,3,6,3,2,3,8,0,0,0,0,0,1,0,1
142377.0,Malygina Daria,O,Russia,27.0,202,2021,Italy,2021-05-31,True,0,0,0,0,0,0,0,0,0,0,0,0,0,0,0,0,0,0,0,0,0,0,0,0
142377.0,Malygina Daria,O,Russia,27.0,202,2021,Brazil,2021-06-01,False,0,1,6,7,0,0,1,1,2,0,4,6,0,1,1,2,0,0,0,0,2,0,0,2
142377.0,Malygina Daria,O,Russia,27.0,202,2021,Japan,2021-06-02,False,0,0,0,0,0,0,0,0,0,0,0,0,0,0,0,0,0,0,0,0,0,0,0,0
119361.0,Pilipenko Daria,L,Russia,31.0,177,2021,Germany,2021-05-25,True,0,0,0,0,0,0,0,0,0,0,0,0,0,0,0,0,1,1,1,3,4,0,0,4
119361.0,Pilipenko Daria,L,Russia,31.0,177,2021,Belgium,2021-05-26,True,0,0,0,0,0,0,6,6,0,0,0,0,0,0,0,0,3,0,5,8,5,3,0,8
119361.0,Pilipenko Daria,L,Russia,31.0,177,2021,Netherlands,2021-05-27,False,0,0,0,0,0,0,2,2,0,0,0,0,0,0,0,0,1,0,5,6,1,2,1,4
119361.0,Pilipenko Daria,L,Russia,31.0,177,2021,Italy,2021-05-31,True,0,0,0,0,0,0,5,5,0,0,0,0,0,0,0,0,3,1,10,14,12,5,0,17
119361.0,Pilipenko Daria,L,Russia,31.0,177,2021,Brazil,2021-06-01,False,0,0,0,0,0,0,6,6,0,0,0,0,0,0,0,0,2,2,4,8,10,3,1,14
119361.0,Pilipenko Daria,L,Russia,31.0,177,2021,Japan,2021-06-02,False,0,0,0,0,0,0,8,8,0,0,0,0,0,0,0,0,6,1,14,21,10,6,0,16
119361.0,Pilipenko Daria,L,Russia,31.0,177,2021,Dominican Republic,2021-06-06,True,0,0,0,0,0,0,8,8,0,0,0,0,0,0,0,0,11,1,15,27,22,4,1,27
119361.0,Pilipenko Daria,L,Russia,31.0,177,2021,Thailand,2021-06-07,True,0,0,0,0,0,0,9,9,0,0,0,0,0,0,0,0,5,0,13,18,10,5,3,18
119361.0,Pilipenko Daria,L,Russia,31.0,177,2021,Canada,2021-06-13,True,0,0,0,0,0,0,0,0,0,0,0,0,0,0,0,0,0,0,0,0,0,0,0,0
119361.0,Pilipenko Daria,L,Russia,31.0,177,2021,Serbia,2021-06-14,True,0,0,0,0,0,0,0,0,0,0,0,0,0,0,0,0,0,0,1,1,3,1,1,5
119361.0,Pilipenko Daria,L,Russia,31.0,177,2021,China,2021-06-18,False,0,0,0,0,0,0,0,0,0,0,0,0,0,0,0,0,0,0,0,0,0,0,0,0
119361.0,Pilipenko Daria,L,Russia,31.0,177,2021,USA,2021-06-19,False,0,0,0,0,0,0,5,5,0,0,0,0,0,0,0,0,2,1,5,8,3,2,2,7
119361.0,Pilipenko Daria,L,Russia,31.0,177,2021,Poland,2021-06-20,False,0,0,0,0,0,0,5,5,0,0,0,0,0,0,0,0,3,2,12,17,6,2,1,9
175202.0,Fedorovtseva Arina,OH,Russia,18.0,190,2021,Germany,2021-05-25,True,0,1,3,4,0,0,0,0,0,0,0,0,0,0,1,1,0,1,1,2,1,0,0,1
175202.0,Fedorovtseva Arina,OH,Russia,18.0,190,2021,Belgium,2021-05-26,True,0,1,14,15,0,0,0,0,10,3,7,20,0,0,2,2,4,3,14,21,4,1,1,6
175202.0,Fedorovtseva Arina,OH,Russia,18.0,190,2021,Netherlands,2021-05-27,False,1,2,9,12,0,1,1,2,14,2,9,25,3,0,0,3,9,1,17,27,2,2,0,4
175202.0,Fedorovtseva Arina,OH,Russia,18.0,190,2021,Italy,2021-05-31,True,3,0,7,10,0,0,0,0,13,2,9,24,2,2,0,4,3,0,5,8,3,1,0,4
175202.0,Fedorovtseva Arina,OH,Russia,18.0,190,2021,Brazil,2021-06-01,False,0,1,6,7,0,0,0,0,6,4,10,20,1,2,0,3,1,2,3,6,3,2,1,6
175202.0,Fedorovtseva Arina,OH,Russia,18.0,190,2021,Japan,2021-06-02,False,0,2,4,6,0,0,1,1,4,1,5,10,0,0,0,0,2,2,6,10,1,0,0,1
175202.0,Fedorovtseva Arina,OH,Russia,18.0,190,2021,Dominican Republic,2021-06-06,True,0,3,17,20,0,1,3,4,18,7,22,47,2,2,2,6,11,1,23,35,8,1,2,11
175202.0,Fedorovtseva Arina,OH,Russia,18.0,190,2021,Thailand,2021-06-07,True,3,2,17,22,0,0,1,1,16,3,12,31,1,2,5,8,6,3,13,22,4,1,4,9
175202.0,Fedorovtseva Arina,OH,Russia,18.0,190,2021,Canada,2021-06-13,True,2,2,6,10,0,0,1,1,13,0,6,19,1,1,0,2,4,0,11,15,6,0,2,8
175202.0,Fedorovtseva Arina,OH,Russia,18.0,190,2021,Serbia,2021-06-14,True,3,0,7,10,0,0,2,2,8,2,3,13,1,0,0,1,2,0,6,8,1,0,0,1
175202.0,Fedorovtseva Arina,OH,Russia,18.0,190,2021,China,2021-06-18,False,1,1,5,7,0,0,0,0,8,5,8,21,0,0,0,0,1,1,13,15,0,3,1,4
175202.0,Fedorovtseva Arina,OH,Russia,18.0,190,2021,USA,2021-06-19,False,1,3,11,15,0,0,2,2,13,3,17,33,0,1,2,3,9,7,19,35,6,1,1,8
175202.0,Fedorovtseva Arina,OH,Russia,18.0,190,2021,Poland,2021-06-20,False,2,2,19,23,0,0,2,2,15,9,8,32,0,4,2,6,13,3,20,36,1,3,2,6
168181.0,Koroleva Irina,MB,Russia,30.0,196,2021,Germany,2021-05-25,True,2,0,7,9,0,0,0,0,5,1,2,8,1,6,2,9,0,0,0,0,1,0,0,1
168181.0,Koroleva Irina,MB,Russia,30.0,196,2021,Belgium,2021-05-26,True,0,0,10,10,0,0,0,0,7,2,5,14,4,5,8,17,0,0,0,0,8,0,0,8
168181.0,Koroleva Irina,MB,Russia,30.0,196,2021,Netherlands,2021-05-27,False,0,1,2,3,0,0,0,0,1,0,0,1,0,1,0,1,0,0,0,0,0,0,0,0
168181.0,Koroleva Irina,MB,Russia,30.0,196,2021,Italy,2021-05-31,True,0,1,8,9,0,0,0,0,4,0,3,7,2,4,2,8,0,0,0,0,2,0,0,2
168181.0,Koroleva Irina,MB,Russia,30.0,196,2021,Brazil,2021-06-01,False,0,0,7,7,0,0,1,1,0,0,2,2,1,1,1,3,0,1,1,2,1,1,0,2
168181.0,Koroleva Irina,MB,Russia,30.0,196,2021,Japan,2021-06-02,False,0,0,8,8,0,0,0,0,5,0,5,10,1,3,1,5,0,0,0,0,1,0,0,1
168181.0,Koroleva Irina,MB,Russia,30.0,196,2021,Dominican Republic,2021-06-06,True,0,0,15,15,0,0,4,4,6,1,3,10,4,11,19,34,0,0,0,0,4,1,2,7
168181.0,Koroleva Irina,MB,Russia,30.0,196,2021,Thailand,2021-06-07,True,1,0,14,15,0,0,0,0,8,0,4,12,2,5,9,16,0,0,0,0,3,0,0,3
168181.0,Koroleva Irina,MB,Russia,30.0,196,2021,Canada,2021-06-13,True,2,0,7,9,0,0,2,2,6,1,2,9,1,3,7,11,0,0,0,0,1,0,2,3
168181.0,Koroleva Irina,MB,Russia,30.0,196,2021,Serbia,2021-06-14,True,4,0,10,14,0,0,0,0,3,2,4,9,4,1,4,9,1,0,0,1,3,0,0,3
168181.0,Koroleva Irina,MB,Russia,30.0,196,2021,China,2021-06-18,False,1,0,9,10,0,0,1,1,3,3,2,8,1,3,4,8,0,0,1,1,2,1,6,9
168181.0,Koroleva Irina,MB,Russia,30.0,196,2021,USA,2021-06-19,False,0,0,10,10,0,1,0,1,7,0,2,9,3,5,9,17,0,0,1,1,1,3,2,6
168181.0,Koroleva Irina,MB,Russia,30.0,196,2021,Poland,2021-06-20,False,1,0,7,8,0,0,1,1,11,2,4,17,5,3,8,16,0,0,1,1,0,2,2,4
132071.0,Goncharova Nataliya,O,Russia,32.0,194,2021,Germany,2021-05-25,True,0,0,14,14,0,0,1,1,18,3,10,31,2,3,6,11,0,0,0,0,5,0,0,5
132071.0,Goncharova Nataliya,O,Russia,32.0,194,2021,Belgium,2021-05-26,True,1,1,13,15,0,0,1,1,20,5,23,48,3,1,3,7,0,0,0,0,10,0,2,12
132071.0,Goncharova Nataliya,O,Russia,32.0,194,2021,Netherlands,2021-05-27,False,0,0,1,1,0,1,0,1,3,1,2,6,0,0,0,0,0,0,1,1,3,0,0,3
132071.0,Goncharova Nataliya,O,Russia,32.0,194,2021,Italy,2021-05-31,True,0,0,5,5,0,0,1,1,7,3,11,21,3,0,5,8,0,0,0,0,1,1,0,2
132071.0,Goncharova Nataliya,O,Russia,32.0,194,2021,Japan,2021-06-02,False,0,0,10,10,0,0,0,0,12,2,21,35,1,4,1,6,0,0,0,0,3,3,0,6
132071.0,Goncharova Nataliya,O,Russia,32.0,194,2021,Dominican Republic,2021-06-06,True,0,1,14,15,0,0,3,3,30,7,21,58,1,0,8,9,0,0,0,0,13,3,2,18
132071.0,Goncharova Nataliya,O,Russia,32.0,194,2021,Thailand,2021-06-07,True,1,2,10,13,0,0,1,1,14,2,15,31,4,1,5,10,0,0,1,1,8,2,1,11
132071.0,Goncharova Nataliya,O,Russia,32.0,194,2021,Canada,2021-06-13,True,1,1,9,11,0,0,0,0,5,1,6,12,1,0,0,1,0,0,0,0,5,2,2,9
132071.0,Goncharova Nataliya,O,Russia,32.0,194,2021,Serbia,2021-06-14,True,0,0,5,5,0,0,1,1,7,0,2,9,1,2,0,3,0,0,0,0,2,0,0,2
132071.0,Goncharova Nataliya,O,Russia,32.0,194,2021,China,2021-06-18,False,1,0,9,10,0,0,7,7,13,2,15,30,0,1,2,3,0,0,0,0,8,2,2,12
132071.0,Goncharova Nataliya,O,Russia,32.0,194,2021,USA,2021-06-19,False,0,0,9,9,0,0,0,0,12,5,14,31,1,2,4,7,0,0,1,1,6,3,3,12
132071.0,Goncharova Nataliya,O,Russia,32.0,194,2021,Poland,2021-06-20,False,0,0,0,0,0,0,0,0,0,0,0,0,0,0,0,0,0,0,0,0,0,0,0,0
173154.0,Gorbunova Valeriia,O,Russia,19.0,190,2021,Belgium,2021-05-26,True,0,0,1,1,0,0,0,0,0,0,3,3,0,0,0,0,0,0,1,1,1,0,0,1
173154.0,Gorbunova Valeriia,O,Russia,19.0,190,2021,Brazil,2021-06-01,False,0,0,0,0,0,0,0,0,0,0,0,0,0,0,0,0,0,0,0,0,0,0,0,0
173154.0,Gorbunova Valeriia,O,Russia,19.0,190,2021,Dominican Republic,2021-06-06,True,0,0,0,0,0,0,0,0,0,0,0,0,0,0,0,0,0,0,0,0,0,0,0,0
173154.0,Gorbunova Valeriia,O,Russia,19.0,190,2021,Thailand,2021-06-07,True,0,0,0,0,0,0,0,0,0,0,0,0,0,0,0,0,0,0,0,0,0,0,0,0
164015.0,Matveeva Polina,S,Russia,19.0,194,2021,Belgium,2021-05-26,True,0,0,0,0,0,0,16,16,0,0,0,0,0,0,1,1,0,0,0,0,0,0,0,0
164015.0,Matveeva Polina,S,Russia,19.0,194,2021,Brazil,2021-06-01,False,0,0,2,2,3,0,40,43,0,0,2,2,0,0,0,0,0,0,1,1,4,2,0,6
164015.0,Matveeva Polina,S,Russia,19.0,194,2021,Japan,2021-06-02,False,0,0,0,0,0,0,0,0,0,0,0,0,0,0,0,0,0,0,0,0,0,0,0,0
164015.0,Matveeva Polina,S,Russia,19.0,194,2021,Dominican Republic,2021-06-06,True,0,0,9,9,13,0,64,77,0,1,0,1,0,4,3,7,0,0,0,0,8,2,0,10
164015.0,Matveeva Polina,S,Russia,19.0,194,2021,Thailand,2021-06-07,True,1,3,10,14,14,2,62,78,4,0,1,5,2,0,1,3,0,0,0,0,7,2,0,9
164015.0,Matveeva Polina,S,Russia,19.0,194,2021,Canada,2021-06-13,True,0,0,1,1,1,0,8,9,0,0,0,0,1,0,0,1,0,0,0,0,2,0,1,3
164015.0,Matveeva Polina,S,Russia,19.0,194,2021,China,2021-06-18,False,0,1,1,2,0,0,23,23,0,0,0,0,0,2,0,2,0,0,0,0,0,0,0,0
164015.0,Matveeva Polina,S,Russia,19.0,194,2021,USA,2021-06-19,False,0,2,1,3,0,0,12,12,0,0,0,0,0,0,0,0,0,0,1,1,0,0,0,0
164015.0,Matveeva Polina,S,Russia,19.0,194,2021,Poland,2021-06-20,False,0,1,7,8,9,0,34,43,1,0,0,1,1,1,1,3,0,0,0,0,4,4,1,9
163842.0,Brovkina Yulia,MB,Russia,20.0,196,2021,Germany,2021-05-25,True,0,0,8,8,0,0,0,0,0,1,0,1,0,1,0,1,0,0,0,0,0,0,0,0
163842.0,Brovkina Yulia,MB,Russia,20.0,196,2021,Belgium,2021-05-26,True,0,0,1,1,0,0,0,0,0,1,0,1,0,0,0,0,0,0,0,0,0,0,0,0
163842.0,Brovkina Yulia,MB,Russia,20.0,196,2021,Netherlands,2021-05-27,False,1,0,8,9,0,0,0,0,5,0,6,11,1,6,0,7,0,0,0,0,0,0,0,0
163842.0,Brovkina Yulia,MB,Russia,20.0,196,2021,Italy,2021-05-31,True,0,0,0,0,0,0,0,0,0,0,0,0,0,0,0,0,0,0,0,0,0,0,0,0
163842.0,Brovkina Yulia,MB,Russia,20.0,196,2021,Brazil,2021-06-01,False,0,0,2,2,0,0,0,0,1,0,2,3,2,2,1,5,0,0,0,0,1,0,0,1
163842.0,Brovkina Yulia,MB,Russia,20.0,196,2021,Japan,2021-06-02,False,0,0,0,0,0,0,0,0,0,0,0,0,0,0,0,0,0,0,0,0,0,0,0,0
163842.0,Brovkina Yulia,MB,Russia,20.0,196,2021,Dominican Republic,2021-06-06,True,0,0,0,0,0,0,1,1,0,0,2,2,0,1,1,2,0,0,0,0,0,0,0,0
163842.0,Brovkina Yulia,MB,Russia,20.0,196,2021,Thailand,2021-06-07,True,0,0,1,1,0,0,0,0,2,0,0,2,0,0,0,0,0,0,0,0,0,0,0,0
163842.0,Brovkina Yulia,MB,Russia,20.0,196,2021,Canada,2021-06-13,True,0,0,0,0,0,0,0,0,0,0,0,0,0,0,0,0,0,0,0,0,0,0,0,0
163842.0,Brovkina Yulia,MB,Russia,20.0,196,2021,Serbia,2021-06-14,True,0,0,0,0,0,0,0,0,0,0,0,0,0,0,0,0,0,0,0,0,0,0,0,0
163842.0,Brovkina Yulia,MB,Russia,20.0,196,2021,China,2021-06-18,False,0,0,0,0,0,0,0,0,0,0,0,0,0,0,0,0,0,0,0,0,0,0,0,0
163842.0,Brovkina Yulia,MB,Russia,20.0,196,2021,USA,2021-06-19,False,1,0,7,8,0,0,1,1,1,0,1,2,2,2,1,5,0,0,0,0,2,1,1,4
163842.0,Brovkina Yulia,MB,Russia,20.0,196,2021,Poland,2021-06-20,False,0,1,11,12,0,0,1,1,5,1,2,8,2,3,4,9,1,0,0,1,1,0,0,1
153448.0,Lazareva Anna,O,Russia,25.0,190,2021,Canada,2021-06-13,True,0,0,2,2,0,0,0,0,4,0,4,8,0,1,1,2,0,0,0,0,2,0,0,2
153448.0,Lazareva Anna,O,Russia,25.0,190,2021,Serbia,2021-06-14,True,0,1,2,3,0,0,0,0,5,4,9,18,0,2,2,4,0,0,0,0,3,2,0,5
153448.0,Lazareva Anna,O,Russia,25.0,190,2021,China,2021-06-18,False,0,0,0,0,0,0,0,0,1,1,0,2,0,1,0,1,0,0,0,0,0,0,0,0
153448.0,Lazareva Anna,O,Russia,25.0,190,2021,USA,2021-06-19,False,0,1,4,5,0,0,0,0,1,1,3,5,0,1,1,2,0,0,0,0,0,0,0,0
153448.0,Lazareva Anna,O,Russia,25.0,190,2021,Poland,2021-06-20,False,0,1,5,6,0,0,1,1,7,6,6,19,2,0,1,3,0,0,0,0,3,2,0,5
119097.0,Startseva Evgeniya,S,Russia,33.0,185,2021,Germany,2021-05-25,True,0,1,6,7,6,0,77,83,3,0,0,3,0,3,6,9,0,0,0,0,3,2,1,6
119097.0,Startseva Evgeniya,S,Russia,33.0,185,2021,Belgium,2021-05-26,True,1,1,9,11,9,1,110,120,2,2,0,4,0,4,2,6,0,0,1,1,12,4,2,18
119097.0,Startseva Evgeniya,S,Russia,33.0,185,2021,Netherlands,2021-05-27,False,0,0,1,1,1,0,14,15,1,0,0,1,0,0,0,0,0,0,0,0,2,1,0,3
119097.0,Startseva Evgeniya,S,Russia,33.0,185,2021,Italy,2021-05-31,True,0,4,13,17,9,1,68,78,1,0,1,2,0,2,3,5,0,0,0,0,6,5,1,12
119097.0,Startseva Evgeniya,S,Russia,33.0,185,2021,Japan,2021-06-02,False,1,1,9,11,3,0,92,95,1,0,1,2,1,4,0,5,0,0,1,1,6,2,2,10
119097.0,Startseva Evgeniya,S,Russia,33.0,185,2021,Dominican Republic,2021-06-06,True,0,0,5,5,5,0,53,58,0,0,2,2,0,0,0,0,0,0,0,0,5,0,0,5
119097.0,Startseva Evgeniya,S,Russia,33.0,185,2021,Canada,2021-06-13,True,0,1,9,10,8,0,38,46,1,1,0,2,1,1,1,3,0,0,0,0,7,1,0,8
119097.0,Startseva Evgeniya,S,Russia,33.0,185,2021,Serbia,2021-06-14,True,0,0,3,3,3,0,22,25,1,0,0,1,1,1,1,3,0,0,1,1,3,2,1,6
119097.0,Startseva Evgeniya,S,Russia,33.0,185,2021,China,2021-06-18,False,0,0,4,4,6,0,61,67,0,0,0,0,0,1,2,3,0,0,0,0,3,0,3,6
119097.0,Startseva Evgeniya,S,Russia,33.0,185,2021,USA,2021-06-19,False,0,0,12,12,12,1,73,86,3,1,1,5,1,1,2,4,0,0,1,1,9,5,2,16
119097.0,Startseva Evgeniya,S,Russia,33.0,185,2021,Poland,2021-06-20,False,0,1,2,3,12,1,54,67,0,0,1,1,0,0,0,0,0,0,0,0,5,3,0,8
142339.0,Fetisova Irina,MB,Russia,27.0,190,2021,Germany,2021-05-25,True,0,1,3,4,0,0,0,0,0,0,2,2,0,2,2,4,0,0,0,0,0,0,0,0
142339.0,Fetisova Irina,MB,Russia,27.0,190,2021,Belgium,2021-05-26,True,0,2,15,17,0,0,0,0,1,1,2,4,2,4,3,9,1,0,0,1,2,1,2,5
142339.0,Fetisova Irina,MB,Russia,27.0,190,2021,Netherlands,2021-05-27,False,0,0,2,2,0,0,0,0,0,0,2,2,0,0,0,0,0,0,0,0,0,0,0,0
142339.0,Fetisova Irina,MB,Russia,27.0,190,2021,Italy,2021-05-31,True,1,1,16,18,0,1,1,2,3,0,1,4,1,3,4,8,0,0,0,0,3,2,0,5
142339.0,Fetisova Irina,MB,Russia,27.0,190,2021,Japan,2021-06-02,False,0,0,8,8,0,0,2,2,2,0,9,11,4,6,1,11,0,0,0,0,1,5,0,6
142339.0,Fetisova Irina,MB,Russia,27.0,190,2021,Dominican Republic,2021-06-06,True,0,1,23,24,0,0,5,5,2,0,0,2,2,5,10,17,0,0,0,0,5,2,3,10
142339.0,Fetisova Irina,MB,Russia,27.0,190,2021,Thailand,2021-06-07,True,0,1,11,12,0,0,1,1,4,1,1,6,6,4,6,16,0,0,0,0,3,0,0,3
142339.0,Fetisova Irina,MB,Russia,27.0,190,2021,Canada,2021-06-13,True,1,0,9,10,0,0,2,2,4,0,0,4,1,2,1,4,0,0,2,2,3,0,1,4
142339.0,Fetisova Irina,MB,Russia,27.0,190,2021,Serbia,2021-06-14,True,1,1,10,12,0,0,2,2,4,1,1,6,0,1,2,3,0,0,0,0,0,0,0,0
142339.0,Fetisova Irina,MB,Russia,27.0,190,2021,China,2021-06-18,False,0,1,9,10,0,0,0,0,0,1,1,2,1,2,6,9,0,0,3,3,1,2,0,3
142339.0,Fetisova Irina,MB,Russia,27.0,190,2021,USA,2021-06-19,False,0,0,9,9,0,0,3,3,3,0,4,7,1,3,2,6,0,0,0,0,6,2,0,8
142339.0,Fetisova Irina,MB,Russia,27.0,190,2021,Poland,2021-06-20,False,0,0,4,4,0,0,0,0,1,0,1,2,1,1,1,3,0,0,0,0,0,0,0,0
119677.0,Kosheleva Tatyana,OH,Russia,33.0,191,2021,Germany,2021-05-25,True,0,1,4,5,0,0,0,0,10,1,11,22,1,2,5,8,4,3,11,18,1,1,1,3
119677.0,Kosheleva Tatyana,OH,Russia,33.0,191,2021,Belgium,2021-05-26,True,0,1,7,8,0,0,1,1,6,2,11,19,6,2,7,15,6,0,8,14,7,1,4,12
119677.0,Kosheleva Tatyana,OH,Russia,33.0,191,2021,Netherlands,2021-05-27,False,0,0,1,1,0,0,1,1,1,1,2,4,0,1,1,2,2,0,2,4,0,1,0,1
119677.0,Kosheleva Tatyana,OH,Russia,33.0,191,2021,Italy,2021-05-31,True,0,1,7,8,0,0,0,0,10,1,5,16,1,2,0,3,7,2,26,35,4,3,1,8
119677.0,Kosheleva Tatyana,OH,Russia,33.0,191,2021,Brazil,2021-06-01,False,1,0,7,8,0,1,0,1,5,0,3,8,0,4,0,4,7,2,18,27,6,1,2,9
119677.0,Kosheleva Tatyana,OH,Russia,33.0,191,2021,Japan,2021-06-02,False,0,0,7,7,0,0,2,2,5,2,14,21,1,2,0,3,5,3,10,18,3,5,0,8
119677.0,Kosheleva Tatyana,OH,Russia,33.0,191,2021,Canada,2021-06-13,True,2,0,7,9,0,0,2,2,7,0,8,15,0,0,1,1,2,2,5,9,4,0,0,4
119677.0,Kosheleva Tatyana,OH,Russia,33.0,191,2021,Serbia,2021-06-14,True,1,0,5,6,0,0,0,0,2,2,1,5,0,1,1,2,1,0,1,2,4,0,0,4
119677.0,Kosheleva Tatyana,OH,Russia,33.0,191,2021,China,2021-06-18,False,0,0,3,3,0,0,0,0,3,3,8,14,0,2,0,2,1,0,6,7,1,2,0,3
119677.0,Kosheleva Tatyana,OH,Russia,33.0,191,2021,USA,2021-06-19,False,0,0,2,2,0,0,0,0,2,1,3,6,1,1,0,2,1,0,6,7,0,0,0,0
119677.0,Kosheleva Tatyana,OH,Russia,33.0,191,2021,Poland,2021-06-20,False,1,1,3,5,0,0,1,1,1,1,3,5,2,1,0,3,2,0,10,12,0,1,0,1
142329.0,Voronkova Irina,OH,Russia,26.0,190,2021,Germany,2021-05-25,True,3,1,10,14,0,0,1,1,10,3,8,21,1,3,2,6,9,2,11,22,5,0,0,5
142329.0,Voronkova Irina,OH,Russia,26.0,190,2021,Belgium,2021-05-26,True,1,4,13,18,0,0,1,1,16,3,18,37,0,6,2,8,13,0,24,37,9,2,1,12
142329.0,Voronkova Irina,OH,Russia,26.0,190,2021,Netherlands,2021-05-27,False,0,0,2,2,0,0,1,1,0,1,4,5,0,0,0,0,1,0,1,2,3,1,0,4
142329.0,Voronkova Irina,OH,Russia,26.0,190,2021,Italy,2021-05-31,True,0,1,2,3,0,0,0,0,3,4,6,13,0,0,0,0,0,1,2,3,4,1,0,5
142329.0,Voronkova Irina,OH,Russia,26.0,190,2021,Brazil,2021-06-01,False,0,0,5,5,0,0,0,0,5,4,12,21,1,0,0,1,3,1,4,8,2,2,2,6
142329.0,Voronkova Irina,OH,Russia,26.0,190,2021,Japan,2021-06-02,False,1,1,9,11,0,0,0,0,10,2,10,22,0,2,1,3,10,1,7,18,2,2,0,4
142329.0,Voronkova Irina,OH,Russia,26.0,190,2021,Dominican Republic,2021-06-06,True,1,3,14,18,0,0,5,5,18,6,19,43,0,3,6,9,5,1,22,28,14,0,2,16
142329.0,Voronkova Irina,OH,Russia,26.0,190,2021,Thailand,2021-06-07,True,0,2,8,10,0,0,2,2,5,2,10,17,1,2,0,3,10,1,11,22,13,1,0,14
142329.0,Voronkova Irina,OH,Russia,26.0,190,2021,Canada,2021-06-13,True,0,0,0,0,0,0,0,0,0,0,0,0,0,0,0,0,0,0,0,0,0,0,0,0
142329.0,Voronkova Irina,OH,Russia,26.0,190,2021,Serbia,2021-06-14,True,0,1,7,8,0,0,0,0,8,1,3,12,1,0,2,3,2,0,3,5,6,0,1,7
142329.0,Voronkova Irina,OH,Russia,26.0,190,2021,China,2021-06-18,False,1,0,7,8,0,0,1,1,12,3,14,29,0,1,4,5,7,0,21,28,8,4,1,13
142329.0,Voronkova Irina,OH,Russia,26.0,190,2021,USA,2021-06-19,False,1,3,6,10,0,0,5,5,12,2,10,24,0,3,2,5,4,1,13,18,8,3,3,14
142329.0,Voronkova Irina,OH,Russia,26.0,190,2021,Poland,2021-06-20,False,1,0,8,9,0,0,0,0,10,6,11,27,2,2,3,7,6,3,18,27,3,1,1,5
173153.0,Podkopaeva Anna,L,Russia,31.0,175,2021,Canada,2021-06-13,True,0,0,0,0,0,0,4,4,0,0,0,0,0,0,0,0,0,0,5,5,10,3,0,13
173153.0,Podkopaeva Anna,L,Russia,31.0,175,2021,Serbia,2021-06-14,True,0,0,0,0,0,0,4,4,0,0,0,0,0,0,0,0,3,1,7,11,10,3,2,15
173153.0,Podkopaeva Anna,L,Russia,31.0,175,2021,China,2021-06-18,False,0,0,0,0,0,0,6,6,0,0,0,0,0,0,0,0,1,0,16,17,14,3,2,19
173153.0,Podkopaeva Anna,L,Russia,31.0,175,2021,USA,2021-06-19,False,0,0,0,0,0,0,4,4,0,0,0,0,0,0,0,0,0,1,10,11,6,3,1,10
173153.0,Podkopaeva Anna,L,Russia,31.0,175,2021,Poland,2021-06-20,False,0,0,0,0,0,0,6,6,0,0,0,0,0,0,0,0,2,0,4,6,11,3,1,15
180970.0,Lazareva Ekaterina,S,Russia,26.0,182,2021,Germany,2021-05-25,True,0,0,0,0,0,0,0,0,0,0,0,0,0,0,0,0,0,0,0,0,0,0,0,0
180970.0,Lazareva Ekaterina,S,Russia,26.0,182,2021,Netherlands,2021-05-27,False,1,1,12,14,8,0,77,85,1,0,1,2,0,2,0,2,0,0,0,0,10,4,0,14
180970.0,Lazareva Ekaterina,S,Russia,26.0,182,2021,Italy,2021-05-31,True,0,0,0,0,0,0,0,0,0,0,0,0,0,0,0,0,0,0,0,0,0,0,0,0
180970.0,Lazareva Ekaterina,S,Russia,26.0,182,2021,Brazil,2021-06-01,False,0,0,3,3,1,3,42,46,0,0,0,0,0,1,1,2,0,0,0,0,7,2,1,10
180970.0,Lazareva Ekaterina,S,Russia,26.0,182,2021,Thailand,2021-06-07,True,0,1,2,3,3,0,18,21,0,0,1,1,0,0,0,0,0,0,0,0,3,0,1,4
180970.0,Lazareva Ekaterina,S,Russia,26.0,182,2021,Serbia,2021-06-14,True,1,0,4,5,6,0,39,45,1,0,2,3,0,2,2,4,0,0,0,0,1,1,0,2
164025.0,Pipunyrova Ekaterina,OH,Russia,22.0,188,2021,Brazil,2021-06-01,False,0,0,0,0,0,0,0,0,0,2,2,4,0,0,1,1,0,1,4,5,2,0,0,2
164025.0,Pipunyrova Ekaterina,OH,Russia,22.0,188,2021,Dominican Republic,2021-06-06,True,0,0,0,0,0,0,0,0,0,0,0,0,0,0,0,0,0,0,0,0,0,0,0,0
164025.0,Pipunyrova Ekaterina,OH,Russia,22.0,188,2021,Thailand,2021-06-07,True,0,0,0,0,0,0,0,0,0,0,0,0,0,0,0,0,0,0,1,1,1,0,0,1
164025.0,Pipunyrova Ekaterina,OH,Russia,22.0,188,2021,Canada,2021-06-13,True,0,1,1,2,0,0,1,1,0,0,0,0,0,0,0,0,0,0,1,1,0,0,0,0
164025.0,Pipunyrova Ekaterina,OH,Russia,22.0,188,2021,Serbia,2021-06-14,True,1,0,1,2,0,0,0,0,0,0,0,0,0,0,0,0,0,0,0,0,0,0,0,0
164025.0,Pipunyrova Ekaterina,OH,Russia,22.0,188,2021,China,2021-06-18,False,0,1,0,1,0,0,0,0,0,0,0,0,0,0,0,0,0,0,0,0,0,0,0,0
164025.0,Pipunyrova Ekaterina,OH,Russia,22.0,188,2021,USA,2021-06-19,False,0,0,0,0,0,0,0,0,0,0,0,0,0,0,0,0,0,0,0,0,0,0,0,0
164025.0,Pipunyrova Ekaterina,OH,Russia,22.0,188,2021,Poland,2021-06-20,False,0,1,1,2,0,0,0,0,0,0,0,0,0,0,0,0,0,0,0,0,0,0,0,0
151625.0,Smirnova Kseniia,OH,Russia,23.0,187,2021,Germany,2021-05-25,True,0,0,4,4,0,0,0,0,0,0,1,1,0,0,0,0,0,0,0,0,1,0,0,1
151625.0,Smirnova Kseniia,OH,Russia,23.0,187,2021,Netherlands,2021-05-27,False,1,3,8,12,0,1,0,1,17,5,18,40,0,0,0,0,0,0,0,0,5,3,0,8
151625.0,Smirnova Kseniia,OH,Russia,23.0,187,2021,Italy,2021-05-31,True,0,1,4,5,0,0,0,0,0,0,0,0,0,0,0,0,0,0,0,0,1,0,0,1
151625.0,Smirnova Kseniia,OH,Russia,23.0,187,2021,Brazil,2021-06-01,False,0,0,7,7,0,0,1,1,8,5,20,33,0,1,0,1,1,0,0,1,6,3,0,9
151625.0,Smirnova Kseniia,OH,Russia,23.0,187,2021,Japan,2021-06-02,False,0,1,1,2,0,0,0,0,0,0,0,0,0,0,0,0,0,0,0,0,0,0,0,0
151625.0,Smirnova Kseniia,OH,Russia,23.0,187,2021,Dominican Republic,2021-06-06,True,0,0,1,1,0,0,0,0,0,0,2,2,0,0,0,0,0,0,1,1,3,0,0,3
151625.0,Smirnova Kseniia,OH,Russia,23.0,187,2021,Thailand,2021-06-07,True,0,1,1,2,0,0,0,0,5,1,3,9,2,1,0,3,1,2,3,6,2,0,0,2
151625.0,Smirnova Kseniia,OH,Russia,23.0,187,2021,Canada,2021-06-13,True,2,1,6,9,0,0,0,0,0,1,2,3,0,2,1,3,1,0,1,2,1,0,0,1
151625.0,Smirnova Kseniia,OH,Russia,23.0,187,2021,Serbia,2021-06-14,True,0,0,6,6,0,0,0,0,4,3,1,8,0,0,0,0,3,2,12,17,3,1,0,4
151625.0,Smirnova Kseniia,OH,Russia,23.0,187,2021,China,2021-06-18,False,0,0,3,3,0,0,0,0,0,0,0,0,0,0,0,0,0,0,0,0,0,0,0,0
151625.0,Smirnova Kseniia,OH,Russia,23.0,187,2021,USA,2021-06-19,False,0,1,3,4,0,0,0,0,2,0,2,4,0,2,0,2,1,3,3,7,0,0,1,1
151625.0,Smirnova Kseniia,OH,Russia,23.0,187,2021,Poland,2021-06-20,False,1,2,8,11,0,0,1,1,5,5,8,18,0,1,2,3,2,0,1,3,3,0,0,3
152168.0,Lazovic Katarina,OH,Serbia,22.0,182,2021,Poland,2021-05-26,True,0,4,17,21,0,0,3,3,17,3,18,38,1,4,0,5,7,3,22,32,4,2,1,7
152168.0,Lazovic Katarina,OH,Serbia,22.0,182,2021,Italy,2021-05-27,True,0,3,14,17,0,0,4,4,17,8,22,47,1,2,3,6,7,0,15,22,10,0,1,11
152168.0,Lazovic Katarina,OH,Serbia,22.0,182,2021,USA,2021-05-31,False,2,2,2,6,0,0,0,0,8,3,10,21,2,2,4,8,6,1,16,23,5,2,1,8
152168.0,Lazovic Katarina,OH,Serbia,22.0,182,2021,Thailand,2021-06-01,True,0,2,16,18,1,0,1,2,14,2,12,28,0,2,0,2,8,0,12,20,14,0,1,15
152168.0,Lazovic Katarina,OH,Serbia,22.0,182,2021,Netherlands,2021-06-02,False,2,3,10,15,0,0,3,3,14,6,16,36,0,0,3,3,7,1,27,35,11,5,5,21
152168.0,Lazovic Katarina,OH,Serbia,22.0,182,2021,Brazil,2021-06-06,False,0,1,4,5,0,0,2,2,6,2,6,14,0,0,1,1,12,4,12,28,4,0,1,5
152168.0,Lazovic Katarina,OH,Serbia,22.0,182,2021,China,2021-06-07,True,3,1,14,18,0,0,3,3,22,12,14,48,1,2,1,4,14,0,22,36,9,3,0,12
152168.0,Lazovic Katarina,OH,Serbia,22.0,182,2021,Belgium,2021-06-08,False,0,3,16,19,0,0,5,5,14,9,32,55,2,6,7,15,5,0,21,26,24,2,8,34
152168.0,Lazovic Katarina,OH,Serbia,22.0,182,2021,Canada,2021-06-12,False,0,0,0,0,0,0,0,0,0,0,0,0,0,0,0,0,0,0,0,0,1,0,0,1
163120.0,Caric Sara,O,Serbia,21.0,193,2021,Poland,2021-05-26,True,0,1,8,9,0,0,1,1,19,3,13,35,2,2,1,5,0,0,0,0,5,2,0,7
163120.0,Caric Sara,O,Serbia,21.0,193,2021,Italy,2021-05-27,True,0,4,5,9,0,0,2,2,8,9,10,27,3,1,1,5,0,0,0,0,8,0,1,9
163120.0,Caric Sara,O,Serbia,21.0,193,2021,Thailand,2021-06-01,True,0,1,9,10,0,0,0,0,8,7,16,31,6,3,3,12,0,0,0,0,13,2,2,17
163120.0,Caric Sara,O,Serbia,21.0,193,2021,Netherlands,2021-06-02,False,0,0,8,8,0,0,1,1,7,8,20,35,0,1,2,3,0,0,0,0,8,3,3,14
163120.0,Caric Sara,O,Serbia,21.0,193,2021,Brazil,2021-06-06,False,1,0,5,6,0,0,5,5,3,3,11,17,0,1,1,2,0,0,0,0,3,1,0,4
163120.0,Caric Sara,O,Serbia,21.0,193,2021,China,2021-06-07,True,0,1,12,13,0,0,0,0,20,5,17,42,2,4,0,6,0,0,0,0,6,2,1,9
163120.0,Caric Sara,O,Serbia,21.0,193,2021,Belgium,2021-06-08,False,0,1,14,15,0,0,3,3,18,5,24,47,1,5,11,17,0,0,0,0,12,4,1,17
163120.0,Caric Sara,O,Serbia,21.0,193,2021,Canada,2021-06-12,False,1,1,13,15,0,0,3,3,12,6,14,32,2,2,3,7,0,0,0,0,9,3,0,12
181204.0,Uzelac Aleksandra,OH,Serbia,17.0,188,2021,Poland,2021-05-26,True,0,0,0,0,0,0,0,0,0,0,0,0,0,0,0,0,0,0,0,0,0,0,0,0
181204.0,Uzelac Aleksandra,OH,Serbia,17.0,188,2021,Italy,2021-05-27,True,0,0,0,0,0,0,0,0,0,0,0,0,0,0,0,0,0,0,0,0,0,0,0,0
181204.0,Uzelac Aleksandra,OH,Serbia,17.0,188,2021,USA,2021-05-31,False,0,0,11,11,0,1,3,4,8,7,8,23,0,1,0,1,3,3,8,14,4,2,3,9
181204.0,Uzelac Aleksandra,OH,Serbia,17.0,188,2021,Thailand,2021-06-01,True,0,0,0,0,0,0,0,0,0,0,0,0,0,0,0,0,0,0,0,0,0,0,0,0
181204.0,Uzelac Aleksandra,OH,Serbia,17.0,188,2021,Netherlands,2021-06-02,False,0,1,0,1,0,0,0,0,1,2,0,3,0,0,0,0,0,0,0,0,1,0,0,1
181204.0,Uzelac Aleksandra,OH,Serbia,17.0,188,2021,Brazil,2021-06-06,False,0,0,0,0,0,0,0,0,0,0,0,0,0,0,0,0,0,0,0,0,0,0,0,0
181204.0,Uzelac Aleksandra,OH,Serbia,17.0,188,2021,China,2021-06-07,True,0,0,0,0,0,0,0,0,0,0,0,0,0,0,0,0,0,0,0,0,0,0,0,0
181204.0,Uzelac Aleksandra,OH,Serbia,17.0,188,2021,Belgium,2021-06-08,False,0,0,4,4,0,0,1,1,1,2,4,7,0,2,1,3,0,0,0,0,1,0,0,1
181204.0,Uzelac Aleksandra,OH,Serbia,17.0,188,2021,Canada,2021-06-12,False,0,0,1,1,0,0,0,0,0,1,1,2,0,0,0,0,0,0,5,5,1,1,0,2
181204.0,Uzelac Aleksandra,OH,Serbia,17.0,188,2021,Russia,2021-06-14,False,0,0,5,5,0,0,1,1,4,2,4,10,0,0,1,1,0,2,2,4,0,2,1,3
181204.0,Uzelac Aleksandra,OH,Serbia,17.0,188,2021,Germany,2021-06-18,False,0,0,0,0,0,0,0,0,0,1,0,1,0,0,0,0,0,0,0,0,0,1,0,1
181204.0,Uzelac Aleksandra,OH,Serbia,17.0,188,2021,Dominican Republic,2021-06-19,False,0,3,8,11,0,0,4,4,14,0,8,22,2,1,0,3,11,2,18,31,4,1,0,5
181204.0,Uzelac Aleksandra,OH,Serbia,17.0,188,2021,Japan,2021-06-20,False,0,0,6,6,0,0,0,0,1,4,13,18,1,0,0,1,3,1,7,11,1,0,0,1
152169.0,Jaksic Ana,S,Serbia,24.0,178,2021,Poland,2021-05-26,True,0,2,11,13,10,1,90,101,1,0,0,1,1,2,0,3,0,0,0,0,4,1,0,5
152169.0,Jaksic Ana,S,Serbia,24.0,178,2021,Italy,2021-05-27,True,1,1,19,21,20,1,81,102,1,0,1,2,1,0,0,1,0,0,0,0,11,0,1,12
152169.0,Jaksic Ana,S,Serbia,24.0,178,2021,USA,2021-05-31,False,0,0,5,5,5,0,66,71,0,1,0,1,0,1,3,4,0,1,0,1,7,3,2,12
152169.0,Jaksic Ana,S,Serbia,24.0,178,2021,Thailand,2021-06-01,True,1,0,9,10,14,1,75,90,3,0,3,6,2,0,3,5,0,0,0,0,3,0,1,4
152169.0,Jaksic Ana,S,Serbia,24.0,178,2021,Netherlands,2021-06-02,False,0,1,1,2,3,0,21,24,0,0,1,1,0,0,0,0,0,0,0,0,2,0,0,2
152169.0,Jaksic Ana,S,Serbia,24.0,178,2021,Brazil,2021-06-06,False,0,0,1,1,1,0,24,25,0,0,2,2,0,1,0,1,0,0,0,0,2,0,0,2
152169.0,Jaksic Ana,S,Serbia,24.0,178,2021,China,2021-06-07,True,1,2,13,16,5,0,71,76,3,0,1,4,0,1,0,1,0,0,0,0,2,5,0,7
152169.0,Jaksic Ana,S,Serbia,24.0,178,2021,Belgium,2021-06-08,False,1,1,17,19,23,3,104,130,1,0,2,3,2,1,4,7,0,0,0,0,8,3,1,12
152169.0,Jaksic Ana,S,Serbia,24.0,178,2021,Canada,2021-06-12,False,0,1,9,10,9,0,54,63,1,0,0,1,0,3,1,4,0,0,0,0,7,3,1,11
152169.0,Jaksic Ana,S,Serbia,24.0,178,2021,Russia,2021-06-14,False,1,0,5,6,5,0,53,58,1,0,1,2,1,3,2,6,0,0,0,0,3,2,1,6
152169.0,Jaksic Ana,S,Serbia,24.0,178,2021,Germany,2021-06-18,False,0,0,8,8,2,0,50,52,2,0,1,3,0,1,1,2,0,0,0,0,5,3,1,9
152169.0,Jaksic Ana,S,Serbia,24.0,178,2021,Dominican Republic,2021-06-19,False,0,1,5,6,11,1,36,48,1,0,1,2,0,1,0,1,0,0,0,0,4,3,0,7
152169.0,Jaksic Ana,S,Serbia,24.0,178,2021,Japan,2021-06-20,False,0,0,1,1,1,0,20,21,0,0,0,0,1,2,1,4,0,0,0,0,0,0,0,0
152167.0,Kocic Jovana,MB,Serbia,24.0,191,2021,Poland,2021-05-26,True,0,1,16,17,0,0,0,0,3,0,2,5,6,4,4,14,0,0,1,1,3,0,0,3
152167.0,Kocic Jovana,MB,Serbia,24.0,191,2021,Italy,2021-05-27,True,0,1,22,23,0,0,2,2,8,0,6,14,1,7,2,10,0,0,0,0,0,2,0,2
152167.0,Kocic Jovana,MB,Serbia,24.0,191,2021,USA,2021-05-31,False,0,0,0,0,0,0,0,0,0,0,0,0,0,0,0,0,0,0,0,0,0,0,0,0
152167.0,Kocic Jovana,MB,Serbia,24.0,191,2021,Thailand,2021-06-01,True,0,1,12,13,0,0,1,1,4,1,4,9,5,4,6,15,1,0,1,2,2,0,1,3
152167.0,Kocic Jovana,MB,Serbia,24.0,191,2021,Netherlands,2021-06-02,False,0,0,13,13,0,0,4,4,7,0,7,14,7,5,10,22,0,0,2,2,4,0,1,5
152167.0,Kocic Jovana,MB,Serbia,24.0,191,2021,Brazil,2021-06-06,False,0,0,3,3,0,0,1,1,2,0,3,5,0,3,1,4,0,0,0,0,2,0,0,2
152167.0,Kocic Jovana,MB,Serbia,24.0,191,2021,China,2021-06-07,True,0,0,9,9,0,0,0,0,7,2,5,14,2,0,1,3,0,0,0,0,4,0,0,4
152167.0,Kocic Jovana,MB,Serbia,24.0,191,2021,Belgium,2021-06-08,False,1,0,18,19,0,0,3,3,5,0,6,11,4,8,12,24,0,0,0,0,9,0,0,9
152167.0,Kocic Jovana,MB,Serbia,24.0,191,2021,Canada,2021-06-12,False,0,0,12,12,0,0,1,1,6,1,4,11,1,5,5,11,0,0,0,0,3,0,2,5
152167.0,Kocic Jovana,MB,Serbia,24.0,191,2021,Russia,2021-06-14,False,0,0,6,6,0,0,1,1,0,3,2,5,2,2,1,5,0,0,0,0,0,0,0,0
152167.0,Kocic Jovana,MB,Serbia,24.0,191,2021,Germany,2021-06-18,False,0,0,8,8,0,0,0,0,1,1,1,3,3,4,0,7,0,0,0,0,1,1,0,2
152167.0,Kocic Jovana,MB,Serbia,24.0,191,2021,Dominican Republic,2021-06-19,False,0,1,3,4,0,0,1,1,1,2,2,5,2,5,4,11,0,0,0,0,1,0,0,1
152167.0,Kocic Jovana,MB,Serbia,24.0,191,2021,Japan,2021-06-20,False,0,0,7,7,0,0,0,0,4,2,2,8,3,2,0,5,0,0,0,0,2,0,0,2
142479.0,Lozo Sara,O,Serbia,24.0,186,2021,Poland,2021-05-26,True,0,1,13,14,0,0,4,4,13,6,12,31,0,5,1,6,6,1,14,21,12,1,1,14
142479.0,Lozo Sara,O,Serbia,24.0,186,2021,Italy,2021-05-27,True,0,1,7,8,0,0,1,1,8,4,7,19,0,1,0,1,5,0,20,25,7,1,0,8
142479.0,Lozo Sara,O,Serbia,24.0,186,2021,USA,2021-05-31,False,0,0,0,0,0,0,0,0,0,0,1,1,0,0,0,0,0,0,0,0,0,0,0,0
142479.0,Lozo Sara,O,Serbia,24.0,186,2021,Thailand,2021-06-01,True,3,0,5,8,0,0,1,1,3,4,9,16,0,0,0,0,3,2,9,14,5,0,0,5
142479.0,Lozo Sara,O,Serbia,24.0,186,2021,Netherlands,2021-06-02,False,0,2,3,5,0,0,3,3,7,5,14,26,1,2,2,5,0,3,13,16,3,2,0,5
142479.0,Lozo Sara,O,Serbia,24.0,186,2021,Brazil,2021-06-06,False,0,2,0,2,0,0,1,1,2,3,3,8,0,1,0,1,4,1,4,9,1,0,1,2
142479.0,Lozo Sara,O,Serbia,24.0,186,2021,China,2021-06-07,True,3,2,10,15,0,0,4,4,11,5,14,30,2,1,0,3,12,1,14,27,10,2,0,12
142479.0,Lozo Sara,O,Serbia,24.0,186,2021,Belgium,2021-06-08,False,2,1,14,17,0,0,7,7,13,3,27,43,1,3,8,12,8,4,24,36,16,1,1,18
142479.0,Lozo Sara,O,Serbia,24.0,186,2021,Canada,2021-06-12,False,3,0,11,14,0,0,5,5,12,5,13,30,1,0,3,4,8,3,22,33,11,5,0,16
142479.0,Lozo Sara,O,Serbia,24.0,186,2021,Russia,2021-06-14,False,1,0,9,10,0,0,5,5,7,5,9,21,1,1,1,3,2,2,15,19,6,4,0,10
142479.0,Lozo Sara,O,Serbia,24.0,186,2021,Germany,2021-06-18,False,1,1,9,11,0,0,5,5,8,3,10,21,1,0,0,1,9,1,11,21,8,4,0,12
142479.0,Lozo Sara,O,Serbia,24.0,186,2021,Dominican Republic,2021-06-19,False,0,0,0,0,0,0,0,0,0,0,0,0,0,0,0,0,0,0,0,0,0,0,0,0
142479.0,Lozo Sara,O,Serbia,24.0,186,2021,Japan,2021-06-20,False,0,1,4,5,0,0,5,5,6,2,9,17,1,1,0,2,14,5,17,36,1,4,0,5
163056.0,Djordjevic Mila,S,Serbia,23.0,181,2021,Poland,2021-05-26,True,0,1,0,1,0,1,8,9,0,0,0,0,0,0,0,0,0,0,0,0,0,0,0,0
163056.0,Djordjevic Mila,S,Serbia,23.0,181,2021,Italy,2021-05-27,True,0,1,1,2,1,0,14,15,1,0,0,1,0,1,0,1,0,0,0,0,1,2,0,3
163056.0,Djordjevic Mila,S,Serbia,23.0,181,2021,USA,2021-05-31,False,0,0,0,0,0,1,15,16,0,0,0,0,0,0,0,0,0,0,0,0,2,2,2,6
163056.0,Djordjevic Mila,S,Serbia,23.0,181,2021,Thailand,2021-06-01,True,0,0,1,1,2,0,12,14,1,0,0,1,0,1,0,1,0,0,0,0,1,0,0,1
163056.0,Djordjevic Mila,S,Serbia,23.0,181,2021,Netherlands,2021-06-02,False,0,1,18,19,21,2,83,106,0,0,2,2,0,1,1,2,0,0,0,0,12,0,2,14
163056.0,Djordjevic Mila,S,Serbia,23.0,181,2021,Brazil,2021-06-06,False,0,2,3,5,6,1,35,42,1,0,0,1,1,1,1,3,0,0,0,0,3,1,1,5
163056.0,Djordjevic Mila,S,Serbia,23.0,181,2021,China,2021-06-07,True,0,2,1,3,2,0,46,48,0,0,0,0,0,1,0,1,0,0,0,0,2,0,0,2
163056.0,Djordjevic Mila,S,Serbia,23.0,181,2021,Belgium,2021-06-08,False,0,0,0,0,2,0,19,21,0,1,0,1,1,1,0,2,0,0,0,0,2,2,0,4
163056.0,Djordjevic Mila,S,Serbia,23.0,181,2021,Canada,2021-06-12,False,0,1,3,4,3,0,39,42,0,0,3,3,3,3,2,8,0,0,0,0,2,3,0,5
163056.0,Djordjevic Mila,S,Serbia,23.0,181,2021,Russia,2021-06-14,False,0,0,0,0,1,0,2,3,0,0,0,0,0,0,0,0,0,0,0,0,1,0,0,1
163056.0,Djordjevic Mila,S,Serbia,23.0,181,2021,Germany,2021-06-18,False,0,1,1,2,0,0,21,21,0,2,0,2,1,0,0,1,0,0,0,0,3,0,0,3
163056.0,Djordjevic Mila,S,Serbia,23.0,181,2021,Dominican Republic,2021-06-19,False,0,2,0,2,4,0,22,26,1,0,0,1,0,1,0,1,0,0,0,0,2,3,0,5
163056.0,Djordjevic Mila,S,Serbia,23.0,181,2021,Japan,2021-06-20,False,0,2,7,9,2,0,55,57,3,0,1,4,2,6,2,10,0,0,0,0,4,3,0,7
138480.0,Medic Sofija,MB,Serbia,31.0,184,2021,Poland,2021-05-26,True,0,0,2,2,0,0,0,0,0,1,3,4,0,1,0,1,0,0,1,1,0,0,0,0
138480.0,Medic Sofija,MB,Serbia,31.0,184,2021,Italy,2021-05-27,True,1,1,11,13,0,0,1,1,5,0,6,11,2,4,3,9,0,0,1,1,0,0,0,0
138480.0,Medic Sofija,MB,Serbia,31.0,184,2021,USA,2021-05-31,False,1,0,4,5,0,0,2,2,2,1,4,7,2,2,5,9,0,0,0,0,3,0,0,3
138480.0,Medic Sofija,MB,Serbia,31.0,184,2021,Thailand,2021-06-01,True,0,2,6,8,0,0,0,0,1,3,3,7,3,0,7,10,0,0,0,0,1,0,0,1
138480.0,Medic Sofija,MB,Serbia,31.0,184,2021,Netherlands,2021-06-02,False,0,2,8,10,0,0,2,2,4,1,4,9,3,7,7,17,0,0,1,1,4,0,1,5
138480.0,Medic Sofija,MB,Serbia,31.0,184,2021,Brazil,2021-06-06,False,0,0,0,0,0,0,0,0,0,0,0,0,0,0,0,0,0,0,0,0,0,0,0,0
138480.0,Medic Sofija,MB,Serbia,31.0,184,2021,China,2021-06-07,True,1,0,16,17,0,0,1,1,3,2,3,8,1,3,1,5,0,0,0,0,1,0,0,1
138480.0,Medic Sofija,MB,Serbia,31.0,184,2021,Belgium,2021-06-08,False,0,0,2,2,0,0,1,1,0,0,0,0,1,2,1,4,0,0,0,0,0,0,0,0
138480.0,Medic Sofija,MB,Serbia,31.0,184,2021,Canada,2021-06-12,False,0,1,5,6,0,0,0,0,1,2,3,6,1,5,2,8,0,0,1,1,5,0,0,5
138480.0,Medic Sofija,MB,Serbia,31.0,184,2021,Russia,2021-06-14,False,1,1,3,5,0,0,0,0,2,0,0,2,1,1,0,2,0,0,0,0,2,0,0,2
138480.0,Medic Sofija,MB,Serbia,31.0,184,2021,Germany,2021-06-18,False,1,0,4,5,0,0,0,0,0,0,0,0,0,2,0,2,0,0,1,1,0,0,0,0
138480.0,Medic Sofija,MB,Serbia,31.0,184,2021,Dominican Republic,2021-06-19,False,0,0,0,0,0,0,0,0,0,0,0,0,0,0,0,0,0,0,0,0,0,0,0,0
138480.0,Medic Sofija,MB,Serbia,31.0,184,2021,Japan,2021-06-20,False,0,0,1,1,0,0,0,0,0,1,1,2,0,0,0,0,0,0,0,0,0,0,0,0
153452.0,Markovic Bozica,MB,Serbia,24.0,185,2021,Poland,2021-05-26,True,3,0,12,15,0,0,0,0,5,1,0,6,1,4,0,5,0,0,0,0,1,0,0,1
153452.0,Markovic Bozica,MB,Serbia,24.0,185,2021,Italy,2021-05-27,True,0,0,0,0,0,0,0,0,0,0,0,0,0,0,0,0,0,0,0,0,0,0,0,0
153452.0,Markovic Bozica,MB,Serbia,24.0,185,2021,Brazil,2021-06-06,False,0,1,8,9,0,0,2,2,2,2,4,8,1,4,5,10,0,0,0,0,2,0,2,4
153452.0,Markovic Bozica,MB,Serbia,24.0,185,2021,China,2021-06-07,True,0,0,1,1,0,0,0,0,0,0,0,0,0,0,0,0,0,0,0,0,0,1,0,1
153452.0,Markovic Bozica,MB,Serbia,24.0,185,2021,Belgium,2021-06-08,False,0,1,7,8,0,0,1,1,9,1,3,13,1,9,13,23,0,0,0,0,2,1,1,4
153452.0,Markovic Bozica,MB,Serbia,24.0,185,2021,Canada,2021-06-12,False,0,0,1,1,0,0,0,0,0,0,0,0,0,0,0,0,0,0,0,0,1,0,0,1
153452.0,Markovic Bozica,MB,Serbia,24.0,185,2021,Russia,2021-06-14,False,0,1,2,3,0,0,0,0,0,0,2,2,0,2,1,3,0,0,1,1,2,0,0,2
153452.0,Markovic Bozica,MB,Serbia,24.0,185,2021,Germany,2021-06-18,False,0,1,6,7,0,0,0,0,1,0,7,8,0,2,0,2,1,0,1,2,1,1,0,2
153452.0,Markovic Bozica,MB,Serbia,24.0,185,2021,Dominican Republic,2021-06-19,False,0,0,2,2,0,0,0,0,0,1,2,3,0,1,0,1,0,0,0,0,1,0,0,1
153452.0,Markovic Bozica,MB,Serbia,24.0,185,2021,Japan,2021-06-20,False,0,2,2,4,0,0,0,0,2,1,4,7,0,0,0,0,0,0,0,0,0,0,0,0
173974.0,Savic Vanja,O,Serbia,19.0,188,2021,Poland,2021-05-26,True,0,1,0,1,0,0,0,0,0,1,2,3,0,0,1,1,0,0,0,0,1,0,0,1
173974.0,Savic Vanja,O,Serbia,19.0,188,2021,Italy,2021-05-27,True,0,0,0,0,0,0,0,0,1,2,1,4,1,0,0,1,0,0,0,0,0,0,0,0
173974.0,Savic Vanja,O,Serbia,19.0,188,2021,USA,2021-05-31,False,0,1,4,5,0,0,0,0,1,5,16,22,0,3,3,6,0,0,0,0,3,0,2,5
173974.0,Savic Vanja,O,Serbia,19.0,188,2021,Thailand,2021-06-01,True,0,0,0,0,0,0,0,0,0,0,0,0,0,0,0,0,0,0,0,0,0,0,0,0
173974.0,Savic Vanja,O,Serbia,19.0,188,2021,Netherlands,2021-06-02,False,1,0,2,3,0,0,0,0,3,1,3,7,0,0,1,1,0,0,0,0,2,1,0,3
173974.0,Savic Vanja,O,Serbia,19.0,188,2021,Brazil,2021-06-06,False,0,0,0,0,0,0,1,1,0,3,1,4,0,0,0,0,0,0,0,0,1,2,0,3
173974.0,Savic Vanja,O,Serbia,19.0,188,2021,Canada,2021-06-12,False,0,2,1,3,0,0,0,0,1,0,4,5,0,2,2,4,0,0,0,0,1,0,0,1
173974.0,Savic Vanja,O,Serbia,19.0,188,2021,Russia,2021-06-14,False,0,0,6,6,0,0,0,0,7,3,8,18,0,3,0,3,0,0,0,0,1,2,2,5
173974.0,Savic Vanja,O,Serbia,19.0,188,2021,Germany,2021-06-18,False,0,1,8,9,0,0,0,0,10,5,10,25,3,0,0,3,0,0,0,0,1,3,0,4
173974.0,Savic Vanja,O,Serbia,19.0,188,2021,Dominican Republic,2021-06-19,False,0,2,7,9,0,0,1,1,9,2,7,18,0,2,1,3,0,0,0,0,3,1,0,4
173974.0,Savic Vanja,O,Serbia,19.0,188,2021,Japan,2021-06-20,False,1,1,10,12,0,0,2,2,6,6,14,26,0,2,0,2,0,0,0,0,4,4,0,8
152176.0,Bukilic Vanja,O,Serbia,22.0,191,2021,USA,2021-05-31,False,0,0,3,3,0,0,0,0,1,3,8,12,0,2,1,3,0,0,0,0,2,0,2,4
152176.0,Bukilic Vanja,O,Serbia,22.0,191,2021,Netherlands,2021-06-02,False,0,0,0,0,0,0,0,0,0,0,0,0,0,0,0,0,0,0,0,0,0,0,0,0
152176.0,Bukilic Vanja,O,Serbia,22.0,191,2021,China,2021-06-07,True,0,0,0,0,0,0,0,0,0,1,0,1,0,0,0,0,0,0,0,0,0,0,0,0
152176.0,Bukilic Vanja,O,Serbia,22.0,191,2021,Belgium,2021-06-08,False,0,0,0,0,0,0,0,0,0,0,0,0,0,0,0,0,0,0,0,0,0,0,0,0
152176.0,Bukilic Vanja,O,Serbia,22.0,191,2021,Russia,2021-06-14,False,0,0,0,0,0,0,1,1,1,0,0,1,0,0,1,1,0,0,0,0,0,0,0,0
152176.0,Bukilic Vanja,O,Serbia,22.0,191,2021,Germany,2021-06-18,False,0,1,0,1,0,0,0,0,0,0,1,1,0,0,0,0,0,0,0,0,0,0,0,0
152176.0,Bukilic Vanja,O,Serbia,22.0,191,2021,Dominican Republic,2021-06-19,False,0,1,2,3,0,0,0,0,3,2,4,9,0,0,0,0,0,0,0,0,1,3,0,4
152176.0,Bukilic Vanja,O,Serbia,22.0,191,2021,Japan,2021-06-20,False,0,0,0,0,0,0,0,0,0,0,0,0,0,0,0,0,0,0,0,0,0,0,0,0
163967.0,Delic Jelena,MB,Serbia,21.0,193,2021,Poland,2021-05-26,True,0,0,0,0,0,0,0,0,0,0,0,0,0,0,0,0,0,0,0,0,0,0,0,0
163967.0,Delic Jelena,MB,Serbia,21.0,193,2021,Italy,2021-05-27,True,0,0,0,0,0,0,0,0,0,0,0,0,0,0,0,0,0,0,0,0,0,0,0,0
163967.0,Delic Jelena,MB,Serbia,21.0,193,2021,USA,2021-05-31,False,0,0,7,7,0,0,1,1,0,0,4,4,1,3,2,6,0,0,0,0,1,1,0,2
163967.0,Delic Jelena,MB,Serbia,21.0,193,2021,Thailand,2021-06-01,True,0,0,0,0,0,0,0,0,0,0,0,0,0,0,0,0,0,0,0,0,0,0,0,0
163967.0,Delic Jelena,MB,Serbia,21.0,193,2021,Netherlands,2021-06-02,False,0,0,0,0,0,0,0,0,0,0,0,0,0,0,0,0,0,0,0,0,0,0,0,0
163967.0,Delic Jelena,MB,Serbia,21.0,193,2021,Brazil,2021-06-06,False,0,1,2,3,0,0,0,0,0,0,0,0,0,1,0,1,0,0,0,0,0,0,0,0
163967.0,Delic Jelena,MB,Serbia,21.0,193,2021,China,2021-06-07,True,0,0,0,0,0,0,0,0,0,0,0,0,0,0,0,0,0,0,0,0,0,0,0,0
163967.0,Delic Jelena,MB,Serbia,21.0,193,2021,Belgium,2021-06-08,False,0,0,0,0,0,0,0,0,0,0,0,0,0,0,0,0,0,0,0,0,0,0,0,0
163967.0,Delic Jelena,MB,Serbia,21.0,193,2021,Canada,2021-06-12,False,1,0,5,6,0,0,1,1,0,0,0,0,0,0,0,0,0,0,0,0,0,1,0,1
163967.0,Delic Jelena,MB,Serbia,21.0,193,2021,Russia,2021-06-14,False,0,1,1,2,0,0,1,1,0,0,1,1,2,1,0,3,0,0,0,0,0,0,0,0
163967.0,Delic Jelena,MB,Serbia,21.0,193,2021,Germany,2021-06-18,False,1,0,3,4,0,0,0,0,0,0,1,1,1,1,0,2,0,0,0,0,0,0,0,0
163967.0,Delic Jelena,MB,Serbia,21.0,193,2021,Dominican Republic,2021-06-19,False,0,0,6,6,0,0,0,0,0,2,1,3,3,2,1,6,0,0,0,0,4,0,1,5
163967.0,Delic Jelena,MB,Serbia,21.0,193,2021,Japan,2021-06-20,False,0,0,0,0,0,0,0,0,0,0,0,0,0,0,0,0,0,0,0,0,0,0,0,0
163117.0,Djurdjevic Sanja,L,Serbia,24.0,177,2021,Poland,2021-05-26,True,0,0,0,0,0,0,4,4,0,0,0,0,0,0,0,0,3,1,13,17,25,3,0,28
163117.0,Djurdjevic Sanja,L,Serbia,24.0,177,2021,Italy,2021-05-27,True,0,0,0,0,0,0,6,6,0,0,0,0,0,0,0,0,7,1,12,20,5,6,0,11
163117.0,Djurdjevic Sanja,L,Serbia,24.0,177,2021,USA,2021-05-31,False,0,0,0,0,0,0,0,0,0,0,0,0,0,0,0,0,0,0,0,0,0,0,0,0
163117.0,Djurdjevic Sanja,L,Serbia,24.0,177,2021,Thailand,2021-06-01,True,0,0,0,0,0,0,3,3,0,0,0,0,0,0,0,0,1,2,8,11,17,1,3,21
163117.0,Djurdjevic Sanja,L,Serbia,24.0,177,2021,Netherlands,2021-06-02,False,0,0,0,0,0,0,9,9,0,0,0,0,0,0,0,0,4,4,20,28,22,2,2,26
163117.0,Djurdjevic Sanja,L,Serbia,24.0,177,2021,Brazil,2021-06-06,False,0,0,0,0,0,0,1,1,0,0,0,0,0,0,0,0,1,0,1,2,2,1,1,4
163117.0,Djurdjevic Sanja,L,Serbia,24.0,177,2021,China,2021-06-07,True,0,0,0,0,0,0,12,12,0,0,0,0,0,0,0,0,9,2,11,22,6,5,1,12
163117.0,Djurdjevic Sanja,L,Serbia,24.0,177,2021,Russia,2021-06-14,False,0,0,0,0,0,0,3,3,0,0,0,0,0,0,0,0,4,2,12,18,5,2,0,7
163117.0,Djurdjevic Sanja,L,Serbia,24.0,177,2021,Germany,2021-06-18,False,0,0,0,0,0,0,6,6,0,0,0,0,0,0,0,0,2,1,8,11,12,6,2,20
163117.0,Djurdjevic Sanja,L,Serbia,24.0,177,2021,Dominican Republic,2021-06-19,False,0,0,0,0,0,0,0,0,0,0,0,0,0,0,0,0,0,2,0,2,0,0,0,0
163117.0,Djurdjevic Sanja,L,Serbia,24.0,177,2021,Japan,2021-06-20,False,0,0,0,0,0,0,5,5,0,0,0,0,0,0,0,0,1,0,4,5,6,3,0,9
173178.0,Gocanin Bojana,L,Serbia,19.0,179,2021,Poland,2021-05-26,True,0,0,0,0,0,0,0,0,0,0,0,0,0,0,0,0,0,0,0,0,0,0,0,0
173178.0,Gocanin Bojana,L,Serbia,19.0,179,2021,Italy,2021-05-27,True,0,0,0,0,0,0,1,1,0,0,0,0,0,0,0,0,0,0,0,0,3,2,0,5
173178.0,Gocanin Bojana,L,Serbia,19.0,179,2021,USA,2021-05-31,False,0,0,0,0,0,0,6,6,0,0,0,0,0,0,0,0,4,0,6,10,13,3,4,20
173178.0,Gocanin Bojana,L,Serbia,19.0,179,2021,Thailand,2021-06-01,True,0,0,0,0,0,0,0,0,0,0,0,0,0,0,0,0,0,0,0,0,0,0,0,0
173178.0,Gocanin Bojana,L,Serbia,19.0,179,2021,Netherlands,2021-06-02,False,0,0,0,0,0,0,0,0,0,0,0,0,0,0,0,0,0,0,0,0,0,0,0,0
173178.0,Gocanin Bojana,L,Serbia,19.0,179,2021,Brazil,2021-06-06,False,0,0,0,0,0,0,2,2,0,0,0,0,0,0,0,0,6,0,11,17,3,0,1,4
173178.0,Gocanin Bojana,L,Serbia,19.0,179,2021,China,2021-06-07,True,0,0,0,0,0,0,0,0,0,0,0,0,0,0,0,0,0,0,0,0,0,0,0,0
173178.0,Gocanin Bojana,L,Serbia,19.0,179,2021,Belgium,2021-06-08,False,0,0,0,0,0,1,11,12,0,0,0,0,0,0,0,0,5,4,26,35,25,2,1,28
173178.0,Gocanin Bojana,L,Serbia,19.0,179,2021,Canada,2021-06-12,False,0,0,0,0,0,0,4,4,0,0,0,0,0,0,0,0,10,5,12,27,14,3,1,18
173178.0,Gocanin Bojana,L,Serbia,19.0,179,2021,Russia,2021-06-14,False,0,0,0,0,0,0,4,4,0,0,0,0,0,0,0,0,3,3,11,17,2,1,1,4
173178.0,Gocanin Bojana,L,Serbia,19.0,179,2021,Germany,2021-06-18,False,0,0,0,0,0,0,0,0,0,0,0,0,0,0,0,0,0,0,0,0,0,0,0,0
173178.0,Gocanin Bojana,L,Serbia,19.0,179,2021,Dominican Republic,2021-06-19,False,0,0,0,0,0,0,5,5,0,0,0,0,0,0,0,0,6,0,11,17,7,4,0,11
173178.0,Gocanin Bojana,L,Serbia,19.0,179,2021,Japan,2021-06-20,False,0,0,0,0,0,0,1,1,0,0,0,0,0,0,0,0,2,0,0,2,3,1,0,4
173979.0,Cvetkovic Jovana,OH,Serbia,20.0,186,2021,USA,2021-05-31,False,0,0,2,2,0,0,0,0,0,0,0,0,0,0,0,0,0,0,0,0,0,0,0,0
173979.0,Cvetkovic Jovana,OH,Serbia,20.0,186,2021,Thailand,2021-06-01,True,0,0,0,0,0,0,0,0,0,0,0,0,0,0,0,0,0,0,0,0,0,0,0,0
173979.0,Cvetkovic Jovana,OH,Serbia,20.0,186,2021,Belgium,2021-06-08,False,0,0,0,0,0,0,0,0,0,0,0,0,0,0,0,0,0,0,0,0,0,0,0,0
173979.0,Cvetkovic Jovana,OH,Serbia,20.0,186,2021,Canada,2021-06-12,False,0,0,0,0,0,0,1,1,0,0,0,0,0,0,0,0,0,0,3,3,0,1,0,1
173979.0,Cvetkovic Jovana,OH,Serbia,20.0,186,2021,Russia,2021-06-14,False,0,0,0,0,0,0,0,0,0,0,0,0,0,0,0,0,0,0,0,0,0,0,0,0
173979.0,Cvetkovic Jovana,OH,Serbia,20.0,186,2021,Germany,2021-06-18,False,0,0,3,3,0,0,7,7,2,1,9,12,0,1,1,2,4,3,5,12,3,2,0,5
173979.0,Cvetkovic Jovana,OH,Serbia,20.0,186,2021,Dominican Republic,2021-06-19,False,0,1,1,2,0,0,0,0,0,0,3,3,0,0,0,0,1,0,2,3,0,0,0,0
173979.0,Cvetkovic Jovana,OH,Serbia,20.0,186,2021,Japan,2021-06-20,False,0,1,1,2,0,0,0,0,0,0,4,4,0,0,0,0,2,0,6,8,1,0,0,1
163119.0,Mirosavljevic Jovana,OH,Serbia,22.0,183,2021,Poland,2021-05-26,True,0,1,0,1,0,0,0,0,0,0,0,0,0,0,0,0,0,0,0,0,0,0,0,0
163119.0,Mirosavljevic Jovana,OH,Serbia,22.0,183,2021,Italy,2021-05-27,True,0,1,4,5,0,0,0,0,6,1,6,13,0,0,0,0,4,0,3,7,3,0,0,3
163119.0,Mirosavljevic Jovana,OH,Serbia,22.0,183,2021,USA,2021-05-31,False,0,0,6,6,0,0,1,1,3,0,6,9,0,1,2,3,3,0,9,12,4,1,0,5
163119.0,Mirosavljevic Jovana,OH,Serbia,22.0,183,2021,Thailand,2021-06-01,True,0,1,4,5,0,0,0,0,6,3,9,18,2,0,1,3,8,1,9,18,5,2,0,7
163119.0,Mirosavljevic Jovana,OH,Serbia,22.0,183,2021,Netherlands,2021-06-02,False,0,1,8,9,0,0,0,0,11,2,7,20,0,1,1,2,3,0,1,4,6,3,0,9
163119.0,Mirosavljevic Jovana,OH,Serbia,22.0,183,2021,Brazil,2021-06-06,False,0,2,5,7,0,0,3,3,8,4,13,25,1,1,1,3,5,0,4,9,3,4,1,8
163119.0,Mirosavljevic Jovana,OH,Serbia,22.0,183,2021,China,2021-06-07,True,0,0,1,1,0,0,0,0,0,0,0,0,0,0,0,0,0,0,0,0,0,0,0,0
163119.0,Mirosavljevic Jovana,OH,Serbia,22.0,183,2021,Belgium,2021-06-08,False,0,0,2,2,0,0,0,0,1,0,1,2,0,0,1,1,0,0,3,3,0,0,0,0
163119.0,Mirosavljevic Jovana,OH,Serbia,22.0,183,2021,Canada,2021-06-12,False,1,0,13,14,0,0,4,4,15,8,13,36,1,2,0,3,8,0,3,11,9,5,1,15
163119.0,Mirosavljevic Jovana,OH,Serbia,22.0,183,2021,Russia,2021-06-14,False,0,0,6,6,0,0,2,2,5,5,7,17,1,3,2,6,3,2,7,12,5,2,0,7
163119.0,Mirosavljevic Jovana,OH,Serbia,22.0,183,2021,Germany,2021-06-18,False,0,0,3,3,0,0,1,1,7,2,11,20,0,1,0,1,6,1,9,16,4,1,0,5
163119.0,Mirosavljevic Jovana,OH,Serbia,22.0,183,2021,Dominican Republic,2021-06-19,False,0,1,8,9,0,0,3,3,5,4,13,22,0,1,3,4,5,0,14,19,3,0,0,3
163119.0,Mirosavljevic Jovana,OH,Serbia,22.0,183,2021,Japan,2021-06-20,False,1,0,3,4,0,0,0,0,0,1,7,8,0,1,1,2,0,1,3,4,0,2,1,3
131866.0,Pannoy Piyanut,L,Thailand,32.0,170,2021,Japan,2021-05-25,False,0,0,0,0,0,0,0,0,0,0,0,0,0,0,0,0,1,3,5,9,6,0,1,7
131866.0,Pannoy Piyanut,L,Thailand,32.0,170,2021,China,2021-05-27,False,0,0,0,0,0,0,6,6,0,0,0,0,0,0,0,0,13,0,7,20,6,2,1,9
131866.0,Pannoy Piyanut,L,Thailand,32.0,170,2021,Netherlands,2021-05-31,False,0,0,0,0,0,0,1,1,0,0,0,0,0,0,0,0,4,1,9,14,6,5,0,11
131866.0,Pannoy Piyanut,L,Thailand,32.0,170,2021,Serbia,2021-06-01,False,0,0,0,0,0,0,4,4,0,0,0,0,0,0,0,0,6,0,6,12,12,2,1,15
131866.0,Pannoy Piyanut,L,Thailand,32.0,170,2021,USA,2021-06-02,False,0,0,0,0,0,0,7,7,0,0,0,0,0,0,0,0,4,1,5,10,5,7,1,13
131866.0,Pannoy Piyanut,L,Thailand,32.0,170,2021,Russia,2021-06-07,False,0,0,0,0,0,0,1,1,0,0,0,0,0,0,0,0,14,3,18,35,4,1,2,7
131866.0,Pannoy Piyanut,L,Thailand,32.0,170,2021,Dominican Republic,2021-06-08,False,0,0,0,0,0,0,9,9,0,0,0,0,0,0,0,0,20,1,19,40,4,0,0,4
131866.0,Pannoy Piyanut,L,Thailand,32.0,170,2021,Germany,2021-06-12,True,0,0,0,0,0,0,8,8,0,0,0,0,0,0,0,0,4,0,7,11,7,1,2,10
131866.0,Pannoy Piyanut,L,Thailand,32.0,170,2021,Poland,2021-06-13,False,0,0,0,0,0,0,5,5,0,0,0,0,0,0,0,0,4,0,10,14,9,1,1,11
131866.0,Pannoy Piyanut,L,Thailand,32.0,170,2021,Brazil,2021-06-14,False,0,0,0,0,0,0,8,8,0,0,0,0,0,0,0,0,5,0,8,13,14,5,0,19
131866.0,Pannoy Piyanut,L,Thailand,32.0,170,2021,Belgium,2021-06-18,False,0,0,0,0,0,0,8,8,0,0,0,0,0,0,0,0,14,1,17,32,5,4,0,9
131866.0,Pannoy Piyanut,L,Thailand,32.0,170,2021,Canada,2021-06-19,True,0,0,0,0,0,0,5,5,0,0,0,0,0,0,0,0,10,1,4,15,6,0,3,9
131866.0,Pannoy Piyanut,L,Thailand,32.0,170,2021,Italy,2021-06-20,False,0,0,0,0,0,0,5,5,0,0,0,0,0,0,0,0,12,0,13,25,7,2,0,9
181410.0,ManaKij Sirima,S,Thailand,31.0,168,2021,Japan,2021-05-25,False,0,0,0,0,1,0,7,8,0,0,0,0,0,0,0,0,0,0,0,0,1,0,0,1
181410.0,ManaKij Sirima,S,Thailand,31.0,168,2021,China,2021-05-27,False,0,0,0,0,0,0,4,4,0,0,0,0,0,0,0,0,0,0,0,0,0,0,0,0
181410.0,ManaKij Sirima,S,Thailand,31.0,168,2021,Netherlands,2021-05-31,False,0,0,0,0,0,0,0,0,0,0,0,0,0,0,0,0,0,0,0,0,0,1,0,1
181410.0,ManaKij Sirima,S,Thailand,31.0,168,2021,Serbia,2021-06-01,False,0,0,1,1,0,0,7,7,1,1,0,2,0,1,1,2,0,0,0,0,0,0,0,0
181410.0,ManaKij Sirima,S,Thailand,31.0,168,2021,USA,2021-06-02,False,0,0,2,2,2,0,26,28,0,0,0,0,0,0,0,0,0,0,0,0,0,2,0,2
181410.0,ManaKij Sirima,S,Thailand,31.0,168,2021,Germany,2021-06-12,True,0,0,0,0,0,0,0,0,0,0,0,0,0,0,0,0,0,0,0,0,0,0,0,0
181410.0,ManaKij Sirima,S,Thailand,31.0,168,2021,Poland,2021-06-13,False,0,0,0,0,1,0,4,5,0,0,0,0,0,0,0,0,0,0,0,0,0,2,0,2
181410.0,ManaKij Sirima,S,Thailand,31.0,168,2021,Canada,2021-06-19,True,0,0,0,0,0,0,0,0,0,0,0,0,0,0,0,0,0,0,0,0,0,0,0,0
181410.0,ManaKij Sirima,S,Thailand,31.0,168,2021,Italy,2021-06-20,False,0,0,0,0,0,0,0,0,0,0,0,0,0,0,0,0,0,0,0,0,0,0,0,0
113352.0,Thinkaow Pleumjit,MB,Thailand,38.0,180,2021,Japan,2021-05-25,False,0,2,7,9,0,0,0,0,9,1,8,18,1,2,2,5,0,0,1,1,2,0,0,2
113352.0,Thinkaow Pleumjit,MB,Thailand,38.0,180,2021,China,2021-05-27,False,0,0,6,6,0,0,1,1,6,2,8,16,2,2,2,6,0,0,0,0,1,1,0,2
113352.0,Thinkaow Pleumjit,MB,Thailand,38.0,180,2021,Netherlands,2021-05-31,False,2,1,4,7,0,0,0,0,5,2,6,13,1,2,2,5,0,0,0,0,0,0,0,0
113352.0,Thinkaow Pleumjit,MB,Thailand,38.0,180,2021,Serbia,2021-06-01,False,1,0,12,13,0,0,1,1,6,3,18,27,1,3,4,8,1,0,1,2,4,1,0,5
113352.0,Thinkaow Pleumjit,MB,Thailand,38.0,180,2021,USA,2021-06-02,False,0,0,8,8,0,0,2,2,4,0,12,16,0,3,0,3,0,0,0,0,2,1,0,3
113352.0,Thinkaow Pleumjit,MB,Thailand,38.0,180,2021,Russia,2021-06-07,False,3,0,9,12,0,0,5,5,15,4,13,32,1,5,4,10,1,0,3,4,5,2,1,8
113352.0,Thinkaow Pleumjit,MB,Thailand,38.0,180,2021,Dominican Republic,2021-06-08,False,0,1,8,9,0,0,1,1,9,3,16,28,3,2,1,6,0,0,0,0,1,2,1,4
113352.0,Thinkaow Pleumjit,MB,Thailand,38.0,180,2021,Germany,2021-06-12,True,2,2,12,16,0,0,1,1,12,1,10,23,1,5,4,10,0,0,3,3,10,0,2,12
113352.0,Thinkaow Pleumjit,MB,Thailand,38.0,180,2021,Poland,2021-06-13,False,0,1,8,9,0,1,4,5,6,1,8,15,0,2,7,9,0,0,0,0,1,1,1,3
113352.0,Thinkaow Pleumjit,MB,Thailand,38.0,180,2021,Brazil,2021-06-14,False,0,1,4,5,0,0,2,2,8,2,8,18,0,0,0,0,0,0,0,0,0,0,0,0
113352.0,Thinkaow Pleumjit,MB,Thailand,38.0,180,2021,Belgium,2021-06-18,False,0,4,9,13,0,0,3,3,12,2,15,29,1,2,1,4,0,0,0,0,3,1,0,4
113352.0,Thinkaow Pleumjit,MB,Thailand,38.0,180,2021,Canada,2021-06-19,True,2,1,9,12,0,0,3,3,10,1,11,22,1,4,7,12,0,0,0,0,2,0,1,3
113352.0,Thinkaow Pleumjit,MB,Thailand,38.0,180,2021,Italy,2021-06-20,False,1,1,11,13,0,0,3,3,12,2,15,29,3,5,4,12,0,0,0,0,6,3,1,10
114638.0,Sittirak Onuma,OH,Thailand,35.0,175,2021,Japan,2021-05-25,False,0,1,6,7,0,0,0,0,7,6,16,29,1,0,2,3,2,0,4,6,4,2,0,6
114638.0,Sittirak Onuma,OH,Thailand,35.0,175,2021,China,2021-05-27,False,2,1,10,13,0,0,1,1,11,4,11,26,0,2,0,2,4,3,12,19,5,0,1,6
114638.0,Sittirak Onuma,OH,Thailand,35.0,175,2021,Netherlands,2021-05-31,False,0,0,7,7,0,0,0,0,10,4,17,31,0,0,1,1,1,0,3,4,1,3,0,4
114638.0,Sittirak Onuma,OH,Thailand,35.0,175,2021,Serbia,2021-06-01,False,1,1,10,12,0,0,4,4,12,4,21,37,0,1,0,1,4,0,11,15,10,3,2,15
114638.0,Sittirak Onuma,OH,Thailand,35.0,175,2021,USA,2021-06-02,False,0,2,7,9,0,0,4,4,7,5,12,24,0,0,0,0,3,4,17,24,2,1,0,3
114638.0,Sittirak Onuma,OH,Thailand,35.0,175,2021,Russia,2021-06-07,False,0,1,13,14,0,0,2,2,9,12,17,38,0,4,2,6,4,0,3,7,8,2,2,12
114638.0,Sittirak Onuma,OH,Thailand,35.0,175,2021,Dominican Republic,2021-06-08,False,1,0,5,6,1,0,0,1,6,6,25,37,0,2,1,3,3,0,0,3,5,2,0,7
114638.0,Sittirak Onuma,OH,Thailand,35.0,175,2021,Germany,2021-06-12,True,0,2,17,19,0,0,4,4,20,5,25,50,0,0,8,8,2,1,9,12,11,2,2,15
114638.0,Sittirak Onuma,OH,Thailand,35.0,175,2021,Poland,2021-06-13,False,0,1,11,12,0,1,1,2,10,5,14,29,0,2,2,4,1,1,1,3,7,2,2,11
114638.0,Sittirak Onuma,OH,Thailand,35.0,175,2021,Brazil,2021-06-14,False,0,1,6,7,0,1,3,4,8,6,13,27,0,0,0,0,7,0,7,14,3,2,0,5
114638.0,Sittirak Onuma,OH,Thailand,35.0,175,2021,Belgium,2021-06-18,False,1,0,12,13,0,0,6,6,11,8,22,41,0,2,1,3,0,1,2,3,7,6,1,14
114638.0,Sittirak Onuma,OH,Thailand,35.0,175,2021,Canada,2021-06-19,True,0,1,7,8,0,0,0,0,10,2,6,18,0,1,1,2,0,0,5,5,5,1,0,6
114638.0,Sittirak Onuma,OH,Thailand,35.0,175,2021,Italy,2021-06-20,False,0,2,15,17,0,0,7,7,24,4,25,53,0,4,2,6,4,1,7,12,15,3,1,19
152186.0,Sang-Ob Tirawan,MB,Thailand,23.0,176,2021,Japan,2021-05-25,False,0,0,0,0,0,0,0,0,0,0,0,0,0,0,0,0,0,0,0,0,0,0,0,0
152186.0,Sang-Ob Tirawan,MB,Thailand,23.0,176,2021,USA,2021-06-02,False,0,0,0,0,0,0,0,0,0,0,1,1,0,0,0,0,0,0,0,0,0,0,0,0
152186.0,Sang-Ob Tirawan,MB,Thailand,23.0,176,2021,Brazil,2021-06-14,False,0,0,0,0,0,0,0,0,0,0,0,0,0,0,0,0,0,0,0,0,0,0,0,0
122866.0,Chuewulim Sutadta,OH,Thailand,29.0,173,2021,Japan,2021-05-25,False,0,1,4,5,0,0,0,0,5,4,7,16,0,0,1,1,8,0,13,21,5,1,0,6
122866.0,Chuewulim Sutadta,OH,Thailand,29.0,173,2021,China,2021-05-27,False,0,0,3,3,0,0,0,0,2,0,7,9,0,1,0,1,1,1,0,2,1,0,0,1
122866.0,Chuewulim Sutadta,OH,Thailand,29.0,173,2021,Netherlands,2021-05-31,False,0,0,5,5,0,0,0,0,2,3,5,10,0,1,0,1,2,2,8,12,1,2,0,3
122866.0,Chuewulim Sutadta,OH,Thailand,29.0,173,2021,Serbia,2021-06-01,False,1,0,6,7,0,0,0,0,5,6,6,17,0,3,0,3,2,0,6,8,5,1,0,6
122866.0,Chuewulim Sutadta,OH,Thailand,29.0,173,2021,USA,2021-06-02,False,0,0,5,5,0,0,1,1,4,1,8,13,0,0,0,0,0,0,8,8,2,1,0,3
122866.0,Chuewulim Sutadta,OH,Thailand,29.0,173,2021,Russia,2021-06-07,False,0,0,4,4,0,0,3,3,1,2,2,5,0,0,1,1,1,1,7,9,2,2,1,5
122866.0,Chuewulim Sutadta,OH,Thailand,29.0,173,2021,Dominican Republic,2021-06-08,False,0,0,11,11,0,0,0,0,4,1,7,12,0,2,0,2,1,1,3,5,3,1,0,4
122866.0,Chuewulim Sutadta,OH,Thailand,29.0,173,2021,Germany,2021-06-12,True,1,0,15,16,0,0,2,2,13,1,7,21,0,0,1,1,5,3,15,23,10,2,2,14
122866.0,Chuewulim Sutadta,OH,Thailand,29.0,173,2021,Poland,2021-06-13,False,0,0,5,5,0,0,2,2,3,0,10,13,0,0,2,2,4,0,12,16,3,3,0,6
122866.0,Chuewulim Sutadta,OH,Thailand,29.0,173,2021,Brazil,2021-06-14,False,0,0,5,5,0,0,1,1,0,2,6,8,0,0,0,0,2,2,8,12,3,1,0,4
122866.0,Chuewulim Sutadta,OH,Thailand,29.0,173,2021,Belgium,2021-06-18,False,0,0,14,14,0,0,2,2,12,1,13,26,0,0,0,0,6,1,20,27,4,5,0,9
122866.0,Chuewulim Sutadta,OH,Thailand,29.0,173,2021,Canada,2021-06-19,True,0,1,9,10,0,0,2,2,8,4,10,22,0,2,2,4,4,0,7,11,12,1,1,14
122866.0,Chuewulim Sutadta,OH,Thailand,29.0,173,2021,Italy,2021-06-20,False,0,0,16,16,0,0,3,3,12,5,18,35,0,3,2,5,6,2,12,20,11,4,1,16
113916.0,Apinyapong Wilavan,L,Thailand,37.0,173,2021,Japan,2021-05-25,False,0,0,2,2,0,0,0,0,1,0,2,3,0,0,0,0,0,1,6,7,0,1,0,1
113916.0,Apinyapong Wilavan,L,Thailand,37.0,173,2021,China,2021-05-27,False,0,0,5,5,0,0,2,2,2,1,5,8,1,2,0,3,1,0,6,7,4,2,0,6
113916.0,Apinyapong Wilavan,L,Thailand,37.0,173,2021,Netherlands,2021-05-31,False,0,0,0,0,0,0,0,0,0,0,0,0,0,0,0,0,0,0,0,0,6,5,1,12
113916.0,Apinyapong Wilavan,L,Thailand,37.0,173,2021,Serbia,2021-06-01,False,0,0,0,0,0,0,2,2,0,0,0,0,0,0,0,0,0,0,0,0,8,1,1,10
113916.0,Apinyapong Wilavan,L,Thailand,37.0,173,2021,USA,2021-06-02,False,0,0,0,0,0,0,0,0,0,0,0,0,0,0,0,0,0,0,0,0,1,0,0,1
113916.0,Apinyapong Wilavan,L,Thailand,37.0,173,2021,Russia,2021-06-07,False,0,0,0,0,0,0,5,5,0,0,0,0,0,0,0,0,2,0,1,3,10,1,1,12
113916.0,Apinyapong Wilavan,L,Thailand,37.0,173,2021,Dominican Republic,2021-06-08,False,0,0,0,0,0,0,1,1,0,0,0,0,0,0,0,0,0,0,0,0,4,8,0,12
113916.0,Apinyapong Wilavan,L,Thailand,37.0,173,2021,Germany,2021-06-12,True,0,0,0,0,0,0,0,0,0,0,0,0,0,0,0,0,0,0,2,2,0,0,0,0
113916.0,Apinyapong Wilavan,L,Thailand,37.0,173,2021,Poland,2021-06-13,False,0,0,5,5,0,0,3,3,2,1,10,13,0,3,1,4,3,0,8,11,7,0,3,10
113916.0,Apinyapong Wilavan,L,Thailand,37.0,173,2021,Brazil,2021-06-14,False,0,0,3,3,0,0,1,1,1,3,12,16,0,2,0,2,2,1,11,14,1,1,0,2
113916.0,Apinyapong Wilavan,L,Thailand,37.0,173,2021,Belgium,2021-06-18,False,0,0,3,3,0,0,0,0,1,1,2,4,0,0,0,0,2,0,3,5,2,2,1,5
113916.0,Apinyapong Wilavan,L,Thailand,37.0,173,2021,Canada,2021-06-19,True,0,0,3,3,0,0,2,2,0,0,0,0,0,0,0,0,0,0,4,4,4,0,0,4
113916.0,Apinyapong Wilavan,L,Thailand,37.0,173,2021,Italy,2021-06-20,False,0,0,0,0,0,0,9,9,0,0,0,0,0,0,0,0,4,1,7,12,11,1,1,13
113358.0,Hyapha Amporn,MB,Thailand,36.0,180,2021,Japan,2021-05-25,False,0,0,0,0,0,0,0,0,0,0,0,0,0,0,0,0,0,0,0,0,0,0,0,0
113358.0,Hyapha Amporn,MB,Thailand,36.0,180,2021,China,2021-05-27,False,0,0,2,2,0,0,0,0,2,0,0,2,0,1,1,2,0,0,0,0,0,0,1,1
113358.0,Hyapha Amporn,MB,Thailand,36.0,180,2021,Netherlands,2021-05-31,False,0,0,0,0,0,0,0,0,0,0,0,0,0,0,0,0,0,0,0,0,0,0,0,0
113358.0,Hyapha Amporn,MB,Thailand,36.0,180,2021,Serbia,2021-06-01,False,0,0,0,0,0,0,0,0,0,0,0,0,0,0,0,0,0,0,0,0,0,0,0,0
113358.0,Hyapha Amporn,MB,Thailand,36.0,180,2021,Russia,2021-06-07,False,1,0,9,10,0,0,2,2,2,2,5,9,1,1,0,2,1,1,1,3,2,0,0,2
113358.0,Hyapha Amporn,MB,Thailand,36.0,180,2021,Dominican Republic,2021-06-08,False,0,1,3,4,0,0,0,0,3,0,5,8,0,2,1,3,0,0,0,0,3,1,0,4
113358.0,Hyapha Amporn,MB,Thailand,36.0,180,2021,Germany,2021-06-12,True,0,0,6,6,0,0,1,1,0,2,2,4,0,0,3,3,0,0,2,2,1,1,0,2
113358.0,Hyapha Amporn,MB,Thailand,36.0,180,2021,Poland,2021-06-13,False,0,0,0,0,0,0,0,0,0,0,0,0,0,0,0,0,0,0,0,0,0,0,0,0
113358.0,Hyapha Amporn,MB,Thailand,36.0,180,2021,Belgium,2021-06-18,False,0,0,0,0,0,0,0,0,0,0,0,0,0,0,0,0,0,0,0,0,0,0,0,0
113358.0,Hyapha Amporn,MB,Thailand,36.0,180,2021,Canada,2021-06-19,True,0,0,0,0,0,0,0,0,0,0,0,0,0,0,0,0,0,0,0,0,0,0,0,0
113358.0,Hyapha Amporn,MB,Thailand,36.0,180,2021,Italy,2021-06-20,False,0,0,1,1,0,0,1,1,0,1,1,2,0,0,1,1,0,0,0,0,1,0,0,1
118998.0,Chaisri Tapaphaipun,L,Thailand,32.0,168,2021,Japan,2021-05-25,False,0,0,0,0,0,0,1,1,0,0,0,0,0,0,0,0,1,0,7,8,6,2,2,10
118998.0,Chaisri Tapaphaipun,L,Thailand,32.0,168,2021,China,2021-05-27,False,0,0,0,0,0,0,1,1,0,0,0,0,0,0,0,0,0,0,0,0,4,1,4,9
118998.0,Chaisri Tapaphaipun,L,Thailand,32.0,168,2021,Netherlands,2021-05-31,False,0,0,4,4,0,0,0,0,2,1,5,8,0,0,0,0,6,0,4,10,0,0,0,0
118998.0,Chaisri Tapaphaipun,L,Thailand,32.0,168,2021,Serbia,2021-06-01,False,1,0,2,3,0,0,2,2,0,2,2,4,0,1,0,1,1,0,2,3,5,0,0,5
118998.0,Chaisri Tapaphaipun,L,Thailand,32.0,168,2021,USA,2021-06-02,False,0,0,2,2,0,0,1,1,1,2,3,6,0,0,0,0,0,0,4,4,2,2,0,4
118998.0,Chaisri Tapaphaipun,L,Thailand,32.0,168,2021,Russia,2021-06-07,False,0,0,1,1,0,0,1,1,1,0,1,2,0,0,1,1,0,0,4,4,2,0,0,2
118998.0,Chaisri Tapaphaipun,L,Thailand,32.0,168,2021,Dominican Republic,2021-06-08,False,0,0,0,0,0,0,0,0,0,0,0,0,0,0,0,0,0,0,0,0,2,0,0,2
118998.0,Chaisri Tapaphaipun,L,Thailand,32.0,168,2021,Germany,2021-06-12,True,0,0,0,0,0,0,4,4,0,0,0,0,0,0,0,0,0,0,0,0,8,0,1,9
118998.0,Chaisri Tapaphaipun,L,Thailand,32.0,168,2021,Poland,2021-06-13,False,0,0,0,0,0,0,0,0,0,0,0,0,0,0,0,0,0,0,0,0,4,1,2,7
118998.0,Chaisri Tapaphaipun,L,Thailand,32.0,168,2021,Brazil,2021-06-14,False,0,0,0,0,0,0,0,0,0,0,0,0,0,0,0,0,0,0,0,0,0,0,0,0
118998.0,Chaisri Tapaphaipun,L,Thailand,32.0,168,2021,Belgium,2021-06-18,False,0,0,0,0,0,0,4,4,0,0,0,0,0,0,0,0,0,0,0,0,8,8,1,17
118998.0,Chaisri Tapaphaipun,L,Thailand,32.0,168,2021,Canada,2021-06-19,True,0,0,0,0,0,0,2,2,0,0,0,0,0,0,0,0,0,0,0,0,3,1,0,4
113917.0,Tomkom Nootsara,S,Thailand,36.0,169,2021,Japan,2021-05-25,False,1,1,6,8,9,4,72,85,0,1,2,3,0,0,0,0,0,0,0,0,7,0,3,10
113917.0,Tomkom Nootsara,S,Thailand,36.0,169,2021,China,2021-05-27,False,0,1,8,9,15,1,63,79,2,2,1,5,0,0,1,1,0,0,1,1,6,2,0,8
113917.0,Tomkom Nootsara,S,Thailand,36.0,169,2021,Netherlands,2021-05-31,False,0,0,7,7,6,0,0,6,0,1,2,3,1,0,1,2,0,0,0,0,1,7,0,8
113917.0,Tomkom Nootsara,S,Thailand,36.0,169,2021,Serbia,2021-06-01,False,0,0,9,9,10,0,97,107,0,2,1,3,0,1,2,3,0,0,1,1,9,2,0,11
113917.0,Tomkom Nootsara,S,Thailand,36.0,169,2021,USA,2021-06-02,False,0,0,4,4,0,0,49,49,0,0,0,0,0,0,0,0,0,0,0,0,0,2,0,2
113917.0,Tomkom Nootsara,S,Thailand,36.0,169,2021,Russia,2021-06-07,False,1,0,9,10,20,0,60,80,1,0,2,3,0,4,3,7,0,0,0,0,12,0,2,14
113917.0,Tomkom Nootsara,S,Thailand,36.0,169,2021,Dominican Republic,2021-06-08,False,0,0,1,1,12,0,36,48,0,0,3,3,0,1,2,3,0,0,0,0,2,2,0,4
113917.0,Tomkom Nootsara,S,Thailand,36.0,169,2021,Germany,2021-06-12,True,0,1,19,20,12,2,105,119,2,0,0,2,1,2,3,6,0,0,0,0,14,4,0,18
113917.0,Tomkom Nootsara,S,Thailand,36.0,169,2021,Poland,2021-06-13,False,1,1,7,9,24,0,49,73,1,0,2,3,0,2,2,4,0,1,0,1,7,1,3,11
113917.0,Tomkom Nootsara,S,Thailand,36.0,169,2021,Brazil,2021-06-14,False,0,1,2,3,8,2,71,81,0,0,3,3,0,0,1,1,0,0,0,0,4,2,0,6
113917.0,Tomkom Nootsara,S,Thailand,36.0,169,2021,Belgium,2021-06-18,False,1,0,14,15,16,0,84,100,0,0,5,5,0,0,1,1,0,0,0,0,8,4,0,12
113917.0,Tomkom Nootsara,S,Thailand,36.0,169,2021,Canada,2021-06-19,True,1,1,7,9,8,0,68,76,0,0,1,1,0,2,3,5,0,0,0,0,4,0,1,5
113917.0,Tomkom Nootsara,S,Thailand,36.0,169,2021,Italy,2021-06-20,False,1,1,16,18,22,2,129,153,2,0,3,5,0,1,2,3,0,0,0,0,21,3,3,27
152206.0,Juangjan Pattiya,OH,Thailand,24.0,172,2021,Japan,2021-05-25,False,0,0,0,0,0,0,0,0,0,1,0,1,0,1,0,1,0,0,0,0,0,0,0,0
152206.0,Juangjan Pattiya,OH,Thailand,24.0,172,2021,China,2021-05-27,False,0,0,0,0,0,0,0,0,0,3,0,3,0,0,0,0,0,0,0,0,0,0,0,0
152206.0,Juangjan Pattiya,OH,Thailand,24.0,172,2021,Netherlands,2021-05-31,False,0,0,0,0,0,0,0,0,1,2,1,4,0,0,0,0,0,0,0,0,0,0,0,0
152206.0,Juangjan Pattiya,OH,Thailand,24.0,172,2021,Serbia,2021-06-01,False,0,0,3,3,0,0,0,0,3,1,4,8,0,0,0,0,2,0,2,4,1,1,0,2
152206.0,Juangjan Pattiya,OH,Thailand,24.0,172,2021,USA,2021-06-02,False,0,0,1,1,0,0,0,0,1,1,0,2,0,0,0,0,0,0,0,0,0,0,0,0
152206.0,Juangjan Pattiya,OH,Thailand,24.0,172,2021,Russia,2021-06-07,False,0,1,1,2,0,0,0,0,1,1,0,2,0,0,0,0,0,0,1,1,0,0,0,0
152206.0,Juangjan Pattiya,OH,Thailand,24.0,172,2021,Dominican Republic,2021-06-08,False,0,0,3,3,0,0,0,0,1,2,1,4,0,0,0,0,0,0,2,2,1,1,0,2
152206.0,Juangjan Pattiya,OH,Thailand,24.0,172,2021,Germany,2021-06-12,True,0,0,0,0,0,0,0,0,0,0,0,0,0,0,0,0,0,0,0,0,0,0,0,0
152206.0,Juangjan Pattiya,OH,Thailand,24.0,172,2021,Poland,2021-06-13,False,0,1,0,1,0,0,0,0,0,1,1,2,0,0,0,0,0,0,0,0,0,0,0,0
152206.0,Juangjan Pattiya,OH,Thailand,24.0,172,2021,Brazil,2021-06-14,False,0,0,0,0,0,0,1,1,0,2,1,3,0,0,0,0,0,0,0,0,0,0,0,0
152206.0,Juangjan Pattiya,OH,Thailand,24.0,172,2021,Belgium,2021-06-18,False,0,0,0,0,0,0,0,0,0,0,0,0,0,0,0,0,0,0,0,0,0,0,0,0
152206.0,Juangjan Pattiya,OH,Thailand,24.0,172,2021,Canada,2021-06-19,True,0,0,0,0,0,0,0,0,0,0,0,0,0,0,0,0,0,0,0,0,0,0,0,0
152206.0,Juangjan Pattiya,OH,Thailand,24.0,172,2021,Italy,2021-06-20,False,0,0,0,0,0,0,0,0,0,0,0,0,0,0,0,0,0,0,0,0,0,0,0,0
114283.0,Kanthong Malika,O,Thailand,35.0,178,2021,Japan,2021-05-25,False,1,0,8,9,0,0,0,0,7,2,8,17,0,1,3,4,7,1,7,15,3,0,2,5
114283.0,Kanthong Malika,O,Thailand,35.0,178,2021,China,2021-05-27,False,0,1,7,8,0,0,0,0,8,4,4,16,0,5,2,7,6,1,11,18,3,1,1,5
114283.0,Kanthong Malika,O,Thailand,35.0,178,2021,Netherlands,2021-05-31,False,0,1,8,9,0,0,0,0,5,1,7,13,0,0,1,1,7,1,9,17,9,3,1,13
114283.0,Kanthong Malika,O,Thailand,35.0,178,2021,Serbia,2021-06-01,False,0,0,6,6,0,0,1,1,1,5,9,15,0,0,0,0,1,4,5,10,5,2,3,10
114283.0,Kanthong Malika,O,Thailand,35.0,178,2021,USA,2021-06-02,False,0,0,5,5,0,0,1,1,3,3,7,13,1,0,0,1,4,2,9,15,4,1,0,5
114283.0,Kanthong Malika,O,Thailand,35.0,178,2021,Russia,2021-06-07,False,0,1,10,11,0,0,3,3,6,3,10,19,2,5,4,11,3,0,9,12,3,3,1,7
114283.0,Kanthong Malika,O,Thailand,35.0,178,2021,Dominican Republic,2021-06-08,False,0,1,6,7,0,1,1,2,3,5,11,19,0,2,0,2,7,1,7,15,6,2,0,8
114283.0,Kanthong Malika,O,Thailand,35.0,178,2021,Germany,2021-06-12,True,0,2,11,13,0,0,5,5,9,5,18,32,1,4,4,9,6,0,12,18,7,3,2,12
114283.0,Kanthong Malika,O,Thailand,35.0,178,2021,Poland,2021-06-13,False,1,1,8,10,0,0,5,5,6,3,11,20,0,2,4,6,5,1,7,13,5,2,1,8
114283.0,Kanthong Malika,O,Thailand,35.0,178,2021,Brazil,2021-06-14,False,0,1,3,4,0,1,0,1,6,2,12,20,0,0,1,1,5,2,8,15,1,2,0,3
114283.0,Kanthong Malika,O,Thailand,35.0,178,2021,Belgium,2021-06-18,False,0,0,16,16,0,0,2,2,16,2,13,31,0,2,1,3,7,3,10,20,11,6,2,19
114283.0,Kanthong Malika,O,Thailand,35.0,178,2021,Canada,2021-06-19,True,2,0,19,21,0,0,1,1,13,1,6,20,1,4,6,11,5,0,1,6,11,1,2,14
114283.0,Kanthong Malika,O,Thailand,35.0,178,2021,Italy,2021-06-20,False,1,2,16,19,0,0,2,2,8,7,24,39,0,6,6,12,6,2,19,27,12,1,1,14
167829.0,Piampongsan Gullapa,S,Thailand,31.0,176,2021,Russia,2021-06-07,False,0,0,2,2,4,0,24,28,0,0,2,2,0,1,0,1,0,0,0,0,0,0,0,0
167829.0,Piampongsan Gullapa,S,Thailand,31.0,176,2021,Brazil,2021-06-14,False,0,0,0,0,0,0,9,9,0,0,0,0,0,0,0,0,0,0,0,0,2,0,0,2
119003.0,Krause Karina,MB,Thailand,33.0,177,2021,Japan,2021-05-25,False,0,1,8,9,,,,,5,1,4,10,0,3,1,4,0,0,0,0,1,0,1,2
119003.0,Krause Karina,MB,Thailand,33.0,177,2021,China,2021-05-27,False,0,0,8,8,,,,,4,3,2,9,0,2,2,4,0,0,0,0,0,2,0,2
119003.0,Krause Karina,MB,Thailand,33.0,177,2021,Netherlands,2021-05-31,False,0,1,2,3,,,,,1,4,1,6,0,0,0,0,0,0,0,0,0,0,0,0
119003.0,Krause Karina,MB,Thailand,33.0,177,2021,Serbia,2021-06-01,False,0,0,6,6,,,,,3,1,3,7,0,0,2,2,1,0,1,2,1,0,0,1
119003.0,Krause Karina,MB,Thailand,33.0,177,2021,USA,2021-06-02,False,0,2,6,8,,,,,4,2,4,10,0,1,0,1,0,0,0,0,0,1,0,1
119003.0,Krause Karina,MB,Thailand,33.0,177,2021,Russia,2021-06-07,False,0,1,4,5,,,,,7,0,2,9,0,1,0,1,0,0,0,0,1,0,0,1
119003.0,Krause Karina,MB,Thailand,33.0,177,2021,Dominican Republic,2021-06-08,False,0,0,5,5,,,,,6,1,2,9,0,1,1,2,0,0,0,0,2,0,0,2
119003.0,Krause Karina,MB,Thailand,33.0,177,2021,Germany,2021-06-12,True,0,1,7,8,,,,,4,2,4,10,0,1,2,3,0,0,0,0,3,0,0,3
119003.0,Krause Karina,MB,Thailand,33.0,177,2021,Poland,2021-06-13,False,0,1,7,8,,,,,9,0,2,11,0,4,5,9,0,0,0,0,5,0,0,5
119003.0,Krause Karina,MB,Thailand,33.0,177,2021,Brazil,2021-06-14,False,0,0,6,6,,,,,2,0,5,7,1,1,0,2,0,0,0,0,0,1,0,1
119003.0,Krause Karina,MB,Thailand,33.0,177,2021,Belgium,2021-06-18,False,0,0,8,8,,,,,10,1,5,16,1,0,1,2,0,0,0,0,1,3,0,4
119003.0,Krause Karina,MB,Thailand,33.0,177,2021,Canada,2021-06-19,True,0,1,10,11,,,,,5,0,5,10,0,1,2,3,0,0,1,1,2,0,0,2
119003.0,Krause Karina,MB,Thailand,33.0,177,2021,Italy,2021-06-20,False,1,1,10,12,,,,,2,2,4,8,0,0,1,1,0,1,0,1,4,0,1,5
147188.0,Phomla Soraya,S,Thailand,29.0,169,2021,Dominican Republic,2021-06-08,False,0,0,8,8,10,1,48,59,1,0,4,5,0,1,0,1,0,0,1,1,4,1,0,5
147188.0,Phomla Soraya,S,Thailand,29.0,169,2021,Belgium,2021-06-18,False,0,0,3,3,1,0,24,25,0,0,0,0,0,0,0,0,0,0,0,0,1,1,0,2
147188.0,Phomla Soraya,S,Thailand,29.0,169,2021,Italy,2021-06-20,False,0,0,0,0,0,0,0,0,0,0,0,0,0,0,0,0,0,0,0,0,0,0,0,0
152207.0,Nilapa Chatsuda,OH,Thailand,23.0,173,2021,China,2021-05-27,False,0,0,0,0,0,0,0,0,1,0,2,3,0,0,0,0,0,0,0,0,0,0,0,0
152207.0,Nilapa Chatsuda,OH,Thailand,23.0,173,2021,Netherlands,2021-05-31,False,0,0,1,1,0,0,0,0,0,0,1,1,0,0,0,0,1,0,4,5,2,1,0,3
152207.0,Nilapa Chatsuda,OH,Thailand,23.0,173,2021,Serbia,2021-06-01,False,0,1,3,4,0,0,0,0,0,2,5,7,0,1,0,1,3,0,5,8,1,0,0,1
152207.0,Nilapa Chatsuda,OH,Thailand,23.0,173,2021,USA,2021-06-02,False,0,0,1,1,0,0,1,1,1,1,3,5,0,0,0,0,0,0,2,2,0,0,0,0
152207.0,Nilapa Chatsuda,OH,Thailand,23.0,173,2021,Russia,2021-06-07,False,1,0,2,3,0,0,0,0,1,1,9,11,0,0,0,0,1,1,0,2,2,1,0,3
152207.0,Nilapa Chatsuda,OH,Thailand,23.0,173,2021,Dominican Republic,2021-06-08,False,0,0,3,3,0,0,2,2,0,1,5,6,0,0,0,0,0,0,3,3,0,0,0,0
152207.0,Nilapa Chatsuda,OH,Thailand,23.0,173,2021,Germany,2021-06-12,True,0,0,0,0,0,0,0,0,0,0,0,0,0,0,0,0,0,0,0,0,0,0,0,0
152207.0,Nilapa Chatsuda,OH,Thailand,23.0,173,2021,Poland,2021-06-13,False,0,0,1,1,0,0,0,0,2,0,1,3,0,1,0,1,0,0,3,3,0,1,0,1
152207.0,Nilapa Chatsuda,OH,Thailand,23.0,173,2021,Brazil,2021-06-14,False,0,0,1,1,0,0,0,0,0,1,0,1,0,0,0,0,0,0,0,0,0,0,0,0
152207.0,Nilapa Chatsuda,OH,Thailand,23.0,173,2021,Belgium,2021-06-18,False,1,0,2,3,0,0,0,0,0,2,0,2,0,0,0,0,0,0,0,0,0,0,0,0
152207.0,Nilapa Chatsuda,OH,Thailand,23.0,173,2021,Canada,2021-06-19,True,0,0,0,0,0,0,0,0,0,0,0,0,0,0,0,0,0,0,0,0,0,0,0,0
152207.0,Nilapa Chatsuda,OH,Thailand,23.0,173,2021,Italy,2021-06-20,False,0,0,2,2,0,0,0,0,0,0,0,0,0,0,0,0,0,0,0,0,0,0,0,0
142178.0,Nuanjam Watchareeya,MB,Thailand,25.0,178,2021,Japan,2021-05-25,False,0,0,0,0,0,0,0,0,0,0,0,0,0,0,0,0,0,0,0,0,0,0,0,0
142178.0,Nuanjam Watchareeya,MB,Thailand,25.0,178,2021,China,2021-05-27,False,0,0,1,1,0,0,0,0,0,0,0,0,0,0,0,0,0,0,0,0,1,0,0,1
142178.0,Nuanjam Watchareeya,MB,Thailand,25.0,178,2021,Netherlands,2021-05-31,False,0,0,5,5,0,0,0,0,2,1,9,12,1,1,0,2,0,1,0,1,0,0,0,0
142178.0,Nuanjam Watchareeya,MB,Thailand,25.0,178,2021,Serbia,2021-06-01,False,1,0,2,3,0,0,0,0,0,2,3,5,0,2,0,2,0,0,1,1,1,0,0,1
142178.0,Nuanjam Watchareeya,MB,Thailand,25.0,178,2021,USA,2021-06-02,False,0,0,4,4,0,0,1,1,1,1,2,4,0,0,0,0,0,0,0,0,0,1,0,1
142178.0,Nuanjam Watchareeya,MB,Thailand,25.0,178,2021,Russia,2021-06-07,False,0,0,0,0,0,0,0,0,0,0,0,0,0,0,0,0,0,0,0,0,0,0,0,0
142178.0,Nuanjam Watchareeya,MB,Thailand,25.0,178,2021,Dominican Republic,2021-06-08,False,0,0,0,0,0,0,0,0,0,0,0,0,0,0,0,0,0,0,0,0,0,0,0,0
142178.0,Nuanjam Watchareeya,MB,Thailand,25.0,178,2021,Germany,2021-06-12,True,0,0,0,0,0,0,0,0,0,0,0,0,0,0,0,0,0,0,0,0,0,0,0,0
142178.0,Nuanjam Watchareeya,MB,Thailand,25.0,178,2021,Poland,2021-06-13,False,0,0,0,0,0,0,0,0,0,0,0,0,0,0,0,0,0,0,0,0,0,0,0,0
142178.0,Nuanjam Watchareeya,MB,Thailand,25.0,178,2021,Brazil,2021-06-14,False,0,0,2,2,0,0,0,0,1,0,1,2,0,0,0,0,0,0,0,0,0,0,0,0
142178.0,Nuanjam Watchareeya,MB,Thailand,25.0,178,2021,Belgium,2021-06-18,False,0,0,0,0,0,0,1,1,0,0,0,0,0,0,0,0,0,0,0,0,0,0,0,0
142178.0,Nuanjam Watchareeya,MB,Thailand,25.0,178,2021,Canada,2021-06-19,True,0,0,0,0,0,0,0,0,0,0,0,0,0,0,0,0,0,0,0,0,0,0,0,0
142178.0,Nuanjam Watchareeya,MB,Thailand,25.0,178,2021,Italy,2021-06-20,False,0,2,2,4,0,0,0,0,3,2,4,9,0,1,5,6,0,0,1,1,2,0,0,2
132835.0,Hancock Micha,S,USA,29.0,180,2021,Dominican Republic,2021-05-25,False,0,0,0,0,0,0,0,0,0,0,0,0,0,0,0,0,0,0,0,0,0,0,0,0
132835.0,Hancock Micha,S,USA,29.0,180,2021,Serbia,2021-05-31,False,0,0,0,0,0,0,0,0,0,0,0,0,0,0,0,0,0,0,0,0,0,0,0,0
132835.0,Hancock Micha,S,USA,29.0,180,2021,Netherlands,2021-06-01,False,2,4,7,13,34,2,58,94,3,0,2,5,0,1,1,2,0,0,0,0,11,3,1,15
132835.0,Hancock Micha,S,USA,29.0,180,2021,Thailand,2021-06-02,False,1,2,12,15,27,1,52,80,1,0,4,5,2,1,1,4,0,0,0,0,1,1,0,2
132835.0,Hancock Micha,S,USA,29.0,180,2021,Germany,2021-06-06,False,3,3,12,18,6,1,61,68,1,0,0,1,0,0,2,2,0,0,0,0,5,1,0,6
132835.0,Hancock Micha,S,USA,29.0,180,2021,Italy,2021-06-08,False,0,0,0,0,0,0,0,0,0,0,0,0,0,0,0,0,0,0,0,0,0,0,0,0
132835.0,Hancock Micha,S,USA,29.0,180,2021,Belgium,2021-06-12,False,0,0,0,0,0,0,0,0,0,0,0,0,0,0,0,0,0,0,0,0,0,0,0,0
132835.0,Hancock Micha,S,USA,29.0,180,2021,Japan,2021-06-13,False,0,3,8,11,17,1,51,69,0,0,1,1,2,0,3,5,0,0,0,0,10,6,0,16
132835.0,Hancock Micha,S,USA,29.0,180,2021,Poland,2021-06-18,False,4,5,6,15,14,0,77,91,1,0,1,2,1,3,1,5,0,0,1,1,8,0,1,9
132835.0,Hancock Micha,S,USA,29.0,180,2021,Russia,2021-06-19,False,0,0,0,0,0,0,0,0,0,0,0,0,0,0,0,0,0,0,0,0,0,0,0,0
132835.0,Hancock Micha,S,USA,29.0,180,2021,China,2021-06-20,False,1,1,7,9,8,2,63,73,2,1,1,4,0,2,0,2,0,0,0,0,3,4,1,8
132835.0,Hancock Micha,S,USA,29.0,180,2021,Brazil,2021-06-25,False,0,2,1,3,3,0,10,13,0,0,0,0,0,0,0,0,0,0,0,0,3,1,0,4
143517.0,Poulter Jordyn,S,USA,24.0,188,2021,Canada,2021-05-26,False,0,0,0,0,0,0,0,0,0,0,0,0,0,0,0,0,0,0,0,0,0,0,0,0
143517.0,Poulter Jordyn,S,USA,24.0,188,2021,Brazil,2021-05-27,False,2,0,15,17,45,0,91,136,0,0,1,1,0,6,5,11,0,0,2,2,11,1,2,14
143517.0,Poulter Jordyn,S,USA,24.0,188,2021,Serbia,2021-05-31,False,0,0,11,11,29,1,52,82,2,0,1,3,1,1,5,7,0,0,0,0,6,0,1,7
143517.0,Poulter Jordyn,S,USA,24.0,188,2021,Italy,2021-06-08,False,1,0,19,20,16,0,95,111,1,1,3,5,1,0,1,2,0,1,0,1,6,1,0,7
143517.0,Poulter Jordyn,S,USA,24.0,188,2021,Belgium,2021-06-12,False,1,1,11,13,19,1,69,89,1,0,0,1,0,2,4,6,1,1,0,2,8,2,0,10
143517.0,Poulter Jordyn,S,USA,24.0,188,2021,Japan,2021-06-13,False,1,0,6,7,8,0,20,28,0,0,0,0,0,0,0,0,0,0,0,0,3,0,0,3
143517.0,Poulter Jordyn,S,USA,24.0,188,2021,Poland,2021-06-18,False,0,0,0,0,0,0,0,0,0,0,0,0,0,0,0,0,0,0,0,0,0,0,0,0
143517.0,Poulter Jordyn,S,USA,24.0,188,2021,Russia,2021-06-19,False,1,0,15,16,39,2,62,103,1,0,3,4,0,2,5,7,0,0,0,0,6,1,3,10
143517.0,Poulter Jordyn,S,USA,24.0,188,2021,China,2021-06-20,False,0,0,0,0,0,0,0,0,0,0,0,0,0,0,0,0,0,0,0,0,0,0,0,0
143517.0,Poulter Jordyn,S,USA,24.0,188,2021,Brazil,2021-06-25,False,0,0,15,15,33,2,85,120,2,0,4,6,4,3,3,10,0,0,0,0,10,3,1,14
146722.0,Plummer Kathryn,OH,USA,23.0,198,2021,Dominican Republic,2021-05-25,False,0,3,6,9,1,0,1,2,14,5,9,28,2,3,1,6,7,1,16,24,4,3,0,7
146722.0,Plummer Kathryn,OH,USA,23.0,198,2021,Canada,2021-05-26,False,2,3,8,13,0,0,0,0,8,4,13,25,1,0,0,1,11,0,23,34,3,0,0,3
146722.0,Plummer Kathryn,OH,USA,23.0,198,2021,Brazil,2021-05-27,False,0,0,0,0,0,0,0,0,0,0,0,0,0,0,0,0,0,0,0,0,0,0,0,0
146722.0,Plummer Kathryn,OH,USA,23.0,198,2021,Germany,2021-06-06,False,0,0,0,0,0,0,0,0,0,0,0,0,0,0,0,0,0,0,0,0,0,0,0,0
135564.0,Wong-Orantes Justine,L,USA,26.0,168,2021,Dominican Republic,2021-05-25,False,0,0,0,0,0,0,2,2,0,0,0,0,0,0,0,0,9,0,6,15,10,5,1,16
135564.0,Wong-Orantes Justine,L,USA,26.0,168,2021,Canada,2021-05-26,False,0,0,0,0,0,0,6,6,0,0,0,0,0,0,0,0,3,0,3,6,17,0,0,17
135564.0,Wong-Orantes Justine,L,USA,26.0,168,2021,Brazil,2021-05-27,False,0,0,0,0,0,0,6,6,0,0,0,0,0,0,0,0,11,0,12,23,25,2,3,30
135564.0,Wong-Orantes Justine,L,USA,26.0,168,2021,Serbia,2021-05-31,False,0,0,0,0,0,0,0,0,0,0,0,0,0,0,0,0,0,0,0,0,0,0,0,0
135564.0,Wong-Orantes Justine,L,USA,26.0,168,2021,Netherlands,2021-06-01,False,0,0,0,0,0,0,12,12,0,0,0,0,0,0,0,0,9,0,5,14,14,3,4,21
135564.0,Wong-Orantes Justine,L,USA,26.0,168,2021,Thailand,2021-06-02,False,0,0,0,0,0,0,0,0,0,0,0,0,0,0,0,0,0,0,0,0,0,0,0,0
135564.0,Wong-Orantes Justine,L,USA,26.0,168,2021,Germany,2021-06-06,False,0,0,0,0,0,0,4,4,0,0,0,0,0,0,0,0,7,2,15,24,14,2,0,16
135564.0,Wong-Orantes Justine,L,USA,26.0,168,2021,Italy,2021-06-08,False,0,0,0,0,0,0,5,5,0,0,0,0,0,0,0,0,8,2,19,29,20,6,0,26
135564.0,Wong-Orantes Justine,L,USA,26.0,168,2021,Belgium,2021-06-12,False,0,0,0,0,0,0,11,11,0,0,0,0,0,0,0,0,13,1,5,19,11,0,1,12
135564.0,Wong-Orantes Justine,L,USA,26.0,168,2021,Japan,2021-06-13,False,0,0,0,0,1,0,12,13,0,0,0,0,0,0,0,0,5,2,0,7,14,0,0,14
135564.0,Wong-Orantes Justine,L,USA,26.0,168,2021,Poland,2021-06-18,False,0,0,0,0,0,0,9,9,0,0,0,0,0,0,0,0,5,1,11,17,17,3,1,21
135564.0,Wong-Orantes Justine,L,USA,26.0,168,2021,Russia,2021-06-19,False,0,0,0,0,0,0,0,0,0,0,0,0,0,0,0,0,0,0,0,0,0,0,0,0
135564.0,Wong-Orantes Justine,L,USA,26.0,168,2021,China,2021-06-20,False,0,0,0,0,0,0,0,0,0,0,0,0,0,0,0,0,0,0,0,0,0,0,0,0
135564.0,Wong-Orantes Justine,L,USA,26.0,168,2021,Brazil,2021-06-25,False,0,0,0,0,0,0,9,9,0,0,0,0,0,0,0,0,7,0,16,23,14,6,0,20
145702.0,Dixon Tetori,MB,USA,29.0,191,2021,Dominican Republic,2021-05-25,False,0,1,9,10,0,0,0,0,6,1,6,13,0,1,2,3,0,0,0,0,0,1,0,1
145702.0,Dixon Tetori,MB,USA,29.0,191,2021,Canada,2021-05-26,False,0,3,9,12,0,0,0,0,5,0,6,11,2,1,2,5,0,0,0,0,1,0,0,1
145702.0,Dixon Tetori,MB,USA,29.0,191,2021,Brazil,2021-05-27,False,0,0,0,0,0,0,0,0,0,0,0,0,0,0,0,0,0,0,0,0,0,0,0,0
145702.0,Dixon Tetori,MB,USA,29.0,191,2021,Serbia,2021-05-31,False,0,0,0,0,0,0,0,0,0,0,0,0,0,0,0,0,0,0,0,0,0,0,0,0
145702.0,Dixon Tetori,MB,USA,29.0,191,2021,Netherlands,2021-06-01,False,2,1,8,11,0,0,0,0,3,1,7,11,0,3,4,7,0,0,0,0,3,1,0,4
145702.0,Dixon Tetori,MB,USA,29.0,191,2021,Thailand,2021-06-02,False,0,0,0,0,0,0,0,0,0,0,0,0,0,0,0,0,0,0,0,0,0,0,0,0
145702.0,Dixon Tetori,MB,USA,29.0,191,2021,Germany,2021-06-06,False,0,0,0,0,0,0,0,0,0,0,0,0,0,0,0,0,0,0,0,0,0,0,0,0
145702.0,Dixon Tetori,MB,USA,29.0,191,2021,Italy,2021-06-08,False,0,0,0,0,0,0,0,0,0,0,0,0,0,0,0,0,0,0,0,0,0,0,0,0
145702.0,Dixon Tetori,MB,USA,29.0,191,2021,Japan,2021-06-13,False,0,0,0,0,0,0,0,0,0,0,0,0,0,0,0,0,0,0,0,0,0,0,0,0
145702.0,Dixon Tetori,MB,USA,29.0,191,2021,Poland,2021-06-18,False,0,2,8,10,0,1,0,1,3,2,4,9,3,3,2,8,0,0,0,0,2,0,1,3
145702.0,Dixon Tetori,MB,USA,29.0,191,2021,Russia,2021-06-19,False,0,0,0,0,0,0,0,0,0,0,0,0,0,0,0,0,0,0,0,0,0,0,0,0
145702.0,Dixon Tetori,MB,USA,29.0,191,2021,China,2021-06-20,False,0,0,0,0,0,0,0,0,0,0,0,0,0,0,0,0,0,0,0,0,0,0,0,0
132500.0,Carlini Lauren,S,USA,27.0,185,2021,Dominican Republic,2021-05-25,False,1,0,10,11,0,0,0,0,1,0,1,2,1,1,0,2,0,0,0,0,2,2,0,4
132500.0,Carlini Lauren,S,USA,27.0,185,2021,Canada,2021-05-26,False,2,0,14,16,3,0,92,95,2,0,1,3,2,2,0,4,0,0,0,0,1,0,0,1
132500.0,Carlini Lauren,S,USA,27.0,185,2021,Brazil,2021-05-27,False,0,0,0,0,0,0,0,0,0,0,0,0,0,0,0,0,0,0,0,0,0,0,0,0
132500.0,Carlini Lauren,S,USA,27.0,185,2021,Netherlands,2021-06-01,False,0,0,0,0,0,0,0,0,0,0,0,0,0,0,0,0,0,0,0,0,0,0,0,0
132500.0,Carlini Lauren,S,USA,27.0,185,2021,Thailand,2021-06-02,False,0,0,0,0,0,0,0,0,0,0,0,0,0,0,0,0,0,0,0,0,0,0,0,0
132500.0,Carlini Lauren,S,USA,27.0,185,2021,Germany,2021-06-06,False,0,0,0,0,0,0,0,0,0,0,0,0,0,0,0,0,0,0,0,0,0,0,0,0
160909.0,Tapp Hannah,MB,USA,26.0,191,2021,Dominican Republic,2021-05-25,False,0,1,13,14,0,0,0,0,3,0,3,6,4,3,2,9,0,0,0,0,0,1,0,1
160909.0,Tapp Hannah,MB,USA,26.0,191,2021,Canada,2021-05-26,False,0,0,11,11,0,0,0,0,6,0,4,10,1,0,0,1,0,0,0,0,0,0,0,0
160909.0,Tapp Hannah,MB,USA,26.0,191,2021,Brazil,2021-05-27,False,0,0,0,0,0,0,0,0,0,0,0,0,0,0,0,0,0,0,0,0,0,0,0,0
160909.0,Tapp Hannah,MB,USA,26.0,191,2021,Netherlands,2021-06-01,False,0,0,0,0,0,0,0,0,0,0,0,0,0,0,0,0,0,0,0,0,0,0,0,0
160909.0,Tapp Hannah,MB,USA,26.0,191,2021,Thailand,2021-06-02,False,1,2,8,11,0,0,1,1,6,1,2,9,0,3,0,3,1,0,0,1,3,0,0,3
160909.0,Tapp Hannah,MB,USA,26.0,191,2021,Germany,2021-06-06,False,0,0,0,0,0,0,0,0,0,0,0,0,0,0,0,0,0,0,0,0,0,0,0,0
160909.0,Tapp Hannah,MB,USA,26.0,191,2021,Italy,2021-06-08,False,0,0,0,0,0,0,0,0,0,0,0,0,0,0,0,0,0,0,0,0,0,0,0,0
160909.0,Tapp Hannah,MB,USA,26.0,191,2021,Belgium,2021-06-12,False,0,0,0,0,0,0,0,0,0,0,0,0,0,0,0,0,0,0,0,0,0,0,0,0
160909.0,Tapp Hannah,MB,USA,26.0,191,2021,Russia,2021-06-19,False,0,0,0,0,0,0,0,0,0,0,0,0,0,0,0,0,0,0,0,0,0,0,0,0
160909.0,Tapp Hannah,MB,USA,26.0,191,2021,China,2021-06-20,False,0,0,4,4,0,0,0,0,0,1,1,2,1,0,2,3,0,0,0,0,0,2,0,2
114051.0,Larson Jordan,OH,USA,35.0,188,2021,Dominican Republic,2021-05-25,False,0,1,14,15,1,1,2,4,14,1,13,28,1,4,0,5,5,0,5,10,2,2,0,4
114051.0,Larson Jordan,OH,USA,35.0,188,2021,Canada,2021-05-26,False,0,0,0,0,0,0,0,0,0,0,0,0,0,0,0,0,0,0,0,0,0,0,0,0
114051.0,Larson Jordan,OH,USA,35.0,188,2021,Brazil,2021-05-27,False,0,0,17,17,0,0,5,5,15,3,20,38,1,3,1,5,5,0,8,13,14,4,0,18
114051.0,Larson Jordan,OH,USA,35.0,188,2021,Serbia,2021-05-31,False,0,0,0,0,0,0,0,0,0,0,0,0,0,0,0,0,0,0,0,0,0,0,0,0
114051.0,Larson Jordan,OH,USA,35.0,188,2021,Netherlands,2021-06-01,False,1,2,7,10,0,0,2,2,8,2,21,31,1,1,2,4,7,0,5,12,14,2,0,16
114051.0,Larson Jordan,OH,USA,35.0,188,2021,Thailand,2021-06-02,False,0,0,0,0,0,0,0,0,0,0,0,0,0,0,0,0,0,0,0,0,0,0,0,0
114051.0,Larson Jordan,OH,USA,35.0,188,2021,Germany,2021-06-06,False,2,1,14,17,0,0,6,6,8,2,7,17,0,2,1,3,3,1,3,7,3,1,0,4
114051.0,Larson Jordan,OH,USA,35.0,188,2021,Italy,2021-06-08,False,0,0,0,0,0,0,0,0,0,0,0,0,0,0,0,0,0,0,0,0,0,0,0,0
114051.0,Larson Jordan,OH,USA,35.0,188,2021,Belgium,2021-06-12,False,0,5,16,21,0,0,3,3,10,4,7,21,0,2,2,4,5,1,12,18,13,1,0,14
114051.0,Larson Jordan,OH,USA,35.0,188,2021,Japan,2021-06-13,False,0,0,0,0,0,0,0,0,0,0,0,0,0,0,0,0,0,0,0,0,0,0,0,0
114051.0,Larson Jordan,OH,USA,35.0,188,2021,Poland,2021-06-18,False,0,0,0,0,0,0,0,0,0,0,0,0,0,0,0,0,0,0,0,0,0,0,0,0
114051.0,Larson Jordan,OH,USA,35.0,188,2021,Russia,2021-06-19,False,4,0,11,15,0,0,2,2,15,3,13,31,0,2,1,3,7,1,15,23,12,1,1,14
114051.0,Larson Jordan,OH,USA,35.0,188,2021,China,2021-06-20,False,0,0,0,0,0,0,0,0,0,0,0,0,0,0,0,0,0,0,0,0,0,0,0,0
114051.0,Larson Jordan,OH,USA,35.0,188,2021,Brazil,2021-06-25,False,0,0,14,14,0,0,8,8,10,3,16,29,1,3,1,5,7,0,7,14,10,2,1,13
155307.0,Drews Andrea,O,USA,28.0,191,2021,Dominican Republic,2021-05-25,False,0,0,0,0,0,0,0,0,0,0,0,0,0,0,0,0,0,0,0,0,0,0,0,0
155307.0,Drews Andrea,O,USA,28.0,191,2021,Canada,2021-05-26,False,0,1,13,14,0,1,0,1,19,4,14,37,1,1,2,4,0,0,0,0,4,0,0,4
155307.0,Drews Andrea,O,USA,28.0,191,2021,Brazil,2021-05-27,False,1,0,16,17,0,1,1,2,15,7,15,37,0,3,5,8,0,0,0,0,9,2,2,13
155307.0,Drews Andrea,O,USA,28.0,191,2021,Serbia,2021-05-31,False,0,0,0,0,0,0,0,0,0,0,0,0,0,0,0,0,0,0,0,0,0,0,0,0
155307.0,Drews Andrea,O,USA,28.0,191,2021,Netherlands,2021-06-01,False,0,2,11,13,0,0,0,0,9,4,12,25,2,2,5,9,0,0,0,0,12,1,0,13
155307.0,Drews Andrea,O,USA,28.0,191,2021,Thailand,2021-06-02,False,0,0,0,0,0,0,0,0,0,0,0,0,0,0,0,0,0,0,0,0,0,0,0,0
155307.0,Drews Andrea,O,USA,28.0,191,2021,Germany,2021-06-06,False,0,1,6,7,0,0,1,1,17,0,9,26,0,2,0,2,0,0,0,0,3,1,0,4
155307.0,Drews Andrea,O,USA,28.0,191,2021,Italy,2021-06-08,False,2,1,15,18,0,0,0,0,18,3,9,30,0,3,1,4,0,0,0,0,9,1,1,11
155307.0,Drews Andrea,O,USA,28.0,191,2021,Belgium,2021-06-12,False,0,0,0,0,0,0,0,0,0,0,0,0,0,0,0,0,0,0,0,0,0,0,0,0
155307.0,Drews Andrea,O,USA,28.0,191,2021,Japan,2021-06-13,False,1,1,3,5,0,0,2,2,9,2,15,26,0,3,7,10,0,0,0,0,5,1,2,8
155307.0,Drews Andrea,O,USA,28.0,191,2021,Poland,2021-06-18,False,0,0,0,0,0,0,0,0,0,0,0,0,0,0,0,0,0,0,0,0,0,0,0,0
155307.0,Drews Andrea,O,USA,28.0,191,2021,Russia,2021-06-19,False,3,2,13,18,0,0,2,2,13,5,14,32,1,7,4,12,0,0,0,0,7,4,3,14
155307.0,Drews Andrea,O,USA,28.0,191,2021,China,2021-06-20,False,0,0,9,9,0,0,2,2,9,3,7,19,2,1,0,3,0,0,0,0,1,5,0,6
155307.0,Drews Andrea,O,USA,28.0,191,2021,Brazil,2021-06-25,False,0,1,4,5,0,0,0,0,12,5,8,25,0,0,2,2,0,0,0,0,5,0,0,5
172978.0,Thompson Jordan,O,USA,24.0,193,2021,Dominican Republic,2021-05-25,False,1,1,12,14,3,0,1,4,13,3,17,33,1,4,3,8,0,0,0,0,6,2,0,8
172978.0,Thompson Jordan,O,USA,24.0,193,2021,Canada,2021-05-26,False,0,0,0,0,0,0,0,0,0,0,0,0,0,0,0,0,0,0,0,0,0,0,0,0
172978.0,Thompson Jordan,O,USA,24.0,193,2021,Brazil,2021-05-27,False,0,0,0,0,0,0,0,0,0,0,0,0,0,0,0,0,0,0,0,0,0,0,0,0
172978.0,Thompson Jordan,O,USA,24.0,193,2021,Serbia,2021-05-31,False,2,1,11,14,0,0,5,5,15,1,12,28,0,2,3,5,0,0,0,0,9,3,2,14
172978.0,Thompson Jordan,O,USA,24.0,193,2021,Netherlands,2021-06-01,False,0,0,0,0,0,0,0,0,0,0,0,0,0,0,0,0,0,0,0,0,0,0,0,0
172978.0,Thompson Jordan,O,USA,24.0,193,2021,Thailand,2021-06-02,False,0,3,4,7,0,0,0,0,14,2,9,25,3,2,1,6,0,0,0,0,5,1,0,6
172978.0,Thompson Jordan,O,USA,24.0,193,2021,Germany,2021-06-06,False,0,0,0,0,0,0,0,0,0,0,0,0,0,0,0,0,0,0,0,0,0,0,0,0
172978.0,Thompson Jordan,O,USA,24.0,193,2021,Italy,2021-06-08,False,0,0,0,0,0,0,0,0,0,0,0,0,0,0,0,0,0,0,0,0,0,0,0,0
172978.0,Thompson Jordan,O,USA,24.0,193,2021,Belgium,2021-06-12,False,0,3,6,9,0,0,3,3,18,3,16,37,3,2,5,10,0,0,0,0,7,3,0,10
172978.0,Thompson Jordan,O,USA,24.0,193,2021,Japan,2021-06-13,False,0,1,0,1,0,0,1,1,7,0,4,11,0,0,3,3,0,0,0,0,0,0,0,0
172978.0,Thompson Jordan,O,USA,24.0,193,2021,Poland,2021-06-18,False,0,1,12,13,0,0,1,1,14,1,15,30,3,4,3,10,0,0,0,0,6,2,2,10
172978.0,Thompson Jordan,O,USA,24.0,193,2021,Russia,2021-06-19,False,0,0,0,0,0,0,0,0,0,0,0,0,0,0,0,0,0,0,0,0,0,0,0,0
172978.0,Thompson Jordan,O,USA,24.0,193,2021,China,2021-06-20,False,0,0,0,0,0,0,0,0,0,0,0,0,0,0,0,0,0,0,0,0,0,0,0,0
172978.0,Thompson Jordan,O,USA,24.0,193,2021,Brazil,2021-06-25,False,2,1,10,13,0,0,1,1,12,8,11,31,2,5,2,9,0,0,0,0,8,3,1,12
162942.0,Wilhite Sarah,OH,USA,26.0,185,2021,Dominican Republic,2021-05-25,False,0,0,0,0,0,0,0,0,0,0,0,0,0,0,0,0,0,0,0,0,0,0,0,0
162942.0,Wilhite Sarah,OH,USA,26.0,185,2021,Canada,2021-05-26,False,0,1,8,9,0,0,4,4,8,2,13,23,3,0,0,3,4,0,2,6,2,0,0,2
162942.0,Wilhite Sarah,OH,USA,26.0,185,2021,Brazil,2021-05-27,False,2,1,18,21,0,0,0,0,21,5,17,43,2,1,2,5,10,1,23,34,4,0,1,5
162942.0,Wilhite Sarah,OH,USA,26.0,185,2021,Germany,2021-06-06,False,0,0,0,0,0,0,0,0,0,0,0,0,0,0,0,0,0,0,0,0,0,0,0,0
162942.0,Wilhite Sarah,OH,USA,26.0,185,2021,Italy,2021-06-08,False,0,0,0,0,0,0,0,0,0,0,0,0,0,0,0,0,0,0,0,0,0,0,0,0
162942.0,Wilhite Sarah,OH,USA,26.0,185,2021,Belgium,2021-06-12,False,0,0,0,0,0,0,0,0,0,0,0,0,0,0,0,0,0,0,0,0,0,0,0,0
162942.0,Wilhite Sarah,OH,USA,26.0,185,2021,Japan,2021-06-13,False,0,0,0,0,0,0,0,0,0,0,0,0,0,0,0,0,0,0,0,0,0,0,0,0
162942.0,Wilhite Sarah,OH,USA,26.0,185,2021,Poland,2021-06-18,False,0,0,0,0,0,0,0,0,0,0,0,0,0,0,0,0,0,0,0,0,0,0,0,0
162942.0,Wilhite Sarah,OH,USA,26.0,185,2021,Russia,2021-06-19,False,0,0,0,0,0,0,0,0,0,0,0,0,0,0,0,0,0,0,0,0,0,0,0,0
162942.0,Wilhite Sarah,OH,USA,26.0,185,2021,China,2021-06-20,False,0,0,0,0,0,0,0,0,0,0,0,0,0,0,0,0,0,0,0,0,0,0,0,0
119550.0,Bartsch-Hackley Michelle,OH,USA,32.0,190,2021,Canada,2021-05-26,False,0,0,0,0,0,0,0,0,0,0,0,0,0,0,0,0,0,0,0,0,0,0,0,0
119550.0,Bartsch-Hackley Michelle,OH,USA,32.0,190,2021,Serbia,2021-05-31,False,1,2,9,12,0,0,2,2,9,4,9,22,1,0,1,2,5,2,15,22,3,0,1,4
119550.0,Bartsch-Hackley Michelle,OH,USA,32.0,190,2021,Netherlands,2021-06-01,False,0,0,0,0,0,0,0,0,0,0,0,0,0,0,0,0,0,0,0,0,0,0,0,0
119550.0,Bartsch-Hackley Michelle,OH,USA,32.0,190,2021,Thailand,2021-06-02,False,4,1,17,22,0,0,2,2,11,1,8,20,3,4,0,7,9,0,8,17,3,4,0,7
119550.0,Bartsch-Hackley Michelle,OH,USA,32.0,190,2021,Italy,2021-06-08,False,1,2,9,12,0,0,2,2,16,2,15,33,2,0,2,4,6,3,20,29,7,4,1,12
119550.0,Bartsch-Hackley Michelle,OH,USA,32.0,190,2021,Belgium,2021-06-12,False,0,0,0,0,0,0,0,0,0,0,0,0,0,0,0,0,0,0,0,0,0,0,0,0
119550.0,Bartsch-Hackley Michelle,OH,USA,32.0,190,2021,Japan,2021-06-13,False,1,1,13,15,0,0,4,4,12,0,15,27,1,3,3,7,14,1,14,29,10,2,1,13
119550.0,Bartsch-Hackley Michelle,OH,USA,32.0,190,2021,Poland,2021-06-18,False,1,0,16,17,0,0,3,3,14,3,16,33,2,2,2,6,11,1,17,29,10,1,1,12
119550.0,Bartsch-Hackley Michelle,OH,USA,32.0,190,2021,Russia,2021-06-19,False,0,0,0,0,0,0,0,0,0,0,0,0,0,0,0,0,0,0,0,0,0,0,0,0
119550.0,Bartsch-Hackley Michelle,OH,USA,32.0,190,2021,China,2021-06-20,False,0,1,8,9,0,0,2,2,7,3,9,19,0,0,0,0,8,1,12,21,2,4,1,7
119550.0,Bartsch-Hackley Michelle,OH,USA,32.0,190,2021,Brazil,2021-06-25,False,1,1,21,23,0,0,4,4,18,5,21,44,3,4,2,9,23,0,30,53,11,2,1,14
142658.0,Hill Kimberly,OH,USA,32.0,193,2021,Dominican Republic,2021-05-25,False,0,0,0,0,0,0,0,0,0,0,0,0,0,0,0,0,0,0,0,0,0,0,0,0
142658.0,Hill Kimberly,OH,USA,32.0,193,2021,Brazil,2021-05-27,False,0,0,0,0,0,0,0,0,0,0,0,0,0,0,0,0,0,0,0,0,0,0,0,0
142658.0,Hill Kimberly,OH,USA,32.0,193,2021,Serbia,2021-05-31,False,0,1,12,13,0,0,1,1,5,2,16,23,0,2,1,3,2,0,4,6,11,0,1,12
142658.0,Hill Kimberly,OH,USA,32.0,193,2021,Netherlands,2021-06-01,False,0,0,0,0,0,0,0,0,0,0,0,0,0,0,0,0,0,0,0,0,0,0,0,0
142658.0,Hill Kimberly,OH,USA,32.0,193,2021,Thailand,2021-06-02,False,0,1,8,9,0,0,0,0,9,4,12,25,2,0,2,4,6,0,4,10,5,4,0,9
142658.0,Hill Kimberly,OH,USA,32.0,193,2021,Germany,2021-06-06,False,0,0,0,0,0,0,0,0,0,0,0,0,0,0,0,0,0,0,0,0,0,0,0,0
142658.0,Hill Kimberly,OH,USA,32.0,193,2021,Italy,2021-06-08,False,0,0,0,0,0,0,0,0,0,0,0,0,0,0,0,0,0,0,0,0,0,0,0,0
142658.0,Hill Kimberly,OH,USA,32.0,193,2021,Belgium,2021-06-12,False,0,1,6,7,0,0,0,0,0,0,0,0,0,0,0,0,0,0,0,0,0,0,0,0
142658.0,Hill Kimberly,OH,USA,32.0,193,2021,Japan,2021-06-13,False,0,1,3,4,0,0,1,1,0,0,0,0,0,0,0,0,0,0,0,0,0,0,0,0
142658.0,Hill Kimberly,OH,USA,32.0,193,2021,Poland,2021-06-18,False,0,1,15,16,0,0,2,2,8,3,13,24,5,4,2,11,3,1,10,14,9,2,3,14
142658.0,Hill Kimberly,OH,USA,32.0,193,2021,Russia,2021-06-19,False,0,0,0,0,0,0,3,3,0,0,0,0,0,0,0,0,8,2,20,30,11,6,3,20
142658.0,Hill Kimberly,OH,USA,32.0,193,2021,China,2021-06-20,False,0,0,0,0,0,0,1,1,0,0,0,0,0,0,0,0,15,5,22,42,7,6,1,14
115495.0,Akinradewo Foluke,MB,USA,34.0,191,2021,Dominican Republic,2021-05-25,False,0,0,0,0,0,0,0,0,0,0,0,0,0,0,0,0,0,0,0,0,0,0,0,0
115495.0,Akinradewo Foluke,MB,USA,34.0,191,2021,Canada,2021-05-26,False,0,0,0,0,0,0,0,0,0,0,0,0,0,0,0,0,0,0,0,0,0,0,0,0
115495.0,Akinradewo Foluke,MB,USA,34.0,191,2021,Brazil,2021-05-27,False,1,0,12,13,0,1,0,1,7,2,6,15,2,8,7,17,1,1,1,3,2,0,2,4
115495.0,Akinradewo Foluke,MB,USA,34.0,191,2021,Serbia,2021-05-31,False,0,0,0,0,0,0,0,0,0,0,0,0,0,0,0,0,0,0,0,0,0,0,0,0
115495.0,Akinradewo Foluke,MB,USA,34.0,191,2021,Netherlands,2021-06-01,False,0,0,10,10,0,0,0,0,8,3,3,14,1,4,2,7,0,0,0,0,2,1,0,3
115495.0,Akinradewo Foluke,MB,USA,34.0,191,2021,Germany,2021-06-06,False,0,1,4,5,0,0,0,0,2,0,5,7,1,2,0,3,0,0,0,0,3,1,0,4
115495.0,Akinradewo Foluke,MB,USA,34.0,191,2021,Italy,2021-06-08,False,0,3,14,17,0,0,1,1,7,2,4,13,4,8,10,22,0,0,0,0,5,2,0,7
115495.0,Akinradewo Foluke,MB,USA,34.0,191,2021,Belgium,2021-06-12,False,0,2,5,7,0,0,1,1,8,0,4,12,1,1,2,4,0,0,0,0,4,1,0,5
115495.0,Akinradewo Foluke,MB,USA,34.0,191,2021,Japan,2021-06-13,False,0,0,0,0,0,0,0,0,0,0,0,0,0,0,0,0,0,0,0,0,0,0,0,0
115495.0,Akinradewo Foluke,MB,USA,34.0,191,2021,Poland,2021-06-18,False,0,0,11,11,0,0,1,1,5,1,5,11,0,6,4,10,0,0,0,0,1,0,0,1
115495.0,Akinradewo Foluke,MB,USA,34.0,191,2021,China,2021-06-20,False,0,1,5,6,0,0,0,0,7,2,2,11,0,1,0,1,0,0,1,1,0,0,0,0
115495.0,Akinradewo Foluke,MB,USA,34.0,191,2021,Brazil,2021-06-25,False,0,1,11,12,0,0,0,0,5,2,5,12,2,7,1,10,0,0,0,0,4,0,1,5
155415.0,Courtney Megan,OH,USA,28.0,185,2021,Dominican Republic,2021-05-25,False,0,0,0,0,0,0,0,0,0,0,0,0,0,0,0,0,0,0,0,0,0,0,0,0
155415.0,Courtney Megan,OH,USA,28.0,185,2021,Canada,2021-05-26,False,0,0,0,0,0,0,0,0,0,0,0,0,0,0,0,0,0,0,0,0,0,0,0,0
155415.0,Courtney Megan,OH,USA,28.0,185,2021,Brazil,2021-05-27,False,0,0,0,0,0,0,0,0,0,0,0,0,0,0,0,0,0,0,0,0,0,0,0,0
155415.0,Courtney Megan,OH,USA,28.0,185,2021,Serbia,2021-05-31,False,0,0,0,0,0,0,4,4,0,0,0,0,0,0,0,0,5,1,13,19,22,0,1,23
155415.0,Courtney Megan,OH,USA,28.0,185,2021,Netherlands,2021-06-01,False,0,0,0,0,0,0,0,0,0,0,0,0,0,0,0,0,0,0,0,0,0,0,0,0
155415.0,Courtney Megan,OH,USA,28.0,185,2021,Thailand,2021-06-02,False,0,0,0,0,0,0,4,4,0,0,0,0,0,0,0,0,9,0,7,16,5,4,0,9
140052.0,Washington Haleigh,MB,USA,26.0,190,2021,Dominican Republic,2021-05-25,False,0,0,0,0,0,0,0,0,0,0,0,0,0,0,0,0,0,0,0,0,0,0,0,0
140052.0,Washington Haleigh,MB,USA,26.0,190,2021,Canada,2021-05-26,False,0,0,0,0,0,0,0,0,0,0,0,0,0,0,0,0,0,0,0,0,0,0,0,0
140052.0,Washington Haleigh,MB,USA,26.0,190,2021,Brazil,2021-05-27,False,0,2,10,12,0,0,0,0,9,1,5,15,1,5,9,15,0,0,0,0,3,0,0,3
140052.0,Washington Haleigh,MB,USA,26.0,190,2021,Serbia,2021-05-31,False,1,3,10,14,0,0,0,0,6,1,5,12,4,4,5,13,0,0,0,0,4,1,0,5
140052.0,Washington Haleigh,MB,USA,26.0,190,2021,Netherlands,2021-06-01,False,0,0,0,0,0,0,0,0,0,0,0,0,0,0,0,0,0,0,0,0,0,0,0,0
140052.0,Washington Haleigh,MB,USA,26.0,190,2021,Thailand,2021-06-02,False,1,1,7,9,0,0,0,0,6,0,4,10,1,3,2,6,0,0,1,1,0,1,0,1
140052.0,Washington Haleigh,MB,USA,26.0,190,2021,Italy,2021-06-08,False,2,2,10,14,0,0,0,0,6,1,5,12,1,6,7,14,0,0,0,0,2,0,1,3
140052.0,Washington Haleigh,MB,USA,26.0,190,2021,Belgium,2021-06-12,False,0,0,0,0,0,0,0,0,0,0,0,0,0,0,0,0,0,0,0,0,0,0,0,0
140052.0,Washington Haleigh,MB,USA,26.0,190,2021,Japan,2021-06-13,False,0,0,6,6,0,0,0,0,7,0,6,13,1,4,4,9,0,0,0,0,0,2,0,2
140052.0,Washington Haleigh,MB,USA,26.0,190,2021,Poland,2021-06-18,False,0,0,0,0,0,0,0,0,0,0,0,0,0,0,0,0,0,0,0,0,0,0,0,0
140052.0,Washington Haleigh,MB,USA,26.0,190,2021,Russia,2021-06-19,False,1,1,13,15,0,0,1,1,13,1,6,20,4,5,9,18,0,0,0,0,0,1,2,3
140052.0,Washington Haleigh,MB,USA,26.0,190,2021,China,2021-06-20,False,0,1,2,3,0,0,0,0,2,0,0,2,1,1,0,2,0,0,0,0,0,0,0,0
140052.0,Washington Haleigh,MB,USA,26.0,190,2021,Brazil,2021-06-25,False,0,2,11,13,0,0,0,0,7,2,5,14,1,5,5,11,0,0,0,0,3,2,0,5
141933.0,Robinson Kelsey,OH,USA,29.0,188,2021,Serbia,2021-05-31,False,0,0,0,0,0,0,0,0,0,0,0,0,0,0,0,0,0,0,0,0,0,0,0,0
141933.0,Robinson Kelsey,OH,USA,29.0,188,2021,Netherlands,2021-06-01,False,2,0,14,16,0,0,4,4,10,5,13,28,1,2,0,3,9,0,10,19,15,0,1,16
141933.0,Robinson Kelsey,OH,USA,29.0,188,2021,Thailand,2021-06-02,False,0,0,0,0,0,0,0,0,0,0,0,0,0,0,0,0,0,0,0,0,0,0,0,0
141933.0,Robinson Kelsey,OH,USA,29.0,188,2021,Germany,2021-06-06,False,3,2,10,15,0,0,4,4,12,6,8,26,2,0,1,3,5,0,8,13,4,2,0,6
141933.0,Robinson Kelsey,OH,USA,29.0,188,2021,Italy,2021-06-08,False,1,3,9,13,0,0,7,7,9,6,17,32,1,3,2,6,5,0,4,9,14,1,1,16
141933.0,Robinson Kelsey,OH,USA,29.0,188,2021,Belgium,2021-06-12,False,1,1,9,11,0,0,1,1,12,2,16,30,1,2,3,6,3,1,7,11,16,3,0,19
141933.0,Robinson Kelsey,OH,USA,29.0,188,2021,Japan,2021-06-13,False,2,3,11,16,0,1,0,1,11,3,14,28,1,2,5,8,14,1,13,28,15,1,0,16
141933.0,Robinson Kelsey,OH,USA,29.0,188,2021,Poland,2021-06-18,False,0,0,0,0,0,0,0,0,0,0,0,0,0,0,0,0,0,0,0,0,0,0,0,0
141933.0,Robinson Kelsey,OH,USA,29.0,188,2021,Russia,2021-06-19,False,2,1,15,18,0,0,9,9,11,3,17,31,3,3,3,9,13,0,10,23,10,2,4,16
141933.0,Robinson Kelsey,OH,USA,29.0,188,2021,China,2021-06-20,False,0,1,7,8,0,0,3,3,9,4,12,25,0,2,0,2,3,1,1,5,5,2,1,8
141933.0,Robinson Kelsey,OH,USA,29.0,188,2021,Brazil,2021-06-25,False,0,0,2,2,0,0,0,0,0,0,0,0,0,0,0,0,0,0,0,0,0,0,0,0
166638.0,Ogbogu Chiaka,MB,USA,26.0,188,2021,Serbia,2021-05-31,False,1,5,2,8,0,0,0,0,6,0,8,14,2,7,6,15,0,0,0,0,2,1,0,3
166638.0,Ogbogu Chiaka,MB,USA,26.0,188,2021,Thailand,2021-06-02,False,0,0,0,0,0,0,0,0,0,0,0,0,0,0,0,0,0,0,0,0,0,0,0,0
166638.0,Ogbogu Chiaka,MB,USA,26.0,188,2021,Germany,2021-06-06,False,0,2,9,11,0,0,1,1,5,0,2,7,1,3,4,8,0,0,0,0,0,1,0,1
166638.0,Ogbogu Chiaka,MB,USA,26.0,188,2021,Belgium,2021-06-12,False,0,2,4,6,0,1,0,1,4,0,3,7,2,2,4,8,0,0,0,0,1,0,0,1
166638.0,Ogbogu Chiaka,MB,USA,26.0,188,2021,Japan,2021-06-13,False,0,2,5,7,0,0,0,0,3,1,5,9,4,3,11,18,0,0,0,0,2,0,1,3
166638.0,Ogbogu Chiaka,MB,USA,26.0,188,2021,Poland,2021-06-18,False,0,0,0,0,0,0,0,0,0,0,0,0,0,0,0,0,0,0,0,0,0,0,0,0
166638.0,Ogbogu Chiaka,MB,USA,26.0,188,2021,Russia,2021-06-19,False,2,5,10,17,0,0,0,0,7,0,1,8,2,7,6,15,0,0,1,1,0,0,1,1
166638.0,Ogbogu Chiaka,MB,USA,26.0,188,2021,Brazil,2021-06-25,False,0,0,0,0,0,0,0,0,0,0,0,0,0,0,0,0,0,0,0,0,0,0,0,0
160209.0,Van Sas Elise,S,Belgium,25.0,188,2022,Serbia,2022-06-01,False,0,0,0,0,1,0,0,1,0,0,0,0,0,1,0,1,0,0,0,0,0,0,0,0
160209.0,Van Sas Elise,S,Belgium,25.0,188,2022,Italy,2022-06-02,False,0,0,3,3,1,0,14,15,0,0,1,1,0,0,0,0,0,0,0,0,1,0,0,1
160209.0,Van Sas Elise,S,Belgium,25.0,188,2022,Thailand,2022-06-04,True,0,0,0,0,0,0,2,2,0,0,0,0,0,0,2,2,0,0,0,0,0,0,0,0
160209.0,Van Sas Elise,S,Belgium,25.0,188,2022,Germany,2022-06-30,False,0,0,0,0,0,0,1,1,0,0,0,0,0,0,0,0,0,0,0,0,0,0,0,0
160209.0,Van Sas Elise,S,Belgium,25.0,188,2022,Netherlands,2022-07-01,False,0,0,0,0,0,0,0,0,0,0,0,0,0,1,0,1,0,0,0,0,0,0,0,0
160209.0,Van Sas Elise,S,Belgium,25.0,188,2022,Japan,2022-07-03,True,0,0,0,0,0,0,2,2,0,0,0,0,0,0,0,0,0,0,0,0,0,0,0,0
152042.0,Herbots Britt,OH,Belgium,23.0,182,2022,Serbia,2022-06-01,False,3,2,10,15,0,0,2,2,27,6,42,75,1,3,4,8,5,1,18,24,4,1,1,6
152042.0,Herbots Britt,OH,Belgium,23.0,182,2022,Italy,2022-06-02,False,0,4,10,14,0,0,1,1,24,6,25,55,2,4,1,7,2,1,23,26,7,4,1,12
152042.0,Herbots Britt,OH,Belgium,23.0,182,2022,Thailand,2022-06-04,True,0,1,21,22,0,0,3,3,22,10,34,66,1,3,5,9,4,0,15,19,14,4,1,19
152042.0,Herbots Britt,OH,Belgium,23.0,182,2022,China,2022-06-15,False,1,0,4,5,0,0,1,1,5,4,2,11,0,0,0,0,0,0,0,0,0,1,0,1
152042.0,Herbots Britt,OH,Belgium,23.0,182,2022,Canada,2022-06-16,False,1,0,11,12,0,0,1,1,24,4,31,59,4,1,2,7,1,0,7,8,7,5,0,12
152042.0,Herbots Britt,OH,Belgium,23.0,182,2022,Poland,2022-06-18,True,0,2,14,16,1,0,2,3,33,8,43,84,0,0,6,6,4,1,9,14,7,0,1,8
152042.0,Herbots Britt,OH,Belgium,23.0,182,2022,Bulgaria,2022-06-19,True,0,3,21,24,0,0,2,2,23,11,50,84,3,4,5,12,7,1,27,35,12,3,1,16
152042.0,Herbots Britt,OH,Belgium,23.0,182,2022,Germany,2022-06-30,False,0,1,13,14,0,0,6,6,33,6,43,82,1,2,1,4,2,0,9,11,8,2,0,10
152042.0,Herbots Britt,OH,Belgium,23.0,182,2022,Netherlands,2022-07-01,False,2,2,12,16,0,1,4,5,28,11,47,86,1,3,0,4,16,1,19,36,6,1,0,7
152042.0,Herbots Britt,OH,Belgium,23.0,182,2022,Japan,2022-07-03,True,0,3,14,17,0,0,7,7,29,3,35,67,0,2,1,3,8,0,7,15,11,1,0,12
135880.0,Lemmens Nathalie,MB,Belgium,28.0,192,2022,Serbia,2022-06-01,False,0,0,4,4,0,0,2,2,1,0,2,3,1,3,4,8,0,0,0,0,0,1,0,1
135880.0,Lemmens Nathalie,MB,Belgium,28.0,192,2022,Italy,2022-06-02,False,0,1,9,10,0,0,3,3,4,2,4,10,4,3,8,15,0,0,0,0,2,2,1,5
135880.0,Lemmens Nathalie,MB,Belgium,28.0,192,2022,Thailand,2022-06-04,True,0,1,10,11,0,0,2,2,10,0,1,11,0,8,7,15,0,0,0,0,2,1,0,3
135880.0,Lemmens Nathalie,MB,Belgium,28.0,192,2022,China,2022-06-15,False,0,0,0,0,0,0,0,0,0,0,0,0,0,0,0,0,0,0,0,0,0,0,0,0
135880.0,Lemmens Nathalie,MB,Belgium,28.0,192,2022,Canada,2022-06-16,False,1,0,18,19,0,0,2,2,1,1,4,6,0,3,5,8,0,0,0,0,3,0,0,3
135880.0,Lemmens Nathalie,MB,Belgium,28.0,192,2022,Poland,2022-06-18,True,0,1,15,16,0,0,2,2,6,0,5,11,2,4,4,10,0,0,1,1,3,1,0,4
135880.0,Lemmens Nathalie,MB,Belgium,28.0,192,2022,Bulgaria,2022-06-19,True,0,1,8,9,0,0,6,6,5,3,4,12,3,1,7,11,0,0,0,0,1,0,0,1
135880.0,Lemmens Nathalie,MB,Belgium,28.0,192,2022,Germany,2022-06-30,False,0,2,8,10,0,0,1,1,5,1,4,10,1,5,1,7,0,0,0,0,3,1,0,4
135880.0,Lemmens Nathalie,MB,Belgium,28.0,192,2022,Netherlands,2022-07-01,False,0,1,11,12,0,0,1,1,0,0,5,5,2,3,3,8,0,0,0,0,0,1,0,1
135880.0,Lemmens Nathalie,MB,Belgium,28.0,192,2022,Japan,2022-07-03,True,0,0,16,16,0,0,2,2,6,2,3,11,2,9,4,15,0,0,0,0,2,0,0,2
156326.0,Guilliams Jodie,OH,Belgium,25.0,180,2022,China,2022-06-15,False,0,1,11,12,0,0,2,2,7,3,9,19,0,1,2,3,5,1,10,16,4,3,1,8
156326.0,Guilliams Jodie,OH,Belgium,25.0,180,2022,Canada,2022-06-16,False,1,1,9,11,0,0,1,1,5,2,10,17,1,3,4,8,4,1,13,18,6,3,0,9
156326.0,Guilliams Jodie,OH,Belgium,25.0,180,2022,Poland,2022-06-18,True,0,1,12,13,0,0,3,3,3,5,4,12,0,4,0,4,4,2,17,23,15,4,0,19
156326.0,Guilliams Jodie,OH,Belgium,25.0,180,2022,Bulgaria,2022-06-19,True,1,1,13,15,1,0,3,4,5,8,10,23,0,2,2,4,7,0,29,36,10,4,3,17
156326.0,Guilliams Jodie,OH,Belgium,25.0,180,2022,Germany,2022-06-30,False,0,2,15,17,0,0,4,4,8,2,8,18,0,1,0,1,9,2,16,27,12,1,0,13
156326.0,Guilliams Jodie,OH,Belgium,25.0,180,2022,Netherlands,2022-07-01,False,0,2,12,14,0,0,3,3,12,4,16,32,1,1,2,4,14,3,25,42,16,1,1,18
156326.0,Guilliams Jodie,OH,Belgium,25.0,180,2022,Japan,2022-07-03,True,0,0,6,6,0,0,1,1,3,5,10,18,0,2,1,3,12,0,12,24,5,1,1,7
151117.0,Van Gestel Celine,OH,Belgium,25.0,183,2022,Serbia,2022-06-01,False,1,1,14,16,0,0,3,3,8,6,21,35,0,4,4,8,5,1,24,30,10,3,5,18
151117.0,Van Gestel Celine,OH,Belgium,25.0,183,2022,Italy,2022-06-02,False,0,1,14,15,0,0,0,0,8,7,17,32,1,2,1,4,10,2,20,32,6,5,1,12
151117.0,Van Gestel Celine,OH,Belgium,25.0,183,2022,Thailand,2022-06-04,True,0,0,12,12,0,1,2,3,12,3,29,44,1,3,5,9,11,1,22,34,24,3,1,28
151117.0,Van Gestel Celine,OH,Belgium,25.0,183,2022,China,2022-06-15,False,1,2,5,8,0,0,1,1,10,5,13,28,0,0,1,1,7,1,36,44,8,0,0,8
151117.0,Van Gestel Celine,OH,Belgium,25.0,183,2022,Canada,2022-06-16,False,2,1,16,19,0,0,3,3,12,2,8,22,2,4,1,7,4,1,24,29,11,7,0,18
151117.0,Van Gestel Celine,OH,Belgium,25.0,183,2022,Poland,2022-06-18,True,1,0,19,20,0,0,6,6,5,3,17,25,1,5,4,10,2,0,14,16,11,0,0,11
151117.0,Van Gestel Celine,OH,Belgium,25.0,183,2022,Bulgaria,2022-06-19,True,0,0,4,4,0,0,0,0,0,0,3,3,0,1,2,3,2,0,6,8,7,4,0,11
151117.0,Van Gestel Celine,OH,Belgium,25.0,183,2022,Germany,2022-06-30,False,0,0,0,0,0,0,0,0,0,0,0,0,0,0,0,0,0,0,0,0,0,0,0,0
151117.0,Van Gestel Celine,OH,Belgium,25.0,183,2022,Netherlands,2022-07-01,False,0,0,0,0,0,0,0,0,0,0,0,0,0,0,0,0,0,0,0,0,0,0,0,0
151117.0,Van Gestel Celine,OH,Belgium,25.0,183,2022,Japan,2022-07-03,True,0,0,0,0,0,0,0,0,0,0,0,0,0,0,0,0,0,0,0,0,0,0,0,0
181275.0,Demeyer Nel,OH,Belgium,22.0,175,2022,Serbia,2022-06-01,False,0,0,0,0,0,0,3,3,0,0,0,0,0,0,0,0,1,1,5,7,5,4,1,10
181275.0,Demeyer Nel,OH,Belgium,22.0,175,2022,Italy,2022-06-02,False,0,0,0,0,0,0,0,0,0,0,0,0,0,0,0,0,0,0,0,0,0,0,0,0
181275.0,Demeyer Nel,OH,Belgium,22.0,175,2022,Thailand,2022-06-04,True,0,0,0,0,0,0,0,0,0,0,0,0,0,0,0,0,1,0,2,3,2,0,0,2
181275.0,Demeyer Nel,OH,Belgium,22.0,175,2022,Poland,2022-06-18,True,0,0,0,0,0,1,4,5,0,0,0,0,0,0,0,0,0,0,0,0,13,3,0,16
181275.0,Demeyer Nel,OH,Belgium,22.0,175,2022,Bulgaria,2022-06-19,True,0,0,0,0,0,0,6,6,0,0,0,0,0,0,0,0,0,0,2,2,12,3,4,19
181275.0,Demeyer Nel,OH,Belgium,22.0,175,2022,Germany,2022-06-30,False,0,0,0,0,0,0,2,2,0,0,0,0,0,0,0,0,0,0,3,3,5,1,0,6
181275.0,Demeyer Nel,OH,Belgium,22.0,175,2022,Netherlands,2022-07-01,False,0,0,0,0,0,0,7,7,0,0,0,0,0,0,0,0,0,0,1,1,10,4,0,14
181275.0,Demeyer Nel,OH,Belgium,22.0,175,2022,Japan,2022-07-03,True,0,0,0,0,0,0,0,0,0,0,0,0,0,0,0,0,0,0,0,0,1,0,0,1
177099.0,Martin Pauline,O,Belgium,20.0,189,2022,Serbia,2022-06-01,False,0,0,0,0,0,0,0,0,0,0,0,0,0,0,0,0,0,0,0,0,0,0,0,0
177099.0,Martin Pauline,O,Belgium,20.0,189,2022,Italy,2022-06-02,False,2,1,13,16,1,1,1,3,9,4,10,23,0,1,2,3,0,0,0,0,4,2,3,9
177099.0,Martin Pauline,O,Belgium,20.0,189,2022,Thailand,2022-06-04,True,0,0,0,0,0,0,0,0,0,0,0,0,0,0,0,0,0,0,0,0,0,0,0,0
177099.0,Martin Pauline,O,Belgium,20.0,189,2022,China,2022-06-15,False,0,1,5,6,0,0,2,2,11,4,8,23,0,0,1,1,0,0,0,0,5,2,0,7
177099.0,Martin Pauline,O,Belgium,20.0,189,2022,Canada,2022-06-16,False,0,1,0,1,0,0,0,0,2,3,0,5,2,1,1,4,1,0,0,1,1,0,0,1
177099.0,Martin Pauline,O,Belgium,20.0,189,2022,Poland,2022-06-18,True,0,0,0,0,0,0,0,0,0,0,0,0,0,0,0,0,0,0,0,0,0,0,0,0
177099.0,Martin Pauline,O,Belgium,20.0,189,2022,Bulgaria,2022-06-19,True,1,0,4,5,0,0,2,2,4,3,2,9,0,0,2,2,0,0,0,0,5,1,0,6
177099.0,Martin Pauline,O,Belgium,20.0,189,2022,Germany,2022-06-30,False,0,0,0,0,0,0,0,0,0,0,0,0,0,0,0,0,0,0,0,0,0,0,0,0
177099.0,Martin Pauline,O,Belgium,20.0,189,2022,Netherlands,2022-07-01,False,0,0,0,0,0,0,0,0,0,0,0,0,0,0,0,0,0,0,0,0,0,0,0,0
177099.0,Martin Pauline,O,Belgium,20.0,189,2022,Japan,2022-07-03,True,0,0,0,0,0,0,0,0,0,0,0,0,0,0,0,0,0,0,0,0,0,0,0,0
166072.0,Goris Stien,OH,Belgium,21.0,185,2022,Serbia,2022-06-01,False,0,0,0,0,0,0,0,0,0,0,0,0,0,0,0,0,0,0,0,0,0,0,0,0
166072.0,Goris Stien,OH,Belgium,21.0,185,2022,Italy,2022-06-02,False,0,0,0,0,0,0,0,0,0,0,0,0,0,0,0,0,0,0,0,0,0,0,0,0
166072.0,Goris Stien,OH,Belgium,21.0,185,2022,Thailand,2022-06-04,True,0,0,0,0,0,0,0,0,0,0,0,0,0,0,0,0,0,0,0,0,0,0,0,0
166072.0,Goris Stien,OH,Belgium,21.0,185,2022,China,2022-06-15,False,0,1,6,7,0,0,1,1,4,1,5,10,0,3,4,7,0,0,0,0,3,4,0,7
166072.0,Goris Stien,OH,Belgium,21.0,185,2022,Canada,2022-06-16,False,0,0,0,0,0,0,0,0,0,0,0,0,0,0,0,0,0,0,0,0,0,0,0,0
166072.0,Goris Stien,OH,Belgium,21.0,185,2022,Poland,2022-06-18,True,0,0,0,0,0,0,0,0,0,0,0,0,0,0,0,0,0,0,0,0,0,0,0,0
166072.0,Goris Stien,OH,Belgium,21.0,185,2022,Bulgaria,2022-06-19,True,0,0,0,0,0,0,0,0,0,0,0,0,0,0,0,0,0,0,0,0,0,0,0,0
160479.0,Krenicky Charlotte,S,Belgium,22.0,189,2022,Serbia,2022-06-01,False,0,0,0,0,2,0,2,4,1,0,0,1,0,0,0,0,0,0,0,0,0,0,0,0
160479.0,Krenicky Charlotte,S,Belgium,22.0,189,2022,Italy,2022-06-02,False,0,0,0,0,0,0,0,0,0,0,0,0,0,0,0,0,0,0,0,0,0,0,0,0
160479.0,Krenicky Charlotte,S,Belgium,22.0,189,2022,Thailand,2022-06-04,True,0,0,0,0,0,1,1,2,1,0,0,1,0,0,0,0,0,0,0,0,0,0,0,0
160479.0,Krenicky Charlotte,S,Belgium,22.0,189,2022,China,2022-06-15,False,0,0,6,6,11,2,45,58,1,0,0,1,0,0,0,0,0,0,0,0,10,0,1,11
160479.0,Krenicky Charlotte,S,Belgium,22.0,189,2022,Canada,2022-06-16,False,0,0,4,4,2,0,26,28,1,0,0,1,0,1,1,2,0,0,0,0,1,1,0,2
160479.0,Krenicky Charlotte,S,Belgium,22.0,189,2022,Poland,2022-06-18,True,0,0,9,9,13,0,66,79,1,0,0,1,0,4,3,7,0,0,0,0,9,2,1,12
160479.0,Krenicky Charlotte,S,Belgium,22.0,189,2022,Bulgaria,2022-06-19,True,1,2,6,9,10,1,47,58,1,0,1,2,1,1,6,8,0,0,0,0,6,2,2,10
160479.0,Krenicky Charlotte,S,Belgium,22.0,189,2022,Germany,2022-06-30,False,0,1,2,3,1,0,39,40,1,0,1,2,0,1,0,1,0,0,0,0,2,1,0,3
160479.0,Krenicky Charlotte,S,Belgium,22.0,189,2022,Netherlands,2022-07-01,False,0,0,1,1,0,0,13,13,0,0,1,1,0,0,0,0,0,0,0,0,0,2,0,2
160479.0,Krenicky Charlotte,S,Belgium,22.0,189,2022,Japan,2022-07-03,True,0,0,1,1,0,0,8,8,0,1,0,1,1,0,0,1,0,0,0,0,0,0,0,0
156325.0,Janssens Marlies,MB,Belgium,25.0,193,2022,Serbia,2022-06-01,False,1,1,11,13,0,0,3,3,10,0,14,24,6,1,3,10,0,0,1,1,1,1,1,3
156325.0,Janssens Marlies,MB,Belgium,25.0,193,2022,Italy,2022-06-02,False,0,0,0,0,0,0,0,0,0,0,0,0,0,0,0,0,0,0,0,0,0,0,0,0
156325.0,Janssens Marlies,MB,Belgium,25.0,193,2022,Thailand,2022-06-04,True,1,2,11,14,0,0,1,1,9,3,4,16,4,4,9,17,0,0,0,0,4,2,0,6
156325.0,Janssens Marlies,MB,Belgium,25.0,193,2022,China,2022-06-15,False,0,0,0,0,0,0,0,0,0,0,0,0,0,0,0,0,0,0,0,0,0,0,0,0
156325.0,Janssens Marlies,MB,Belgium,25.0,193,2022,Canada,2022-06-16,False,0,2,9,11,2,0,6,8,5,3,4,12,3,3,1,7,0,0,0,0,1,0,1,2
156325.0,Janssens Marlies,MB,Belgium,25.0,193,2022,Poland,2022-06-18,True,1,2,10,13,1,0,0,1,6,4,7,17,5,6,7,18,0,0,0,0,7,3,0,10
156325.0,Janssens Marlies,MB,Belgium,25.0,193,2022,Bulgaria,2022-06-19,True,1,5,10,16,0,0,0,0,8,0,8,16,1,2,5,8,0,0,0,0,5,0,0,5
156325.0,Janssens Marlies,MB,Belgium,25.0,193,2022,Germany,2022-06-30,False,2,2,10,14,0,0,3,3,6,1,6,13,3,2,1,6,0,0,1,1,3,0,0,3
156325.0,Janssens Marlies,MB,Belgium,25.0,193,2022,Netherlands,2022-07-01,False,1,2,8,11,0,0,2,2,8,1,8,17,4,3,6,13,0,0,0,0,2,0,0,2
156325.0,Janssens Marlies,MB,Belgium,25.0,193,2022,Japan,2022-07-03,True,0,3,10,13,0,0,2,2,7,2,16,25,4,7,3,14,0,0,0,0,3,0,0,3
160208.0,Van De Vyver Jutta,S,Belgium,26.0,173,2022,Serbia,2022-06-01,False,0,1,12,13,27,1,106,134,0,0,1,1,0,1,4,5,0,0,0,0,5,2,2,9
160208.0,Van De Vyver Jutta,S,Belgium,26.0,173,2022,Italy,2022-06-02,False,1,2,11,14,7,1,95,103,0,0,1,1,0,3,2,5,0,0,0,0,8,0,1,9
160208.0,Van De Vyver Jutta,S,Belgium,26.0,173,2022,Thailand,2022-06-04,True,1,2,19,22,43,2,93,138,2,0,2,4,0,2,2,4,0,0,1,1,11,2,4,17
160208.0,Van De Vyver Jutta,S,Belgium,26.0,173,2022,China,2022-06-15,False,0,0,3,3,6,1,21,28,0,0,0,0,0,2,0,2,0,0,0,0,0,2,1,3
160208.0,Van De Vyver Jutta,S,Belgium,26.0,173,2022,Canada,2022-06-16,False,0,2,12,14,4,2,57,63,0,0,1,1,1,0,0,1,0,0,0,0,9,3,3,15
160208.0,Van De Vyver Jutta,S,Belgium,26.0,173,2022,Poland,2022-06-18,True,0,0,4,4,8,0,47,55,0,0,2,2,0,1,0,1,0,0,0,0,5,3,0,8
160208.0,Van De Vyver Jutta,S,Belgium,26.0,173,2022,Bulgaria,2022-06-19,True,2,1,10,13,19,1,70,90,2,0,0,2,0,0,2,2,0,0,0,0,11,1,0,12
160208.0,Van De Vyver Jutta,S,Belgium,26.0,173,2022,Germany,2022-06-30,False,0,0,10,10,6,1,82,89,0,0,4,4,0,2,0,2,0,0,1,1,2,1,0,3
160208.0,Van De Vyver Jutta,S,Belgium,26.0,173,2022,Netherlands,2022-07-01,False,0,2,16,18,5,0,127,132,1,0,1,2,0,0,1,1,0,0,1,1,14,5,0,19
160208.0,Van De Vyver Jutta,S,Belgium,26.0,173,2022,Japan,2022-07-03,True,2,2,10,14,9,0,117,126,1,0,1,2,0,1,2,3,0,0,0,0,11,0,0,11
168160.0,Rampelberg Britt,L,Belgium,22.0,165,2022,Serbia,2022-06-01,False,0,0,0,0,0,0,3,3,0,0,0,0,0,0,0,0,3,0,11,14,7,1,0,8
168160.0,Rampelberg Britt,L,Belgium,22.0,165,2022,Italy,2022-06-02,False,0,0,0,0,0,0,5,5,0,0,0,0,0,0,0,0,6,1,17,24,9,4,2,15
168160.0,Rampelberg Britt,L,Belgium,22.0,165,2022,Thailand,2022-06-04,True,0,0,0,0,1,0,12,13,0,0,0,0,0,0,0,0,9,1,27,37,11,7,2,20
168160.0,Rampelberg Britt,L,Belgium,22.0,165,2022,China,2022-06-15,False,0,0,0,0,0,0,10,10,0,0,0,0,0,0,0,0,4,0,5,9,13,6,1,20
168160.0,Rampelberg Britt,L,Belgium,22.0,165,2022,Canada,2022-06-16,False,0,0,0,0,0,0,12,12,0,0,0,0,0,0,0,0,6,2,19,27,7,9,1,17
168160.0,Rampelberg Britt,L,Belgium,22.0,165,2022,Poland,2022-06-18,True,0,0,0,0,0,0,11,11,0,0,0,0,0,0,0,0,5,3,29,37,13,3,1,17
168160.0,Rampelberg Britt,L,Belgium,22.0,165,2022,Bulgaria,2022-06-19,True,0,0,0,0,0,1,6,7,0,0,0,0,0,0,0,0,3,0,14,17,7,1,1,9
168160.0,Rampelberg Britt,L,Belgium,22.0,165,2022,Germany,2022-06-30,False,0,0,0,0,0,0,9,9,0,0,0,0,0,0,0,0,14,2,26,42,14,3,1,18
168160.0,Rampelberg Britt,L,Belgium,22.0,165,2022,Netherlands,2022-07-01,False,0,0,0,0,0,0,7,7,0,0,0,0,0,0,0,0,4,0,4,8,14,1,0,15
168160.0,Rampelberg Britt,L,Belgium,22.0,165,2022,Japan,2022-07-03,True,0,0,0,0,0,0,5,5,0,0,0,0,0,0,1,1,9,0,7,16,15,2,0,17
152040.0,Van Avermaet Silke,MB,Belgium,23.0,192,2022,Serbia,2022-06-01,False,0,1,8,9,0,0,0,0,3,1,14,18,0,5,4,9,0,0,0,0,3,0,0,3
152040.0,Van Avermaet Silke,MB,Belgium,23.0,192,2022,Italy,2022-06-02,False,1,0,12,13,0,0,0,0,7,3,9,19,2,8,4,14,0,0,1,1,1,1,0,2
152040.0,Van Avermaet Silke,MB,Belgium,23.0,192,2022,Thailand,2022-06-04,True,3,1,15,19,1,0,2,3,11,3,8,22,2,1,6,9,0,0,0,0,6,1,4,11
152040.0,Van Avermaet Silke,MB,Belgium,23.0,192,2022,Poland,2022-06-18,True,1,1,2,4,0,0,0,0,4,0,3,7,0,3,5,8,0,0,0,0,1,0,0,1
152040.0,Van Avermaet Silke,MB,Belgium,23.0,192,2022,Bulgaria,2022-06-19,True,1,1,6,8,0,0,1,1,9,3,14,26,3,8,8,19,0,0,0,0,9,1,2,12
152040.0,Van Avermaet Silke,MB,Belgium,23.0,192,2022,Germany,2022-06-30,False,1,2,13,16,0,0,1,1,8,0,15,23,0,2,0,2,0,0,0,0,11,4,0,15
152040.0,Van Avermaet Silke,MB,Belgium,23.0,192,2022,Netherlands,2022-07-01,False,0,0,12,12,0,0,3,3,11,3,9,23,1,2,3,6,0,0,0,0,11,2,0,13
152040.0,Van Avermaet Silke,MB,Belgium,23.0,192,2022,Japan,2022-07-03,True,0,0,8,8,0,0,0,0,6,0,12,18,2,3,0,5,0,0,0,0,4,2,0,6
152057.0,Stragier Manon,OH,Belgium,24.0,182,2022,Serbia,2022-06-01,False,0,2,9,11,0,0,0,0,4,1,6,11,1,1,2,4,3,0,5,8,0,1,0,1
152057.0,Stragier Manon,OH,Belgium,24.0,182,2022,Italy,2022-06-02,False,0,1,1,2,0,0,1,1,0,0,0,0,0,0,0,0,0,1,0,1,0,0,0,0
152057.0,Stragier Manon,OH,Belgium,24.0,182,2022,Thailand,2022-06-04,True,1,1,4,6,0,0,1,1,0,1,1,2,0,1,2,3,0,0,2,2,5,2,1,8
152057.0,Stragier Manon,OH,Belgium,24.0,182,2022,Poland,2022-06-18,True,2,0,5,7,0,0,0,0,0,0,0,0,0,0,0,0,0,0,0,0,0,1,0,1
152057.0,Stragier Manon,OH,Belgium,24.0,182,2022,Bulgaria,2022-06-19,True,1,1,2,4,0,0,0,0,0,0,1,1,0,0,0,0,0,0,0,0,2,0,0,2
152057.0,Stragier Manon,OH,Belgium,24.0,182,2022,Germany,2022-06-30,False,1,0,1,2,0,0,0,0,0,0,0,0,0,0,0,0,0,0,0,0,0,0,0,0
152057.0,Stragier Manon,OH,Belgium,24.0,182,2022,Netherlands,2022-07-01,False,0,1,3,4,0,1,0,1,0,0,0,0,0,0,0,0,0,0,0,0,1,1,0,2
152057.0,Stragier Manon,OH,Belgium,24.0,182,2022,Japan,2022-07-03,True,3,1,13,17,0,0,1,1,7,0,9,16,2,2,2,6,17,3,11,31,9,3,0,12
170698.0,Koulberg Anna,MB,Belgium,18.0,188,2022,Serbia,2022-06-01,False,0,0,0,0,0,0,0,0,0,0,0,0,0,0,0,0,0,0,0,0,0,0,0,0
170698.0,Koulberg Anna,MB,Belgium,18.0,188,2022,Italy,2022-06-02,False,0,0,1,1,0,0,0,0,0,0,0,0,0,0,0,0,0,0,0,0,0,0,0,0
170698.0,Koulberg Anna,MB,Belgium,18.0,188,2022,Thailand,2022-06-04,True,0,0,0,0,0,0,0,0,0,0,0,0,0,0,0,0,0,0,0,0,0,0,0,0
170698.0,Koulberg Anna,MB,Belgium,18.0,188,2022,China,2022-06-15,False,0,1,8,9,0,0,0,0,6,2,3,11,0,1,2,3,0,0,1,1,1,2,0,3
170698.0,Koulberg Anna,MB,Belgium,18.0,188,2022,Canada,2022-06-16,False,0,0,0,0,0,0,0,0,0,0,0,0,0,0,1,1,0,0,0,0,0,0,0,0
170698.0,Koulberg Anna,MB,Belgium,18.0,188,2022,Poland,2022-06-18,True,0,0,0,0,0,0,0,0,0,0,0,0,0,0,0,0,0,0,0,0,0,0,0,0
170698.0,Koulberg Anna,MB,Belgium,18.0,188,2022,Bulgaria,2022-06-19,True,0,0,0,0,0,0,0,0,0,0,0,0,0,0,0,0,0,0,0,0,0,0,0,0
170698.0,Koulberg Anna,MB,Belgium,18.0,188,2022,Germany,2022-06-30,False,0,0,0,0,0,0,0,0,0,0,0,0,0,0,0,0,0,0,0,0,0,0,0,0
170698.0,Koulberg Anna,MB,Belgium,18.0,188,2022,Netherlands,2022-07-01,False,0,0,3,3,0,0,0,0,0,0,1,1,0,0,0,0,0,0,1,1,0,0,0,0
170698.0,Koulberg Anna,MB,Belgium,18.0,188,2022,Japan,2022-07-03,True,0,0,1,1,0,0,0,0,0,0,0,0,0,0,0,0,0,0,0,0,0,0,0,0
152119.0,Duarte Alecrim Diana,MB,Brazil,24.0,194,2022,Germany,2022-05-31,True,0,0,8,8,0,0,2,2,7,1,2,10,4,4,5,13,0,0,0,0,7,1,0,8
152119.0,Duarte Alecrim Diana,MB,Brazil,24.0,194,2022,Poland,2022-06-02,True,0,1,8,9,0,0,1,1,6,1,2,9,2,2,2,6,0,0,0,0,4,0,0,4
152119.0,Duarte Alecrim Diana,MB,Brazil,24.0,194,2022,Dominican Republic,2022-06-03,True,0,0,0,0,0,0,0,0,0,0,0,0,0,0,0,0,0,0,0,0,0,0,0,0
152119.0,Duarte Alecrim Diana,MB,Brazil,24.0,194,2022,Italy,2022-06-18,False,2,2,10,14,0,0,0,0,1,2,3,6,2,3,0,5,1,0,0,1,2,0,0,2
152119.0,Duarte Alecrim Diana,MB,Brazil,24.0,194,2022,Serbia,2022-06-19,True,0,0,9,9,0,0,0,0,2,1,4,7,3,2,6,11,0,0,0,0,2,0,0,2
173848.0,Gambatto Kudiess Julia,MB,Brazil,20.0,192,2022,Italy,2022-06-18,False,0,0,0,0,0,0,0,0,0,0,0,0,0,0,0,0,0,0,0,0,0,0,0,0
173848.0,Gambatto Kudiess Julia,MB,Brazil,20.0,192,2022,Serbia,2022-06-19,True,0,0,0,0,0,0,0,0,0,0,0,0,0,0,0,0,0,0,0,0,0,0,0,0
173848.0,Gambatto Kudiess Julia,MB,Brazil,20.0,192,2022,China,2022-06-28,True,0,1,7,8,1,0,1,2,5,2,3,10,1,6,5,12,0,0,0,0,3,0,1,4
173848.0,Gambatto Kudiess Julia,MB,Brazil,20.0,192,2022,Bulgaria,2022-07-01,True,0,1,9,10,0,0,2,2,8,1,0,9,3,2,1,6,0,0,0,0,3,0,0,3
173848.0,Gambatto Kudiess Julia,MB,Brazil,20.0,192,2022,Thailand,2022-07-02,True,0,0,12,12,0,0,0,0,10,1,6,17,2,4,2,8,0,0,0,0,3,2,1,6
173848.0,Gambatto Kudiess Julia,MB,Brazil,20.0,192,2022,Japan,2022-07-13,True,1,2,11,14,0,0,1,1,1,1,4,6,3,3,5,11,0,0,0,0,2,0,2,4
173848.0,Gambatto Kudiess Julia,MB,Brazil,20.0,192,2022,Serbia,2022-07-16,True,0,1,6,7,0,0,2,2,3,1,2,6,3,3,2,8,1,0,1,2,1,0,0,1
173848.0,Gambatto Kudiess Julia,MB,Brazil,20.0,192,2022,Italy,2022-07-17,False,0,0,6,6,0,0,1,1,1,0,4,5,0,2,3,5,0,0,0,0,0,0,0,0
144866.0,Da Silva Ana Carolina,MB,Brazil,31.0,183,2022,Germany,2022-05-31,True,1,1,21,23,0,0,4,4,9,3,4,16,6,3,6,15,0,0,0,0,5,0,1,6
144866.0,Da Silva Ana Carolina,MB,Brazil,31.0,183,2022,Poland,2022-06-02,True,3,2,7,12,0,0,2,2,5,1,2,8,7,8,4,19,0,0,0,0,2,1,0,3
144866.0,Da Silva Ana Carolina,MB,Brazil,31.0,183,2022,Dominican Republic,2022-06-03,True,0,1,11,12,0,0,1,1,5,3,7,15,6,7,8,21,0,0,0,0,3,0,0,3
144866.0,Da Silva Ana Carolina,MB,Brazil,31.0,183,2022,Italy,2022-06-18,False,1,1,11,13,0,0,1,1,6,3,2,11,2,6,4,12,1,0,1,2,2,0,0,2
144866.0,Da Silva Ana Carolina,MB,Brazil,31.0,183,2022,Serbia,2022-06-19,True,1,1,11,13,0,0,2,2,6,0,2,8,6,4,5,15,0,0,0,0,1,2,2,5
144866.0,Da Silva Ana Carolina,MB,Brazil,31.0,183,2022,China,2022-06-28,True,1,2,13,16,0,1,1,2,9,3,3,15,4,4,2,10,0,0,0,0,0,0,3,3
144866.0,Da Silva Ana Carolina,MB,Brazil,31.0,183,2022,Bulgaria,2022-07-01,True,1,1,16,18,0,0,2,2,5,0,4,9,2,4,4,10,0,0,0,0,1,0,1,2
144866.0,Da Silva Ana Carolina,MB,Brazil,31.0,183,2022,Thailand,2022-07-02,True,0,1,15,16,0,0,0,0,12,2,5,19,4,8,2,14,0,0,0,0,1,0,0,1
144866.0,Da Silva Ana Carolina,MB,Brazil,31.0,183,2022,Japan,2022-07-13,True,0,1,13,14,0,0,4,4,6,1,9,16,4,6,13,23,0,0,0,0,3,0,2,5
144866.0,Da Silva Ana Carolina,MB,Brazil,31.0,183,2022,Serbia,2022-07-16,True,0,1,17,18,0,0,3,3,7,2,2,11,6,10,10,26,0,0,0,0,2,1,1,4
144866.0,Da Silva Ana Carolina,MB,Brazil,31.0,183,2022,Italy,2022-07-17,False,1,1,10,12,0,0,1,1,6,0,2,8,1,6,4,11,0,0,0,0,0,1,1,2
115970.0,Zalewski Daroit Priscila,OH,Brazil,34.0,184,2022,Germany,2022-05-31,True,1,2,20,23,0,0,2,2,11,3,16,30,1,4,3,8,6,1,3,10,9,5,0,14
115970.0,Zalewski Daroit Priscila,OH,Brazil,34.0,184,2022,Poland,2022-06-02,True,0,0,12,12,0,0,0,0,5,4,10,19,0,1,3,4,11,1,16,28,7,2,0,9
115970.0,Zalewski Daroit Priscila,OH,Brazil,34.0,184,2022,Dominican Republic,2022-06-03,True,0,0,14,14,0,0,0,0,8,0,10,18,0,0,1,1,7,3,1,11,5,2,0,7
115970.0,Zalewski Daroit Priscila,OH,Brazil,34.0,184,2022,Italy,2022-06-18,False,2,0,2,4,0,0,0,0,2,3,2,7,0,0,0,0,1,0,2,3,1,0,0,1
115970.0,Zalewski Daroit Priscila,OH,Brazil,34.0,184,2022,Serbia,2022-06-19,True,0,0,7,7,0,0,0,0,9,3,14,26,5,3,7,15,13,0,13,26,8,1,1,10
115970.0,Zalewski Daroit Priscila,OH,Brazil,34.0,184,2022,China,2022-06-28,True,0,0,11,11,0,0,5,5,8,6,5,19,1,1,1,3,4,1,19,24,7,2,5,14
115970.0,Zalewski Daroit Priscila,OH,Brazil,34.0,184,2022,Bulgaria,2022-07-01,True,0,3,3,6,0,0,1,1,5,5,7,17,2,3,2,7,4,1,21,26,7,2,0,9
115970.0,Zalewski Daroit Priscila,OH,Brazil,34.0,184,2022,Thailand,2022-07-02,True,0,0,0,0,0,0,0,0,0,0,0,0,0,0,0,0,0,0,0,0,0,0,0,0
115970.0,Zalewski Daroit Priscila,OH,Brazil,34.0,184,2022,Japan,2022-07-13,True,0,0,0,0,0,0,0,0,0,0,0,0,0,0,0,0,0,0,0,0,0,0,0,0
115970.0,Zalewski Daroit Priscila,OH,Brazil,34.0,184,2022,Serbia,2022-07-16,True,0,0,0,0,0,0,0,0,0,0,0,0,0,0,0,0,0,0,0,0,0,0,0,0
115970.0,Zalewski Daroit Priscila,OH,Brazil,34.0,184,2022,Italy,2022-07-17,False,0,0,5,5,0,0,0,0,1,1,1,3,0,0,0,0,4,1,7,12,1,1,1,3
152135.0,Alexandre Costa Nunes Nyeme Victoria,L,Brazil,24.0,175,2022,Germany,2022-05-31,True,0,0,0,0,0,0,18,18,0,0,0,0,0,0,0,0,10,2,5,17,25,4,2,31
152135.0,Alexandre Costa Nunes Nyeme Victoria,L,Brazil,24.0,175,2022,Poland,2022-06-02,True,0,0,0,0,0,0,10,10,0,0,0,0,0,0,0,0,12,0,5,17,9,4,0,13
152135.0,Alexandre Costa Nunes Nyeme Victoria,L,Brazil,24.0,175,2022,Dominican Republic,2022-06-03,True,0,0,0,0,0,0,7,7,0,0,0,0,0,0,0,0,17,1,1,19,21,5,1,27
152135.0,Alexandre Costa Nunes Nyeme Victoria,L,Brazil,24.0,175,2022,Italy,2022-06-18,False,0,0,0,0,0,0,5,5,0,0,0,0,0,0,0,0,11,0,16,27,6,5,1,12
152135.0,Alexandre Costa Nunes Nyeme Victoria,L,Brazil,24.0,175,2022,Serbia,2022-06-19,True,0,0,0,0,0,0,7,7,0,0,0,0,0,0,0,0,10,0,4,14,15,1,1,17
152135.0,Alexandre Costa Nunes Nyeme Victoria,L,Brazil,24.0,175,2022,China,2022-06-28,True,0,0,0,0,0,0,0,0,0,0,0,0,0,0,0,0,0,0,0,0,0,0,0,0
152135.0,Alexandre Costa Nunes Nyeme Victoria,L,Brazil,24.0,175,2022,Bulgaria,2022-07-01,True,0,0,0,0,0,0,0,0,0,0,0,0,0,0,0,0,0,0,0,0,0,0,1,1
152135.0,Alexandre Costa Nunes Nyeme Victoria,L,Brazil,24.0,175,2022,Thailand,2022-07-02,True,0,0,0,0,0,0,0,0,0,0,0,0,0,0,0,0,0,0,0,0,0,0,0,0
152135.0,Alexandre Costa Nunes Nyeme Victoria,L,Brazil,24.0,175,2022,Japan,2022-07-13,True,0,0,0,0,0,0,0,0,0,0,0,0,0,0,0,0,0,0,0,0,0,0,0,0
152135.0,Alexandre Costa Nunes Nyeme Victoria,L,Brazil,24.0,175,2022,Serbia,2022-07-16,True,0,0,0,0,0,0,6,6,0,0,0,0,0,0,0,0,4,1,6,11,5,1,4,10
152135.0,Alexandre Costa Nunes Nyeme Victoria,L,Brazil,24.0,175,2022,Italy,2022-07-17,False,0,0,0,0,0,0,2,2,0,0,0,0,0,0,0,0,13,1,18,32,10,3,6,19
136897.0,Montibeller Rosamaria,OH,Brazil,28.0,185,2022,Italy,2022-06-18,False,0,0,2,2,0,0,0,0,1,1,3,5,0,0,0,0,0,0,0,0,1,0,0,1
136897.0,Montibeller Rosamaria,OH,Brazil,28.0,185,2022,Serbia,2022-06-19,True,0,0,0,0,0,0,0,0,0,0,4,4,0,0,1,1,0,0,0,0,0,0,0,0
136897.0,Montibeller Rosamaria,OH,Brazil,28.0,185,2022,China,2022-06-28,True,0,0,3,3,0,0,0,0,0,0,0,0,0,0,0,0,0,0,0,0,0,1,0,1
136897.0,Montibeller Rosamaria,OH,Brazil,28.0,185,2022,Bulgaria,2022-07-01,True,0,0,0,0,0,0,0,0,0,0,0,0,0,0,0,0,0,0,0,0,0,0,0,0
136897.0,Montibeller Rosamaria,OH,Brazil,28.0,185,2022,Thailand,2022-07-02,True,0,0,1,1,0,0,0,0,0,0,0,0,0,0,0,0,0,0,0,0,0,0,0,0
136897.0,Montibeller Rosamaria,OH,Brazil,28.0,185,2022,Japan,2022-07-13,True,1,0,10,11,0,0,1,1,0,0,0,0,0,0,0,0,0,0,0,0,1,0,0,1
136897.0,Montibeller Rosamaria,OH,Brazil,28.0,185,2022,Serbia,2022-07-16,True,0,2,0,2,0,0,0,0,0,0,0,0,0,0,0,0,0,0,0,0,0,0,0,0
136897.0,Montibeller Rosamaria,OH,Brazil,28.0,185,2022,Italy,2022-07-17,False,0,0,2,2,0,0,0,0,0,0,0,0,0,0,0,0,0,0,0,0,0,1,0,1
151187.0,Silva Carneiro Macris Fernanda,S,Brazil,34.0,178,2022,Germany,2022-05-31,True,0,1,13,14,23,0,95,118,1,0,0,1,0,0,0,0,0,0,1,1,17,1,0,18
151187.0,Silva Carneiro Macris Fernanda,S,Brazil,34.0,178,2022,Poland,2022-06-02,True,1,1,13,15,12,0,52,64,0,1,0,1,0,1,0,1,0,0,0,0,7,1,0,8
151187.0,Silva Carneiro Macris Fernanda,S,Brazil,34.0,178,2022,Dominican Republic,2022-06-03,True,1,1,8,10,26,1,61,88,0,0,2,2,0,3,1,4,0,0,0,0,8,1,0,9
151187.0,Silva Carneiro Macris Fernanda,S,Brazil,34.0,178,2022,Italy,2022-06-18,False,0,1,6,7,26,1,54,81,0,1,0,1,1,2,1,4,0,0,1,1,1,2,0,3
151187.0,Silva Carneiro Macris Fernanda,S,Brazil,34.0,178,2022,Serbia,2022-06-19,True,0,2,9,11,20,0,65,85,0,0,1,1,0,3,5,8,0,0,0,0,2,2,0,4
151187.0,Silva Carneiro Macris Fernanda,S,Brazil,34.0,178,2022,China,2022-06-28,True,0,3,17,20,36,1,76,113,1,0,4,5,0,1,1,2,0,0,0,0,4,2,2,8
151187.0,Silva Carneiro Macris Fernanda,S,Brazil,34.0,178,2022,Bulgaria,2022-07-01,True,0,1,11,12,4,0,65,69,2,0,0,2,2,3,2,7,0,1,0,1,4,0,1,5
151187.0,Silva Carneiro Macris Fernanda,S,Brazil,34.0,178,2022,Thailand,2022-07-02,True,0,0,8,8,5,2,73,80,0,0,0,0,0,0,1,1,0,0,0,0,2,0,0,2
151187.0,Silva Carneiro Macris Fernanda,S,Brazil,34.0,178,2022,Japan,2022-07-13,True,0,0,13,13,31,3,68,102,2,0,1,3,2,4,5,11,0,0,0,0,8,3,1,12
151187.0,Silva Carneiro Macris Fernanda,S,Brazil,34.0,178,2022,Serbia,2022-07-16,True,0,0,12,12,24,0,69,93,1,0,2,3,0,4,3,7,0,0,0,0,7,4,4,15
151187.0,Silva Carneiro Macris Fernanda,S,Brazil,34.0,178,2022,Italy,2022-07-17,False,0,0,7,7,13,0,55,68,1,0,0,1,1,0,1,2,0,0,0,0,1,2,1,4
119575.0,Ratzke Roberta Silva,S,Brazil,32.0,185,2022,Germany,2022-05-31,True,0,0,1,1,1,0,9,10,0,0,1,1,0,0,0,0,0,0,0,0,0,0,0,0
119575.0,Ratzke Roberta Silva,S,Brazil,32.0,185,2022,Poland,2022-06-02,True,0,0,0,0,0,0,3,3,0,0,0,0,0,0,0,0,0,0,0,0,0,0,0,0
119575.0,Ratzke Roberta Silva,S,Brazil,32.0,185,2022,Dominican Republic,2022-06-03,True,0,0,3,3,2,0,7,9,0,0,0,0,0,0,0,0,0,0,0,0,0,0,0,0
119575.0,Ratzke Roberta Silva,S,Brazil,32.0,185,2022,Italy,2022-06-18,False,0,0,1,1,5,0,9,14,0,0,0,0,0,0,0,0,0,0,0,0,1,1,0,2
119575.0,Ratzke Roberta Silva,S,Brazil,32.0,185,2022,Serbia,2022-06-19,True,0,0,2,2,2,0,4,6,0,0,0,0,0,0,0,0,0,0,0,0,0,0,0,0
119575.0,Ratzke Roberta Silva,S,Brazil,32.0,185,2022,China,2022-06-28,True,0,0,5,5,5,0,12,17,0,0,0,0,0,0,1,1,0,0,0,0,2,0,0,2
119575.0,Ratzke Roberta Silva,S,Brazil,32.0,185,2022,Bulgaria,2022-07-01,True,0,0,3,3,1,0,4,5,0,0,0,0,0,0,0,0,0,0,0,0,1,0,0,1
119575.0,Ratzke Roberta Silva,S,Brazil,32.0,185,2022,Thailand,2022-07-02,True,0,1,7,8,5,0,45,50,0,0,0,0,0,1,3,4,0,0,0,0,2,0,1,3
119575.0,Ratzke Roberta Silva,S,Brazil,32.0,185,2022,Japan,2022-07-13,True,0,0,5,5,5,0,9,14,0,0,1,1,0,0,0,0,0,0,0,0,0,1,0,1
119575.0,Ratzke Roberta Silva,S,Brazil,32.0,185,2022,Serbia,2022-07-16,True,0,0,5,5,3,0,10,13,0,0,0,0,0,0,0,0,0,0,0,0,1,1,0,2
119575.0,Ratzke Roberta Silva,S,Brazil,32.0,185,2022,Italy,2022-07-17,False,0,1,4,5,2,0,19,21,0,0,0,0,0,0,0,0,0,0,0,0,2,0,0,2
136896.0,Braga Guimaraes Gabriela,OH,Brazil,28.0,180,2022,Italy,2022-06-18,False,0,2,8,10,0,0,1,1,8,6,10,24,0,2,2,4,10,1,10,21,4,0,1,5
136896.0,Braga Guimaraes Gabriela,OH,Brazil,28.0,180,2022,Serbia,2022-06-19,True,0,1,23,24,0,0,1,1,14,7,14,35,0,0,3,3,4,0,2,6,7,1,1,9
136896.0,Braga Guimaraes Gabriela,OH,Brazil,28.0,180,2022,China,2022-06-28,True,1,0,21,22,0,0,2,2,25,9,21,55,2,3,2,7,13,1,32,46,9,2,3,14
136896.0,Braga Guimaraes Gabriela,OH,Brazil,28.0,180,2022,Bulgaria,2022-07-01,True,0,1,8,9,0,0,0,0,12,4,11,27,0,2,1,3,3,2,12,17,6,1,0,7
136896.0,Braga Guimaraes Gabriela,OH,Brazil,28.0,180,2022,Thailand,2022-07-02,True,0,1,21,22,0,0,1,1,14,4,16,34,0,7,1,8,13,0,23,36,8,6,4,18
136896.0,Braga Guimaraes Gabriela,OH,Brazil,28.0,180,2022,Japan,2022-07-13,True,0,1,18,19,0,0,4,4,22,5,20,47,1,2,3,6,11,1,23,35,12,2,2,16
136896.0,Braga Guimaraes Gabriela,OH,Brazil,28.0,180,2022,Serbia,2022-07-16,True,0,0,17,17,0,0,3,3,15,5,10,30,0,1,6,7,4,0,8,12,7,6,3,16
136896.0,Braga Guimaraes Gabriela,OH,Brazil,28.0,180,2022,Italy,2022-07-17,False,1,0,11,12,0,0,2,2,9,7,10,26,1,0,2,3,3,0,3,6,9,2,1,12
152128.0,Barbosa De Souza Karina,OH,Brazil,24.0,182,2022,Germany,2022-05-31,True,0,0,4,4,0,0,0,0,0,0,0,0,0,0,0,0,0,0,0,0,0,1,0,1
152128.0,Barbosa De Souza Karina,OH,Brazil,24.0,182,2022,Poland,2022-06-02,True,1,0,9,10,0,0,2,2,1,0,0,1,0,0,0,0,0,0,0,0,1,0,0,1
152128.0,Barbosa De Souza Karina,OH,Brazil,24.0,182,2022,Dominican Republic,2022-06-03,True,0,0,7,7,0,0,0,0,0,0,0,0,0,0,0,0,0,0,0,0,2,0,0,2
173849.0,Menezes Oliveira de Souza Ana Cristina,OH,Brazil,18.0,192,2022,Germany,2022-05-31,True,0,1,0,1,0,0,0,0,2,0,2,4,0,0,0,0,0,0,0,0,0,0,0,0
173849.0,Menezes Oliveira de Souza Ana Cristina,OH,Brazil,18.0,192,2022,Poland,2022-06-02,True,0,0,0,0,0,0,0,0,0,0,0,0,0,0,0,0,0,0,0,0,0,0,0,0
173849.0,Menezes Oliveira de Souza Ana Cristina,OH,Brazil,18.0,192,2022,Dominican Republic,2022-06-03,True,1,0,6,7,0,0,0,0,3,4,2,9,0,0,0,0,3,1,2,6,2,1,0,3
173849.0,Menezes Oliveira de Souza Ana Cristina,OH,Brazil,18.0,192,2022,Italy,2022-06-18,False,0,0,1,1,0,1,1,2,2,2,0,4,0,0,0,0,0,0,0,0,0,0,1,1
173849.0,Menezes Oliveira de Souza Ana Cristina,OH,Brazil,18.0,192,2022,Serbia,2022-06-19,True,0,0,0,0,0,0,0,0,0,0,0,0,0,0,0,0,0,0,0,0,0,0,0,0
173849.0,Menezes Oliveira de Souza Ana Cristina,OH,Brazil,18.0,192,2022,Japan,2022-07-13,True,0,0,0,0,0,0,0,0,0,0,0,0,0,0,0,0,0,0,0,0,0,0,0,0
173849.0,Menezes Oliveira de Souza Ana Cristina,OH,Brazil,18.0,192,2022,Serbia,2022-07-16,True,0,0,0,0,0,0,0,0,0,0,0,0,0,0,0,0,0,0,0,0,0,0,0,0
173849.0,Menezes Oliveira de Souza Ana Cristina,OH,Brazil,18.0,192,2022,Italy,2022-07-17,False,0,0,1,1,0,0,1,1,6,1,4,11,0,1,1,2,0,0,0,0,1,0,0,1
164674.0,Araujo Natália,L,Brazil,25.0,162,2022,Germany,2022-05-31,True,0,0,0,0,0,0,0,0,0,0,0,0,0,0,0,0,0,0,0,0,0,0,0,0
164674.0,Araujo Natália,L,Brazil,25.0,162,2022,Poland,2022-06-02,True,0,0,0,0,0,0,0,0,0,0,0,0,0,0,0,0,0,0,0,0,0,0,0,0
164674.0,Araujo Natália,L,Brazil,25.0,162,2022,Dominican Republic,2022-06-03,True,0,0,0,0,0,0,0,0,0,0,0,0,0,0,0,0,0,0,0,0,0,0,0,0
164674.0,Araujo Natália,L,Brazil,25.0,162,2022,Italy,2022-06-18,False,0,0,0,0,0,0,0,0,0,0,0,0,0,0,0,0,0,0,0,0,0,0,0,0
164674.0,Araujo Natália,L,Brazil,25.0,162,2022,Serbia,2022-06-19,True,0,0,0,0,0,0,0,0,0,0,0,0,0,0,0,0,0,0,0,0,0,0,0,0
164674.0,Araujo Natália,L,Brazil,25.0,162,2022,China,2022-06-28,True,0,0,0,0,2,0,11,13,0,0,0,0,0,0,0,0,4,0,12,16,17,2,2,21
164674.0,Araujo Natália,L,Brazil,25.0,162,2022,Bulgaria,2022-07-01,True,0,0,0,0,0,0,3,3,0,0,0,0,0,0,0,0,1,0,6,7,8,1,0,9
164674.0,Araujo Natália,L,Brazil,25.0,162,2022,Thailand,2022-07-02,True,0,0,0,0,0,0,4,4,0,0,0,0,0,0,0,0,7,3,9,19,13,3,1,17
164674.0,Araujo Natália,L,Brazil,25.0,162,2022,Japan,2022-07-13,True,0,0,0,0,0,0,8,8,0,0,0,0,0,0,0,0,4,1,12,17,17,7,3,27
164674.0,Araujo Natália,L,Brazil,25.0,162,2022,Serbia,2022-07-16,True,0,0,0,0,0,0,7,7,0,0,0,0,0,0,0,0,3,2,6,11,4,7,2,13
164674.0,Araujo Natália,L,Brazil,25.0,162,2022,Italy,2022-07-17,False,0,0,0,0,0,0,0,0,0,0,0,0,0,0,0,0,0,0,0,0,1,0,0,1
152130.0,Viezel Lorena Giovana,MB,Brazil,23.0,190,2022,Germany,2022-05-31,True,0,0,0,0,0,0,0,0,0,0,0,0,0,0,0,0,0,0,0,0,0,0,0,0
152130.0,Viezel Lorena Giovana,MB,Brazil,23.0,190,2022,Poland,2022-06-02,True,0,0,0,0,0,0,0,0,0,0,0,0,0,0,0,0,0,0,0,0,0,0,0,0
152130.0,Viezel Lorena Giovana,MB,Brazil,23.0,190,2022,Dominican Republic,2022-06-03,True,1,0,6,7,0,0,0,0,4,0,5,9,2,4,3,9,0,0,0,0,1,0,0,1
152130.0,Viezel Lorena Giovana,MB,Brazil,23.0,190,2022,Italy,2022-06-18,False,0,0,4,4,0,0,0,0,0,1,1,2,0,1,1,2,0,0,0,0,0,0,0,0
152130.0,Viezel Lorena Giovana,MB,Brazil,23.0,190,2022,Serbia,2022-06-19,True,0,0,0,0,0,0,0,0,0,0,0,0,0,0,0,0,0,0,0,0,0,0,0,0
152130.0,Viezel Lorena Giovana,MB,Brazil,23.0,190,2022,China,2022-06-28,True,0,0,0,0,0,0,0,0,0,0,0,0,0,0,0,0,0,0,0,0,0,0,0,0
152130.0,Viezel Lorena Giovana,MB,Brazil,23.0,190,2022,Bulgaria,2022-07-01,True,0,0,0,0,0,0,0,0,0,0,0,0,0,0,0,0,0,0,0,0,0,0,0,0
152130.0,Viezel Lorena Giovana,MB,Brazil,23.0,190,2022,Thailand,2022-07-02,True,0,0,0,0,0,0,0,0,0,0,0,0,0,0,0,0,0,0,0,0,0,0,0,0
152130.0,Viezel Lorena Giovana,MB,Brazil,23.0,190,2022,Japan,2022-07-13,True,0,0,0,0,0,0,0,0,0,0,0,0,0,0,0,0,0,0,0,0,0,0,0,0
152130.0,Viezel Lorena Giovana,MB,Brazil,23.0,190,2022,Serbia,2022-07-16,True,0,0,0,0,0,0,0,0,0,0,0,0,0,0,0,0,0,0,0,0,0,0,0,0
152130.0,Viezel Lorena Giovana,MB,Brazil,23.0,190,2022,Italy,2022-07-17,False,0,0,2,2,0,0,0,0,1,0,0,1,0,0,0,0,0,0,1,1,0,0,0,0
171260.0,Nascimento Kisy,O,Brazil,23.0,191,2022,Germany,2022-05-31,True,0,1,4,5,0,0,2,2,9,1,13,23,1,0,0,1,0,0,0,0,4,0,0,4
171260.0,Nascimento Kisy,O,Brazil,23.0,191,2022,Poland,2022-06-02,True,0,0,0,0,0,0,0,0,1,1,0,2,0,0,0,0,0,0,0,0,0,0,0,0
171260.0,Nascimento Kisy,O,Brazil,23.0,191,2022,Dominican Republic,2022-06-03,True,1,1,11,13,0,0,4,4,18,5,12,35,1,1,2,4,0,0,0,0,9,2,0,11
171260.0,Nascimento Kisy,O,Brazil,23.0,191,2022,Italy,2022-06-18,False,0,2,5,7,0,0,0,0,12,4,6,22,0,3,0,3,0,0,0,0,3,0,0,3
171260.0,Nascimento Kisy,O,Brazil,23.0,191,2022,Serbia,2022-06-19,True,0,0,7,7,0,0,1,1,9,4,11,24,5,2,6,13,1,0,1,2,10,0,1,11
171260.0,Nascimento Kisy,O,Brazil,23.0,191,2022,China,2022-06-28,True,0,4,8,12,0,0,4,4,22,5,24,51,3,4,4,11,0,0,0,0,8,3,6,17
171260.0,Nascimento Kisy,O,Brazil,23.0,191,2022,Bulgaria,2022-07-01,True,1,1,7,9,1,0,1,2,5,3,9,17,2,2,4,8,0,0,0,0,3,2,1,6
171260.0,Nascimento Kisy,O,Brazil,23.0,191,2022,Thailand,2022-07-02,True,0,1,12,13,0,0,0,0,9,4,14,27,2,5,1,8,0,0,0,0,9,1,0,10
171260.0,Nascimento Kisy,O,Brazil,23.0,191,2022,Japan,2022-07-13,True,0,3,5,8,0,0,1,1,16,4,16,36,4,3,1,8,0,0,1,1,4,4,2,10
171260.0,Nascimento Kisy,O,Brazil,23.0,191,2022,Serbia,2022-07-16,True,1,0,11,12,0,0,1,1,17,5,16,38,1,0,2,3,0,0,0,0,9,1,2,12
171260.0,Nascimento Kisy,O,Brazil,23.0,191,2022,Italy,2022-07-17,False,1,0,7,8,0,0,0,0,12,4,11,27,1,6,1,8,0,0,0,0,2,5,0,7
162999.0,Bergmann Julia Isabelle,OH,Brazil,22.0,191,2022,Germany,2022-05-31,True,0,1,11,12,0,0,0,0,18,8,22,48,1,4,2,7,37,2,21,60,10,3,0,13
162999.0,Bergmann Julia Isabelle,OH,Brazil,22.0,191,2022,Poland,2022-06-02,True,0,0,8,8,0,0,2,2,8,1,13,22,0,1,2,3,5,1,4,10,3,0,2,5
162999.0,Bergmann Julia Isabelle,OH,Brazil,22.0,191,2022,Dominican Republic,2022-06-03,True,2,1,13,16,0,0,1,1,10,4,15,29,1,3,0,4,18,0,5,23,14,4,0,18
162999.0,Bergmann Julia Isabelle,OH,Brazil,22.0,191,2022,Italy,2022-06-18,False,0,3,6,9,0,0,0,0,8,3,4,15,0,1,1,2,9,0,12,21,2,0,2,4
162999.0,Bergmann Julia Isabelle,OH,Brazil,22.0,191,2022,Serbia,2022-06-19,True,0,0,0,0,0,0,0,0,0,0,0,0,0,0,0,0,0,0,0,0,0,0,0,0
162999.0,Bergmann Julia Isabelle,OH,Brazil,22.0,191,2022,China,2022-06-28,True,1,2,3,6,0,0,1,1,2,1,1,4,0,0,1,1,1,1,11,13,3,0,3,6
162999.0,Bergmann Julia Isabelle,OH,Brazil,22.0,191,2022,Bulgaria,2022-07-01,True,1,1,3,5,0,0,0,0,3,1,1,5,0,0,0,0,0,0,3,3,1,0,0,1
162999.0,Bergmann Julia Isabelle,OH,Brazil,22.0,191,2022,Thailand,2022-07-02,True,1,0,17,18,0,0,0,0,15,6,19,40,1,1,1,3,4,1,20,25,11,2,2,15
162999.0,Bergmann Julia Isabelle,OH,Brazil,22.0,191,2022,Japan,2022-07-13,True,1,2,13,16,0,0,0,0,14,4,12,30,2,1,1,4,5,3,22,30,12,3,1,16
162999.0,Bergmann Julia Isabelle,OH,Brazil,22.0,191,2022,Serbia,2022-07-16,True,1,1,13,15,0,0,2,2,15,6,15,36,0,4,1,5,18,2,25,45,7,4,1,12
162999.0,Bergmann Julia Isabelle,OH,Brazil,22.0,191,2022,Italy,2022-07-17,False,0,1,7,8,0,0,0,0,3,4,6,13,0,1,1,2,8,0,5,13,5,3,0,8
164673.0,Araujo De Souza Mayany Cristina,MB,Brazil,26.0,185,2022,Germany,2022-05-31,True,0,0,0,0,0,0,0,0,0,0,0,0,0,0,0,0,0,0,0,0,0,0,0,0
164673.0,Araujo De Souza Mayany Cristina,MB,Brazil,26.0,185,2022,Poland,2022-06-02,True,0,0,0,0,0,0,0,0,0,0,0,0,0,0,0,0,0,0,0,0,0,0,0,0
164673.0,Araujo De Souza Mayany Cristina,MB,Brazil,26.0,185,2022,Dominican Republic,2022-06-03,True,0,0,0,0,0,0,0,0,0,0,0,0,0,0,0,0,0,0,0,0,0,0,0,0
164673.0,Araujo De Souza Mayany Cristina,MB,Brazil,26.0,185,2022,China,2022-06-28,True,0,0,0,0,0,0,0,0,0,0,0,0,0,0,0,0,0,0,0,0,0,0,0,0
164673.0,Araujo De Souza Mayany Cristina,MB,Brazil,26.0,185,2022,Bulgaria,2022-07-01,True,0,0,0,0,0,0,0,0,0,0,0,0,0,0,0,0,0,0,0,0,0,0,0,0
164673.0,Araujo De Souza Mayany Cristina,MB,Brazil,26.0,185,2022,Thailand,2022-07-02,True,0,0,0,0,0,0,0,0,0,0,0,0,0,0,0,0,0,0,0,0,0,0,0,0
152125.0,Da Silva Lorrayna,O,Brazil,23.0,185,2022,China,2022-06-28,True,0,0,0,0,0,0,0,0,0,0,2,2,0,0,0,0,0,0,0,0,0,0,0,0
152125.0,Da Silva Lorrayna,O,Brazil,23.0,185,2022,Bulgaria,2022-07-01,True,0,1,0,1,0,0,0,0,0,0,1,1,0,0,0,0,0,0,0,0,0,0,0,0
152125.0,Da Silva Lorrayna,O,Brazil,23.0,185,2022,Thailand,2022-07-02,True,0,0,0,0,0,0,0,0,0,0,0,0,0,0,0,0,0,0,0,0,0,0,0,0
141658.0,Geraldo Teixeira Lorenne,O,Brazil,27.0,187,2022,Germany,2022-05-31,True,1,0,10,11,0,0,1,1,7,4,15,26,0,1,0,1,0,0,0,0,2,3,0,5
141658.0,Geraldo Teixeira Lorenne,O,Brazil,27.0,187,2022,Poland,2022-06-02,True,0,1,7,8,0,0,0,0,6,1,17,24,3,0,1,4,0,0,0,0,5,3,0,8
141658.0,Geraldo Teixeira Lorenne,O,Brazil,27.0,187,2022,Dominican Republic,2022-06-03,True,0,0,1,1,0,0,0,0,0,0,3,3,0,0,0,0,0,0,0,0,0,0,1,1
141658.0,Geraldo Teixeira Lorenne,O,Brazil,27.0,187,2022,Japan,2022-07-13,True,0,0,1,1,0,1,0,1,3,0,4,7,0,2,0,2,0,0,0,0,0,0,0,0
141658.0,Geraldo Teixeira Lorenne,O,Brazil,27.0,187,2022,Serbia,2022-07-16,True,0,0,1,1,0,0,0,0,1,3,2,6,0,1,0,1,0,0,0,0,1,1,0,2
141658.0,Geraldo Teixeira Lorenne,O,Brazil,27.0,187,2022,Italy,2022-07-17,False,0,0,0,0,0,0,0,0,1,1,3,5,0,1,1,2,0,0,0,0,0,0,0,0
142341.0,Dimitrova Gergana,OH,Bulgaria,27.0,184,2022,Thailand,2022-05-31,False,0,0,6,6,0,0,2,2,12,1,8,21,1,1,3,5,5,0,18,23,7,4,2,13
142341.0,Dimitrova Gergana,OH,Bulgaria,27.0,184,2022,Netherlands,2022-06-02,True,1,1,16,18,0,0,2,2,17,1,27,45,2,1,3,6,9,2,28,39,19,5,1,25
142341.0,Dimitrova Gergana,OH,Bulgaria,27.0,184,2022,Serbia,2022-06-03,False,1,0,10,11,0,0,1,1,7,8,12,27,1,2,1,4,2,1,13,16,6,3,0,9
124202.0,Dimitrova Nasya,MB,Bulgaria,30.0,190,2022,Thailand,2022-05-31,False,0,1,10,11,0,0,1,1,9,2,4,15,1,5,3,9,0,0,0,0,1,3,0,4
124202.0,Dimitrova Nasya,MB,Bulgaria,30.0,190,2022,Netherlands,2022-06-02,True,0,1,10,11,0,0,2,2,10,4,5,19,4,6,12,22,0,0,1,1,4,1,1,6
124202.0,Dimitrova Nasya,MB,Bulgaria,30.0,190,2022,Serbia,2022-06-03,False,1,0,6,7,0,0,0,0,6,2,6,14,0,5,3,8,1,1,2,4,2,1,3,6
124202.0,Dimitrova Nasya,MB,Bulgaria,30.0,190,2022,USA,2022-06-15,False,1,1,7,9,0,0,0,0,3,0,7,10,1,3,0,4,0,2,0,2,1,0,0,1
124202.0,Dimitrova Nasya,MB,Bulgaria,30.0,190,2022,Japan,2022-06-16,False,0,0,1,1,1,0,1,2,1,1,2,4,1,2,0,3,0,0,1,1,1,0,0,1
124202.0,Dimitrova Nasya,MB,Bulgaria,30.0,190,2022,Canada,2022-06-18,True,0,1,11,12,0,0,1,1,8,0,2,10,3,4,13,20,0,1,0,1,3,0,0,3
124202.0,Dimitrova Nasya,MB,Bulgaria,30.0,190,2022,Belgium,2022-06-19,False,0,1,14,15,0,0,7,7,5,2,13,20,9,6,6,21,0,0,0,0,8,1,1,10
124202.0,Dimitrova Nasya,MB,Bulgaria,30.0,190,2022,Dominican Republic,2022-06-28,True,0,2,9,11,2,0,0,2,6,0,2,8,4,3,0,7,0,0,0,0,1,0,1,2
124202.0,Dimitrova Nasya,MB,Bulgaria,30.0,190,2022,Brazil,2022-07-01,False,1,0,10,11,0,1,0,1,7,0,3,10,1,5,0,6,0,0,1,1,3,1,2,6
124202.0,Dimitrova Nasya,MB,Bulgaria,30.0,190,2022,Italy,2022-07-02,False,3,0,13,16,0,0,1,1,5,1,5,11,0,6,0,6,0,0,0,0,2,2,1,5
124202.0,Dimitrova Nasya,MB,Bulgaria,30.0,190,2022,Poland,2022-07-03,True,1,1,16,18,0,0,4,4,10,1,7,18,4,4,1,9,0,0,0,0,1,1,0,2
153422.0,Neykova Polina,S,Bulgaria,24.0,182,2022,Dominican Republic,2022-06-28,True,0,0,0,0,0,0,0,0,0,0,0,0,0,0,0,0,0,0,1,1,0,0,0,0
153422.0,Neykova Polina,S,Bulgaria,24.0,182,2022,Brazil,2022-07-01,False,0,0,0,0,0,0,0,0,0,0,0,0,0,0,0,0,0,0,0,0,0,0,0,0
153422.0,Neykova Polina,S,Bulgaria,24.0,182,2022,Italy,2022-07-02,False,0,0,0,0,0,0,0,0,0,0,0,0,0,0,0,0,0,0,0,0,0,0,0,0
153422.0,Neykova Polina,S,Bulgaria,24.0,182,2022,Poland,2022-07-03,True,0,0,0,0,0,0,0,0,0,0,0,0,0,0,0,0,0,0,0,0,0,0,0,0
174474.0,Yordanova Maria,OH,Bulgaria,20.0,184,2022,USA,2022-06-15,False,1,4,2,7,0,0,1,1,6,3,7,16,1,0,2,3,7,3,20,30,5,2,0,7
174474.0,Yordanova Maria,OH,Bulgaria,20.0,184,2022,Japan,2022-06-16,False,0,2,7,9,0,0,0,0,10,5,11,26,0,1,5,6,9,3,16,28,9,1,1,11
174474.0,Yordanova Maria,OH,Bulgaria,20.0,184,2022,Canada,2022-06-18,True,1,0,9,10,1,0,4,5,13,4,8,25,1,1,0,2,3,2,13,18,9,1,0,10
174474.0,Yordanova Maria,OH,Bulgaria,20.0,184,2022,Belgium,2022-06-19,False,0,3,15,18,0,1,5,6,17,7,18,42,2,5,4,11,5,5,43,53,14,3,2,19
174474.0,Yordanova Maria,OH,Bulgaria,20.0,184,2022,Dominican Republic,2022-06-28,True,1,1,9,11,0,0,0,0,19,5,17,41,2,0,0,2,2,0,12,14,5,1,1,7
174474.0,Yordanova Maria,OH,Bulgaria,20.0,184,2022,Brazil,2022-07-01,False,0,1,4,5,0,0,0,0,5,6,5,16,1,2,0,3,4,1,19,24,3,1,1,5
174474.0,Yordanova Maria,OH,Bulgaria,20.0,184,2022,Italy,2022-07-02,False,0,0,6,6,0,1,0,1,9,6,7,22,0,3,1,4,2,2,24,28,1,2,1,4
174474.0,Yordanova Maria,OH,Bulgaria,20.0,184,2022,Poland,2022-07-03,True,0,1,10,11,0,0,2,2,20,8,14,42,2,1,1,4,3,1,24,28,8,2,0,10
142347.0,Paskova-Kaneva Miroslava,OH,Bulgaria,27.0,181,2022,Thailand,2022-05-31,False,0,2,11,13,0,0,2,2,3,5,11,19,1,6,4,11,1,1,11,13,5,4,1,10
142347.0,Paskova-Kaneva Miroslava,OH,Bulgaria,27.0,181,2022,Netherlands,2022-06-02,True,1,3,10,14,1,0,5,6,16,3,21,40,2,6,3,11,4,0,19,23,10,6,2,18
142347.0,Paskova-Kaneva Miroslava,OH,Bulgaria,27.0,181,2022,Serbia,2022-06-03,False,0,3,5,8,0,0,1,1,8,1,10,19,0,3,5,8,4,1,29,34,6,3,4,13
142347.0,Paskova-Kaneva Miroslava,OH,Bulgaria,27.0,181,2022,USA,2022-06-15,False,1,1,9,11,0,0,3,3,11,5,14,30,2,4,0,6,1,1,6,8,6,2,0,8
142347.0,Paskova-Kaneva Miroslava,OH,Bulgaria,27.0,181,2022,Japan,2022-06-16,False,0,0,14,14,0,0,4,4,4,4,14,22,0,2,2,4,2,1,15,18,9,4,0,13
142347.0,Paskova-Kaneva Miroslava,OH,Bulgaria,27.0,181,2022,Canada,2022-06-18,True,1,2,11,14,0,0,0,0,12,2,10,24,1,3,3,7,8,2,16,26,8,2,1,11
142347.0,Paskova-Kaneva Miroslava,OH,Bulgaria,27.0,181,2022,Belgium,2022-06-19,False,0,1,19,20,0,0,5,5,13,11,27,51,0,3,3,6,2,2,17,21,12,3,1,16
142347.0,Paskova-Kaneva Miroslava,OH,Bulgaria,27.0,181,2022,Dominican Republic,2022-06-28,True,0,0,12,12,0,0,0,0,10,4,11,25,0,0,1,1,4,0,16,20,4,0,0,4
142347.0,Paskova-Kaneva Miroslava,OH,Bulgaria,27.0,181,2022,Brazil,2022-07-01,False,1,0,8,9,0,0,0,0,6,2,9,17,0,0,0,0,5,0,12,17,3,2,0,5
142347.0,Paskova-Kaneva Miroslava,OH,Bulgaria,27.0,181,2022,Italy,2022-07-02,False,0,2,7,9,0,0,0,0,7,2,11,20,0,3,1,4,1,1,20,22,9,1,3,13
142347.0,Paskova-Kaneva Miroslava,OH,Bulgaria,27.0,181,2022,Poland,2022-07-03,True,1,2,19,22,0,0,2,2,7,3,12,22,0,3,0,3,1,0,20,21,11,0,0,11
138283.0,Kitipova Lora,S,Bulgaria,31.0,184,2022,Thailand,2022-05-31,False,0,1,8,9,24,0,50,74,1,0,2,3,0,3,1,4,0,0,0,0,1,2,2,5
138283.0,Kitipova Lora,S,Bulgaria,31.0,184,2022,Netherlands,2022-06-02,True,0,2,8,10,27,0,88,115,0,0,1,1,1,3,2,6,0,0,0,0,3,4,6,13
138283.0,Kitipova Lora,S,Bulgaria,31.0,184,2022,Serbia,2022-06-03,False,1,1,10,12,12,0,68,80,1,0,4,5,0,6,3,9,0,0,0,0,2,1,1,4
138283.0,Kitipova Lora,S,Bulgaria,31.0,184,2022,USA,2022-06-15,False,2,0,8,10,5,1,68,74,3,0,1,4,0,0,0,0,0,0,1,1,2,2,0,4
138283.0,Kitipova Lora,S,Bulgaria,31.0,184,2022,Japan,2022-06-16,False,0,0,7,7,18,0,48,66,1,0,0,1,0,5,1,6,0,0,0,0,3,0,0,3
138283.0,Kitipova Lora,S,Bulgaria,31.0,184,2022,Canada,2022-06-18,True,0,1,16,17,8,0,70,78,3,0,2,5,0,5,1,6,0,0,0,0,8,1,1,10
138283.0,Kitipova Lora,S,Bulgaria,31.0,184,2022,Belgium,2022-06-19,False,0,4,20,24,36,0,87,123,5,0,1,6,2,5,4,11,0,0,0,0,19,3,2,24
138283.0,Kitipova Lora,S,Bulgaria,31.0,184,2022,Dominican Republic,2022-06-28,True,0,1,11,12,51,2,3,56,0,0,0,0,0,0,1,1,0,0,0,0,4,2,0,6
138283.0,Kitipova Lora,S,Bulgaria,31.0,184,2022,Brazil,2022-07-01,False,1,1,10,12,11,1,67,79,0,0,2,2,0,4,1,5,0,0,0,0,3,1,0,4
138283.0,Kitipova Lora,S,Bulgaria,31.0,184,2022,Italy,2022-07-02,False,0,2,1,3,3,1,34,38,0,0,1,1,0,0,0,0,0,0,0,0,1,1,0,2
138283.0,Kitipova Lora,S,Bulgaria,31.0,184,2022,Poland,2022-07-03,True,0,2,14,16,10,0,95,105,4,0,2,6,0,2,1,3,0,0,0,0,10,1,3,14
142348.0,Barakova Petya,S,Bulgaria,28.0,180,2022,Thailand,2022-05-31,False,0,1,1,2,2,0,2,4,0,0,0,0,0,1,0,1,0,0,0,0,0,0,0,0
142348.0,Barakova Petya,S,Bulgaria,28.0,180,2022,Netherlands,2022-06-02,True,0,0,2,2,4,1,16,21,0,0,1,1,0,0,1,1,0,0,0,0,1,0,0,1
142348.0,Barakova Petya,S,Bulgaria,28.0,180,2022,Serbia,2022-06-03,False,0,0,2,2,5,0,11,16,0,0,0,0,0,0,0,0,0,0,0,0,1,0,1,2
142348.0,Barakova Petya,S,Bulgaria,28.0,180,2022,USA,2022-06-15,False,0,0,1,1,1,0,3,4,0,0,0,0,0,0,0,0,0,0,0,0,0,0,0,0
142348.0,Barakova Petya,S,Bulgaria,28.0,180,2022,Japan,2022-06-16,False,0,0,3,3,8,0,16,24,1,0,0,1,0,0,1,1,0,0,0,0,3,0,0,3
142348.0,Barakova Petya,S,Bulgaria,28.0,180,2022,Canada,2022-06-18,True,0,0,0,0,0,0,0,0,0,0,0,0,0,0,0,0,0,0,0,0,0,0,0,0
142348.0,Barakova Petya,S,Bulgaria,28.0,180,2022,Belgium,2022-06-19,False,0,0,0,0,0,0,2,2,0,0,0,0,0,0,0,0,0,0,0,0,0,0,0,0
142348.0,Barakova Petya,S,Bulgaria,28.0,180,2022,Dominican Republic,2022-06-28,True,0,0,0,0,0,0,0,0,0,0,0,0,0,0,0,0,0,0,0,0,0,0,0,0
142348.0,Barakova Petya,S,Bulgaria,28.0,180,2022,Brazil,2022-07-01,False,0,0,1,1,1,1,14,16,0,0,0,0,0,0,0,0,0,0,0,0,0,0,0,0
142348.0,Barakova Petya,S,Bulgaria,28.0,180,2022,Italy,2022-07-02,False,0,1,3,4,4,0,42,46,0,0,2,2,0,1,3,4,0,0,0,0,1,3,1,5
142348.0,Barakova Petya,S,Bulgaria,28.0,180,2022,Poland,2022-07-03,True,0,0,0,0,0,0,0,0,0,0,0,0,0,0,0,0,0,0,0,0,0,0,0,0
163261.0,Saykova Borislava,MB,Bulgaria,22.0,187,2022,Thailand,2022-05-31,False,0,2,2,4,0,0,0,0,0,0,0,0,0,0,0,0,0,0,0,0,0,1,0,1
163261.0,Saykova Borislava,MB,Bulgaria,22.0,187,2022,Netherlands,2022-06-02,True,0,1,0,1,0,0,0,0,0,0,0,0,0,0,0,0,0,0,0,0,0,0,0,0
163261.0,Saykova Borislava,MB,Bulgaria,22.0,187,2022,Serbia,2022-06-03,False,0,0,2,2,0,0,0,0,0,0,0,0,0,0,1,1,0,0,0,0,0,0,0,0
163261.0,Saykova Borislava,MB,Bulgaria,22.0,187,2022,USA,2022-06-15,False,0,0,2,2,0,0,0,0,0,0,0,0,0,0,0,0,0,0,0,0,0,0,0,0
163261.0,Saykova Borislava,MB,Bulgaria,22.0,187,2022,Japan,2022-06-16,False,0,2,6,8,1,0,1,2,0,0,4,4,0,1,6,7,0,0,2,2,1,0,0,1
163261.0,Saykova Borislava,MB,Bulgaria,22.0,187,2022,Canada,2022-06-18,True,0,0,0,0,0,0,0,0,0,0,0,0,0,0,0,0,0,0,0,0,0,0,0,0
163261.0,Saykova Borislava,MB,Bulgaria,22.0,187,2022,Belgium,2022-06-19,False,0,1,0,1,0,0,0,0,0,0,0,0,0,0,0,0,0,0,0,0,0,0,0,0
163261.0,Saykova Borislava,MB,Bulgaria,22.0,187,2022,Dominican Republic,2022-06-28,True,0,0,0,0,0,0,0,0,0,0,0,0,0,0,0,0,0,0,0,0,0,0,0,0
163261.0,Saykova Borislava,MB,Bulgaria,22.0,187,2022,Brazil,2022-07-01,False,0,1,1,2,0,0,0,0,0,0,0,0,0,0,0,0,0,0,0,0,0,0,0,0
163261.0,Saykova Borislava,MB,Bulgaria,22.0,187,2022,Italy,2022-07-02,False,1,0,4,5,0,0,0,0,1,0,0,1,0,2,0,2,0,0,0,0,0,0,0,0
163261.0,Saykova Borislava,MB,Bulgaria,22.0,187,2022,Poland,2022-07-03,True,0,0,0,0,0,0,0,0,0,0,0,0,0,0,0,0,0,0,0,0,0,0,0,0
142337.0,Todorova Mira,MB,Bulgaria,28.0,187,2022,Thailand,2022-05-31,False,0,1,3,4,0,0,1,1,4,1,0,5,0,1,4,5,0,0,0,0,1,0,0,1
142337.0,Todorova Mira,MB,Bulgaria,28.0,187,2022,Netherlands,2022-06-02,True,0,1,0,1,0,0,0,0,2,0,2,4,1,0,1,2,0,0,0,0,0,0,0,0
142337.0,Todorova Mira,MB,Bulgaria,28.0,187,2022,Serbia,2022-06-03,False,0,0,0,0,0,0,0,0,0,0,0,0,0,0,0,0,0,0,0,0,0,0,0,0
142337.0,Todorova Mira,MB,Bulgaria,28.0,187,2022,USA,2022-06-15,False,0,1,7,8,0,0,0,0,1,1,2,4,1,6,1,8,0,0,0,0,1,0,0,1
142337.0,Todorova Mira,MB,Bulgaria,28.0,187,2022,Japan,2022-06-16,False,0,1,8,9,0,0,0,0,5,0,4,9,1,4,3,8,0,0,2,2,3,0,0,3
142337.0,Todorova Mira,MB,Bulgaria,28.0,187,2022,Canada,2022-06-18,True,0,1,10,11,1,0,2,3,4,0,2,6,1,6,5,12,0,0,0,0,3,0,0,3
142337.0,Todorova Mira,MB,Bulgaria,28.0,187,2022,Belgium,2022-06-19,False,0,0,15,15,0,0,1,1,9,1,4,14,2,0,2,4,0,0,0,0,12,0,0,12
142337.0,Todorova Mira,MB,Bulgaria,28.0,187,2022,Dominican Republic,2022-06-28,True,1,1,5,7,0,0,0,0,4,0,6,10,3,3,1,7,0,0,1,1,3,0,0,3
142337.0,Todorova Mira,MB,Bulgaria,28.0,187,2022,Brazil,2022-07-01,False,0,2,6,8,0,0,0,0,5,1,4,10,1,1,2,4,0,0,1,1,4,1,0,5
142337.0,Todorova Mira,MB,Bulgaria,28.0,187,2022,Italy,2022-07-02,False,0,0,3,3,0,0,0,0,2,0,3,5,0,5,0,5,0,0,0,0,0,0,0,0
142337.0,Todorova Mira,MB,Bulgaria,28.0,187,2022,Poland,2022-07-03,True,0,3,7,10,0,0,0,0,8,1,3,12,1,7,3,11,0,0,0,0,3,1,0,4
124201.0,Vuchkova Hristina Hristova,MB,Bulgaria,31.0,190,2022,Thailand,2022-05-31,False,0,0,3,3,0,0,0,0,3,0,2,5,0,1,1,2,0,0,0,0,0,0,0,0
124201.0,Vuchkova Hristina Hristova,MB,Bulgaria,31.0,190,2022,Netherlands,2022-06-02,True,2,0,17,19,0,0,1,1,8,3,7,18,1,6,5,12,0,0,0,0,2,1,2,5
124201.0,Vuchkova Hristina Hristova,MB,Bulgaria,31.0,190,2022,Serbia,2022-06-03,False,0,0,9,9,0,0,2,2,5,0,3,8,2,5,3,10,0,0,0,0,0,1,2,3
142351.0,Todorova Zhana,L,Bulgaria,26.0,170,2022,Thailand,2022-05-31,False,0,0,0,0,0,0,1,1,0,0,0,0,0,0,0,0,5,1,12,18,7,4,9,20
142351.0,Todorova Zhana,L,Bulgaria,26.0,170,2022,Netherlands,2022-06-02,True,0,0,0,0,0,0,7,7,0,0,0,0,0,0,0,0,8,0,6,14,14,3,12,29
142351.0,Todorova Zhana,L,Bulgaria,26.0,170,2022,Serbia,2022-06-03,False,0,0,0,0,0,3,7,10,0,0,0,0,0,0,0,0,3,1,7,11,10,4,7,21
142351.0,Todorova Zhana,L,Bulgaria,26.0,170,2022,USA,2022-06-15,False,0,0,0,0,0,0,10,10,0,0,0,0,0,0,0,0,3,0,8,11,8,4,2,14
142351.0,Todorova Zhana,L,Bulgaria,26.0,170,2022,Japan,2022-06-16,False,0,0,0,0,0,1,4,5,0,0,0,0,0,0,0,0,4,0,6,10,11,3,0,14
142351.0,Todorova Zhana,L,Bulgaria,26.0,170,2022,Canada,2022-06-18,True,0,0,0,0,0,0,11,11,0,0,0,0,0,0,0,0,6,2,9,17,15,3,1,19
142351.0,Todorova Zhana,L,Bulgaria,26.0,170,2022,Belgium,2022-06-19,False,0,0,0,0,1,0,26,27,0,0,0,0,0,0,0,0,8,1,9,18,29,1,1,31
142351.0,Todorova Zhana,L,Bulgaria,26.0,170,2022,Dominican Republic,2022-06-28,True,0,0,0,0,5,0,0,5,0,0,0,0,0,0,0,0,2,0,7,9,3,3,1,7
142351.0,Todorova Zhana,L,Bulgaria,26.0,170,2022,Brazil,2022-07-01,False,0,0,0,0,0,0,1,1,0,0,0,0,0,0,0,0,1,2,7,10,7,2,3,12
142351.0,Todorova Zhana,L,Bulgaria,26.0,170,2022,Italy,2022-07-02,False,0,0,0,0,0,0,6,6,0,0,0,0,0,0,0,0,2,0,7,9,4,1,1,6
142351.0,Todorova Zhana,L,Bulgaria,26.0,170,2022,Poland,2022-07-03,True,0,0,0,0,0,0,6,6,0,0,0,0,0,0,0,0,4,1,13,18,7,4,3,14
163141.0,Marinova Radostina,O,Bulgaria,24.0,186,2022,Thailand,2022-05-31,False,0,0,0,0,0,0,0,0,0,0,0,0,0,0,0,0,0,0,0,0,0,0,0,0
163141.0,Marinova Radostina,O,Bulgaria,24.0,186,2022,Netherlands,2022-06-02,True,0,0,0,0,0,0,0,0,0,0,0,0,0,0,0,0,0,0,0,0,0,0,0,0
163141.0,Marinova Radostina,O,Bulgaria,24.0,186,2022,Serbia,2022-06-03,False,0,1,1,2,0,0,0,0,2,0,7,9,0,1,1,2,0,0,0,0,0,0,0,0
163141.0,Marinova Radostina,O,Bulgaria,24.0,186,2022,USA,2022-06-15,False,0,0,0,0,0,0,0,0,0,0,0,0,0,0,0,0,0,0,0,0,0,0,0,0
163141.0,Marinova Radostina,O,Bulgaria,24.0,186,2022,Japan,2022-06-16,False,0,0,2,2,0,0,0,0,2,0,3,5,0,0,1,1,0,0,0,0,1,1,0,2
163141.0,Marinova Radostina,O,Bulgaria,24.0,186,2022,Canada,2022-06-18,True,0,0,0,0,0,0,0,0,0,0,0,0,0,0,0,0,0,0,0,0,0,0,0,0
163141.0,Marinova Radostina,O,Bulgaria,24.0,186,2022,Belgium,2022-06-19,False,0,0,0,0,0,0,0,0,0,0,0,0,0,0,0,0,0,0,0,0,0,0,0,0
163141.0,Marinova Radostina,O,Bulgaria,24.0,186,2022,Dominican Republic,2022-06-28,True,3,1,16,20,1,0,0,1,4,3,4,11,0,0,0,0,0,0,0,0,1,0,0,1
163141.0,Marinova Radostina,O,Bulgaria,24.0,186,2022,Brazil,2022-07-01,False,0,0,2,2,0,0,0,0,4,3,6,13,0,1,0,1,0,0,0,0,0,0,0,0
163141.0,Marinova Radostina,O,Bulgaria,24.0,186,2022,Italy,2022-07-02,False,0,0,5,5,0,0,0,0,2,0,14,16,1,1,0,2,0,0,0,0,1,0,4,5
163141.0,Marinova Radostina,O,Bulgaria,24.0,186,2022,Poland,2022-07-03,True,0,0,0,0,0,0,0,0,0,0,0,0,0,0,0,0,0,0,0,0,0,0,0,0
142333.0,Chausheva Silvana,O,Bulgaria,27.0,188,2022,Thailand,2022-05-31,False,0,0,7,7,0,0,1,1,8,3,6,17,0,0,1,1,0,0,0,0,4,1,0,5
142333.0,Chausheva Silvana,O,Bulgaria,27.0,188,2022,Netherlands,2022-06-02,True,2,0,15,17,0,0,4,4,10,5,12,27,0,4,2,6,0,0,0,0,8,2,2,12
142333.0,Chausheva Silvana,O,Bulgaria,27.0,188,2022,Serbia,2022-06-03,False,0,0,10,10,0,0,0,0,8,4,15,27,1,3,1,5,1,0,0,1,7,2,0,9
142333.0,Chausheva Silvana,O,Bulgaria,27.0,188,2022,USA,2022-06-15,False,1,0,12,13,0,0,1,1,8,3,11,22,0,2,1,3,0,0,0,0,6,2,2,10
142333.0,Chausheva Silvana,O,Bulgaria,27.0,188,2022,Japan,2022-06-16,False,0,0,7,7,0,0,5,5,13,4,10,27,0,4,3,7,0,0,0,0,2,2,1,5
142333.0,Chausheva Silvana,O,Bulgaria,27.0,188,2022,Canada,2022-06-18,True,1,1,9,11,0,0,1,1,10,3,19,32,1,3,3,7,0,0,1,1,3,1,0,4
142333.0,Chausheva Silvana,O,Bulgaria,27.0,188,2022,Belgium,2022-06-19,False,1,2,14,17,0,0,2,2,12,7,29,48,1,4,10,15,0,0,0,0,11,2,0,13
142333.0,Chausheva Silvana,O,Bulgaria,27.0,188,2022,Dominican Republic,2022-06-28,True,0,0,0,0,0,0,0,0,0,0,0,0,0,0,0,0,0,0,0,0,0,0,0,0
142333.0,Chausheva Silvana,O,Bulgaria,27.0,188,2022,Brazil,2022-07-01,False,0,1,3,4,0,0,0,0,2,5,7,14,2,2,0,4,0,0,0,0,3,0,0,3
142333.0,Chausheva Silvana,O,Bulgaria,27.0,188,2022,Italy,2022-07-02,False,0,1,1,2,0,0,1,1,7,1,7,15,0,0,0,0,0,0,0,0,0,1,0,1
142333.0,Chausheva Silvana,O,Bulgaria,27.0,188,2022,Poland,2022-07-03,True,0,1,18,19,0,0,4,4,10,3,17,30,1,4,3,8,0,0,1,1,5,1,0,6
163142.0,Milanova Aleksandra,OH,Bulgaria,21.0,183,2022,Thailand,2022-05-31,False,1,3,1,5,0,0,0,0,4,0,0,4,0,0,0,0,2,3,6,11,1,0,1,2
163142.0,Milanova Aleksandra,OH,Bulgaria,21.0,183,2022,Netherlands,2022-06-02,True,0,1,1,2,0,0,0,0,1,2,2,5,0,0,0,0,2,0,2,4,2,1,1,4
163142.0,Milanova Aleksandra,OH,Bulgaria,21.0,183,2022,Serbia,2022-06-03,False,0,0,1,1,0,0,0,0,2,0,0,2,0,1,1,2,0,0,2,2,0,1,0,1
163142.0,Milanova Aleksandra,OH,Bulgaria,21.0,183,2022,USA,2022-06-15,False,0,1,1,2,0,0,0,0,5,1,1,7,0,0,1,1,1,1,12,14,1,1,0,2
163142.0,Milanova Aleksandra,OH,Bulgaria,21.0,183,2022,Japan,2022-06-16,False,0,0,1,1,0,0,0,0,3,1,2,6,0,0,0,0,0,0,0,0,0,1,0,1
163142.0,Milanova Aleksandra,OH,Bulgaria,21.0,183,2022,Canada,2022-06-18,True,0,0,0,0,0,0,0,0,0,0,0,0,0,0,0,0,0,0,0,0,0,0,0,0
163142.0,Milanova Aleksandra,OH,Bulgaria,21.0,183,2022,Belgium,2022-06-19,False,0,0,0,0,0,0,0,0,0,0,0,0,0,0,0,0,0,0,0,0,0,0,0,0
163142.0,Milanova Aleksandra,OH,Bulgaria,21.0,183,2022,Dominican Republic,2022-06-28,True,0,0,0,0,0,0,0,0,0,0,0,0,0,0,0,0,0,0,0,0,0,0,0,0
163142.0,Milanova Aleksandra,OH,Bulgaria,21.0,183,2022,Brazil,2022-07-01,False,1,1,5,7,0,0,0,0,2,4,4,10,0,1,0,1,3,0,7,10,4,1,1,6
163142.0,Milanova Aleksandra,OH,Bulgaria,21.0,183,2022,Italy,2022-07-02,False,0,0,0,0,0,0,1,1,1,0,2,3,0,1,0,1,1,0,2,3,0,0,0,0
163142.0,Milanova Aleksandra,OH,Bulgaria,21.0,183,2022,Poland,2022-07-03,True,0,0,0,0,0,0,0,0,0,0,0,0,0,0,0,0,0,0,0,0,0,0,0,0
153425.0,Shahpazova Mirela,S,Bulgaria,25.0,175,2022,Thailand,2022-05-31,False,0,0,0,0,0,0,0,0,0,0,0,0,0,0,0,0,0,0,0,0,0,0,0,0
153425.0,Shahpazova Mirela,S,Bulgaria,25.0,175,2022,Netherlands,2022-06-02,True,0,0,0,0,0,0,0,0,0,0,0,0,0,0,0,0,0,0,0,0,0,0,0,0
153425.0,Shahpazova Mirela,S,Bulgaria,25.0,175,2022,Serbia,2022-06-03,False,0,0,0,0,0,0,0,0,0,0,0,0,0,0,0,0,0,0,0,0,0,0,0,0
153425.0,Shahpazova Mirela,S,Bulgaria,25.0,175,2022,USA,2022-06-15,False,0,0,0,0,0,0,0,0,0,0,0,0,0,0,0,0,0,0,0,0,0,0,0,0
153425.0,Shahpazova Mirela,S,Bulgaria,25.0,175,2022,Japan,2022-06-16,False,0,0,0,0,0,0,0,0,0,0,0,0,0,0,0,0,0,0,0,0,0,0,0,0
153425.0,Shahpazova Mirela,S,Bulgaria,25.0,175,2022,Canada,2022-06-18,True,0,0,0,0,0,0,0,0,0,0,0,0,0,0,0,0,0,0,0,0,0,0,0,0
153425.0,Shahpazova Mirela,S,Bulgaria,25.0,175,2022,Belgium,2022-06-19,False,0,0,0,0,0,0,0,0,0,0,0,0,0,0,0,0,0,0,0,0,0,0,0,0
164660.0,Krivoshiyska Mariya,MB,Bulgaria,21.0,186,2022,USA,2022-06-15,False,0,0,0,0,0,0,0,0,0,0,0,0,0,0,0,0,0,0,0,0,0,0,0,0
164660.0,Krivoshiyska Mariya,MB,Bulgaria,21.0,186,2022,Japan,2022-06-16,False,0,0,0,0,0,0,0,0,0,0,0,0,0,0,0,0,0,0,0,0,0,0,0,0
164660.0,Krivoshiyska Mariya,MB,Bulgaria,21.0,186,2022,Canada,2022-06-18,True,0,0,0,0,0,0,0,0,0,0,0,0,0,0,0,0,0,0,0,0,0,0,0,0
164660.0,Krivoshiyska Mariya,MB,Bulgaria,21.0,186,2022,Belgium,2022-06-19,False,0,0,0,0,0,0,0,0,0,0,0,0,0,0,0,0,0,0,0,0,0,0,0,0
164660.0,Krivoshiyska Mariya,MB,Bulgaria,21.0,186,2022,Dominican Republic,2022-06-28,True,0,0,0,0,0,0,0,0,0,0,0,0,0,0,0,0,0,0,0,0,0,0,0,0
164660.0,Krivoshiyska Mariya,MB,Bulgaria,21.0,186,2022,Brazil,2022-07-01,False,0,0,0,0,0,0,0,0,0,0,0,0,0,0,0,0,0,0,0,0,0,0,0,0
164660.0,Krivoshiyska Mariya,MB,Bulgaria,21.0,186,2022,Italy,2022-07-02,False,0,0,0,0,0,0,0,0,0,0,0,0,0,0,0,0,0,0,0,0,0,0,0,0
164660.0,Krivoshiyska Mariya,MB,Bulgaria,21.0,186,2022,Poland,2022-07-03,True,0,0,0,0,0,0,0,0,0,0,0,0,0,0,0,0,0,0,0,0,0,0,0,0
140907.0,Vasileva Ralitsa,O,Bulgaria,31.0,190,2022,Thailand,2022-05-31,False,0,0,0,0,0,0,0,0,0,0,0,0,0,0,0,0,0,0,0,0,0,0,0,0
140907.0,Vasileva Ralitsa,O,Bulgaria,31.0,190,2022,Netherlands,2022-06-02,True,0,0,1,1,0,0,3,3,1,1,1,3,0,2,2,4,0,0,0,0,1,0,0,1
140907.0,Vasileva Ralitsa,O,Bulgaria,31.0,190,2022,Serbia,2022-06-03,False,0,0,0,0,0,0,0,0,0,0,1,1,0,0,0,0,1,0,1,2,0,0,0,0
140907.0,Vasileva Ralitsa,O,Bulgaria,31.0,190,2022,USA,2022-06-15,False,0,0,1,1,0,0,0,0,0,1,0,1,0,0,0,0,0,0,0,0,0,0,0,0
140907.0,Vasileva Ralitsa,O,Bulgaria,31.0,190,2022,Japan,2022-06-16,False,0,0,0,0,0,0,0,0,1,2,2,5,0,0,2,2,0,0,4,4,0,0,0,0
140907.0,Vasileva Ralitsa,O,Bulgaria,31.0,190,2022,Canada,2022-06-18,True,0,0,0,0,0,0,0,0,0,0,0,0,0,0,0,0,0,0,0,0,0,0,0,0
140907.0,Vasileva Ralitsa,O,Bulgaria,31.0,190,2022,Belgium,2022-06-19,False,0,0,0,0,0,0,0,0,0,0,0,0,0,0,0,0,0,0,0,0,0,0,0,0
140907.0,Vasileva Ralitsa,O,Bulgaria,31.0,190,2022,Dominican Republic,2022-06-28,True,0,0,0,0,0,0,0,0,0,0,0,0,0,0,0,0,0,0,0,0,0,0,0,0
140907.0,Vasileva Ralitsa,O,Bulgaria,31.0,190,2022,Brazil,2022-07-01,False,0,0,0,0,0,0,0,0,0,0,0,0,0,0,0,0,0,0,0,0,0,0,0,0
140907.0,Vasileva Ralitsa,O,Bulgaria,31.0,190,2022,Italy,2022-07-02,False,0,0,0,0,0,0,0,0,1,1,0,2,0,0,0,0,0,1,3,4,0,0,0,0
140907.0,Vasileva Ralitsa,O,Bulgaria,31.0,190,2022,Poland,2022-07-03,True,0,0,0,0,0,0,0,0,0,0,0,0,0,0,0,0,0,0,0,0,0,0,0,0
175276.0,Fitterer Allyssah Marie,MB,Canada,27.0,189,2022,Poland,2022-06-01,False,0,0,0,0,0,0,0,0,0,0,0,0,0,0,0,0,0,0,0,0,0,0,0,0
168355.0,Van Ryk Kiera,OH,Canada,24.0,188,2022,Poland,2022-06-01,False,1,7,9,17,0,0,4,4,12,11,16,39,1,1,4,6,0,0,0,0,5,3,1,9
168355.0,Van Ryk Kiera,OH,Canada,24.0,188,2022,Thailand,2022-06-14,False,2,3,7,12,1,0,1,2,17,7,13,37,1,1,3,5,0,0,0,0,5,0,2,7
168355.0,Van Ryk Kiera,OH,Canada,24.0,188,2022,Belgium,2022-06-16,True,2,4,8,14,0,1,16,17,20,9,12,41,0,6,8,14,0,0,0,0,11,4,1,16
168355.0,Van Ryk Kiera,OH,Canada,24.0,188,2022,China,2022-06-17,False,1,4,5,10,1,0,5,6,13,8,14,35,0,0,2,2,0,0,2,2,6,1,1,8
168355.0,Van Ryk Kiera,OH,Canada,24.0,188,2022,Bulgaria,2022-06-18,False,3,2,8,13,0,0,2,2,17,6,13,36,0,4,4,8,0,0,0,0,8,2,1,11
168355.0,Van Ryk Kiera,OH,Canada,24.0,188,2022,Netherlands,2022-07-03,False,3,5,13,21,0,0,7,7,18,12,18,48,1,3,2,6,0,0,0,0,21,2,0,23
175158.0,Murmann Julia,L,Canada,20.0,181,2022,Poland,2022-06-01,False,0,0,0,0,0,0,12,12,0,0,0,0,0,0,0,0,6,1,5,12,9,5,0,14
175158.0,Murmann Julia,L,Canada,20.0,181,2022,Thailand,2022-06-14,False,0,0,0,0,0,0,3,3,0,0,0,0,0,0,0,0,2,0,11,13,3,2,1,6
175158.0,Murmann Julia,L,Canada,20.0,181,2022,Belgium,2022-06-16,True,0,0,0,0,0,0,8,8,0,0,0,0,0,0,0,0,3,0,10,13,7,2,2,11
175158.0,Murmann Julia,L,Canada,20.0,181,2022,China,2022-06-17,False,0,0,0,0,0,0,0,0,0,0,0,0,0,0,0,0,0,0,0,0,0,0,0,0
175158.0,Murmann Julia,L,Canada,20.0,181,2022,Bulgaria,2022-06-18,False,0,0,0,0,0,0,12,12,0,0,0,0,0,0,0,0,4,0,9,13,8,3,0,11
175158.0,Murmann Julia,L,Canada,20.0,181,2022,Netherlands,2022-07-03,False,0,0,0,0,0,0,0,0,0,0,0,0,0,0,0,0,0,0,0,0,0,0,0,0
153629.0,White Jazmine Ruth,MB,Canada,29.0,186,2022,Poland,2022-06-01,False,0,0,0,0,0,0,0,0,0,0,0,0,0,0,0,0,0,0,0,0,0,0,0,0
153629.0,White Jazmine Ruth,MB,Canada,29.0,186,2022,Thailand,2022-06-14,False,0,0,0,0,0,0,0,0,0,0,0,0,0,0,0,0,0,0,0,0,0,0,0,0
153629.0,White Jazmine Ruth,MB,Canada,29.0,186,2022,Belgium,2022-06-16,True,0,0,0,0,0,0,0,0,0,0,0,0,0,0,0,0,0,0,0,0,0,0,0,0
153629.0,White Jazmine Ruth,MB,Canada,29.0,186,2022,China,2022-06-17,False,0,0,4,4,1,0,0,1,1,0,0,1,0,0,0,0,0,0,0,0,2,0,0,2
153629.0,White Jazmine Ruth,MB,Canada,29.0,186,2022,Bulgaria,2022-06-18,False,0,0,0,0,0,0,0,0,0,0,0,0,0,0,0,0,0,0,0,0,0,0,0,0
153629.0,White Jazmine Ruth,MB,Canada,29.0,186,2022,Netherlands,2022-07-03,False,0,0,0,0,0,0,0,0,0,0,0,0,0,0,0,0,0,0,0,0,0,0,0,0
142777.0,Ogoms Alicia,MB,Canada,28.0,194,2022,Thailand,2022-06-14,False,0,0,2,2,0,0,0,0,0,0,0,0,0,1,1,2,0,0,0,0,0,0,0,0
142777.0,Ogoms Alicia,MB,Canada,28.0,194,2022,Belgium,2022-06-16,True,0,0,0,0,0,0,0,0,0,0,0,0,0,0,0,0,0,0,0,0,0,0,0,0
142777.0,Ogoms Alicia,MB,Canada,28.0,194,2022,China,2022-06-17,False,0,0,10,10,0,0,3,3,2,1,3,6,1,3,13,17,0,0,0,0,1,1,0,2
142777.0,Ogoms Alicia,MB,Canada,28.0,194,2022,Bulgaria,2022-06-18,False,0,0,0,0,0,0,0,0,0,0,0,0,0,0,0,0,0,0,0,0,0,0,0,0
142777.0,Ogoms Alicia,MB,Canada,28.0,194,2022,Netherlands,2022-07-03,False,0,0,0,0,0,0,0,0,0,0,0,0,0,0,0,0,0,0,0,0,0,0,0,0
132236.0,Gray Alexa,OH,Canada,28.0,185,2022,Poland,2022-06-01,False,0,0,14,14,0,0,3,3,19,6,17,42,0,1,5,6,33,3,19,55,10,1,0,11
132236.0,Gray Alexa,OH,Canada,28.0,185,2022,Thailand,2022-06-14,False,0,0,7,7,0,0,0,0,12,4,18,34,1,6,2,9,5,3,29,37,3,3,0,6
132236.0,Gray Alexa,OH,Canada,28.0,185,2022,Belgium,2022-06-16,True,0,1,14,15,0,0,2,2,23,4,16,43,1,1,2,4,6,0,28,34,10,4,0,14
132236.0,Gray Alexa,OH,Canada,28.0,185,2022,China,2022-06-17,False,0,0,0,0,0,0,0,0,0,0,0,0,0,0,0,0,0,0,0,0,0,0,0,0
132236.0,Gray Alexa,OH,Canada,28.0,185,2022,Bulgaria,2022-06-18,False,1,0,8,9,0,1,1,2,8,5,20,33,1,0,5,6,6,1,33,40,8,3,0,11
132236.0,Gray Alexa,OH,Canada,28.0,185,2022,Netherlands,2022-07-03,False,0,0,21,21,0,0,9,9,21,4,20,45,1,3,0,4,15,3,28,46,12,2,0,14
157583.0,Baker Courtney,S,Canada,25.0,180,2022,Poland,2022-06-01,False,0,1,0,1,1,0,4,5,0,0,0,0,1,0,0,1,0,0,0,0,0,0,0,0
157583.0,Baker Courtney,S,Canada,25.0,180,2022,Netherlands,2022-07-03,False,0,0,0,0,0,0,0,0,0,0,0,0,0,0,0,0,0,0,0,0,0,0,0,0
173581.0,Mitrovic Andrea,OH,Canada,23.0,187,2022,Poland,2022-06-01,False,0,1,1,2,0,0,0,0,0,0,0,0,0,0,0,0,3,0,0,3,2,0,0,2
173581.0,Mitrovic Andrea,OH,Canada,23.0,187,2022,Thailand,2022-06-14,False,1,3,6,10,0,0,1,1,4,2,5,11,0,3,0,3,3,0,9,12,3,2,0,5
173581.0,Mitrovic Andrea,OH,Canada,23.0,187,2022,Belgium,2022-06-16,True,0,0,1,1,0,0,0,0,0,0,0,0,0,0,0,0,0,2,2,4,0,0,0,0
173581.0,Mitrovic Andrea,OH,Canada,23.0,187,2022,China,2022-06-17,False,0,1,1,2,0,0,2,2,4,2,4,10,0,0,1,1,2,1,3,6,1,1,0,2
173581.0,Mitrovic Andrea,OH,Canada,23.0,187,2022,Bulgaria,2022-06-18,False,0,0,0,0,0,0,0,0,0,0,0,0,0,0,0,0,0,0,0,0,0,0,0,0
173581.0,Mitrovic Andrea,OH,Canada,23.0,187,2022,Netherlands,2022-07-03,False,0,0,2,2,0,0,0,0,4,1,3,8,0,1,1,2,1,0,1,2,3,0,0,3
139522.0,Cross Jennifer,MB,Canada,30.0,194,2022,Poland,2022-06-01,False,0,1,11,12,0,0,1,1,2,0,2,4,3,5,3,11,0,0,0,0,4,3,0,7
139522.0,Cross Jennifer,MB,Canada,30.0,194,2022,Thailand,2022-06-14,False,1,0,5,6,0,0,0,0,3,0,4,7,1,1,4,6,0,0,0,0,0,0,0,0
139522.0,Cross Jennifer,MB,Canada,30.0,194,2022,Belgium,2022-06-16,True,1,1,11,13,0,0,1,1,3,0,2,5,5,3,7,15,0,0,0,0,1,2,0,3
139522.0,Cross Jennifer,MB,Canada,30.0,194,2022,China,2022-06-17,False,1,0,3,4,0,0,0,0,0,2,0,2,1,2,1,4,0,0,1,1,1,0,0,1
139522.0,Cross Jennifer,MB,Canada,30.0,194,2022,Bulgaria,2022-06-18,False,0,0,12,12,1,0,1,2,5,0,3,8,1,5,3,9,0,0,0,0,3,2,0,5
139522.0,Cross Jennifer,MB,Canada,30.0,194,2022,Netherlands,2022-07-03,False,2,0,19,21,0,0,3,3,4,0,5,9,3,4,4,11,0,0,0,0,4,0,0,4
173585.0,King Brie,S,Canada,25.0,183,2022,Poland,2022-06-01,False,1,1,12,14,12,1,75,88,0,0,4,4,1,1,2,4,0,0,0,0,14,3,1,18
173585.0,King Brie,S,Canada,25.0,183,2022,Thailand,2022-06-14,False,1,1,10,12,27,3,68,98,0,0,1,1,0,3,0,3,0,0,0,0,4,6,0,10
173585.0,King Brie,S,Canada,25.0,183,2022,Belgium,2022-06-16,True,1,0,18,19,26,0,68,94,4,1,1,6,1,7,3,11,0,1,0,1,10,3,1,14
173585.0,King Brie,S,Canada,25.0,183,2022,China,2022-06-17,False,1,1,9,11,17,0,55,72,2,1,3,6,0,1,0,1,0,0,0,0,8,4,2,14
173585.0,King Brie,S,Canada,25.0,183,2022,Bulgaria,2022-06-18,False,0,0,11,11,14,0,70,84,1,0,4,5,1,8,4,13,0,0,0,0,7,3,1,11
173585.0,King Brie,S,Canada,25.0,183,2022,Netherlands,2022-07-03,False,0,0,12,12,0,2,128,130,1,1,1,3,2,1,1,4,0,0,0,0,15,3,0,18
174676.0,Howe Hilary,OH,Canada,24.0,185,2022,Poland,2022-06-01,False,0,4,8,12,0,0,3,3,8,4,11,23,1,2,1,4,3,2,2,7,10,1,0,11
174676.0,Howe Hilary,OH,Canada,24.0,185,2022,Thailand,2022-06-14,False,1,0,3,4,0,0,0,0,0,2,4,6,1,0,0,1,1,0,3,4,1,0,0,1
174676.0,Howe Hilary,OH,Canada,24.0,185,2022,Belgium,2022-06-16,True,0,4,6,10,0,0,0,0,12,5,8,25,2,2,2,6,1,2,26,29,9,0,1,10
174676.0,Howe Hilary,OH,Canada,24.0,185,2022,China,2022-06-17,False,0,3,6,9,0,0,6,6,11,5,14,30,0,1,5,6,3,6,26,35,5,1,2,8
174676.0,Howe Hilary,OH,Canada,24.0,185,2022,Bulgaria,2022-06-18,False,2,0,10,12,0,0,1,1,5,4,3,12,0,0,3,3,1,2,9,12,8,1,0,9
174676.0,Howe Hilary,OH,Canada,24.0,185,2022,Netherlands,2022-07-03,False,0,3,7,10,0,0,3,3,6,6,15,27,1,3,3,7,8,3,15,26,6,0,0,6
174680.0,Livingston Caroline,OH,Canada,26.0,188,2022,Poland,2022-06-01,False,0,1,0,1,0,0,0,0,0,0,0,0,0,0,0,0,0,0,0,0,1,1,1,3
174680.0,Livingston Caroline,OH,Canada,26.0,188,2022,Thailand,2022-06-14,False,0,0,2,2,0,0,0,0,0,0,0,0,0,0,0,0,2,0,2,4,0,0,0,0
174680.0,Livingston Caroline,OH,Canada,26.0,188,2022,Belgium,2022-06-16,True,0,0,9,9,0,0,0,0,0,0,0,0,0,0,0,0,0,0,0,0,1,0,0,1
174680.0,Livingston Caroline,OH,Canada,26.0,188,2022,China,2022-06-17,False,1,0,9,10,0,0,2,2,6,3,10,19,0,0,1,1,6,1,19,26,9,1,0,10
174680.0,Livingston Caroline,OH,Canada,26.0,188,2022,Bulgaria,2022-06-18,False,0,2,1,3,0,0,0,0,0,0,0,0,0,1,0,1,2,0,2,4,1,0,0,1
174680.0,Livingston Caroline,OH,Canada,26.0,188,2022,Netherlands,2022-07-03,False,0,1,5,6,0,0,0,0,0,0,0,0,0,0,0,0,0,0,0,0,0,0,0,0
170054.0,Georgiadis Katerina,L,Canada,21.0,168,2022,Poland,2022-06-01,False,0,0,0,0,0,0,0,0,0,0,0,0,0,0,0,0,0,0,0,0,0,0,0,0
156485.0,Robitaille Kim,S,Canada,31.0,180,2022,Thailand,2022-06-14,False,0,0,0,0,0,0,0,0,0,0,0,0,0,0,0,0,0,0,0,0,0,0,0,0
156485.0,Robitaille Kim,S,Canada,31.0,180,2022,Belgium,2022-06-16,True,0,0,0,0,0,0,0,0,0,0,0,0,0,0,0,0,0,0,0,0,0,0,0,0
156485.0,Robitaille Kim,S,Canada,31.0,180,2022,China,2022-06-17,False,0,0,1,1,3,0,16,19,0,0,0,0,0,0,1,1,0,0,0,0,1,0,2,3
156485.0,Robitaille Kim,S,Canada,31.0,180,2022,Bulgaria,2022-06-18,False,0,0,0,0,0,0,0,0,0,0,0,0,0,0,0,0,0,0,0,0,0,0,0,0
168354.0,Maglio Emily,MB,Canada,26.0,191,2022,Poland,2022-06-01,False,0,3,11,14,0,0,1,1,7,1,3,11,0,4,2,6,3,0,1,4,3,1,0,4
168354.0,Maglio Emily,MB,Canada,26.0,191,2022,Thailand,2022-06-14,False,0,4,6,10,0,0,0,0,7,0,5,12,1,3,3,7,0,0,0,0,0,0,0,0
168354.0,Maglio Emily,MB,Canada,26.0,191,2022,Belgium,2022-06-16,True,0,3,12,15,0,0,1,1,7,2,3,12,2,1,1,4,0,0,3,3,4,0,0,4
168354.0,Maglio Emily,MB,Canada,26.0,191,2022,China,2022-06-17,False,1,2,7,10,0,0,1,1,7,0,3,10,1,4,0,5,0,0,0,0,2,1,0,3
168354.0,Maglio Emily,MB,Canada,26.0,191,2022,Bulgaria,2022-06-18,False,1,1,6,8,0,0,0,0,9,0,5,14,3,8,2,13,0,0,0,0,4,1,0,5
168354.0,Maglio Emily,MB,Canada,26.0,191,2022,Netherlands,2022-07-03,False,0,2,3,5,0,0,3,3,8,2,7,17,4,7,4,15,1,1,0,2,5,1,0,6
181280.0,Palermo Arielle,L,Canada,22.0,170,2022,Thailand,2022-06-14,False,0,0,0,0,0,0,0,0,0,0,0,0,0,0,0,0,0,0,0,0,0,0,0,0
181280.0,Palermo Arielle,L,Canada,22.0,170,2022,Belgium,2022-06-16,True,0,0,0,0,0,0,0,0,0,0,0,0,0,0,0,0,0,0,0,0,0,0,0,0
181280.0,Palermo Arielle,L,Canada,22.0,170,2022,China,2022-06-17,False,0,0,0,0,2,0,6,8,0,0,0,0,0,0,0,0,3,1,13,17,14,4,1,19
181280.0,Palermo Arielle,L,Canada,22.0,170,2022,Bulgaria,2022-06-18,False,0,0,0,0,0,0,0,0,0,0,0,0,0,0,0,0,0,0,0,0,0,0,0,0
181280.0,Palermo Arielle,L,Canada,22.0,170,2022,Netherlands,2022-07-03,False,0,0,0,0,0,0,14,14,0,0,0,0,0,0,0,0,7,0,10,17,14,3,0,17
189156.0,Grills Sydney,O,Canada,23.0,192,2022,Poland,2022-06-01,False,1,1,2,4,0,0,0,0,1,0,0,1,0,0,0,0,0,0,0,0,1,0,0,1
189156.0,Grills Sydney,O,Canada,23.0,192,2022,Thailand,2022-06-14,False,0,0,0,0,0,0,0,0,0,0,0,0,0,0,0,0,0,0,0,0,0,0,0,0
189156.0,Grills Sydney,O,Canada,23.0,192,2022,Belgium,2022-06-16,True,0,0,0,0,0,0,0,0,0,0,0,0,0,0,0,0,0,0,0,0,0,0,0,0
189156.0,Grills Sydney,O,Canada,23.0,192,2022,China,2022-06-17,False,0,1,0,1,0,0,0,0,0,0,2,2,0,0,0,0,0,0,0,0,0,2,0,2
189156.0,Grills Sydney,O,Canada,23.0,192,2022,Bulgaria,2022-06-18,False,0,0,0,0,0,0,0,0,0,0,0,0,0,0,0,0,0,0,0,0,0,0,0,0
189156.0,Grills Sydney,O,Canada,23.0,192,2022,Netherlands,2022-07-03,False,0,0,0,0,0,0,0,0,0,0,0,0,0,0,0,0,0,0,0,0,0,0,0,0
135746.0,Yuan Xinyue,MB,China,26.0,202,2022,Netherlands,2022-06-01,True,0,0,13,13,0,0,3,3,7,1,3,11,4,7,10,21,0,0,0,0,1,1,2,4
135746.0,Yuan Xinyue,MB,China,26.0,202,2022,Italy,2022-06-04,True,0,1,11,12,1,0,0,1,6,0,5,11,4,11,4,19,0,0,0,0,2,0,0,2
135746.0,Yuan Xinyue,MB,China,26.0,202,2022,Thailand,2022-06-05,False,3,1,14,18,1,0,2,3,6,1,10,17,2,9,9,20,0,0,0,0,4,0,3,7
135746.0,Yuan Xinyue,MB,China,26.0,202,2022,Belgium,2022-06-15,True,0,0,9,9,0,0,1,1,5,0,4,9,1,2,5,8,0,0,0,0,1,0,0,1
135746.0,Yuan Xinyue,MB,China,26.0,202,2022,Canada,2022-06-17,True,1,0,16,17,1,0,1,2,4,1,10,15,3,6,7,16,0,0,0,0,3,1,0,4
135746.0,Yuan Xinyue,MB,China,26.0,202,2022,USA,2022-06-18,False,1,0,8,9,0,1,1,2,3,0,7,10,1,5,5,11,0,0,0,0,2,0,1,3
135746.0,Yuan Xinyue,MB,China,26.0,202,2022,Japan,2022-06-19,False,1,1,7,9,0,0,1,1,5,1,4,10,3,7,6,16,0,0,0,0,1,1,0,2
135746.0,Yuan Xinyue,MB,China,26.0,202,2022,Brazil,2022-06-28,False,0,1,16,17,0,0,1,1,10,1,8,19,2,8,1,11,0,0,0,0,2,1,0,3
135746.0,Yuan Xinyue,MB,China,26.0,202,2022,Poland,2022-06-30,True,1,0,11,12,0,0,3,3,5,1,7,13,2,4,2,8,0,0,0,0,0,0,0,0
135746.0,Yuan Xinyue,MB,China,26.0,202,2022,Dominican Republic,2022-07-01,True,2,0,17,19,1,0,0,1,7,0,7,14,1,10,4,15,0,0,0,0,1,0,3,4
135746.0,Yuan Xinyue,MB,China,26.0,202,2022,Italy,2022-07-14,False,0,0,16,16,0,0,1,1,7,1,7,15,2,3,5,10,0,1,2,3,1,0,0,1
162354.0,Diao Linyu,S,China,28.0,183,2022,Netherlands,2022-06-01,True,2,0,12,14,22,1,71,94,1,0,2,3,3,3,5,11,0,0,0,0,6,5,7,18
162354.0,Diao Linyu,S,China,28.0,183,2022,Italy,2022-06-04,True,0,0,6,6,25,0,12,37,1,0,0,1,0,2,0,2,0,0,1,1,3,5,0,8
162354.0,Diao Linyu,S,China,28.0,183,2022,Thailand,2022-06-05,False,0,0,6,6,26,0,22,48,1,2,0,3,0,1,1,2,0,0,0,0,5,0,1,6
162354.0,Diao Linyu,S,China,28.0,183,2022,Belgium,2022-06-15,True,0,0,0,0,0,0,0,0,0,0,0,0,0,0,0,0,0,0,0,0,0,0,0,0
162354.0,Diao Linyu,S,China,28.0,183,2022,Brazil,2022-06-28,False,1,0,20,21,32,1,69,102,1,0,1,2,1,5,6,12,0,0,0,0,7,0,3,10
162354.0,Diao Linyu,S,China,28.0,183,2022,Poland,2022-06-30,True,0,2,8,10,0,2,60,62,1,0,0,1,1,1,1,3,0,0,0,0,8,2,3,13
162354.0,Diao Linyu,S,China,28.0,183,2022,Dominican Republic,2022-07-01,True,0,1,7,8,64,0,0,64,2,0,0,2,3,5,6,14,0,0,0,0,5,0,2,7
162354.0,Diao Linyu,S,China,28.0,183,2022,Italy,2022-07-14,False,0,0,17,17,30,0,70,100,0,0,1,1,0,3,5,8,0,0,0,0,10,2,2,14
152337.0,Yang Hanyu,MB,China,23.0,196,2022,Netherlands,2022-06-01,True,0,0,0,0,0,0,0,0,0,0,0,0,0,0,0,0,0,0,0,0,0,0,0,0
152337.0,Yang Hanyu,MB,China,23.0,196,2022,Italy,2022-06-04,True,0,0,0,0,0,0,0,0,0,0,0,0,0,0,0,0,0,0,0,0,0,0,0,0
152337.0,Yang Hanyu,MB,China,23.0,196,2022,Thailand,2022-06-05,False,0,0,0,0,0,0,0,0,0,0,0,0,0,0,0,0,0,0,0,0,0,0,0,0
152337.0,Yang Hanyu,MB,China,23.0,196,2022,Belgium,2022-06-15,True,0,0,0,0,0,0,0,0,0,0,0,0,0,0,0,0,0,0,0,0,0,0,0,0
152337.0,Yang Hanyu,MB,China,23.0,196,2022,Canada,2022-06-17,True,0,0,1,1,0,0,2,2,2,0,0,2,0,0,2,2,0,0,0,0,0,0,0,0
152337.0,Yang Hanyu,MB,China,23.0,196,2022,USA,2022-06-18,False,1,1,3,5,0,0,1,1,2,0,5,7,1,2,1,4,0,0,0,0,0,0,0,0
152337.0,Yang Hanyu,MB,China,23.0,196,2022,Japan,2022-06-19,False,0,0,0,0,0,0,0,0,0,0,0,0,0,0,0,0,0,0,0,0,0,0,0,0
152337.0,Yang Hanyu,MB,China,23.0,196,2022,Brazil,2022-06-28,False,0,0,0,0,0,0,0,0,0,0,0,0,0,0,0,0,0,0,0,0,0,0,0,0
152337.0,Yang Hanyu,MB,China,23.0,196,2022,Poland,2022-06-30,True,0,0,0,0,0,0,0,0,0,0,0,0,0,0,0,0,0,0,0,0,0,0,0,0
152337.0,Yang Hanyu,MB,China,23.0,196,2022,Dominican Republic,2022-07-01,True,0,0,0,0,0,0,0,0,0,0,0,0,0,0,0,0,0,0,0,0,0,0,0,0
152337.0,Yang Hanyu,MB,China,23.0,196,2022,Italy,2022-07-14,False,0,0,0,0,0,0,0,0,0,0,0,0,0,0,0,0,0,0,0,0,0,0,0,0
152332.0,Gao Yi,MB,China,24.0,194,2022,Brazil,2022-06-28,False,0,0,0,0,0,0,0,0,0,0,0,0,0,0,0,0,0,0,0,0,0,0,0,0
152332.0,Gao Yi,MB,China,24.0,194,2022,Poland,2022-06-30,True,0,0,0,0,0,0,0,0,0,0,0,0,0,0,0,0,0,0,0,0,0,0,0,0
152332.0,Gao Yi,MB,China,24.0,194,2022,Dominican Republic,2022-07-01,True,0,0,0,0,0,0,0,0,0,0,0,0,0,0,0,0,0,0,0,0,0,0,0,0
152332.0,Gao Yi,MB,China,24.0,194,2022,Italy,2022-07-14,False,0,0,0,0,0,0,0,0,0,0,0,0,0,0,0,0,0,0,0,0,0,0,0,0
143206.0,Gong Xiangyu,O,China,25.0,189,2022,Netherlands,2022-06-01,True,1,0,13,14,0,1,5,6,19,1,17,37,0,5,2,7,4,1,16,21,6,3,6,15
143206.0,Gong Xiangyu,O,China,25.0,189,2022,Italy,2022-06-04,True,1,0,9,10,0,0,1,1,13,4,7,24,2,3,1,6,6,0,13,19,9,1,0,10
143206.0,Gong Xiangyu,O,China,25.0,189,2022,Thailand,2022-06-05,False,1,0,18,19,1,0,4,5,18,3,17,38,1,1,5,7,7,1,8,16,12,1,1,14
143206.0,Gong Xiangyu,O,China,25.0,189,2022,Belgium,2022-06-15,True,0,0,16,16,0,0,0,0,15,0,7,22,3,1,2,6,2,0,0,2,7,2,0,9
143206.0,Gong Xiangyu,O,China,25.0,189,2022,Canada,2022-06-17,True,1,2,11,14,0,0,5,5,13,1,17,31,1,2,1,4,3,0,7,10,17,2,0,19
143206.0,Gong Xiangyu,O,China,25.0,189,2022,USA,2022-06-18,False,0,1,11,12,0,0,3,3,9,3,6,18,2,3,1,6,4,0,1,5,8,3,1,12
143206.0,Gong Xiangyu,O,China,25.0,189,2022,Japan,2022-06-19,False,2,0,17,19,0,1,5,6,9,4,16,29,1,3,4,8,2,1,10,13,5,1,2,8
143206.0,Gong Xiangyu,O,China,25.0,189,2022,Brazil,2022-06-28,False,1,0,14,15,2,0,11,13,14,6,13,33,2,7,2,11,4,0,15,19,9,3,2,14
143206.0,Gong Xiangyu,O,China,25.0,189,2022,Poland,2022-06-30,True,1,1,10,12,0,0,1,1,9,2,4,15,1,1,1,3,5,0,3,8,4,0,1,5
143206.0,Gong Xiangyu,O,China,25.0,189,2022,Dominican Republic,2022-07-01,True,1,0,10,11,2,1,0,3,9,2,8,19,0,4,0,4,2,2,1,5,6,1,0,7
143206.0,Gong Xiangyu,O,China,25.0,189,2022,Italy,2022-07-14,False,0,0,12,12,0,0,5,5,18,3,13,34,2,4,3,9,4,2,6,12,12,2,1,15
143201.0,Wang Yuanyuan,MB,China,25.0,196,2022,Netherlands,2022-06-01,True,0,2,6,8,0,0,6,6,18,4,7,29,3,6,9,18,0,0,0,0,1,0,3,4
143201.0,Wang Yuanyuan,MB,China,25.0,196,2022,Italy,2022-06-04,True,0,0,13,13,0,0,3,3,4,1,6,11,2,5,12,19,0,0,0,0,2,0,1,3
143201.0,Wang Yuanyuan,MB,China,25.0,196,2022,Thailand,2022-06-05,False,0,0,18,18,0,0,2,2,9,2,6,17,1,6,6,13,0,0,0,0,4,4,3,11
143201.0,Wang Yuanyuan,MB,China,25.0,196,2022,Belgium,2022-06-15,True,1,1,11,13,0,0,1,1,7,1,1,9,1,5,5,11,0,0,0,0,2,2,0,4
143201.0,Wang Yuanyuan,MB,China,25.0,196,2022,Canada,2022-06-17,True,1,1,12,14,0,0,0,0,7,2,4,13,4,3,6,13,1,0,1,2,4,0,0,4
143201.0,Wang Yuanyuan,MB,China,25.0,196,2022,USA,2022-06-18,False,0,0,7,7,0,0,0,0,2,0,1,3,0,4,1,5,0,1,0,1,2,0,0,2
143201.0,Wang Yuanyuan,MB,China,25.0,196,2022,Japan,2022-06-19,False,0,0,8,8,0,0,1,1,1,3,4,8,3,0,5,8,0,0,1,1,2,0,0,2
143201.0,Wang Yuanyuan,MB,China,25.0,196,2022,Brazil,2022-06-28,False,1,1,13,15,1,0,2,3,9,1,1,11,5,3,3,11,0,0,1,1,2,0,0,2
143201.0,Wang Yuanyuan,MB,China,25.0,196,2022,Poland,2022-06-30,True,0,1,6,7,0,0,0,0,6,0,2,8,3,1,2,6,0,0,0,0,1,0,1,2
143201.0,Wang Yuanyuan,MB,China,25.0,196,2022,Dominican Republic,2022-07-01,True,0,0,10,10,4,0,0,4,6,1,3,10,1,4,4,9,1,0,2,3,1,0,1,2
143201.0,Wang Yuanyuan,MB,China,25.0,196,2022,Italy,2022-07-14,False,1,1,10,12,0,0,5,5,6,0,2,8,5,4,5,14,1,0,0,1,4,0,1,5
152917.0,Jin Ye,OH,China,27.0,189,2022,Netherlands,2022-06-01,True,0,0,2,2,0,0,0,0,1,2,4,7,0,1,0,1,0,0,5,5,0,1,1,2
152917.0,Jin Ye,OH,China,27.0,189,2022,Italy,2022-06-04,True,0,1,11,12,0,0,2,2,4,0,7,11,2,1,1,4,0,1,6,7,3,0,0,3
152917.0,Jin Ye,OH,China,27.0,189,2022,Thailand,2022-06-05,False,0,0,3,3,0,0,0,0,1,2,1,4,0,1,0,1,0,0,5,5,4,0,0,4
152917.0,Jin Ye,OH,China,27.0,189,2022,Belgium,2022-06-15,True,0,0,13,13,0,0,1,1,7,0,9,16,1,3,2,6,8,1,11,20,7,3,0,10
152917.0,Jin Ye,OH,China,27.0,189,2022,Canada,2022-06-17,True,1,0,4,5,0,0,1,1,2,0,4,6,0,1,0,1,1,0,2,3,2,0,0,2
152917.0,Jin Ye,OH,China,27.0,189,2022,USA,2022-06-18,False,0,0,12,12,0,0,2,2,7,2,4,13,0,2,1,3,1,1,8,10,3,2,0,5
152917.0,Jin Ye,OH,China,27.0,189,2022,Japan,2022-06-19,False,0,1,3,4,0,0,0,0,4,1,3,8,0,0,0,0,1,0,3,4,2,1,0,3
152917.0,Jin Ye,OH,China,27.0,189,2022,Brazil,2022-06-28,False,0,0,12,12,0,0,1,1,2,1,7,10,0,2,2,4,2,3,12,17,6,1,0,7
152917.0,Jin Ye,OH,China,27.0,189,2022,Poland,2022-06-30,True,0,0,14,14,0,0,1,1,7,3,9,19,1,1,2,4,4,0,5,9,6,1,0,7
152917.0,Jin Ye,OH,China,27.0,189,2022,Dominican Republic,2022-07-01,True,0,0,10,10,0,0,0,0,5,2,7,14,2,0,1,3,1,0,8,9,5,1,0,6
152917.0,Jin Ye,OH,China,27.0,189,2022,Italy,2022-07-14,False,0,0,1,1,0,0,0,0,0,0,0,0,0,0,0,0,0,0,0,0,0,1,0,1
135740.0,Wang Yunlu,OH,China,26.0,191,2022,Netherlands,2022-06-01,True,0,0,18,18,0,0,2,2,3,4,7,14,1,0,2,3,9,0,25,34,7,4,5,16
135740.0,Wang Yunlu,OH,China,26.0,191,2022,Italy,2022-06-04,True,0,0,10,10,0,0,1,1,4,2,8,14,1,1,0,2,3,0,7,10,6,2,1,9
135740.0,Wang Yunlu,OH,China,26.0,191,2022,Thailand,2022-06-05,False,2,1,12,15,1,0,2,3,7,3,7,17,2,4,2,8,9,1,20,30,9,3,0,12
135740.0,Wang Yunlu,OH,China,26.0,191,2022,Belgium,2022-06-15,True,0,0,2,2,0,0,0,0,2,1,4,7,1,2,1,4,0,0,5,5,4,0,0,4
135740.0,Wang Yunlu,OH,China,26.0,191,2022,Canada,2022-06-17,True,2,2,12,16,0,0,4,4,4,1,16,21,1,0,0,1,2,1,8,11,6,0,0,6
135740.0,Wang Yunlu,OH,China,26.0,191,2022,USA,2022-06-18,False,0,0,0,0,0,0,0,0,0,0,3,3,0,0,0,0,0,0,0,0,0,0,0,0
135740.0,Wang Yunlu,OH,China,26.0,191,2022,Japan,2022-06-19,False,1,0,7,8,1,0,3,4,3,3,7,13,1,2,1,4,6,4,15,25,3,2,1,6
135740.0,Wang Yunlu,OH,China,26.0,191,2022,Brazil,2022-06-28,False,0,2,5,7,0,0,3,3,3,2,8,13,0,1,0,1,5,0,3,8,5,0,0,5
135740.0,Wang Yunlu,OH,China,26.0,191,2022,Poland,2022-06-30,True,0,0,0,0,0,0,0,0,0,0,0,0,0,0,0,0,0,0,0,0,0,0,0,0
135740.0,Wang Yunlu,OH,China,26.0,191,2022,Dominican Republic,2022-07-01,True,0,0,0,0,0,0,0,0,0,0,0,0,0,0,0,0,0,0,0,0,0,0,0,0
135740.0,Wang Yunlu,OH,China,26.0,191,2022,Italy,2022-07-14,False,1,3,18,22,0,0,5,5,9,3,19,31,0,4,1,5,10,1,9,20,6,3,0,9
172644.0,Wang Yizhu,OH,China,22.0,190,2022,Netherlands,2022-06-01,True,0,1,2,3,0,0,0,0,0,0,0,0,0,0,0,0,0,0,0,0,0,0,0,0
172644.0,Wang Yizhu,OH,China,22.0,190,2022,Italy,2022-06-04,True,0,0,0,0,0,0,0,0,0,0,0,0,0,0,0,0,0,0,0,0,0,0,0,0
172644.0,Wang Yizhu,OH,China,22.0,190,2022,Thailand,2022-06-05,False,0,0,2,2,0,0,0,0,0,0,0,0,0,0,0,0,0,0,0,0,1,0,0,1
172644.0,Wang Yizhu,OH,China,22.0,190,2022,Belgium,2022-06-15,True,0,0,0,0,0,0,0,0,0,0,0,0,0,0,0,0,0,0,0,0,0,0,0,0
172644.0,Wang Yizhu,OH,China,22.0,190,2022,Italy,2022-07-14,False,0,0,0,0,0,0,0,0,0,0,0,0,0,0,0,0,0,0,0,0,0,0,0,0
152318.0,Li Yingying,OH,China,23.0,192,2022,Netherlands,2022-06-01,True,0,1,13,14,0,1,1,2,19,3,23,45,0,5,4,9,5,0,11,16,6,6,5,17
152318.0,Li Yingying,OH,China,23.0,192,2022,Italy,2022-06-04,True,3,3,15,21,0,0,0,0,15,3,14,32,3,0,4,7,1,1,17,19,7,3,2,12
152318.0,Li Yingying,OH,China,23.0,192,2022,Thailand,2022-06-05,False,1,1,16,18,1,0,2,3,26,6,22,54,0,6,3,9,4,0,6,10,14,3,3,20
152318.0,Li Yingying,OH,China,23.0,192,2022,Belgium,2022-06-15,True,0,1,4,5,0,0,0,0,8,2,8,18,1,5,0,6,1,0,8,9,3,2,2,7
152318.0,Li Yingying,OH,China,23.0,192,2022,Canada,2022-06-17,True,3,0,15,18,0,0,3,3,17,8,7,32,0,0,2,2,5,1,8,14,8,3,1,12
152318.0,Li Yingying,OH,China,23.0,192,2022,USA,2022-06-18,False,0,2,7,9,0,1,0,1,12,4,5,21,1,2,3,6,7,2,6,15,6,2,0,8
152318.0,Li Yingying,OH,China,23.0,192,2022,Japan,2022-06-19,False,0,3,10,13,0,0,3,3,25,7,16,48,2,4,1,7,10,1,14,25,12,4,1,17
152318.0,Li Yingying,OH,China,23.0,192,2022,Brazil,2022-06-28,False,0,1,13,14,0,0,3,3,20,11,20,51,1,4,4,9,7,0,22,29,7,1,4,12
152318.0,Li Yingying,OH,China,23.0,192,2022,Poland,2022-06-30,True,1,4,9,14,0,0,0,0,11,4,9,24,3,1,0,4,5,0,5,10,3,2,1,6
152318.0,Li Yingying,OH,China,23.0,192,2022,Dominican Republic,2022-07-01,True,2,0,14,16,0,0,0,0,12,5,7,24,1,1,0,2,8,0,6,14,3,1,0,4
152318.0,Li Yingying,OH,China,23.0,192,2022,Italy,2022-07-14,False,0,2,8,10,0,0,8,8,14,8,13,35,2,8,4,14,13,1,11,25,14,2,0,16
152326.0,Cai Yaqian,S,China,24.0,179,2022,Brazil,2022-06-28,False,0,0,3,3,0,0,0,0,0,0,0,0,0,0,0,0,0,0,0,0,0,1,0,1
152326.0,Cai Yaqian,S,China,24.0,179,2022,Poland,2022-06-30,True,0,0,2,2,0,0,0,0,0,0,0,0,0,0,0,0,0,0,0,0,0,0,0,0
152326.0,Cai Yaqian,S,China,24.0,179,2022,Dominican Republic,2022-07-01,True,0,0,0,0,0,0,0,0,0,0,0,0,0,0,0,0,0,0,0,0,0,0,0,0
135742.0,Zheng Yixin,O,China,27.0,189,2022,Netherlands,2022-06-01,True,0,0,0,0,0,0,0,0,0,0,0,0,0,0,0,0,0,0,0,0,0,0,0,0
135742.0,Zheng Yixin,O,China,27.0,189,2022,Italy,2022-06-04,True,0,0,0,0,0,0,0,0,0,0,0,0,0,0,0,0,0,0,0,0,0,0,0,0
135742.0,Zheng Yixin,O,China,27.0,189,2022,Thailand,2022-06-05,False,0,0,0,0,0,0,0,0,0,0,0,0,0,0,0,0,0,0,0,0,0,0,0,0
135742.0,Zheng Yixin,O,China,27.0,189,2022,Belgium,2022-06-15,True,0,0,0,0,0,0,0,0,0,0,0,0,0,0,0,0,0,0,0,0,0,0,0,0
135742.0,Zheng Yixin,O,China,27.0,189,2022,Canada,2022-06-17,True,0,0,0,0,0,0,0,0,0,0,0,0,0,0,0,0,0,0,0,0,0,0,0,0
135742.0,Zheng Yixin,O,China,27.0,189,2022,USA,2022-06-18,False,0,0,0,0,0,0,0,0,0,0,0,0,0,0,0,0,0,0,0,0,0,0,0,0
135742.0,Zheng Yixin,O,China,27.0,189,2022,Japan,2022-06-19,False,0,0,3,3,0,0,1,1,0,1,1,2,0,4,1,5,0,0,0,0,1,1,0,2
150705.0,Wang Weiyi,L,China,27.0,175,2022,Netherlands,2022-06-01,True,0,0,0,0,0,0,12,12,0,0,0,0,0,0,0,0,3,0,12,15,14,5,2,21
150705.0,Wang Weiyi,L,China,27.0,175,2022,Italy,2022-06-04,True,0,0,0,0,0,0,3,3,0,0,0,0,0,0,0,0,3,2,7,12,4,3,6,13
150705.0,Wang Weiyi,L,China,27.0,175,2022,Thailand,2022-06-05,False,0,0,0,0,1,0,3,4,0,0,0,0,0,0,0,0,3,0,13,16,5,2,2,9
150705.0,Wang Weiyi,L,China,27.0,175,2022,Belgium,2022-06-15,True,0,0,0,0,0,0,5,5,0,0,0,0,0,0,0,0,1,1,12,14,4,1,1,6
150705.0,Wang Weiyi,L,China,27.0,175,2022,Canada,2022-06-17,True,0,0,0,0,0,0,4,4,0,0,0,0,0,0,0,0,2,2,6,10,4,1,0,5
150705.0,Wang Weiyi,L,China,27.0,175,2022,USA,2022-06-18,False,0,0,0,0,0,0,1,1,0,0,0,0,0,0,0,0,5,4,22,31,6,2,0,8
150705.0,Wang Weiyi,L,China,27.0,175,2022,Japan,2022-06-19,False,0,0,0,0,0,0,5,5,0,0,0,0,0,0,0,0,4,0,3,7,7,1,0,8
150705.0,Wang Weiyi,L,China,27.0,175,2022,Brazil,2022-06-28,False,0,0,0,0,0,0,4,4,0,0,0,0,0,0,0,0,4,0,13,17,13,0,1,14
150705.0,Wang Weiyi,L,China,27.0,175,2022,Poland,2022-06-30,True,0,0,0,0,0,0,8,8,0,0,0,0,0,0,0,0,4,1,10,15,14,2,4,20
150705.0,Wang Weiyi,L,China,27.0,175,2022,Dominican Republic,2022-07-01,True,0,0,0,0,2,0,0,2,0,0,0,0,0,0,0,0,2,1,10,13,4,2,2,8
150705.0,Wang Weiyi,L,China,27.0,175,2022,Italy,2022-07-14,False,0,0,0,0,0,0,7,7,0,0,0,0,0,0,0,0,2,3,23,28,14,2,2,18
124130.0,Ding Xia,S,China,33.0,180,2022,Netherlands,2022-06-01,True,0,0,4,4,0,0,18,18,0,0,0,0,0,0,1,1,0,0,0,0,0,1,0,1
124130.0,Ding Xia,S,China,33.0,180,2022,Italy,2022-06-04,True,1,0,9,10,36,0,17,53,1,0,2,3,0,0,3,3,0,0,0,0,4,2,2,8
124130.0,Ding Xia,S,China,33.0,180,2022,Thailand,2022-06-05,False,0,0,8,8,39,0,34,73,2,1,2,5,0,1,3,4,0,0,0,0,1,2,2,5
124130.0,Ding Xia,S,China,33.0,180,2022,Belgium,2022-06-15,True,1,2,13,16,27,1,45,73,1,0,1,2,2,0,3,5,0,0,0,0,6,3,2,11
124130.0,Ding Xia,S,China,33.0,180,2022,Canada,2022-06-17,True,0,0,7,7,23,0,70,93,1,0,1,2,1,2,2,5,0,0,1,1,8,2,2,12
124130.0,Ding Xia,S,China,33.0,180,2022,USA,2022-06-18,False,1,1,11,13,16,1,50,67,0,0,0,0,0,6,4,10,0,0,0,0,3,1,0,4
124130.0,Ding Xia,S,China,33.0,180,2022,Japan,2022-06-19,False,0,0,13,13,32,3,60,95,0,3,1,4,2,2,4,8,0,0,0,0,7,0,1,8
124130.0,Ding Xia,S,China,33.0,180,2022,Brazil,2022-06-28,False,0,0,0,0,1,0,2,3,0,0,0,0,0,0,0,0,0,0,0,0,1,0,0,1
124130.0,Ding Xia,S,China,33.0,180,2022,Poland,2022-06-30,True,0,0,0,0,0,0,3,3,0,0,0,0,0,0,1,1,0,0,0,0,0,0,0,0
124130.0,Ding Xia,S,China,33.0,180,2022,Dominican Republic,2022-07-01,True,0,0,0,0,0,0,0,0,0,0,0,0,0,0,0,0,0,0,0,0,0,0,0,0
124130.0,Ding Xia,S,China,33.0,180,2022,Italy,2022-07-14,False,0,0,0,0,0,0,3,3,0,0,0,0,0,0,0,0,0,0,0,0,0,0,0,0
163909.0,Ni Feifan,L,China,22.0,177,2022,Netherlands,2022-06-01,True,0,0,0,0,0,0,0,0,0,0,0,0,0,0,0,0,0,0,0,0,0,0,0,0
163909.0,Ni Feifan,L,China,22.0,177,2022,Italy,2022-06-04,True,0,0,0,0,0,0,2,2,0,0,0,0,0,0,0,0,0,0,0,0,2,0,1,3
163909.0,Ni Feifan,L,China,22.0,177,2022,Thailand,2022-06-05,False,0,0,0,0,1,0,2,3,0,0,0,0,0,0,0,0,0,0,0,0,10,0,0,10
163909.0,Ni Feifan,L,China,22.0,177,2022,Belgium,2022-06-15,True,0,0,0,0,0,0,0,0,0,0,0,0,0,0,0,0,0,0,0,0,0,0,0,0
163909.0,Ni Feifan,L,China,22.0,177,2022,Canada,2022-06-17,True,0,0,0,0,0,0,5,5,0,0,0,0,0,0,0,0,1,1,7,9,13,2,0,15
163909.0,Ni Feifan,L,China,22.0,177,2022,USA,2022-06-18,False,0,0,0,0,0,0,0,0,0,0,0,0,0,0,0,0,0,0,0,0,0,0,0,0
163909.0,Ni Feifan,L,China,22.0,177,2022,Japan,2022-06-19,False,0,0,0,0,0,0,7,7,0,0,0,0,0,0,0,0,3,1,6,10,15,0,1,16
163909.0,Ni Feifan,L,China,22.0,177,2022,Brazil,2022-06-28,False,0,0,0,0,1,0,4,5,0,0,0,0,0,0,0,0,0,0,0,0,8,3,1,12
163909.0,Ni Feifan,L,China,22.0,177,2022,Poland,2022-06-30,True,0,0,0,0,0,0,0,0,0,0,0,0,0,0,0,0,0,0,0,0,0,0,0,0
163909.0,Ni Feifan,L,China,22.0,177,2022,Dominican Republic,2022-07-01,True,0,0,0,0,1,0,0,1,0,0,0,0,0,0,0,0,0,0,0,0,5,1,0,6
163909.0,Ni Feifan,L,China,22.0,177,2022,Italy,2022-07-14,False,0,0,0,0,0,0,0,0,0,0,0,0,0,0,0,0,0,0,0,0,0,0,0,0
173642.0,Miao Yiwen,O,China,22.0,187,2022,Netherlands,2022-06-01,True,0,0,0,0,0,0,0,0,0,0,0,0,0,0,0,0,0,0,0,0,0,0,0,0
173642.0,Miao Yiwen,O,China,22.0,187,2022,Italy,2022-06-04,True,0,0,0,0,0,0,0,0,0,0,0,0,0,0,0,0,0,0,0,0,0,0,0,0
173642.0,Miao Yiwen,O,China,22.0,187,2022,Thailand,2022-06-05,False,0,0,1,1,0,0,0,0,0,1,0,1,0,0,0,0,0,0,1,1,0,0,0,0
162977.0,Chen Peiyan,O,China,23.0,195,2022,Belgium,2022-06-15,True,0,0,0,0,0,0,0,0,0,0,0,0,0,0,0,0,0,0,0,0,0,0,0,0
162977.0,Chen Peiyan,O,China,23.0,195,2022,Canada,2022-06-17,True,0,0,0,0,0,0,0,0,0,0,0,0,0,0,0,0,0,0,0,0,0,0,0,0
162977.0,Chen Peiyan,O,China,23.0,195,2022,USA,2022-06-18,False,0,0,0,0,0,0,0,0,0,0,0,0,0,0,0,0,0,0,0,0,0,0,0,0
162977.0,Chen Peiyan,O,China,23.0,195,2022,Japan,2022-06-19,False,0,0,0,0,0,0,0,0,0,0,0,0,0,0,0,0,0,0,0,0,0,0,0,0
162977.0,Chen Peiyan,O,China,23.0,195,2022,Brazil,2022-06-28,False,0,0,0,0,0,0,0,0,1,0,2,3,0,1,0,1,0,0,0,0,0,0,0,0
162977.0,Chen Peiyan,O,China,23.0,195,2022,Poland,2022-06-30,True,0,0,2,2,0,0,1,1,0,0,1,1,0,0,0,0,0,0,0,0,0,0,0,0
162977.0,Chen Peiyan,O,China,23.0,195,2022,Dominican Republic,2022-07-01,True,0,0,0,0,0,0,0,0,0,0,0,0,0,0,0,0,0,0,0,0,0,0,0,0
162977.0,Chen Peiyan,O,China,23.0,195,2022,Italy,2022-07-14,False,0,0,0,0,0,0,0,0,0,0,1,1,1,0,0,1,0,0,0,0,0,0,0,0
158817.0,Rodriguez Duran Yaneirys,L,Dominican Republic,22.0,171,2022,Brazil,2022-06-03,False,0,0,0,0,0,0,4,4,0,0,0,0,0,0,0,0,8,2,1,11,6,3,0,9
158817.0,Rodriguez Duran Yaneirys,L,Dominican Republic,22.0,171,2022,Japan,2022-06-04,False,0,0,0,0,0,0,0,0,0,0,0,0,0,0,0,0,0,0,0,0,0,0,0,0
158817.0,Rodriguez Duran Yaneirys,L,Dominican Republic,22.0,171,2022,Italy,2022-06-16,False,0,0,0,0,0,0,13,13,0,0,0,0,0,0,0,0,9,0,9,18,10,4,1,15
158817.0,Rodriguez Duran Yaneirys,L,Dominican Republic,22.0,171,2022,Germany,2022-06-19,True,0,0,0,0,0,1,12,13,0,0,0,0,0,0,0,0,7,2,15,24,9,5,2,16
168727.0,Rabit Esthefany,L,Dominican Republic,21.0,190,2022,Brazil,2022-06-03,False,0,0,0,0,0,0,0,0,0,0,0,0,0,0,0,0,0,0,0,0,0,0,0,0
168727.0,Rabit Esthefany,L,Dominican Republic,21.0,190,2022,Japan,2022-06-04,False,0,0,1,1,0,0,0,0,0,0,0,0,0,0,0,0,0,0,0,0,0,0,0,0
168727.0,Rabit Esthefany,L,Dominican Republic,21.0,190,2022,Italy,2022-06-16,False,0,0,0,0,0,0,0,0,0,0,0,0,0,0,0,0,0,0,0,0,0,0,0,0
168727.0,Rabit Esthefany,L,Dominican Republic,21.0,190,2022,Germany,2022-06-19,True,0,0,0,0,0,0,0,0,0,0,0,0,0,0,0,0,0,0,0,0,0,0,0,0
151087.0,Peralta Luna Vielka Michelle,OH,Dominican Republic,23.0,186,2022,Brazil,2022-06-03,False,2,0,8,10,0,0,5,5,5,4,14,23,0,0,1,1,11,1,19,31,4,2,0,6
151087.0,Peralta Luna Vielka Michelle,OH,Dominican Republic,23.0,186,2022,Japan,2022-06-04,False,0,0,8,8,0,0,1,1,7,4,18,29,1,2,1,4,17,1,13,31,11,3,1,15
151087.0,Peralta Luna Vielka Michelle,OH,Dominican Republic,23.0,186,2022,Italy,2022-06-16,False,0,0,1,1,0,0,0,0,3,0,1,4,0,1,1,2,1,0,2,3,1,0,1,2
151087.0,Peralta Luna Vielka Michelle,OH,Dominican Republic,23.0,186,2022,Germany,2022-06-19,True,0,0,1,1,0,0,0,0,0,0,3,3,0,0,1,1,1,0,1,2,0,0,0,0
151087.0,Peralta Luna Vielka Michelle,OH,Dominican Republic,23.0,186,2022,Bulgaria,2022-06-28,False,0,1,4,5,0,0,0,0,3,2,4,9,0,0,0,0,3,0,7,10,3,2,1,6
151087.0,Peralta Luna Vielka Michelle,OH,Dominican Republic,23.0,186,2022,Thailand,2022-06-30,True,0,0,2,2,0,0,0,0,0,0,0,0,0,0,0,0,1,0,0,1,0,0,0,0
151087.0,Peralta Luna Vielka Michelle,OH,Dominican Republic,23.0,186,2022,China,2022-07-01,False,0,1,7,8,2,0,0,2,8,2,7,17,0,1,0,1,2,1,14,17,0,0,1,1
151087.0,Peralta Luna Vielka Michelle,OH,Dominican Republic,23.0,186,2022,Poland,2022-07-02,True,0,0,1,1,0,0,0,0,4,2,3,9,0,0,0,0,0,0,2,2,1,0,0,1
119545.0,Dominguez Martinez Camil Inmaculada,S,Dominican Republic,31.0,176,2022,Brazil,2022-06-03,False,0,0,0,0,0,0,5,5,0,0,0,0,0,0,0,0,0,0,0,0,1,1,0,2
119545.0,Dominguez Martinez Camil Inmaculada,S,Dominican Republic,31.0,176,2022,Japan,2022-06-04,False,0,0,0,0,1,0,28,29,0,0,0,0,0,0,0,0,0,0,0,0,1,0,1,2
119545.0,Dominguez Martinez Camil Inmaculada,S,Dominican Republic,31.0,176,2022,Italy,2022-06-16,False,0,0,2,2,0,0,6,6,0,1,0,1,0,0,0,0,0,0,0,0,0,0,0,0
119545.0,Dominguez Martinez Camil Inmaculada,S,Dominican Republic,31.0,176,2022,Germany,2022-06-19,True,0,0,0,0,1,0,5,6,0,0,0,0,0,0,0,0,0,0,0,0,0,0,0,0
119545.0,Dominguez Martinez Camil Inmaculada,S,Dominican Republic,31.0,176,2022,Bulgaria,2022-06-28,False,0,0,1,1,0,0,0,0,0,0,0,0,0,0,0,0,0,0,0,0,0,0,0,0
119545.0,Dominguez Martinez Camil Inmaculada,S,Dominican Republic,31.0,176,2022,Thailand,2022-06-30,True,0,0,0,0,0,0,0,0,0,0,0,0,0,0,0,0,0,0,0,0,0,0,0,0
119545.0,Dominguez Martinez Camil Inmaculada,S,Dominican Republic,31.0,176,2022,China,2022-07-01,False,0,0,5,5,41,0,3,44,1,0,1,2,0,1,0,1,0,0,1,1,1,1,1,3
119545.0,Dominguez Martinez Camil Inmaculada,S,Dominican Republic,31.0,176,2022,Poland,2022-07-02,True,0,0,0,0,0,0,0,0,0,0,0,0,0,0,0,0,0,0,0,0,0,0,0,0
119585.0,Marte Frica Niverka Dharlenis,S,Dominican Republic,32.0,178,2022,Brazil,2022-06-03,False,0,0,6,6,7,0,76,83,1,0,4,5,0,2,3,5,1,0,0,1,10,2,0,12
119585.0,Marte Frica Niverka Dharlenis,S,Dominican Republic,32.0,178,2022,Japan,2022-06-04,False,1,1,7,9,12,1,75,88,0,2,3,5,0,1,1,2,0,0,0,0,9,1,0,10
119585.0,Marte Frica Niverka Dharlenis,S,Dominican Republic,32.0,178,2022,Italy,2022-06-16,False,2,1,13,16,22,0,84,106,1,1,3,5,0,5,4,9,0,0,0,0,6,1,1,8
119585.0,Marte Frica Niverka Dharlenis,S,Dominican Republic,32.0,178,2022,Germany,2022-06-19,True,0,2,10,12,18,1,78,97,0,1,2,3,0,2,1,3,0,0,0,0,5,2,1,8
119585.0,Marte Frica Niverka Dharlenis,S,Dominican Republic,32.0,178,2022,Bulgaria,2022-06-28,False,0,1,6,7,48,2,1,51,0,0,2,2,1,4,2,7,0,0,0,0,2,0,0,2
119585.0,Marte Frica Niverka Dharlenis,S,Dominican Republic,32.0,178,2022,Thailand,2022-06-30,True,0,0,10,10,94,1,2,97,0,0,0,0,0,2,3,5,0,0,0,0,4,5,4,13
119585.0,Marte Frica Niverka Dharlenis,S,Dominican Republic,32.0,178,2022,China,2022-07-01,False,0,0,3,3,31,0,1,32,0,0,0,0,0,1,0,1,0,0,0,0,0,0,1,1
119585.0,Marte Frica Niverka Dharlenis,S,Dominican Republic,32.0,178,2022,Poland,2022-07-02,True,0,2,16,18,10,1,137,148,1,1,2,4,1,5,6,12,0,0,0,0,9,0,1,10
143961.0,Hinojosa Diaz Angelica Maria,MB,Dominican Republic,26.0,186,2022,Brazil,2022-06-03,False,0,0,0,0,0,0,0,0,0,0,0,0,0,0,0,0,0,0,0,0,0,0,0,0
143961.0,Hinojosa Diaz Angelica Maria,MB,Dominican Republic,26.0,186,2022,Japan,2022-06-04,False,0,0,0,0,0,0,0,0,0,0,0,0,0,0,0,0,0,0,0,0,0,0,0,0
143961.0,Hinojosa Diaz Angelica Maria,MB,Dominican Republic,26.0,186,2022,Italy,2022-06-16,False,0,0,0,0,0,0,1,1,0,0,0,0,0,1,0,1,0,0,0,0,0,0,0,0
143961.0,Hinojosa Diaz Angelica Maria,MB,Dominican Republic,26.0,186,2022,Germany,2022-06-19,True,0,0,1,1,0,0,0,0,1,0,0,1,0,1,0,1,0,0,0,0,1,0,0,1
143961.0,Hinojosa Diaz Angelica Maria,MB,Dominican Republic,26.0,186,2022,Bulgaria,2022-06-28,False,0,0,0,0,0,0,0,0,0,0,0,0,0,0,0,0,0,0,0,0,0,0,0,0
143961.0,Hinojosa Diaz Angelica Maria,MB,Dominican Republic,26.0,186,2022,Thailand,2022-06-30,True,1,2,7,10,0,0,0,0,0,0,1,1,4,1,1,6,0,0,0,0,1,0,0,1
143961.0,Hinojosa Diaz Angelica Maria,MB,Dominican Republic,26.0,186,2022,China,2022-07-01,False,0,1,4,5,0,0,0,0,0,0,3,3,0,3,1,4,0,0,1,1,0,0,0,0
143961.0,Hinojosa Diaz Angelica Maria,MB,Dominican Republic,26.0,186,2022,Poland,2022-07-02,True,0,0,9,9,0,0,0,0,2,0,3,5,4,1,0,5,0,0,0,0,1,1,2,4
139912.0,Perez Javier Yokaty,S,Dominican Republic,24.0,178,2022,Bulgaria,2022-06-28,False,0,0,0,0,0,0,0,0,0,0,0,0,0,0,0,0,0,0,0,0,0,0,0,0
139912.0,Perez Javier Yokaty,S,Dominican Republic,24.0,178,2022,Thailand,2022-06-30,True,0,0,0,0,0,0,0,0,0,0,0,0,0,0,0,0,0,0,0,0,0,0,0,0
139912.0,Perez Javier Yokaty,S,Dominican Republic,24.0,178,2022,China,2022-07-01,False,0,0,2,2,6,1,1,8,0,0,0,0,0,0,0,0,0,0,0,0,1,0,1,2
139912.0,Perez Javier Yokaty,S,Dominican Republic,24.0,178,2022,Poland,2022-07-02,True,0,0,0,0,0,0,0,0,0,0,0,0,0,0,0,0,0,0,0,0,0,0,0,0
139911.0,Matos Duran Massiel,OH,Dominican Republic,24.0,188,2022,Bulgaria,2022-06-28,False,0,0,0,0,0,0,0,0,0,0,0,0,0,0,0,0,0,0,0,0,0,0,0,0
139911.0,Matos Duran Massiel,OH,Dominican Republic,24.0,188,2022,Thailand,2022-06-30,True,0,0,0,0,0,0,0,0,0,0,0,0,0,0,0,0,0,0,0,0,0,0,0,0
139911.0,Matos Duran Massiel,OH,Dominican Republic,24.0,188,2022,China,2022-07-01,False,0,1,0,1,0,0,0,0,2,3,1,6,0,3,0,3,0,0,4,4,2,0,1,3
139911.0,Matos Duran Massiel,OH,Dominican Republic,24.0,188,2022,Poland,2022-07-02,True,0,0,0,0,0,0,0,0,0,0,0,0,0,0,0,0,0,0,0,0,0,0,0,0
149531.0,Guillen Paredes Madeline Jazmin,OH,Dominican Republic,21.0,186,2022,Brazil,2022-06-03,False,0,1,5,6,0,0,0,0,1,4,2,7,0,1,0,1,2,0,4,6,3,1,0,4
149531.0,Guillen Paredes Madeline Jazmin,OH,Dominican Republic,21.0,186,2022,Japan,2022-06-04,False,0,1,2,3,0,0,0,0,1,1,4,6,0,1,1,2,5,0,1,6,2,1,0,3
149531.0,Guillen Paredes Madeline Jazmin,OH,Dominican Republic,21.0,186,2022,Italy,2022-06-16,False,0,1,7,8,0,0,0,0,0,0,0,0,0,0,0,0,0,0,0,0,0,1,0,1
149531.0,Guillen Paredes Madeline Jazmin,OH,Dominican Republic,21.0,186,2022,Germany,2022-06-19,True,0,0,3,3,0,0,0,0,0,1,0,1,0,0,0,0,0,1,1,2,0,0,0,0
123978.0,Peña Isabel Yonkaira Paola,OH,Dominican Republic,29.0,190,2022,Brazil,2022-06-03,False,1,3,11,15,0,0,3,3,15,6,26,47,1,1,1,3,8,1,9,18,12,4,0,16
123978.0,Peña Isabel Yonkaira Paola,OH,Dominican Republic,29.0,190,2022,Japan,2022-06-04,False,1,1,12,14,0,0,5,5,16,2,28,46,2,0,1,3,25,2,5,32,16,3,0,19
123978.0,Peña Isabel Yonkaira Paola,OH,Dominican Republic,29.0,190,2022,Italy,2022-06-16,False,0,4,13,17,0,0,5,5,19,9,15,43,1,1,3,5,22,1,18,41,4,1,2,7
123978.0,Peña Isabel Yonkaira Paola,OH,Dominican Republic,29.0,190,2022,Germany,2022-06-19,True,0,2,14,16,0,0,2,2,16,8,11,35,2,1,4,7,3,0,13,16,10,0,2,12
123978.0,Peña Isabel Yonkaira Paola,OH,Dominican Republic,29.0,190,2022,Bulgaria,2022-06-28,False,0,0,6,6,1,1,0,2,3,2,11,16,0,0,0,0,2,2,21,25,1,0,0,1
123978.0,Peña Isabel Yonkaira Paola,OH,Dominican Republic,29.0,190,2022,Thailand,2022-06-30,True,1,2,15,18,3,0,1,4,18,6,16,40,0,4,3,7,5,1,19,25,8,1,3,12
123978.0,Peña Isabel Yonkaira Paola,OH,Dominican Republic,29.0,190,2022,China,2022-07-01,False,1,1,7,9,2,0,0,2,11,8,11,30,3,2,1,6,2,2,24,28,2,2,2,6
123978.0,Peña Isabel Yonkaira Paola,OH,Dominican Republic,29.0,190,2022,Poland,2022-07-02,True,2,1,11,14,0,0,4,4,13,8,18,39,0,6,2,8,5,4,16,25,8,2,5,15
115391.0,Mambru Casilla Gina Altagracia,O,Dominican Republic,37.0,182,2022,Brazil,2022-06-03,False,0,0,2,2,0,0,1,1,0,0,0,0,0,0,0,0,0,0,0,0,0,0,0,0
115391.0,Mambru Casilla Gina Altagracia,O,Dominican Republic,37.0,182,2022,Japan,2022-06-04,False,0,2,1,3,0,0,1,1,2,1,6,9,0,1,1,2,0,0,0,0,2,0,0,2
115391.0,Mambru Casilla Gina Altagracia,O,Dominican Republic,37.0,182,2022,Italy,2022-06-16,False,0,1,0,1,0,0,3,3,1,0,0,1,0,1,0,1,0,0,0,0,1,0,0,1
115391.0,Mambru Casilla Gina Altagracia,O,Dominican Republic,37.0,182,2022,Germany,2022-06-19,True,0,0,1,1,0,0,0,0,0,0,2,2,0,1,1,2,0,0,0,0,0,0,0,0
123982.0,Martinez Brayelin Elizabeth,OH,Dominican Republic,26.0,201,2022,Brazil,2022-06-03,False,0,0,0,0,0,0,0,0,0,0,0,0,0,0,0,0,0,0,0,0,0,0,0,0
123982.0,Martinez Brayelin Elizabeth,OH,Dominican Republic,26.0,201,2022,Japan,2022-06-04,False,0,0,0,0,0,0,0,0,0,0,0,0,0,0,0,0,0,0,0,0,0,0,0,0
123982.0,Martinez Brayelin Elizabeth,OH,Dominican Republic,26.0,201,2022,Italy,2022-06-16,False,0,3,10,13,0,0,5,5,15,3,18,36,2,1,6,9,6,0,18,24,9,0,4,13
123982.0,Martinez Brayelin Elizabeth,OH,Dominican Republic,26.0,201,2022,Germany,2022-06-19,True,0,3,6,9,0,0,3,3,9,4,18,31,0,1,5,6,8,2,18,28,5,2,1,8
123982.0,Martinez Brayelin Elizabeth,OH,Dominican Republic,26.0,201,2022,Bulgaria,2022-06-28,False,0,2,11,13,0,0,0,0,3,4,9,16,0,1,0,1,1,1,7,9,2,0,1,3
123982.0,Martinez Brayelin Elizabeth,OH,Dominican Republic,26.0,201,2022,Thailand,2022-06-30,True,0,2,15,17,3,0,0,3,19,3,20,42,0,3,3,6,3,3,16,22,11,4,0,15
123982.0,Martinez Brayelin Elizabeth,OH,Dominican Republic,26.0,201,2022,China,2022-07-01,False,0,1,1,2,0,0,0,0,4,1,6,11,1,1,0,2,0,1,11,12,4,0,1,5
123982.0,Martinez Brayelin Elizabeth,OH,Dominican Republic,26.0,201,2022,Poland,2022-07-02,True,1,2,16,19,0,0,4,4,19,7,16,42,3,5,2,10,2,1,24,27,14,2,3,19
139910.0,Martinez Jineiry,MB,Dominican Republic,25.0,192,2022,Brazil,2022-06-03,False,0,2,8,10,0,0,2,2,5,1,2,8,1,0,2,3,0,0,0,0,1,1,0,2
139910.0,Martinez Jineiry,MB,Dominican Republic,25.0,192,2022,Japan,2022-06-04,False,0,0,14,14,0,0,5,5,3,2,10,15,2,5,6,13,1,0,0,1,9,1,0,10
139910.0,Martinez Jineiry,MB,Dominican Republic,25.0,192,2022,Italy,2022-06-16,False,2,0,16,18,0,0,0,0,7,1,5,13,2,4,4,10,0,0,0,0,1,0,0,1
139910.0,Martinez Jineiry,MB,Dominican Republic,25.0,192,2022,Germany,2022-06-19,True,0,2,14,16,0,0,1,1,8,1,8,17,8,4,10,22,0,0,0,0,1,1,0,2
139910.0,Martinez Jineiry,MB,Dominican Republic,25.0,192,2022,Bulgaria,2022-06-28,False,0,0,5,5,3,0,0,3,8,1,4,13,1,4,0,5,0,1,0,1,1,0,0,1
139910.0,Martinez Jineiry,MB,Dominican Republic,25.0,192,2022,Thailand,2022-06-30,True,0,2,15,17,2,0,0,2,11,4,9,24,2,2,1,5,0,0,0,0,3,0,1,4
139910.0,Martinez Jineiry,MB,Dominican Republic,25.0,192,2022,China,2022-07-01,False,0,0,2,2,0,0,0,0,0,0,5,5,1,1,0,2,0,0,0,0,0,0,0,0
139910.0,Martinez Jineiry,MB,Dominican Republic,25.0,192,2022,Poland,2022-07-02,True,1,1,18,20,0,0,0,0,9,2,9,20,2,13,5,20,0,1,2,3,4,0,1,5
162342.0,Caraballo Arias Samaret Jailene,OH,Dominican Republic,23.0,179,2022,Bulgaria,2022-06-28,False,0,0,3,3,0,0,0,0,0,0,0,0,0,0,0,0,0,0,2,2,0,0,0,0
162342.0,Caraballo Arias Samaret Jailene,OH,Dominican Republic,23.0,179,2022,Thailand,2022-06-30,True,0,0,0,0,0,0,0,0,0,0,0,0,0,0,0,0,0,0,0,0,0,0,0,0
162342.0,Caraballo Arias Samaret Jailene,OH,Dominican Republic,23.0,179,2022,China,2022-07-01,False,0,0,0,0,0,0,0,0,0,0,0,0,0,0,0,0,0,0,2,2,2,0,3,5
162342.0,Caraballo Arias Samaret Jailene,OH,Dominican Republic,23.0,179,2022,Poland,2022-07-02,True,0,0,5,5,0,0,1,1,0,0,0,0,0,0,0,0,2,0,3,5,5,1,0,6
139927.0,Gonzalez Lopez Gaila Ceneida,O,Dominican Republic,25.0,190,2022,Brazil,2022-06-03,False,2,1,9,12,0,0,2,2,12,7,10,29,2,4,1,7,1,0,1,2,6,1,0,7
139927.0,Gonzalez Lopez Gaila Ceneida,O,Dominican Republic,25.0,190,2022,Japan,2022-06-04,False,0,1,8,9,0,0,0,0,10,8,13,31,4,2,1,7,0,0,0,0,6,2,0,8
139927.0,Gonzalez Lopez Gaila Ceneida,O,Dominican Republic,25.0,190,2022,Italy,2022-06-16,False,0,3,11,14,0,0,1,1,13,9,11,33,3,1,2,6,1,0,0,1,4,2,1,7
139927.0,Gonzalez Lopez Gaila Ceneida,O,Dominican Republic,25.0,190,2022,Germany,2022-06-19,True,1,3,11,15,0,0,1,1,15,2,9,26,1,1,4,6,2,1,4,7,6,5,0,11
139927.0,Gonzalez Lopez Gaila Ceneida,O,Dominican Republic,25.0,190,2022,Bulgaria,2022-06-28,False,0,1,6,7,0,0,0,0,8,6,9,23,2,4,2,8,0,0,0,0,0,0,2,2
139927.0,Gonzalez Lopez Gaila Ceneida,O,Dominican Republic,25.0,190,2022,Thailand,2022-06-30,True,2,3,14,19,0,0,0,0,15,3,15,33,1,5,2,8,0,0,0,0,5,1,1,7
139927.0,Gonzalez Lopez Gaila Ceneida,O,Dominican Republic,25.0,190,2022,China,2022-07-01,False,2,1,4,7,0,0,0,0,8,5,8,21,0,1,1,2,0,0,0,0,2,2,2,6
139927.0,Gonzalez Lopez Gaila Ceneida,O,Dominican Republic,25.0,190,2022,Poland,2022-07-02,True,0,5,14,19,0,0,1,1,21,9,14,44,2,6,3,11,1,0,2,3,5,2,2,9
149530.0,Gonzalez Geraldine Sthefany,MB,Dominican Republic,20.0,200,2022,Brazil,2022-06-03,False,0,4,5,9,0,0,2,2,3,2,2,7,0,4,4,8,0,0,0,0,2,0,1,3
149530.0,Gonzalez Geraldine Sthefany,MB,Dominican Republic,20.0,200,2022,Japan,2022-06-04,False,1,3,9,13,0,0,1,1,3,2,4,9,4,6,3,13,0,0,1,1,3,0,0,3
149530.0,Gonzalez Geraldine Sthefany,MB,Dominican Republic,20.0,200,2022,Italy,2022-06-16,False,0,3,11,14,0,0,4,4,5,1,0,6,3,3,3,9,0,1,1,2,1,0,0,1
149530.0,Gonzalez Geraldine Sthefany,MB,Dominican Republic,20.0,200,2022,Germany,2022-06-19,True,0,2,9,11,0,1,2,3,2,1,0,3,0,0,5,5,0,0,2,2,1,1,0,2
149530.0,Gonzalez Geraldine Sthefany,MB,Dominican Republic,20.0,200,2022,Bulgaria,2022-06-28,False,0,1,3,4,0,0,0,0,4,3,1,8,0,0,0,0,0,0,0,0,0,0,0,0
149530.0,Gonzalez Geraldine Sthefany,MB,Dominican Republic,20.0,200,2022,Thailand,2022-06-30,True,0,0,3,3,0,0,0,0,1,1,0,2,1,2,3,6,0,0,0,0,0,0,1,1
149530.0,Gonzalez Geraldine Sthefany,MB,Dominican Republic,20.0,200,2022,China,2022-07-01,False,0,1,6,7,4,1,0,5,1,1,2,4,0,4,1,5,0,0,1,1,1,0,2,3
149530.0,Gonzalez Geraldine Sthefany,MB,Dominican Republic,20.0,200,2022,Poland,2022-07-02,True,0,1,5,6,0,0,2,2,0,1,2,3,0,0,0,0,0,0,0,0,1,0,0,1
139913.0,Martinez Caro Larysmer,L,Dominican Republic,26.0,174,2022,Brazil,2022-06-03,False,0,0,0,0,0,0,5,5,0,0,0,0,0,0,0,0,6,2,9,17,11,4,0,15
139913.0,Martinez Caro Larysmer,L,Dominican Republic,26.0,174,2022,Japan,2022-06-04,False,0,0,0,0,0,0,12,12,0,0,0,0,0,0,0,0,8,0,6,14,17,5,1,23
139913.0,Martinez Caro Larysmer,L,Dominican Republic,26.0,174,2022,Italy,2022-06-16,False,0,0,0,0,0,0,0,0,0,0,0,0,0,0,0,0,0,0,0,0,0,0,0,0
139913.0,Martinez Caro Larysmer,L,Dominican Republic,26.0,174,2022,Germany,2022-06-19,True,0,0,2,2,0,0,0,0,0,0,0,0,0,0,0,0,0,0,4,4,0,0,0,0
139913.0,Martinez Caro Larysmer,L,Dominican Republic,26.0,174,2022,Bulgaria,2022-06-28,False,0,0,0,0,0,0,0,0,0,0,0,0,0,0,0,0,1,1,18,20,0,2,1,3
139913.0,Martinez Caro Larysmer,L,Dominican Republic,26.0,174,2022,Thailand,2022-06-30,True,0,0,0,0,7,0,1,8,0,0,0,0,0,0,0,0,7,2,25,34,16,4,4,24
139913.0,Martinez Caro Larysmer,L,Dominican Republic,26.0,174,2022,China,2022-07-01,False,0,0,0,0,4,0,0,4,0,0,0,0,0,0,0,0,0,1,6,7,4,0,5,9
139913.0,Martinez Caro Larysmer,L,Dominican Republic,26.0,174,2022,Poland,2022-07-02,True,0,0,0,0,0,0,6,6,0,0,0,0,0,0,0,0,8,2,27,37,10,3,1,14
152140.0,Bock Linda,L,Germany,22.0,172,2022,Brazil,2022-05-31,False,0,0,0,0,0,0,0,0,0,0,0,0,0,0,0,0,0,1,1,2,0,0,0,0
152140.0,Bock Linda,L,Germany,22.0,172,2022,Japan,2022-06-02,False,0,0,2,2,0,0,0,0,1,0,0,1,0,0,0,0,0,0,2,2,2,1,0,3
152140.0,Bock Linda,L,Germany,22.0,172,2022,Poland,2022-06-05,False,0,0,0,0,0,0,0,0,0,0,0,0,0,0,0,0,0,0,0,0,0,0,0,0
152140.0,Bock Linda,L,Germany,22.0,172,2022,Netherlands,2022-06-14,True,0,0,0,0,0,0,0,0,0,0,0,0,0,0,0,0,0,0,0,0,0,0,0,0
152140.0,Bock Linda,L,Germany,22.0,172,2022,Italy,2022-06-17,False,0,0,0,0,0,0,0,0,0,0,0,0,0,0,0,0,0,0,0,0,0,0,0,0
152140.0,Bock Linda,L,Germany,22.0,172,2022,Dominican Republic,2022-06-19,False,0,0,0,0,0,0,0,0,0,0,0,0,0,0,0,0,0,0,0,0,0,0,0,0
150973.0,Kästner Pia,S,Germany,24.0,182,2022,Brazil,2022-05-31,False,2,0,11,13,20,0,72,92,1,0,1,2,0,3,2,5,0,0,1,1,11,3,0,14
150973.0,Kästner Pia,S,Germany,24.0,182,2022,Japan,2022-06-02,False,0,1,5,6,19,0,37,56,1,1,1,3,0,0,3,3,0,0,0,0,1,3,0,4
150973.0,Kästner Pia,S,Germany,24.0,182,2022,Poland,2022-06-05,False,0,0,3,3,4,0,27,31,1,0,1,2,0,1,0,1,0,0,0,0,2,0,1,3
150973.0,Kästner Pia,S,Germany,24.0,182,2022,Netherlands,2022-06-14,True,0,1,8,9,9,0,30,39,1,0,0,1,0,0,0,0,0,0,0,0,4,0,2,6
150973.0,Kästner Pia,S,Germany,24.0,182,2022,Italy,2022-06-17,False,1,0,11,12,19,0,55,74,1,1,0,2,1,2,2,5,0,0,0,0,1,2,3,6
150973.0,Kästner Pia,S,Germany,24.0,182,2022,Dominican Republic,2022-06-19,False,0,2,5,7,32,0,71,103,1,0,0,1,0,3,4,7,0,0,0,0,3,2,1,6
150973.0,Kästner Pia,S,Germany,24.0,182,2022,Serbia,2022-06-28,False,0,0,14,14,19,0,84,103,0,0,1,1,0,1,2,3,0,0,0,0,10,1,0,11
150973.0,Kästner Pia,S,Germany,24.0,182,2022,Belgium,2022-06-30,True,1,0,12,13,7,0,97,104,2,0,2,4,0,1,0,1,0,0,0,0,16,0,0,16
150973.0,Kästner Pia,S,Germany,24.0,182,2022,USA,2022-07-03,False,1,0,10,11,5,0,102,107,0,1,1,2,0,2,1,3,0,0,0,0,15,2,0,17
136671.0,Pogany Anna,L,Germany,28.0,170,2022,Brazil,2022-05-31,False,0,0,0,0,0,0,10,10,0,0,0,0,0,0,0,0,29,0,14,43,18,2,1,21
136671.0,Pogany Anna,L,Germany,28.0,170,2022,Japan,2022-06-02,False,0,0,0,0,0,0,17,17,0,0,0,0,0,0,0,0,35,2,15,52,26,5,0,31
136671.0,Pogany Anna,L,Germany,28.0,170,2022,Poland,2022-06-05,False,0,0,0,0,0,0,11,11,0,0,0,0,0,0,0,0,20,2,11,33,20,7,0,27
136671.0,Pogany Anna,L,Germany,28.0,170,2022,Netherlands,2022-06-14,True,0,0,0,0,0,0,0,0,0,0,0,0,0,0,0,0,7,1,10,18,9,7,0,16
136671.0,Pogany Anna,L,Germany,28.0,170,2022,Italy,2022-06-17,False,0,0,0,0,0,0,5,5,0,0,0,0,0,0,0,0,8,0,6,14,3,7,4,14
136671.0,Pogany Anna,L,Germany,28.0,170,2022,Dominican Republic,2022-06-19,False,0,0,0,0,0,0,9,9,0,0,0,0,0,0,0,0,15,0,12,27,11,4,2,17
136671.0,Pogany Anna,L,Germany,28.0,170,2022,Serbia,2022-06-28,False,0,0,0,0,1,0,12,13,0,0,0,0,0,0,0,0,2,0,8,10,7,3,0,10
136671.0,Pogany Anna,L,Germany,28.0,170,2022,Belgium,2022-06-30,True,0,0,0,0,0,0,16,16,0,0,0,0,0,0,0,0,12,2,4,18,11,1,0,12
136671.0,Pogany Anna,L,Germany,28.0,170,2022,USA,2022-07-03,False,0,0,0,0,0,0,11,11,0,0,0,0,0,0,0,0,8,0,9,17,10,1,0,11
163661.0,Glaab Corina,S,Germany,22.0,180,2022,Brazil,2022-05-31,False,0,0,5,5,11,0,27,38,0,0,0,0,0,1,0,1,0,0,0,0,4,2,0,6
163661.0,Glaab Corina,S,Germany,22.0,180,2022,Japan,2022-06-02,False,0,2,9,11,19,0,67,86,0,0,1,1,0,1,0,1,0,0,0,0,13,4,0,17
163661.0,Glaab Corina,S,Germany,22.0,180,2022,Poland,2022-06-05,False,0,1,11,12,17,1,74,92,0,0,1,1,0,2,0,2,0,0,0,0,9,4,0,13
163661.0,Glaab Corina,S,Germany,22.0,180,2022,Netherlands,2022-06-14,True,0,0,8,8,23,0,81,104,0,0,0,0,1,2,1,4,0,0,0,0,7,2,0,9
163661.0,Glaab Corina,S,Germany,22.0,180,2022,Italy,2022-06-17,False,0,0,0,0,0,0,4,4,0,0,0,0,0,0,0,0,0,0,0,0,0,0,0,0
163661.0,Glaab Corina,S,Germany,22.0,180,2022,Dominican Republic,2022-06-19,False,0,0,2,2,7,1,5,13,1,0,1,2,0,1,0,1,0,0,0,0,3,0,0,3
163661.0,Glaab Corina,S,Germany,22.0,180,2022,Serbia,2022-06-28,False,0,0,0,0,0,0,0,0,0,0,0,0,0,0,0,0,0,0,0,0,0,0,0,0
163661.0,Glaab Corina,S,Germany,22.0,180,2022,Belgium,2022-06-30,True,0,0,0,0,0,0,5,5,0,0,0,0,0,0,0,0,0,0,0,0,0,0,0,0
163661.0,Glaab Corina,S,Germany,22.0,180,2022,USA,2022-07-03,False,0,0,0,0,0,0,0,0,0,0,0,0,0,0,0,0,0,0,0,0,0,0,0,0
123911.0,Janiska Jennifer,OH,Germany,28.0,184,2022,Brazil,2022-05-31,False,1,2,19,22,0,0,7,7,13,4,15,32,1,1,0,2,4,0,4,8,17,3,0,20
123911.0,Janiska Jennifer,OH,Germany,28.0,184,2022,Japan,2022-06-02,False,0,0,9,9,0,0,1,1,2,4,6,12,0,0,1,1,5,0,1,6,9,0,0,9
123911.0,Janiska Jennifer,OH,Germany,28.0,184,2022,Poland,2022-06-05,False,0,0,2,2,0,0,2,2,0,0,0,0,0,0,0,0,5,0,2,7,5,3,0,8
123911.0,Janiska Jennifer,OH,Germany,28.0,184,2022,Netherlands,2022-06-14,True,0,0,8,8,0,0,0,0,4,2,6,12,0,0,0,0,5,0,3,8,1,0,1,2
123911.0,Janiska Jennifer,OH,Germany,28.0,184,2022,Italy,2022-06-17,False,0,0,4,4,0,0,0,0,1,1,0,2,0,0,1,1,1,0,2,3,1,0,1,2
123911.0,Janiska Jennifer,OH,Germany,28.0,184,2022,Dominican Republic,2022-06-19,False,2,1,12,15,0,0,2,2,7,7,14,28,0,1,0,1,9,0,9,18,6,1,0,7
123911.0,Janiska Jennifer,OH,Germany,28.0,184,2022,Serbia,2022-06-28,False,0,0,2,2,0,0,1,1,3,1,5,9,1,0,0,1,2,0,8,10,4,0,0,4
123911.0,Janiska Jennifer,OH,Germany,28.0,184,2022,Belgium,2022-06-30,True,0,1,21,22,0,0,13,13,7,4,15,26,0,2,1,3,9,0,6,15,14,3,0,17
123911.0,Janiska Jennifer,OH,Germany,28.0,184,2022,USA,2022-07-03,False,0,0,6,6,0,0,2,2,3,2,5,10,0,0,0,0,5,0,4,9,7,1,1,9
168102.0,Vanjak Ivana,OH,Germany,27.0,193,2022,Brazil,2022-05-31,False,0,2,4,6,0,0,0,0,4,2,13,19,0,0,0,0,4,0,2,6,1,0,0,1
168102.0,Vanjak Ivana,OH,Germany,27.0,193,2022,Japan,2022-06-02,False,1,1,4,6,0,0,0,0,7,3,10,20,1,0,1,2,8,1,1,10,7,3,0,10
168102.0,Vanjak Ivana,OH,Germany,27.0,193,2022,Poland,2022-06-05,False,0,2,1,3,0,0,0,0,7,1,11,19,0,2,2,4,4,1,4,9,7,2,1,10
168102.0,Vanjak Ivana,OH,Germany,27.0,193,2022,Netherlands,2022-06-14,True,0,0,1,1,0,0,0,0,0,1,1,2,0,0,0,0,0,0,0,0,1,1,0,2
168102.0,Vanjak Ivana,OH,Germany,27.0,193,2022,Italy,2022-06-17,False,0,0,0,0,0,0,0,0,0,1,0,1,0,0,0,0,0,0,0,0,0,0,0,0
168102.0,Vanjak Ivana,OH,Germany,27.0,193,2022,Dominican Republic,2022-06-19,False,0,0,0,0,0,0,0,0,0,0,0,0,0,0,0,0,0,0,0,0,0,0,0,0
168102.0,Vanjak Ivana,OH,Germany,27.0,193,2022,Serbia,2022-06-28,False,0,0,3,3,0,0,0,0,1,1,2,4,0,2,1,3,1,0,3,4,2,0,0,2
168102.0,Vanjak Ivana,OH,Germany,27.0,193,2022,Belgium,2022-06-30,True,0,0,0,0,0,0,0,0,0,0,0,0,0,0,0,0,0,0,0,0,0,0,0,0
168102.0,Vanjak Ivana,OH,Germany,27.0,193,2022,USA,2022-07-03,False,0,2,0,2,0,0,2,2,3,3,3,9,0,0,2,2,1,0,2,3,0,2,0,2
163658.0,Alsmeier Lina,OH,Germany,22.0,189,2022,Brazil,2022-05-31,False,0,3,3,6,0,0,0,0,3,2,6,11,0,1,1,2,8,0,3,11,4,2,0,6
163658.0,Alsmeier Lina,OH,Germany,22.0,189,2022,Japan,2022-06-02,False,1,1,6,8,0,0,6,6,13,2,22,37,2,1,0,3,4,0,7,11,11,1,0,12
163658.0,Alsmeier Lina,OH,Germany,22.0,189,2022,Poland,2022-06-05,False,2,4,12,18,0,0,3,3,17,7,15,39,2,2,1,5,9,0,7,16,16,4,0,20
163658.0,Alsmeier Lina,OH,Germany,22.0,189,2022,Netherlands,2022-06-14,True,0,3,9,12,0,1,1,2,14,0,12,26,0,3,3,6,18,3,8,29,4,2,2,8
163658.0,Alsmeier Lina,OH,Germany,22.0,189,2022,Italy,2022-06-17,False,2,3,10,15,0,0,3,3,7,1,8,16,2,0,1,3,12,1,18,31,4,3,1,8
163658.0,Alsmeier Lina,OH,Germany,22.0,189,2022,Dominican Republic,2022-06-19,False,2,1,16,19,0,0,2,2,9,6,6,21,0,0,1,1,6,0,3,9,11,3,1,15
163658.0,Alsmeier Lina,OH,Germany,22.0,189,2022,Serbia,2022-06-28,False,2,3,9,14,0,0,3,3,9,4,11,24,1,2,1,4,2,2,30,34,5,1,2,8
163658.0,Alsmeier Lina,OH,Germany,22.0,189,2022,Belgium,2022-06-30,True,1,3,7,11,0,0,6,6,27,3,17,47,0,0,2,2,7,0,3,10,9,0,0,9
163658.0,Alsmeier Lina,OH,Germany,22.0,189,2022,USA,2022-07-03,False,0,1,8,9,0,0,8,8,7,3,12,22,0,0,0,0,3,1,7,11,7,3,0,10
144980.0,Stigrot Lena,OH,Germany,28.0,184,2022,Brazil,2022-05-31,False,0,0,8,8,0,0,2,2,9,5,18,32,1,2,0,3,6,1,10,17,10,2,1,13
144980.0,Stigrot Lena,OH,Germany,28.0,184,2022,Japan,2022-06-02,False,0,0,15,15,0,0,5,5,12,4,18,34,1,1,1,3,5,0,3,8,13,2,2,17
144980.0,Stigrot Lena,OH,Germany,28.0,184,2022,Poland,2022-06-05,False,0,0,18,18,0,0,4,4,9,1,22,32,2,3,1,6,9,1,6,16,10,1,1,12
144980.0,Stigrot Lena,OH,Germany,28.0,184,2022,Netherlands,2022-06-14,True,0,0,12,12,0,1,0,1,8,1,16,25,1,5,2,8,6,0,4,10,3,0,0,3
144980.0,Stigrot Lena,OH,Germany,28.0,184,2022,Italy,2022-06-17,False,1,0,10,11,0,0,0,0,5,1,12,18,0,0,1,1,4,1,7,12,1,0,1,2
144980.0,Stigrot Lena,OH,Germany,28.0,184,2022,Dominican Republic,2022-06-19,False,0,0,7,7,0,0,1,1,5,4,7,16,4,1,0,5,1,0,2,3,2,0,0,2
144980.0,Stigrot Lena,OH,Germany,28.0,184,2022,Serbia,2022-06-28,False,0,0,5,5,0,0,2,2,6,2,8,16,1,2,4,7,4,0,6,10,7,1,0,8
144980.0,Stigrot Lena,OH,Germany,28.0,184,2022,Belgium,2022-06-30,True,0,1,12,13,0,0,3,3,13,1,12,26,1,7,0,8,12,0,16,28,9,2,0,11
144980.0,Stigrot Lena,OH,Germany,28.0,184,2022,USA,2022-07-03,False,0,1,4,5,0,0,3,3,6,3,10,19,0,0,1,1,5,1,8,14,5,0,0,5
151016.0,Orthmann Hanna,OH,Germany,24.0,-,2022,Brazil,2022-05-31,False,1,2,6,9,0,0,0,0,14,7,18,39,0,2,0,2,2,1,3,6,3,2,0,5
151016.0,Orthmann Hanna,OH,Germany,24.0,-,2022,Japan,2022-06-02,False,1,3,7,11,0,1,3,4,11,4,15,30,0,1,1,2,3,0,0,3,5,3,0,8
151016.0,Orthmann Hanna,OH,Germany,24.0,-,2022,Poland,2022-06-05,False,1,5,10,16,0,0,1,1,18,4,12,34,2,1,0,3,3,1,3,7,4,0,1,5
151016.0,Orthmann Hanna,OH,Germany,24.0,-,2022,Netherlands,2022-06-14,True,0,5,6,11,0,0,0,0,22,5,17,44,1,2,2,5,5,0,5,10,3,1,1,5
151016.0,Orthmann Hanna,OH,Germany,24.0,-,2022,Italy,2022-06-17,False,1,3,5,9,0,0,0,0,11,5,17,33,1,1,1,3,2,0,5,7,0,1,0,1
151016.0,Orthmann Hanna,OH,Germany,24.0,-,2022,Dominican Republic,2022-06-19,False,2,4,6,12,0,0,1,1,20,5,14,39,0,1,0,1,7,1,8,16,4,1,1,6
151016.0,Orthmann Hanna,OH,Germany,24.0,-,2022,Serbia,2022-06-28,False,0,3,7,10,0,0,2,2,13,9,16,38,1,3,1,5,2,0,10,12,2,1,0,3
151016.0,Orthmann Hanna,OH,Germany,24.0,-,2022,Belgium,2022-06-30,True,0,1,4,5,0,0,1,1,5,2,10,17,0,0,1,1,0,0,2,2,3,1,0,4
151016.0,Orthmann Hanna,OH,Germany,24.0,-,2022,USA,2022-07-03,False,0,1,7,8,0,0,3,3,12,7,22,41,1,2,0,3,10,1,10,21,11,6,0,17
118954.0,Hippe Saskia,O,Germany,32.0,186,2022,Brazil,2022-05-31,False,0,0,4,4,0,0,2,2,1,1,2,4,0,0,0,0,0,0,0,0,4,0,0,4
118954.0,Hippe Saskia,O,Germany,32.0,186,2022,Japan,2022-06-02,False,0,2,2,4,0,0,0,0,1,0,1,2,0,0,1,1,1,0,0,1,0,0,0,0
118954.0,Hippe Saskia,O,Germany,32.0,186,2022,Poland,2022-06-05,False,0,0,0,0,0,0,0,0,0,0,0,0,0,0,0,0,0,0,0,0,0,0,0,0
118954.0,Hippe Saskia,O,Germany,32.0,186,2022,Netherlands,2022-06-14,True,0,0,0,0,0,0,0,0,0,0,0,0,0,0,0,0,0,0,0,0,0,0,0,0
118954.0,Hippe Saskia,O,Germany,32.0,186,2022,Italy,2022-06-17,False,0,0,1,1,0,0,0,0,0,0,0,0,0,0,0,0,0,0,0,0,0,1,0,1
118954.0,Hippe Saskia,O,Germany,32.0,186,2022,Dominican Republic,2022-06-19,False,0,1,4,5,0,0,0,0,1,0,1,2,0,0,0,0,0,0,0,0,2,0,0,2
118954.0,Hippe Saskia,O,Germany,32.0,186,2022,Serbia,2022-06-28,False,0,0,4,4,0,0,0,0,2,2,2,6,0,1,0,1,0,0,0,0,1,0,0,1
118954.0,Hippe Saskia,O,Germany,32.0,186,2022,Belgium,2022-06-30,True,0,0,0,0,0,0,0,0,0,0,0,0,0,0,0,0,0,0,0,0,1,0,0,1
118954.0,Hippe Saskia,O,Germany,32.0,186,2022,USA,2022-07-03,False,0,0,5,5,0,0,1,1,5,1,5,11,0,0,0,0,0,0,0,0,4,0,0,4
150812.0,Schölzel Marie,MB,Germany,25.0,190,2022,Brazil,2022-05-31,False,0,1,8,9,0,0,3,3,8,2,3,13,2,6,5,13,0,0,0,0,3,0,0,3
150812.0,Schölzel Marie,MB,Germany,25.0,190,2022,Japan,2022-06-02,False,3,1,12,16,0,0,1,1,10,2,4,16,1,5,4,10,2,1,2,5,0,0,0,0
150812.0,Schölzel Marie,MB,Germany,25.0,190,2022,Poland,2022-06-05,False,0,0,11,11,0,0,2,2,7,2,2,11,0,4,7,11,0,1,1,2,1,0,0,1
150812.0,Schölzel Marie,MB,Germany,25.0,190,2022,Netherlands,2022-06-14,True,0,3,9,12,0,0,0,0,7,4,4,15,1,7,0,8,0,1,0,1,2,1,1,4
150812.0,Schölzel Marie,MB,Germany,25.0,190,2022,Italy,2022-06-17,False,0,0,5,5,0,0,1,1,2,1,1,4,2,2,0,4,0,0,0,0,0,1,0,1
150812.0,Schölzel Marie,MB,Germany,25.0,190,2022,Dominican Republic,2022-06-19,False,0,0,3,3,0,0,1,1,1,1,4,6,1,3,0,4,0,0,0,0,1,0,1,2
150812.0,Schölzel Marie,MB,Germany,25.0,190,2022,Serbia,2022-06-28,False,2,1,14,17,0,0,0,0,4,2,3,9,0,5,3,8,0,0,0,0,2,1,0,3
150812.0,Schölzel Marie,MB,Germany,25.0,190,2022,Belgium,2022-06-30,True,0,1,1,2,0,0,1,1,2,1,0,3,0,4,3,7,0,0,0,0,0,0,0,0
150812.0,Schölzel Marie,MB,Germany,25.0,190,2022,USA,2022-07-03,False,0,0,4,4,0,0,1,1,3,1,5,9,2,0,0,2,0,0,0,0,1,1,0,2
153929.0,Weitzel Camilla,MB,Germany,22.0,195,2022,Brazil,2022-05-31,False,1,1,14,16,0,0,0,0,10,1,5,16,2,6,8,16,0,0,0,0,4,0,0,4
153929.0,Weitzel Camilla,MB,Germany,22.0,195,2022,Japan,2022-06-02,False,0,1,13,14,0,0,1,1,13,1,18,32,1,2,7,10,2,0,3,5,5,0,0,5
153929.0,Weitzel Camilla,MB,Germany,22.0,195,2022,Poland,2022-06-05,False,1,1,15,17,0,0,1,1,6,4,7,17,2,3,4,9,1,0,0,1,2,0,0,2
153929.0,Weitzel Camilla,MB,Germany,22.0,195,2022,Netherlands,2022-06-14,True,1,2,10,13,0,0,0,0,7,0,4,11,3,1,4,8,1,0,0,1,1,2,0,3
153929.0,Weitzel Camilla,MB,Germany,22.0,195,2022,Italy,2022-06-17,False,0,0,9,9,0,0,1,1,4,3,3,10,1,2,2,5,0,0,0,0,0,0,0,0
153929.0,Weitzel Camilla,MB,Germany,22.0,195,2022,Dominican Republic,2022-06-19,False,1,1,18,20,0,0,1,1,6,1,7,14,2,7,7,16,0,0,0,0,1,0,0,1
153929.0,Weitzel Camilla,MB,Germany,22.0,195,2022,Serbia,2022-06-28,False,1,0,11,12,0,0,1,1,10,2,11,23,2,6,3,11,0,1,1,2,4,0,0,4
153929.0,Weitzel Camilla,MB,Germany,22.0,195,2022,Belgium,2022-06-30,True,2,1,17,20,0,0,0,0,8,0,4,12,2,6,1,9,1,0,0,1,1,2,0,3
153929.0,Weitzel Camilla,MB,Germany,22.0,195,2022,USA,2022-07-03,False,2,2,19,23,0,0,2,2,5,0,5,10,3,5,2,10,0,0,0,0,2,0,1,3
182628.0,Strubbe Monique,MB,Germany,21.0,189,2022,Brazil,2022-05-31,False,0,0,0,0,0,0,0,0,0,0,0,0,0,0,0,0,0,0,0,0,0,0,0,0
182628.0,Strubbe Monique,MB,Germany,21.0,189,2022,Japan,2022-06-02,False,0,0,4,4,0,0,0,0,0,0,0,0,0,0,0,0,0,0,0,0,1,0,0,1
182628.0,Strubbe Monique,MB,Germany,21.0,189,2022,Poland,2022-06-05,False,0,0,5,5,0,0,0,0,0,0,0,0,0,0,0,0,0,0,0,0,0,1,0,1
182628.0,Strubbe Monique,MB,Germany,21.0,189,2022,Netherlands,2022-06-14,True,0,0,0,0,0,0,0,0,0,0,0,0,0,0,0,0,0,0,0,0,0,0,0,0
182628.0,Strubbe Monique,MB,Germany,21.0,189,2022,Italy,2022-06-17,False,0,0,0,0,0,0,0,0,0,0,0,0,0,0,0,0,0,0,0,0,0,0,0,0
182628.0,Strubbe Monique,MB,Germany,21.0,189,2022,Dominican Republic,2022-06-19,False,0,0,0,0,0,0,0,0,0,0,0,0,0,0,0,0,0,0,0,0,0,0,0,0
182628.0,Strubbe Monique,MB,Germany,21.0,189,2022,Serbia,2022-06-28,False,0,0,0,0,0,0,0,0,0,0,0,0,0,0,0,0,0,0,0,0,0,0,0,0
182628.0,Strubbe Monique,MB,Germany,21.0,189,2022,Belgium,2022-06-30,True,0,0,0,0,0,0,0,0,0,0,0,0,0,0,0,0,0,0,0,0,0,0,0,0
182628.0,Strubbe Monique,MB,Germany,21.0,189,2022,USA,2022-07-03,False,0,0,0,0,0,0,0,0,0,0,0,0,0,0,0,0,0,0,0,0,0,0,0,0
181272.0,Straube Sarah,S,Germany,20.0,185,2022,Serbia,2022-06-28,False,0,0,0,0,0,0,0,0,0,0,0,0,0,0,0,0,0,0,0,0,0,0,0,0
181272.0,Straube Sarah,S,Germany,20.0,185,2022,Belgium,2022-06-30,True,0,0,0,0,0,0,0,0,0,0,0,0,0,0,0,0,0,0,0,0,0,0,0,0
181272.0,Straube Sarah,S,Germany,20.0,185,2022,USA,2022-07-03,False,0,0,0,0,0,0,9,9,0,0,0,0,0,1,0,1,0,0,0,0,2,1,0,3
177765.0,Cekulaev Anastasia,MB,Germany,19.0,187,2022,Brazil,2022-05-31,False,0,0,1,1,0,0,0,0,1,0,0,1,0,0,0,0,1,0,0,1,0,0,0,0
177765.0,Cekulaev Anastasia,MB,Germany,19.0,187,2022,Japan,2022-06-02,False,0,0,0,0,0,0,0,0,0,0,0,0,0,0,0,0,0,0,0,0,0,0,0,0
177765.0,Cekulaev Anastasia,MB,Germany,19.0,187,2022,Poland,2022-06-05,False,0,0,0,0,0,0,0,0,0,0,0,0,0,0,0,0,0,0,0,0,0,0,0,0
177765.0,Cekulaev Anastasia,MB,Germany,19.0,187,2022,Netherlands,2022-06-14,True,0,0,0,0,0,0,0,0,0,0,0,0,0,0,0,0,0,0,0,0,0,0,0,0
177765.0,Cekulaev Anastasia,MB,Germany,19.0,187,2022,Italy,2022-06-17,False,0,1,1,2,0,0,0,0,1,1,2,4,0,0,0,0,0,0,0,0,0,0,0,0
177765.0,Cekulaev Anastasia,MB,Germany,19.0,187,2022,Dominican Republic,2022-06-19,False,0,1,6,7,0,0,1,1,4,0,3,7,1,1,3,5,0,0,0,0,0,0,0,0
177765.0,Cekulaev Anastasia,MB,Germany,19.0,187,2022,Serbia,2022-06-28,False,0,0,0,0,0,0,0,0,0,0,0,0,0,0,0,0,0,0,0,0,0,0,0,0
177765.0,Cekulaev Anastasia,MB,Germany,19.0,187,2022,Belgium,2022-06-30,True,0,0,7,7,0,0,1,1,5,1,5,11,0,2,0,2,0,0,0,0,1,0,0,1
177765.0,Cekulaev Anastasia,MB,Germany,19.0,187,2022,USA,2022-07-03,False,0,1,4,5,0,0,2,2,6,1,4,11,1,1,2,4,0,0,0,0,2,1,0,3
151658.0,Lubian Marina,MB,Italy,22.0,193,2022,Belgium,2022-06-02,True,0,1,4,5,0,0,1,1,0,0,0,0,0,0,0,0,0,0,0,0,2,0,0,2
151658.0,Lubian Marina,MB,Italy,22.0,193,2022,Netherlands,2022-06-03,True,2,2,11,15,0,0,2,2,6,2,2,10,2,0,5,7,0,0,0,0,3,0,0,3
151658.0,Lubian Marina,MB,Italy,22.0,193,2022,China,2022-06-04,False,2,1,9,12,0,0,1,1,0,2,3,5,0,2,5,7,0,0,1,1,1,1,0,2
151658.0,Lubian Marina,MB,Italy,22.0,193,2022,Dominican Republic,2022-06-16,True,0,2,5,7,0,0,1,1,0,0,0,0,0,0,0,0,0,0,0,0,0,1,0,1
151658.0,Lubian Marina,MB,Italy,22.0,193,2022,Germany,2022-06-17,True,1,1,3,5,0,0,0,0,0,0,0,0,0,0,0,0,0,0,0,0,0,0,0,0
151658.0,Lubian Marina,MB,Italy,22.0,193,2022,Brazil,2022-06-18,True,1,2,15,18,0,0,0,0,7,0,4,11,1,1,5,7,0,0,0,0,5,1,0,6
151658.0,Lubian Marina,MB,Italy,22.0,193,2022,Poland,2022-06-29,True,0,1,2,3,0,0,0,0,0,0,0,0,0,1,0,1,0,0,0,0,0,0,0,0
151658.0,Lubian Marina,MB,Italy,22.0,193,2022,Bulgaria,2022-07-02,True,0,0,0,0,0,0,0,0,0,0,0,0,0,0,0,0,0,0,0,0,0,0,0,0
151658.0,Lubian Marina,MB,Italy,22.0,193,2022,Thailand,2022-07-03,True,0,0,0,0,0,0,0,0,0,0,0,0,0,0,0,0,0,0,0,0,0,0,0,0
151658.0,Lubian Marina,MB,Italy,22.0,193,2022,China,2022-07-14,True,0,2,2,4,0,0,0,0,1,1,0,2,1,0,0,1,0,0,0,0,0,1,0,1
151658.0,Lubian Marina,MB,Italy,22.0,193,2022,Brazil,2022-07-17,True,0,1,1,2,0,0,0,0,0,0,0,0,0,0,0,0,0,0,0,0,0,0,0,0
151986.0,Bosio Francesca,S,Italy,25.0,-,2022,Belgium,2022-06-02,True,0,1,1,2,0,0,1,1,0,0,0,0,0,0,0,0,0,0,0,0,0,1,0,1
151986.0,Bosio Francesca,S,Italy,25.0,-,2022,Netherlands,2022-06-03,True,0,1,9,10,27,1,45,73,0,0,1,1,2,2,3,7,0,0,0,0,11,1,2,14
151986.0,Bosio Francesca,S,Italy,25.0,-,2022,China,2022-06-04,False,0,0,3,3,1,0,4,5,0,0,0,0,0,0,0,0,0,0,0,0,0,0,0,0
151986.0,Bosio Francesca,S,Italy,25.0,-,2022,Dominican Republic,2022-06-16,True,0,0,11,11,18,1,29,48,0,0,1,1,1,1,1,3,0,0,0,0,1,0,0,1
151986.0,Bosio Francesca,S,Italy,25.0,-,2022,Germany,2022-06-17,True,0,0,1,1,0,0,1,1,0,0,0,0,0,0,0,0,0,0,0,0,0,0,0,0
151986.0,Bosio Francesca,S,Italy,25.0,-,2022,Brazil,2022-06-18,True,0,0,1,1,2,0,6,8,0,0,0,0,0,0,0,0,0,0,0,0,0,0,0,0
118764.0,Gennari Alessia,OH,Italy,31.0,184,2022,Belgium,2022-06-02,True,1,1,10,12,0,0,1,1,8,2,15,25,0,3,2,5,4,1,12,17,4,3,0,7
118764.0,Gennari Alessia,OH,Italy,31.0,184,2022,Netherlands,2022-06-03,True,0,1,8,9,0,0,1,1,10,0,12,22,1,3,1,5,7,1,13,21,4,2,0,6
118764.0,Gennari Alessia,OH,Italy,31.0,184,2022,China,2022-06-04,False,0,0,0,0,0,0,0,0,0,0,0,0,0,0,0,0,0,0,0,0,0,0,0,0
118764.0,Gennari Alessia,OH,Italy,31.0,184,2022,Poland,2022-06-29,True,0,2,12,14,1,0,0,1,5,2,12,19,1,4,2,7,3,0,18,21,16,2,4,22
118764.0,Gennari Alessia,OH,Italy,31.0,184,2022,Bulgaria,2022-07-02,True,0,1,14,15,0,0,0,0,8,0,8,16,1,3,0,4,2,0,14,16,8,2,1,11
118764.0,Gennari Alessia,OH,Italy,31.0,184,2022,Thailand,2022-07-03,True,0,0,0,0,0,0,0,0,0,0,0,0,0,0,0,0,0,0,0,0,0,0,0,0
118764.0,Gennari Alessia,OH,Italy,31.0,184,2022,China,2022-07-14,True,0,0,0,0,0,0,0,0,0,0,0,0,0,0,0,0,0,0,0,0,0,0,0,0
118764.0,Gennari Alessia,OH,Italy,31.0,184,2022,Brazil,2022-07-17,True,0,0,0,0,0,0,0,0,0,0,0,0,0,0,0,0,0,0,0,0,0,0,0,0
142391.0,Bonifacio Sara,MB,Italy,26.0,-,2022,Belgium,2022-06-02,True,0,1,14,15,0,0,1,1,4,1,3,8,1,2,4,7,0,0,0,0,0,0,0,0
142391.0,Bonifacio Sara,MB,Italy,26.0,-,2022,Netherlands,2022-06-03,True,0,0,0,0,0,0,0,0,0,0,0,0,0,0,0,0,0,0,0,0,0,0,0,0
142391.0,Bonifacio Sara,MB,Italy,26.0,-,2022,China,2022-06-04,False,0,0,9,9,1,0,1,2,9,1,1,11,1,2,5,8,0,0,0,0,1,0,2,3
142391.0,Bonifacio Sara,MB,Italy,26.0,-,2022,Dominican Republic,2022-06-16,True,0,0,7,7,0,0,0,0,6,1,1,8,2,3,2,7,0,0,0,0,0,1,0,1
142391.0,Bonifacio Sara,MB,Italy,26.0,-,2022,Germany,2022-06-17,True,0,0,0,0,0,0,0,0,0,0,0,0,0,0,0,0,0,0,0,0,0,0,0,0
142391.0,Bonifacio Sara,MB,Italy,26.0,-,2022,Brazil,2022-06-18,True,0,1,11,12,0,0,0,0,3,1,4,8,7,3,1,11,0,0,0,0,1,0,1,2
142391.0,Bonifacio Sara,MB,Italy,26.0,-,2022,Poland,2022-06-29,True,0,0,0,0,0,0,0,0,0,0,0,0,0,0,0,0,0,0,0,0,0,0,0,0
142391.0,Bonifacio Sara,MB,Italy,26.0,-,2022,Bulgaria,2022-07-02,True,0,0,0,0,0,0,0,0,0,0,0,0,0,0,0,0,0,0,0,0,0,0,0,0
142391.0,Bonifacio Sara,MB,Italy,26.0,-,2022,Thailand,2022-07-03,True,0,0,0,0,0,0,0,0,0,0,0,0,0,0,0,0,0,0,0,0,0,0,0,0
142391.0,Bonifacio Sara,MB,Italy,26.0,-,2022,China,2022-07-14,True,0,0,0,0,0,0,0,0,0,0,0,0,0,0,0,0,0,0,0,0,0,0,0,0
142391.0,Bonifacio Sara,MB,Italy,26.0,-,2022,Brazil,2022-07-17,True,0,0,0,0,0,0,0,0,0,0,0,0,0,0,0,0,0,0,0,0,0,0,0,0
143371.0,Malinov Ofelia,S,Italy,27.0,182,2022,Belgium,2022-06-02,True,0,1,12,13,13,3,81,97,0,0,1,1,2,2,4,8,0,1,0,1,7,2,1,10
143371.0,Malinov Ofelia,S,Italy,27.0,182,2022,Netherlands,2022-06-03,True,0,0,0,0,0,0,0,0,0,0,0,0,0,0,0,0,0,0,0,0,0,0,0,0
143371.0,Malinov Ofelia,S,Italy,27.0,182,2022,China,2022-06-04,False,1,3,9,13,55,0,45,100,3,0,2,5,0,1,5,6,0,0,0,0,11,2,1,14
143371.0,Malinov Ofelia,S,Italy,27.0,182,2022,Dominican Republic,2022-06-16,True,0,0,10,10,28,0,50,78,2,0,1,3,0,3,4,7,0,0,0,0,5,0,0,5
143371.0,Malinov Ofelia,S,Italy,27.0,182,2022,Germany,2022-06-17,True,0,0,15,15,28,1,60,89,3,0,2,5,2,2,6,10,0,0,0,0,1,2,0,3
143371.0,Malinov Ofelia,S,Italy,27.0,182,2022,Brazil,2022-06-18,True,0,0,14,14,21,0,45,66,0,0,1,1,4,1,4,9,0,0,0,0,3,1,0,4
143371.0,Malinov Ofelia,S,Italy,27.0,182,2022,Poland,2022-06-29,True,0,3,7,10,76,0,0,76,1,1,0,2,0,4,0,4,0,0,1,1,0,2,0,2
143371.0,Malinov Ofelia,S,Italy,27.0,182,2022,Bulgaria,2022-07-02,True,0,0,0,0,0,0,0,0,0,0,0,0,0,0,0,0,0,0,0,0,0,0,0,0
143371.0,Malinov Ofelia,S,Italy,27.0,182,2022,Thailand,2022-07-03,True,0,0,0,0,0,0,0,0,0,0,0,0,0,0,0,0,0,0,0,0,0,0,0,0
143371.0,Malinov Ofelia,S,Italy,27.0,182,2022,China,2022-07-14,True,0,0,5,5,6,0,27,33,1,0,0,1,0,0,3,3,0,0,0,0,3,0,0,3
143371.0,Malinov Ofelia,S,Italy,27.0,182,2022,Brazil,2022-07-17,True,0,0,0,0,0,0,5,5,1,0,0,1,0,0,1,1,0,0,0,0,0,0,0,0
115478.0,De Gennaro Monica,L,Italy,36.0,174,2022,Belgium,2022-06-02,True,0,0,0,0,0,0,15,15,0,0,0,0,0,0,0,0,4,0,8,12,10,3,0,13
115478.0,De Gennaro Monica,L,Italy,36.0,174,2022,Netherlands,2022-06-03,True,0,0,0,0,1,0,10,11,0,0,0,0,0,0,0,0,0,0,9,9,14,2,0,16
115478.0,De Gennaro Monica,L,Italy,36.0,174,2022,China,2022-06-04,False,0,0,0,0,3,0,8,11,0,0,0,0,0,0,0,0,7,0,15,22,13,3,3,19
115478.0,De Gennaro Monica,L,Italy,36.0,174,2022,Dominican Republic,2022-06-16,True,0,0,0,0,0,0,13,13,0,0,0,0,0,0,0,0,9,1,4,14,14,3,0,17
115478.0,De Gennaro Monica,L,Italy,36.0,174,2022,Germany,2022-06-17,True,0,0,0,0,0,0,5,5,0,0,0,0,0,0,0,0,6,0,4,10,14,0,1,15
115478.0,De Gennaro Monica,L,Italy,36.0,174,2022,Brazil,2022-06-18,True,0,0,0,0,0,0,6,6,0,0,0,0,0,0,0,0,7,0,5,12,4,3,0,7
115478.0,De Gennaro Monica,L,Italy,36.0,174,2022,Poland,2022-06-29,True,0,0,0,0,7,0,0,7,0,0,0,0,0,0,0,0,5,0,9,14,13,3,4,20
115478.0,De Gennaro Monica,L,Italy,36.0,174,2022,Bulgaria,2022-07-02,True,0,0,0,0,0,0,1,1,0,0,0,0,0,0,0,0,1,1,4,6,8,4,1,13
115478.0,De Gennaro Monica,L,Italy,36.0,174,2022,Thailand,2022-07-03,True,0,0,0,0,0,0,2,2,0,0,0,0,0,0,0,0,6,0,2,8,13,1,1,15
115478.0,De Gennaro Monica,L,Italy,36.0,174,2022,China,2022-07-14,True,0,0,0,0,0,0,9,9,0,0,0,0,0,0,0,0,9,0,2,11,19,4,3,26
115478.0,De Gennaro Monica,L,Italy,36.0,174,2022,Brazil,2022-07-17,True,0,0,0,0,0,0,7,7,0,0,0,0,0,0,0,0,4,1,1,6,7,4,4,15
173402.0,Fersino Eleonora,L,Italy,23.0,-,2022,Belgium,2022-06-02,True,0,0,0,0,0,0,0,0,0,0,0,0,0,0,0,0,0,0,0,0,0,0,0,0
173402.0,Fersino Eleonora,L,Italy,23.0,-,2022,Netherlands,2022-06-03,True,0,0,0,0,0,0,0,0,0,0,0,0,0,0,0,0,1,0,1,2,1,0,1,2
173402.0,Fersino Eleonora,L,Italy,23.0,-,2022,China,2022-06-04,False,0,0,0,0,0,0,0,0,0,0,0,0,0,0,0,0,0,0,0,0,0,0,0,0
173402.0,Fersino Eleonora,L,Italy,23.0,-,2022,Dominican Republic,2022-06-16,True,0,0,0,0,0,0,0,0,0,0,0,0,0,0,0,0,1,0,1,2,0,1,0,1
173402.0,Fersino Eleonora,L,Italy,23.0,-,2022,Germany,2022-06-17,True,0,0,0,0,0,0,0,0,0,0,0,0,0,0,0,0,1,0,2,3,1,0,0,1
173402.0,Fersino Eleonora,L,Italy,23.0,-,2022,Brazil,2022-06-18,True,0,0,0,0,0,0,0,0,0,0,0,0,0,0,0,0,3,0,3,6,1,1,0,2
173402.0,Fersino Eleonora,L,Italy,23.0,-,2022,Poland,2022-06-29,True,0,0,0,0,0,0,0,0,0,0,0,0,0,0,0,0,0,0,0,0,0,0,0,0
173402.0,Fersino Eleonora,L,Italy,23.0,-,2022,Bulgaria,2022-07-02,True,0,0,0,0,0,0,0,0,0,0,0,0,0,0,0,0,0,0,0,0,0,0,0,0
173402.0,Fersino Eleonora,L,Italy,23.0,-,2022,Thailand,2022-07-03,True,0,0,0,0,0,0,0,0,0,0,0,0,0,0,0,0,2,0,0,2,1,0,0,1
173402.0,Fersino Eleonora,L,Italy,23.0,-,2022,China,2022-07-14,True,0,0,0,0,0,0,0,0,0,0,0,0,0,0,0,0,0,0,0,0,0,0,0,0
173402.0,Fersino Eleonora,L,Italy,23.0,-,2022,Brazil,2022-07-17,True,0,0,0,0,0,0,0,0,0,0,0,0,0,0,0,0,0,0,0,0,0,1,0,1
150441.0,Orro Alessia,S,Italy,24.0,178,2022,Poland,2022-06-29,True,1,0,13,14,35,2,0,37,1,0,1,2,1,1,2,4,0,0,0,0,3,1,1,5
150441.0,Orro Alessia,S,Italy,24.0,178,2022,Bulgaria,2022-07-02,True,1,2,11,14,6,2,73,81,2,0,1,3,0,5,3,8,0,0,0,0,3,1,1,5
150441.0,Orro Alessia,S,Italy,24.0,178,2022,Thailand,2022-07-03,True,1,1,17,19,10,0,75,85,1,0,1,2,0,2,0,2,0,0,0,0,8,2,2,12
150441.0,Orro Alessia,S,Italy,24.0,178,2022,China,2022-07-14,True,0,0,12,12,17,0,80,97,2,0,1,3,0,2,0,2,0,0,1,1,8,5,1,14
150441.0,Orro Alessia,S,Italy,24.0,178,2022,Brazil,2022-07-17,True,0,1,8,9,19,0,58,77,0,0,4,4,0,0,2,2,1,1,1,3,4,5,3,12
123744.0,Bosetti Caterina Chiara,OH,Italy,29.0,-,2022,Dominican Republic,2022-06-16,True,0,0,9,9,0,0,2,2,4,2,6,12,2,1,0,3,4,1,7,12,0,0,0,0
123744.0,Bosetti Caterina Chiara,OH,Italy,29.0,-,2022,Germany,2022-06-17,True,0,0,13,13,0,0,1,1,11,2,2,15,0,0,3,3,8,2,7,17,5,1,0,6
123744.0,Bosetti Caterina Chiara,OH,Italy,29.0,-,2022,Brazil,2022-06-18,True,0,2,13,15,0,0,4,4,6,5,0,11,1,1,1,3,6,3,5,14,7,0,0,7
123744.0,Bosetti Caterina Chiara,OH,Italy,29.0,-,2022,China,2022-07-14,True,2,2,10,14,0,0,5,5,11,1,13,25,1,3,2,6,21,2,16,39,7,2,0,9
123744.0,Bosetti Caterina Chiara,OH,Italy,29.0,-,2022,Brazil,2022-07-17,True,1,1,8,10,0,1,7,8,10,0,7,17,0,0,1,1,6,1,6,13,3,4,2,9
136690.0,Chirichella Cristina,MB,Italy,29.0,-,2022,Belgium,2022-06-02,True,1,1,8,10,0,0,0,0,5,1,2,8,3,7,8,18,1,0,0,1,1,3,0,4
136690.0,Chirichella Cristina,MB,Italy,29.0,-,2022,Netherlands,2022-06-03,True,0,0,0,0,0,0,0,0,0,0,0,0,0,0,0,0,0,0,0,0,0,0,0,0
136690.0,Chirichella Cristina,MB,Italy,29.0,-,2022,China,2022-06-04,False,0,0,6,6,0,0,2,2,2,3,3,8,1,3,2,6,0,0,0,0,0,0,0,0
136690.0,Chirichella Cristina,MB,Italy,29.0,-,2022,Dominican Republic,2022-06-16,True,0,0,15,15,0,0,0,0,4,2,8,14,1,9,2,12,0,0,0,0,3,1,0,4
136690.0,Chirichella Cristina,MB,Italy,29.0,-,2022,Germany,2022-06-17,True,0,0,11,11,0,0,1,1,6,3,5,14,3,3,4,10,0,0,1,1,2,1,0,3
136690.0,Chirichella Cristina,MB,Italy,29.0,-,2022,Brazil,2022-06-18,True,0,0,0,0,0,0,0,0,0,0,0,0,0,0,0,0,0,0,0,0,0,0,0,0
136690.0,Chirichella Cristina,MB,Italy,29.0,-,2022,Poland,2022-06-29,True,0,2,12,14,0,0,0,0,7,1,3,11,1,3,3,7,0,0,1,1,0,1,0,1
136690.0,Chirichella Cristina,MB,Italy,29.0,-,2022,Bulgaria,2022-07-02,True,1,2,11,14,0,0,0,0,5,0,4,9,2,6,6,14,0,0,0,0,4,0,1,5
136690.0,Chirichella Cristina,MB,Italy,29.0,-,2022,Thailand,2022-07-03,True,0,2,8,10,0,0,0,0,7,0,5,12,0,3,3,6,0,0,0,0,1,1,0,2
136690.0,Chirichella Cristina,MB,Italy,29.0,-,2022,China,2022-07-14,True,1,2,12,15,0,0,2,2,7,1,8,16,1,3,7,11,1,0,0,1,6,0,0,6
136690.0,Chirichella Cristina,MB,Italy,29.0,-,2022,Brazil,2022-07-17,True,1,2,8,11,0,0,0,0,6,1,2,9,2,2,0,4,0,0,0,0,2,0,0,2
136694.0,Danesi Anna,MB,Italy,26.0,-,2022,Dominican Republic,2022-06-16,True,0,0,5,5,0,0,1,1,1,0,3,4,2,2,1,5,0,0,0,0,0,0,0,0
136694.0,Danesi Anna,MB,Italy,26.0,-,2022,Germany,2022-06-17,True,0,2,5,7,0,0,1,1,4,2,3,9,3,2,4,9,0,0,0,0,1,1,0,2
136694.0,Danesi Anna,MB,Italy,26.0,-,2022,Brazil,2022-06-18,True,0,0,0,0,0,0,0,0,0,0,0,0,0,0,0,0,0,0,0,0,0,0,0,0
136694.0,Danesi Anna,MB,Italy,26.0,-,2022,Poland,2022-06-29,True,0,2,9,11,1,1,0,2,6,2,4,12,7,1,5,13,0,0,1,1,3,0,2,5
136694.0,Danesi Anna,MB,Italy,26.0,-,2022,Bulgaria,2022-07-02,True,2,2,8,12,0,0,0,0,6,1,1,8,1,4,5,10,0,0,0,0,1,0,0,1
136694.0,Danesi Anna,MB,Italy,26.0,-,2022,Thailand,2022-07-03,True,1,1,9,11,0,0,0,0,6,0,4,10,2,3,5,10,0,0,0,0,2,1,0,3
136694.0,Danesi Anna,MB,Italy,26.0,-,2022,China,2022-07-14,True,0,1,11,12,0,0,2,2,5,1,4,10,3,3,2,8,0,0,1,1,5,0,0,5
136694.0,Danesi Anna,MB,Italy,26.0,-,2022,Brazil,2022-07-17,True,0,1,16,17,0,0,1,1,8,0,0,8,1,5,6,12,0,0,0,0,3,1,2,6
143393.0,Guerra Anastasia,OH,Italy,26.0,183,2022,Dominican Republic,2022-06-16,True,0,4,5,9,0,0,2,2,17,4,9,30,0,1,1,2,11,1,14,26,13,2,0,15
143393.0,Guerra Anastasia,OH,Italy,26.0,183,2022,Germany,2022-06-17,True,0,0,0,0,0,0,0,0,0,0,0,0,0,0,0,0,0,0,0,0,0,0,0,0
143393.0,Guerra Anastasia,OH,Italy,26.0,183,2022,Brazil,2022-06-18,True,0,0,1,1,0,0,1,1,1,0,2,3,0,1,0,1,0,0,2,2,1,0,0,1
156104.0,Pietrini Elena,OH,Italy,23.0,188,2022,Poland,2022-06-29,True,0,0,0,0,0,0,0,0,0,0,0,0,0,0,0,0,0,0,0,0,0,0,0,0
156104.0,Pietrini Elena,OH,Italy,23.0,188,2022,Bulgaria,2022-07-02,True,0,0,11,11,0,0,0,0,18,0,9,27,2,3,1,6,3,3,19,25,5,1,1,7
156104.0,Pietrini Elena,OH,Italy,23.0,188,2022,Thailand,2022-07-03,True,1,2,7,10,0,0,0,0,8,0,8,16,3,3,0,6,4,0,14,18,3,1,1,5
156104.0,Pietrini Elena,OH,Italy,23.0,188,2022,China,2022-07-14,True,1,1,8,10,0,0,0,0,4,3,4,11,1,1,1,3,7,0,4,11,3,0,0,3
156104.0,Pietrini Elena,OH,Italy,23.0,188,2022,Brazil,2022-07-17,True,0,1,14,15,0,0,2,2,7,3,7,17,1,1,1,3,15,0,28,43,8,1,1,10
151664.0,Nwakalor Sylvia Chinelo,O,Italy,23.0,176,2022,Belgium,2022-06-02,True,1,1,16,18,1,0,1,2,26,9,16,51,2,2,4,8,0,0,0,0,7,2,1,10
151664.0,Nwakalor Sylvia Chinelo,O,Italy,23.0,176,2022,Netherlands,2022-06-03,True,0,0,8,8,0,0,0,0,15,4,5,24,1,1,1,3,0,0,0,0,4,0,3,7
151664.0,Nwakalor Sylvia Chinelo,O,Italy,23.0,176,2022,China,2022-06-04,False,0,0,10,10,1,0,2,3,18,9,13,40,1,4,2,7,0,0,0,0,3,0,2,5
151664.0,Nwakalor Sylvia Chinelo,O,Italy,23.0,176,2022,Dominican Republic,2022-06-16,True,0,1,12,13,0,0,0,0,9,6,18,33,2,4,0,6,0,0,0,0,1,1,0,2
151664.0,Nwakalor Sylvia Chinelo,O,Italy,23.0,176,2022,Germany,2022-06-17,True,0,0,0,0,0,0,0,0,0,0,0,0,0,0,0,0,0,0,0,0,0,0,0,0
151664.0,Nwakalor Sylvia Chinelo,O,Italy,23.0,176,2022,Brazil,2022-06-18,True,0,0,0,0,0,0,0,0,0,0,0,0,0,0,0,0,0,0,0,0,0,0,0,0
151664.0,Nwakalor Sylvia Chinelo,O,Italy,23.0,176,2022,Poland,2022-06-29,True,0,0,0,0,0,0,0,0,0,1,1,2,0,0,1,1,0,0,0,0,1,0,0,1
151664.0,Nwakalor Sylvia Chinelo,O,Italy,23.0,176,2022,Bulgaria,2022-07-02,True,0,1,7,8,0,0,0,0,11,2,6,19,1,2,3,6,0,0,0,0,4,0,1,5
151664.0,Nwakalor Sylvia Chinelo,O,Italy,23.0,176,2022,Thailand,2022-07-03,True,0,0,0,0,0,0,0,0,0,0,0,0,0,0,0,0,0,0,0,0,0,0,0,0
151664.0,Nwakalor Sylvia Chinelo,O,Italy,23.0,176,2022,China,2022-07-14,True,0,0,0,0,0,0,0,0,0,0,0,0,0,0,0,0,0,0,0,0,0,0,0,0
151664.0,Nwakalor Sylvia Chinelo,O,Italy,23.0,176,2022,Brazil,2022-07-17,True,0,0,0,0,0,0,0,0,0,0,0,0,0,0,0,0,0,0,0,0,0,0,0,0
143391.0,D'Odorico Sofia,OH,Italy,26.0,186,2022,Belgium,2022-06-02,True,0,0,0,0,0,0,0,0,0,1,1,2,0,0,0,0,0,0,1,1,0,0,0,0
143391.0,D'Odorico Sofia,OH,Italy,26.0,186,2022,Netherlands,2022-06-03,True,0,0,0,0,0,0,0,0,0,0,0,0,0,0,0,0,0,0,0,0,0,0,0,0
143391.0,D'Odorico Sofia,OH,Italy,26.0,186,2022,China,2022-06-04,False,0,0,0,0,0,0,0,0,0,0,0,0,0,0,0,0,0,0,0,0,0,0,0,0
136701.0,Sylla Myriam Fatime,OH,Italy,28.0,184,2022,Dominican Republic,2022-06-16,True,0,0,0,0,0,0,0,0,0,0,0,0,0,0,0,0,0,0,0,0,0,0,0,0
136701.0,Sylla Myriam Fatime,OH,Italy,28.0,184,2022,Germany,2022-06-17,True,0,0,0,0,0,0,0,0,0,0,0,0,0,0,0,0,0,0,0,0,0,0,0,0
136701.0,Sylla Myriam Fatime,OH,Italy,28.0,184,2022,Brazil,2022-06-18,True,0,0,0,0,0,0,0,0,0,0,0,0,0,0,0,0,0,0,0,0,0,0,0,0
136701.0,Sylla Myriam Fatime,OH,Italy,28.0,184,2022,Poland,2022-06-29,True,1,0,2,3,0,0,0,0,0,0,0,0,0,0,0,0,0,1,0,1,0,0,0,0
136701.0,Sylla Myriam Fatime,OH,Italy,28.0,184,2022,Bulgaria,2022-07-02,True,0,0,0,0,0,0,0,0,0,0,0,0,0,0,0,0,0,0,0,0,0,0,0,0
136701.0,Sylla Myriam Fatime,OH,Italy,28.0,184,2022,Thailand,2022-07-03,True,0,0,9,9,0,1,0,1,9,1,6,16,0,0,2,2,4,0,15,19,4,4,5,13
136701.0,Sylla Myriam Fatime,OH,Italy,28.0,184,2022,China,2022-07-14,True,0,0,6,6,0,0,3,3,5,6,10,21,0,1,2,3,6,0,14,20,10,1,0,11
136701.0,Sylla Myriam Fatime,OH,Italy,28.0,184,2022,Brazil,2022-07-17,True,0,0,0,0,0,0,0,0,0,0,0,0,0,0,0,0,0,0,0,0,0,0,0,0
150840.0,Egonu Paola Ogechi,O,Italy,24.0,193,2022,Dominican Republic,2022-06-16,True,1,2,1,4,0,0,0,0,6,4,7,17,1,2,1,4,0,0,0,0,3,0,1,4
150840.0,Egonu Paola Ogechi,O,Italy,24.0,193,2022,Germany,2022-06-17,True,0,3,8,11,0,0,2,2,22,8,11,41,0,2,1,3,0,0,0,0,3,2,1,6
150840.0,Egonu Paola Ogechi,O,Italy,24.0,193,2022,Brazil,2022-06-18,True,0,3,11,14,0,0,0,0,20,5,13,38,2,4,2,8,0,0,0,0,3,2,0,5
150840.0,Egonu Paola Ogechi,O,Italy,24.0,193,2022,Poland,2022-06-29,True,1,6,7,14,1,1,0,2,26,5,21,52,2,1,3,6,0,0,0,0,6,0,2,8
150840.0,Egonu Paola Ogechi,O,Italy,24.0,193,2022,Bulgaria,2022-07-02,True,0,0,0,0,0,0,0,0,0,0,0,0,0,0,0,0,0,0,0,0,0,0,0,0
150840.0,Egonu Paola Ogechi,O,Italy,24.0,193,2022,Thailand,2022-07-03,True,4,1,9,14,0,1,1,2,19,4,10,33,1,1,1,3,0,0,0,0,4,2,2,8
150840.0,Egonu Paola Ogechi,O,Italy,24.0,193,2022,China,2022-07-14,True,4,1,15,20,0,0,2,2,32,10,24,66,0,4,1,5,0,0,0,0,10,5,1,16
150840.0,Egonu Paola Ogechi,O,Italy,24.0,193,2022,Brazil,2022-07-17,True,0,3,7,10,0,0,0,0,18,8,16,42,3,3,3,9,0,0,0,0,4,4,1,9
143370.0,Degradi Alice Carlotta,OH,Italy,26.0,182,2022,Belgium,2022-06-02,True,0,2,0,2,0,0,0,0,1,2,2,5,0,1,0,1,2,0,5,7,1,0,0,1
143370.0,Degradi Alice Carlotta,OH,Italy,26.0,182,2022,Netherlands,2022-06-03,True,0,4,14,18,1,0,1,2,13,3,8,24,1,3,0,4,2,1,11,14,7,2,2,11
143370.0,Degradi Alice Carlotta,OH,Italy,26.0,182,2022,China,2022-06-04,False,1,5,5,11,0,0,1,1,21,8,11,40,1,2,3,6,5,3,19,27,15,5,1,21
143370.0,Degradi Alice Carlotta,OH,Italy,26.0,182,2022,Dominican Republic,2022-06-16,True,1,3,7,11,0,0,0,0,9,4,15,28,1,1,1,3,12,1,21,34,3,1,2,6
143370.0,Degradi Alice Carlotta,OH,Italy,26.0,182,2022,Germany,2022-06-17,True,1,2,9,12,0,0,1,1,7,5,7,19,0,1,4,5,7,3,20,30,4,0,0,4
143370.0,Degradi Alice Carlotta,OH,Italy,26.0,182,2022,Brazil,2022-06-18,True,0,4,9,13,0,0,1,1,10,3,6,19,0,3,1,4,5,2,20,27,4,1,1,6
143370.0,Degradi Alice Carlotta,OH,Italy,26.0,182,2022,Poland,2022-06-29,True,1,2,16,19,2,0,1,3,16,7,13,36,2,4,1,7,6,3,33,42,9,2,0,11
143370.0,Degradi Alice Carlotta,OH,Italy,26.0,182,2022,Bulgaria,2022-07-02,True,0,0,0,0,0,0,0,0,0,0,0,0,0,0,0,0,0,0,0,0,0,0,0,0
143370.0,Degradi Alice Carlotta,OH,Italy,26.0,182,2022,Thailand,2022-07-03,True,0,0,0,0,0,0,0,0,0,0,0,0,0,0,0,0,0,0,0,0,0,0,0,0
163061.0,Enweonwu Nkemdilim Ruth Terry,O,Italy,22.0,187,2022,Belgium,2022-06-02,True,0,1,0,1,0,0,0,0,0,0,0,0,0,0,0,0,0,0,1,1,1,0,0,1
163061.0,Enweonwu Nkemdilim Ruth Terry,O,Italy,22.0,187,2022,Netherlands,2022-06-03,True,0,0,0,0,0,0,0,0,0,0,0,0,0,0,0,0,0,0,0,0,0,0,0,0
163061.0,Enweonwu Nkemdilim Ruth Terry,O,Italy,22.0,187,2022,China,2022-06-04,False,0,0,0,0,0,0,0,0,0,1,2,3,0,0,0,0,0,0,0,0,1,0,1,2
136697.0,Perinelli Elena,OH,Italy,27.0,182,2022,Belgium,2022-06-02,True,2,1,14,17,0,0,1,1,12,1,14,27,1,4,3,8,11,2,25,38,6,3,0,9
136697.0,Perinelli Elena,OH,Italy,27.0,182,2022,Netherlands,2022-06-03,True,0,0,0,0,0,0,0,0,0,0,0,0,0,0,0,0,0,0,0,0,0,0,0,0
136697.0,Perinelli Elena,OH,Italy,27.0,182,2022,China,2022-06-04,False,0,2,12,14,1,0,3,4,6,6,8,20,0,1,0,1,10,2,27,39,3,4,2,9
151661.0,Mazzaro Alessia,MB,Italy,24.0,184,2022,Belgium,2022-06-02,True,0,0,0,0,0,0,0,0,0,0,1,1,0,0,1,1,0,0,0,0,0,0,0,0
151661.0,Mazzaro Alessia,MB,Italy,24.0,184,2022,Netherlands,2022-06-03,True,1,0,12,13,0,0,3,3,6,1,7,14,3,0,4,7,0,0,1,1,2,0,0,2
151661.0,Mazzaro Alessia,MB,Italy,24.0,184,2022,China,2022-06-04,False,0,0,1,1,0,0,0,0,0,0,0,0,0,1,0,1,0,0,0,0,0,0,0,0
168062.0,Moriya Akane,L,Japan,32.0,165,2022,Germany,2022-06-02,True,0,0,0,0,0,0,0,0,0,0,0,0,0,0,0,0,0,0,0,0,0,0,0,0
168062.0,Moriya Akane,L,Japan,32.0,165,2022,Dominican Republic,2022-06-04,True,0,0,0,0,0,0,0,0,0,0,0,0,0,0,0,0,0,0,0,0,0,0,0,0
168062.0,Moriya Akane,L,Japan,32.0,165,2022,USA,2022-06-05,True,0,0,0,0,0,0,0,0,0,0,0,0,0,0,0,0,0,0,0,0,0,0,0,0
168062.0,Moriya Akane,L,Japan,32.0,165,2022,Poland,2022-06-14,True,0,0,0,0,0,0,0,0,0,0,0,0,0,0,0,0,0,0,0,0,0,0,0,0
168062.0,Moriya Akane,L,Japan,32.0,165,2022,Bulgaria,2022-06-16,True,0,0,0,0,1,0,3,4,0,0,0,0,0,0,0,0,5,0,7,12,18,6,1,25
168062.0,Moriya Akane,L,Japan,32.0,165,2022,Thailand,2022-06-17,True,0,0,0,0,0,0,0,0,0,0,0,0,0,0,0,0,0,0,0,0,0,0,0,0
168062.0,Moriya Akane,L,Japan,32.0,165,2022,China,2022-06-19,True,0,0,0,0,0,0,0,0,0,0,0,0,0,0,0,0,0,0,0,0,0,0,0,0
168062.0,Moriya Akane,L,Japan,32.0,165,2022,Netherlands,2022-06-29,False,0,0,0,0,0,0,3,3,0,0,0,0,0,0,0,0,11,0,9,20,12,3,0,15
168062.0,Moriya Akane,L,Japan,32.0,165,2022,Serbia,2022-07-02,False,0,0,0,0,0,0,0,0,0,0,0,0,0,0,0,0,0,0,0,0,0,0,0,0
168062.0,Moriya Akane,L,Japan,32.0,165,2022,Belgium,2022-07-03,False,0,0,0,0,0,0,0,0,0,0,0,0,0,0,0,0,0,0,0,0,0,0,0,0
168062.0,Moriya Akane,L,Japan,32.0,165,2022,Brazil,2022-07-13,False,0,0,0,0,0,0,0,0,0,0,0,0,0,0,0,0,0,0,0,0,0,0,0,0
146207.0,Uchiseto Mami,L,Japan,31.0,172,2022,Germany,2022-06-02,True,2,0,15,17,0,0,2,2,6,0,17,23,0,3,4,7,25,2,6,33,16,1,0,17
146207.0,Uchiseto Mami,L,Japan,31.0,172,2022,Dominican Republic,2022-06-04,True,0,0,6,6,0,0,1,1,2,2,7,11,0,0,1,1,6,0,1,7,3,0,0,3
146207.0,Uchiseto Mami,L,Japan,31.0,172,2022,USA,2022-06-05,True,0,0,0,0,0,0,0,0,0,0,0,0,0,0,0,0,0,0,0,0,0,0,0,0
146207.0,Uchiseto Mami,L,Japan,31.0,172,2022,Poland,2022-06-14,True,0,0,0,0,0,0,0,0,0,0,0,0,0,0,0,0,0,0,0,0,0,0,0,0
146207.0,Uchiseto Mami,L,Japan,31.0,172,2022,Bulgaria,2022-06-16,True,0,2,7,9,0,0,2,2,9,1,4,14,0,0,1,1,7,0,17,24,8,0,0,8
146207.0,Uchiseto Mami,L,Japan,31.0,172,2022,Thailand,2022-06-17,True,0,0,0,0,0,0,0,0,0,0,0,0,0,0,0,0,0,0,0,0,0,0,0,0
146207.0,Uchiseto Mami,L,Japan,31.0,172,2022,China,2022-06-19,True,0,0,0,0,0,0,0,0,0,0,0,0,0,0,0,0,0,0,0,0,0,0,0,0
146207.0,Uchiseto Mami,L,Japan,31.0,172,2022,Netherlands,2022-06-29,False,0,1,7,8,0,0,0,0,4,1,10,15,0,1,0,1,10,2,10,22,0,0,0,0
146207.0,Uchiseto Mami,L,Japan,31.0,172,2022,Serbia,2022-07-02,False,0,1,1,2,0,0,2,2,3,2,4,9,0,0,0,0,5,0,5,10,2,0,0,2
146207.0,Uchiseto Mami,L,Japan,31.0,172,2022,Belgium,2022-07-03,False,2,1,8,11,0,0,1,1,5,2,7,14,1,0,0,1,10,1,1,12,6,1,0,7
146207.0,Uchiseto Mami,L,Japan,31.0,172,2022,Brazil,2022-07-13,False,0,0,0,0,0,0,0,0,0,0,0,0,0,0,0,0,0,0,0,0,0,0,0,0
143437.0,Nishida Sarina,OH,Japan,26.0,180,2022,Germany,2022-06-02,True,0,2,18,20,0,0,4,4,33,9,34,76,0,2,3,5,19,1,6,26,13,1,0,14
143437.0,Nishida Sarina,OH,Japan,26.0,180,2022,Dominican Republic,2022-06-04,True,0,1,13,14,0,0,4,4,17,8,26,51,2,1,4,7,14,1,4,19,8,1,0,9
143437.0,Nishida Sarina,OH,Japan,26.0,180,2022,USA,2022-06-05,True,0,2,10,12,0,0,0,0,17,4,21,42,2,3,2,7,18,0,3,21,10,1,0,11
143437.0,Nishida Sarina,OH,Japan,26.0,180,2022,Poland,2022-06-14,True,1,0,15,16,0,0,0,0,16,3,12,31,2,1,2,5,3,0,9,12,6,1,1,8
143437.0,Nishida Sarina,OH,Japan,26.0,180,2022,Bulgaria,2022-06-16,True,1,0,14,15,0,0,2,2,17,2,12,31,0,1,4,5,4,0,12,16,9,1,0,10
143437.0,Nishida Sarina,OH,Japan,26.0,180,2022,Thailand,2022-06-17,True,0,1,10,11,0,0,1,1,18,5,17,40,3,2,3,8,3,0,9,12,11,2,3,16
143437.0,Nishida Sarina,OH,Japan,26.0,180,2022,China,2022-06-19,True,1,1,10,12,0,0,1,1,17,3,23,43,4,2,2,8,5,3,23,31,15,3,0,18
143437.0,Nishida Sarina,OH,Japan,26.0,180,2022,Netherlands,2022-06-29,False,0,0,15,15,0,0,0,0,31,3,35,69,0,1,2,3,18,0,11,29,7,3,0,10
143437.0,Nishida Sarina,OH,Japan,26.0,180,2022,Serbia,2022-07-02,False,0,0,16,16,0,0,3,3,13,5,31,49,1,1,2,4,8,1,11,20,11,1,0,12
143437.0,Nishida Sarina,OH,Japan,26.0,180,2022,Belgium,2022-07-03,False,1,1,13,15,0,0,5,5,24,6,33,63,0,3,0,3,9,0,6,15,9,0,0,9
143437.0,Nishida Sarina,OH,Japan,26.0,180,2022,Brazil,2022-07-13,False,0,1,8,9,0,0,1,1,12,6,25,43,1,1,1,3,11,1,31,43,5,3,2,10
162218.0,Ishikawa Mayu,OH,Japan,22.0,174,2022,Germany,2022-06-02,True,0,1,12,13,0,0,1,1,7,5,10,22,0,2,2,4,1,0,2,3,11,4,0,15
162218.0,Ishikawa Mayu,OH,Japan,22.0,174,2022,Dominican Republic,2022-06-04,True,0,1,0,1,0,0,0,0,0,0,0,0,0,0,0,0,0,0,0,0,0,0,0,0
162218.0,Ishikawa Mayu,OH,Japan,22.0,174,2022,USA,2022-06-05,True,0,0,2,2,0,0,0,0,0,0,0,0,0,0,0,0,0,0,0,0,1,0,0,1
162218.0,Ishikawa Mayu,OH,Japan,22.0,174,2022,Poland,2022-06-14,True,0,1,2,3,0,0,0,0,0,0,0,0,0,0,0,0,0,0,0,0,0,0,0,0
162218.0,Ishikawa Mayu,OH,Japan,22.0,174,2022,Bulgaria,2022-06-16,True,2,1,2,5,0,0,1,1,0,4,4,8,0,1,1,2,1,0,1,2,0,1,0,1
162218.0,Ishikawa Mayu,OH,Japan,22.0,174,2022,Thailand,2022-06-17,True,0,0,8,8,0,0,0,0,0,0,0,0,0,0,0,0,0,0,0,0,2,0,0,2
162218.0,Ishikawa Mayu,OH,Japan,22.0,174,2022,China,2022-06-19,True,0,1,2,3,0,0,0,0,0,0,0,0,0,0,0,0,0,0,0,0,0,0,0,0
162218.0,Ishikawa Mayu,OH,Japan,22.0,174,2022,Netherlands,2022-06-29,False,0,3,4,7,0,0,0,0,10,3,4,17,0,0,1,1,3,1,9,13,5,0,0,5
162218.0,Ishikawa Mayu,OH,Japan,22.0,174,2022,Serbia,2022-07-02,False,1,0,8,9,0,0,0,0,8,1,19,28,0,3,0,3,4,0,1,5,9,2,0,11
162218.0,Ishikawa Mayu,OH,Japan,22.0,174,2022,Belgium,2022-07-03,False,0,1,7,8,0,0,0,0,0,0,0,0,0,0,0,0,0,0,0,0,0,1,0,1
162218.0,Ishikawa Mayu,OH,Japan,22.0,174,2022,Brazil,2022-07-13,False,2,1,6,9,0,0,1,1,6,2,4,12,0,0,1,1,6,0,5,11,4,3,1,8
141953.0,Shimamura Haruyo,MB,Japan,31.0,182,2022,Germany,2022-06-02,True,0,0,0,0,0,0,0,0,0,0,0,0,0,0,0,0,0,0,0,0,0,0,0,0
141953.0,Shimamura Haruyo,MB,Japan,31.0,182,2022,Dominican Republic,2022-06-04,True,0,1,7,8,0,0,2,2,1,1,2,4,1,2,4,7,0,0,0,0,2,0,0,2
141953.0,Shimamura Haruyo,MB,Japan,31.0,182,2022,USA,2022-06-05,True,0,0,8,8,0,0,3,3,4,1,5,10,3,7,1,11,4,0,0,4,3,0,0,3
141953.0,Shimamura Haruyo,MB,Japan,31.0,182,2022,Poland,2022-06-14,True,1,0,11,12,0,0,1,1,9,1,6,16,0,3,0,3,0,0,1,1,3,0,1,4
141953.0,Shimamura Haruyo,MB,Japan,31.0,182,2022,Bulgaria,2022-06-16,True,0,1,9,10,0,0,1,1,3,0,10,13,2,2,4,8,0,0,1,1,2,1,1,4
141953.0,Shimamura Haruyo,MB,Japan,31.0,182,2022,Thailand,2022-06-17,True,0,0,8,8,0,0,1,1,4,1,13,18,0,3,7,10,1,0,0,1,4,0,0,4
141953.0,Shimamura Haruyo,MB,Japan,31.0,182,2022,China,2022-06-19,True,1,1,9,11,0,0,1,1,5,2,4,11,1,3,3,7,0,0,1,1,0,0,0,0
141953.0,Shimamura Haruyo,MB,Japan,31.0,182,2022,Netherlands,2022-06-29,False,0,0,7,7,0,0,0,0,5,1,3,9,1,3,3,7,0,0,0,0,1,0,0,1
141953.0,Shimamura Haruyo,MB,Japan,31.0,182,2022,Serbia,2022-07-02,False,2,0,12,14,0,0,1,1,10,2,9,21,0,3,0,3,0,0,0,0,2,1,1,4
141953.0,Shimamura Haruyo,MB,Japan,31.0,182,2022,Belgium,2022-07-03,False,0,0,10,10,0,0,3,3,4,3,8,15,1,6,3,10,0,0,1,1,3,0,0,3
141953.0,Shimamura Haruyo,MB,Japan,31.0,182,2022,Brazil,2022-07-13,False,1,1,16,18,0,0,3,3,6,1,9,16,1,3,6,10,0,0,0,0,4,1,0,5
132100.0,Miyashita Haruka,S,Japan,28.0,176,2022,Poland,2022-06-14,True,0,0,0,0,0,0,0,0,0,0,0,0,0,0,0,0,0,0,0,0,0,0,0,0
132100.0,Miyashita Haruka,S,Japan,28.0,176,2022,Bulgaria,2022-06-16,True,0,0,2,2,0,0,1,1,0,0,0,0,0,0,0,0,0,0,0,0,1,0,0,1
132100.0,Miyashita Haruka,S,Japan,28.0,176,2022,Thailand,2022-06-17,True,0,0,0,0,0,0,0,0,0,0,0,0,0,0,0,0,0,0,0,0,0,0,0,0
132100.0,Miyashita Haruka,S,Japan,28.0,176,2022,China,2022-06-19,True,0,0,0,0,0,0,0,0,0,0,0,0,0,0,0,0,0,0,0,0,0,0,0,0
142367.0,Kojima Manami,L,Japan,28.0,158,2022,Germany,2022-06-02,True,0,0,0,0,0,0,12,12,0,0,0,0,0,0,0,0,16,1,11,28,29,5,4,38
142367.0,Kojima Manami,L,Japan,28.0,158,2022,Dominican Republic,2022-06-04,True,0,0,0,0,0,0,14,14,0,0,0,0,0,0,0,0,19,1,6,26,27,2,0,29
142367.0,Kojima Manami,L,Japan,28.0,158,2022,USA,2022-06-05,True,0,0,0,0,0,0,9,9,0,0,0,0,0,0,0,0,11,0,8,19,16,4,2,22
142367.0,Kojima Manami,L,Japan,28.0,158,2022,Poland,2022-06-14,True,0,0,0,0,0,0,2,2,0,0,0,0,0,0,0,0,6,0,9,15,7,5,1,13
142367.0,Kojima Manami,L,Japan,28.0,158,2022,Bulgaria,2022-06-16,True,0,0,0,0,0,0,0,0,0,0,0,0,0,0,0,0,0,0,0,0,0,0,0,0
142367.0,Kojima Manami,L,Japan,28.0,158,2022,Thailand,2022-06-17,True,0,0,0,0,1,0,8,9,0,0,0,0,0,0,0,0,4,0,14,18,20,3,0,23
142367.0,Kojima Manami,L,Japan,28.0,158,2022,China,2022-06-19,True,0,0,0,0,0,0,17,17,0,0,0,0,0,0,0,0,2,0,14,16,12,4,2,18
142367.0,Kojima Manami,L,Japan,28.0,158,2022,Netherlands,2022-06-29,False,0,0,0,0,0,0,2,2,0,0,0,0,0,0,0,0,5,0,4,9,6,2,0,8
142367.0,Kojima Manami,L,Japan,28.0,158,2022,Serbia,2022-07-02,False,0,0,0,0,0,0,13,13,0,0,0,0,0,0,0,0,28,1,17,46,25,4,0,29
142367.0,Kojima Manami,L,Japan,28.0,158,2022,Belgium,2022-07-03,False,0,0,0,0,0,0,14,14,0,0,0,0,0,0,0,0,15,0,13,28,21,1,0,22
142367.0,Kojima Manami,L,Japan,28.0,158,2022,Brazil,2022-07-13,False,0,0,0,0,0,0,5,5,0,0,0,0,0,0,0,0,2,2,19,23,6,7,8,21
142372.0,Inoue Arisa,OH,Japan,27.0,178,2022,Germany,2022-06-02,True,0,1,14,15,0,0,7,7,13,1,15,29,0,0,3,3,0,0,0,0,10,1,1,12
142372.0,Inoue Arisa,OH,Japan,27.0,178,2022,Dominican Republic,2022-06-04,True,1,2,9,12,0,0,3,3,22,2,17,41,3,0,2,5,0,0,0,0,15,3,1,19
142372.0,Inoue Arisa,OH,Japan,27.0,178,2022,USA,2022-06-05,True,1,0,10,11,0,0,1,1,17,2,24,43,1,3,3,7,1,0,0,1,16,1,0,17
142372.0,Inoue Arisa,OH,Japan,27.0,178,2022,Poland,2022-06-14,True,0,3,8,11,0,0,0,0,16,4,19,39,1,2,3,6,0,0,0,0,2,1,0,3
142372.0,Inoue Arisa,OH,Japan,27.0,178,2022,Bulgaria,2022-06-16,True,0,1,9,10,0,0,1,1,13,0,18,31,3,0,1,4,0,0,0,0,4,2,1,7
142372.0,Inoue Arisa,OH,Japan,27.0,178,2022,Thailand,2022-06-17,True,0,1,10,11,0,0,0,0,17,1,19,37,1,1,8,10,0,0,0,0,14,2,0,16
142372.0,Inoue Arisa,OH,Japan,27.0,178,2022,China,2022-06-19,True,2,2,18,22,0,0,2,2,12,7,27,46,1,1,1,3,0,0,0,0,6,2,2,10
142372.0,Inoue Arisa,OH,Japan,27.0,178,2022,Netherlands,2022-06-29,False,1,1,8,10,0,0,1,1,7,5,14,26,0,2,1,3,0,0,0,0,5,1,0,6
142372.0,Inoue Arisa,OH,Japan,27.0,178,2022,Serbia,2022-07-02,False,1,0,7,8,0,0,1,1,3,4,16,23,1,1,0,2,0,0,0,0,12,1,0,13
142372.0,Inoue Arisa,OH,Japan,27.0,178,2022,Belgium,2022-07-03,False,0,0,8,8,0,0,2,2,7,3,19,29,0,1,1,2,0,0,0,0,8,0,1,9
142372.0,Inoue Arisa,OH,Japan,27.0,178,2022,Brazil,2022-07-13,False,1,1,6,8,0,0,0,0,4,1,5,10,0,1,0,1,0,0,0,0,4,3,3,10
162877.0,Okumu Oba Fuyumi Hawi,OH,Japan,24.0,178,2022,Germany,2022-06-02,True,0,0,0,0,0,0,0,0,0,0,0,0,0,0,0,0,0,0,0,0,0,0,0,0
162877.0,Okumu Oba Fuyumi Hawi,OH,Japan,24.0,178,2022,Dominican Republic,2022-06-04,True,0,0,0,0,0,0,1,1,2,1,1,4,0,0,0,0,0,0,0,0,0,0,0,0
162877.0,Okumu Oba Fuyumi Hawi,OH,Japan,24.0,178,2022,USA,2022-06-05,True,0,0,0,0,0,0,0,0,0,0,0,0,0,0,0,0,0,0,0,0,0,0,0,0
151953.0,Hayashi Kotona,OH,Japan,23.0,173,2022,Germany,2022-06-02,True,0,0,1,1,0,0,0,0,0,0,0,0,0,0,0,0,0,0,0,0,0,0,0,0
151953.0,Hayashi Kotona,OH,Japan,23.0,173,2022,Dominican Republic,2022-06-04,True,1,1,14,16,0,0,0,0,5,2,9,16,0,1,4,5,10,1,1,12,12,0,0,12
151953.0,Hayashi Kotona,OH,Japan,23.0,173,2022,USA,2022-06-05,True,0,0,12,12,0,0,2,2,5,2,6,13,0,3,4,7,7,0,1,8,14,1,0,15
151953.0,Hayashi Kotona,OH,Japan,23.0,173,2022,Poland,2022-06-14,True,1,2,6,9,0,0,0,0,5,2,4,11,1,1,0,2,12,1,16,29,12,4,1,17
151953.0,Hayashi Kotona,OH,Japan,23.0,173,2022,Bulgaria,2022-06-16,True,0,0,0,0,0,0,0,0,0,0,0,0,0,0,0,0,0,0,0,0,0,0,0,0
151953.0,Hayashi Kotona,OH,Japan,23.0,173,2022,Thailand,2022-06-17,True,0,1,8,9,1,0,1,2,6,4,13,23,1,0,3,4,9,0,7,16,9,2,0,11
151953.0,Hayashi Kotona,OH,Japan,23.0,173,2022,China,2022-06-19,True,1,1,9,11,0,0,4,4,18,4,6,28,0,4,7,11,8,1,14,23,12,5,0,17
151953.0,Hayashi Kotona,OH,Japan,23.0,173,2022,Netherlands,2022-06-29,False,0,0,4,4,0,0,0,0,3,2,3,8,0,0,0,0,3,0,4,7,2,0,0,2
151953.0,Hayashi Kotona,OH,Japan,23.0,173,2022,Serbia,2022-07-02,False,1,2,11,14,0,0,8,8,15,6,23,44,1,6,3,10,4,0,2,6,18,2,0,20
151953.0,Hayashi Kotona,OH,Japan,23.0,173,2022,Belgium,2022-07-03,False,1,1,16,18,0,0,7,7,16,3,11,30,0,5,2,7,16,1,7,24,20,1,0,21
151953.0,Hayashi Kotona,OH,Japan,23.0,173,2022,Brazil,2022-07-13,False,1,2,10,13,0,0,5,5,14,5,13,32,1,3,1,5,4,0,11,15,9,1,6,16
162227.0,Yamada Nichika,MB,Japan,23.0,184,2022,Germany,2022-06-02,True,0,3,9,12,0,0,2,2,4,1,8,13,1,2,5,8,0,0,0,0,5,0,0,5
162227.0,Yamada Nichika,MB,Japan,23.0,184,2022,Dominican Republic,2022-06-04,True,0,1,7,8,0,0,1,1,1,0,2,3,0,3,2,5,0,0,0,0,1,0,0,1
162227.0,Yamada Nichika,MB,Japan,23.0,184,2022,USA,2022-06-05,True,0,0,0,0,0,0,0,0,0,0,0,0,0,0,0,0,0,0,0,0,0,0,0,0
162227.0,Yamada Nichika,MB,Japan,23.0,184,2022,Netherlands,2022-06-29,False,2,1,12,15,0,0,1,1,6,1,2,9,1,4,0,5,0,0,0,0,0,0,0,0
162227.0,Yamada Nichika,MB,Japan,23.0,184,2022,Serbia,2022-07-02,False,0,2,2,4,0,0,1,1,0,0,2,2,0,2,3,5,0,0,0,0,0,0,0,0
162227.0,Yamada Nichika,MB,Japan,23.0,184,2022,Belgium,2022-07-03,False,0,0,0,0,0,0,0,0,0,0,0,0,0,0,0,0,0,0,0,0,0,0,0,0
162227.0,Yamada Nichika,MB,Japan,23.0,184,2022,Brazil,2022-07-13,False,0,0,2,2,0,0,0,0,2,1,3,6,0,0,4,4,0,0,0,0,1,0,1,2
189040.0,Yokota Mami,MB,Japan,25.0,177,2022,Poland,2022-06-14,True,1,2,9,12,0,0,0,0,3,1,3,7,0,1,7,8,0,0,2,2,2,1,0,3
189040.0,Yokota Mami,MB,Japan,25.0,177,2022,Bulgaria,2022-06-16,True,0,1,5,6,0,0,3,3,0,0,2,2,0,4,5,9,0,0,1,1,2,0,1,3
189040.0,Yokota Mami,MB,Japan,25.0,177,2022,Thailand,2022-06-17,True,0,2,6,8,0,0,2,2,6,0,3,9,1,1,5,7,0,0,0,0,2,0,0,2
189040.0,Yokota Mami,MB,Japan,25.0,177,2022,China,2022-06-19,True,0,0,16,16,0,0,1,1,2,0,3,5,3,2,3,8,0,0,1,1,4,0,0,4
162876.0,Matsui Tamaki,S,Japan,25.0,170,2022,Germany,2022-06-02,True,0,0,6,6,24,0,46,70,0,0,1,1,0,1,2,3,0,1,0,1,4,1,0,5
162876.0,Matsui Tamaki,S,Japan,25.0,170,2022,Dominican Republic,2022-06-04,True,0,0,2,2,10,1,24,35,0,0,0,0,0,0,1,1,0,0,0,0,3,2,1,6
162876.0,Matsui Tamaki,S,Japan,25.0,170,2022,USA,2022-06-05,True,0,0,0,0,0,0,0,0,0,0,0,0,0,0,0,0,0,0,0,0,0,0,0,0
162876.0,Matsui Tamaki,S,Japan,25.0,170,2022,Poland,2022-06-14,True,0,0,1,1,0,0,0,0,0,0,0,0,0,0,0,0,0,0,0,0,0,0,0,0
162876.0,Matsui Tamaki,S,Japan,25.0,170,2022,Bulgaria,2022-06-16,True,0,0,1,1,2,0,8,10,1,0,0,1,0,0,0,0,0,0,0,0,1,0,1,2
162876.0,Matsui Tamaki,S,Japan,25.0,170,2022,Thailand,2022-06-17,True,0,0,0,0,0,0,0,0,0,0,0,0,0,0,0,0,0,0,0,0,0,0,0,0
162876.0,Matsui Tamaki,S,Japan,25.0,170,2022,China,2022-06-19,True,1,1,13,15,20,1,60,81,1,0,2,3,0,1,1,2,0,0,0,0,12,2,0,14
162876.0,Matsui Tamaki,S,Japan,25.0,170,2022,Netherlands,2022-06-29,False,0,0,6,6,8,0,55,63,0,0,2,2,0,0,1,1,0,0,0,0,3,2,0,5
162876.0,Matsui Tamaki,S,Japan,25.0,170,2022,Serbia,2022-07-02,False,0,0,4,4,0,1,34,35,1,0,0,1,0,1,0,1,0,0,0,0,3,1,0,4
162876.0,Matsui Tamaki,S,Japan,25.0,170,2022,Belgium,2022-07-03,False,1,0,11,12,8,0,73,81,2,0,2,4,0,1,0,1,0,0,0,0,10,0,0,10
162876.0,Matsui Tamaki,S,Japan,25.0,170,2022,Brazil,2022-07-13,False,0,0,8,8,32,1,55,88,3,0,0,3,0,1,5,6,0,0,0,0,6,5,5,16
163046.0,Ogawa Erina,MB,Japan,24.0,178,2022,Germany,2022-06-02,True,2,1,9,12,0,0,1,1,11,3,8,22,0,6,3,9,2,1,0,3,5,0,0,5
163046.0,Ogawa Erina,MB,Japan,24.0,178,2022,Dominican Republic,2022-06-04,True,1,1,7,9,0,0,2,2,7,2,6,15,1,0,7,8,1,0,0,1,9,1,0,10
163046.0,Ogawa Erina,MB,Japan,24.0,178,2022,USA,2022-06-05,True,2,3,12,17,0,0,1,1,3,0,8,11,0,4,1,5,3,0,0,3,3,0,0,3
163046.0,Ogawa Erina,MB,Japan,24.0,178,2022,Poland,2022-06-14,True,0,0,0,0,0,0,0,0,0,0,0,0,0,0,0,0,0,0,0,0,0,0,0,0
163046.0,Ogawa Erina,MB,Japan,24.0,178,2022,Bulgaria,2022-06-16,True,0,0,3,3,0,0,0,0,3,0,1,4,0,0,2,2,0,0,0,0,0,1,0,1
163046.0,Ogawa Erina,MB,Japan,24.0,178,2022,Thailand,2022-06-17,True,0,0,0,0,0,0,0,0,0,0,0,0,0,0,0,0,0,0,0,0,0,0,0,0
163046.0,Ogawa Erina,MB,Japan,24.0,178,2022,China,2022-06-19,True,0,0,0,0,0,0,0,0,0,0,0,0,0,0,0,0,0,0,0,0,0,0,0,0
163046.0,Ogawa Erina,MB,Japan,24.0,178,2022,Netherlands,2022-06-29,False,0,0,6,6,0,0,1,1,1,2,2,5,0,0,0,0,0,0,0,0,1,0,0,1
163046.0,Ogawa Erina,MB,Japan,24.0,178,2022,Serbia,2022-07-02,False,0,0,3,3,0,0,0,0,0,1,3,4,0,1,0,1,0,0,0,0,2,0,0,2
163046.0,Ogawa Erina,MB,Japan,24.0,178,2022,Belgium,2022-07-03,False,0,0,0,0,0,0,0,0,0,0,0,0,0,0,0,0,0,0,0,0,0,0,0,0
163046.0,Ogawa Erina,MB,Japan,24.0,178,2022,Brazil,2022-07-13,False,0,1,13,14,0,0,2,2,3,4,4,11,2,6,2,10,0,0,0,0,3,2,1,6
146519.0,Miyabe Airi,OH,Japan,24.0,181,2022,Netherlands,2022-06-29,False,1,0,5,6,0,0,2,2,6,4,7,17,0,1,0,1,0,0,0,0,2,0,1,3
146519.0,Miyabe Airi,OH,Japan,24.0,181,2022,Serbia,2022-07-02,False,0,0,0,0,0,0,0,0,0,0,0,0,0,0,0,0,0,0,0,0,0,0,0,0
146519.0,Miyabe Airi,OH,Japan,24.0,181,2022,Belgium,2022-07-03,False,0,0,0,0,0,0,0,0,0,0,0,0,0,0,0,0,0,0,0,0,0,0,0,0
161807.0,Hamamatsu Asuka,MB,Japan,24.0,181,2022,Netherlands,2022-06-29,False,0,1,1,2,0,0,0,0,3,1,4,8,0,0,0,0,0,0,2,2,0,0,0,0
161807.0,Hamamatsu Asuka,MB,Japan,24.0,181,2022,Serbia,2022-07-02,False,0,0,4,4,0,0,2,2,1,1,6,8,0,3,1,4,0,0,0,0,0,0,0,0
161807.0,Hamamatsu Asuka,MB,Japan,24.0,181,2022,Belgium,2022-07-03,False,0,1,7,8,0,1,0,1,5,1,4,10,0,4,0,4,0,1,0,1,0,1,0,1
161807.0,Hamamatsu Asuka,MB,Japan,24.0,181,2022,Brazil,2022-07-13,False,0,0,0,0,0,0,0,0,0,0,0,0,0,0,0,0,0,0,0,0,0,0,0,0
151944.0,Seki Nanami,S,Japan,23.0,171,2022,Germany,2022-06-02,True,0,1,7,8,25,1,57,83,0,0,0,0,0,1,0,1,0,0,0,0,10,0,0,10
151944.0,Seki Nanami,S,Japan,23.0,171,2022,Dominican Republic,2022-06-04,True,0,0,16,16,23,0,54,77,3,0,0,3,0,1,6,7,0,0,0,0,13,1,0,14
151944.0,Seki Nanami,S,Japan,23.0,171,2022,USA,2022-06-05,True,1,1,9,11,19,0,79,98,1,0,2,3,0,2,3,5,0,0,0,0,10,0,0,10
151944.0,Seki Nanami,S,Japan,23.0,171,2022,Poland,2022-06-14,True,0,2,7,9,25,0,75,100,0,0,0,0,0,1,2,3,0,0,0,0,1,1,1,3
151944.0,Seki Nanami,S,Japan,23.0,171,2022,Bulgaria,2022-06-16,True,0,1,6,7,29,2,52,83,0,0,0,0,0,1,2,3,0,0,0,0,6,3,1,10
151944.0,Seki Nanami,S,Japan,23.0,171,2022,Thailand,2022-06-17,True,0,1,14,15,31,0,79,110,0,0,0,0,0,0,7,7,0,0,0,0,6,0,0,6
151944.0,Seki Nanami,S,Japan,23.0,171,2022,China,2022-06-19,True,0,0,1,1,3,0,17,20,0,0,0,0,0,0,0,0,0,0,0,0,0,1,0,1
151944.0,Seki Nanami,S,Japan,23.0,171,2022,Netherlands,2022-06-29,False,1,1,15,17,16,0,99,115,1,0,0,1,0,2,0,2,0,0,0,0,4,4,0,8
151944.0,Seki Nanami,S,Japan,23.0,171,2022,Serbia,2022-07-02,False,0,1,8,9,7,2,128,137,1,0,3,4,0,3,0,3,0,0,0,0,10,2,0,12
151944.0,Seki Nanami,S,Japan,23.0,171,2022,Belgium,2022-07-03,False,0,1,5,6,4,1,53,58,1,0,1,2,0,1,0,1,0,0,0,0,4,0,0,4
151944.0,Seki Nanami,S,Japan,23.0,171,2022,Brazil,2022-07-13,False,0,0,4,4,12,0,27,39,0,0,0,0,0,1,1,2,0,0,0,0,1,0,0,1
189193.0,Sato Yoshino,OH,Japan,21.0,177,2022,Germany,2022-06-02,True,0,0,8,8,0,0,1,1,0,0,0,0,0,0,0,0,0,0,0,0,2,1,1,4
189193.0,Sato Yoshino,OH,Japan,21.0,177,2022,Dominican Republic,2022-06-04,True,0,1,1,2,0,0,0,0,0,0,0,0,0,0,0,0,0,0,0,0,0,0,0,0
189193.0,Sato Yoshino,OH,Japan,21.0,177,2022,USA,2022-06-05,True,0,0,1,1,0,0,0,0,0,0,0,0,0,0,0,0,0,0,0,0,0,0,0,0
189193.0,Sato Yoshino,OH,Japan,21.0,177,2022,Poland,2022-06-14,True,0,0,0,0,0,0,0,0,0,0,0,0,0,0,0,0,0,0,0,0,0,0,0,0
189193.0,Sato Yoshino,OH,Japan,21.0,177,2022,Bulgaria,2022-06-16,True,1,1,3,5,0,0,0,0,0,0,0,0,0,0,0,0,0,0,0,0,0,0,0,0
189193.0,Sato Yoshino,OH,Japan,21.0,177,2022,Thailand,2022-06-17,True,0,1,2,3,0,0,0,0,0,0,0,0,0,0,0,0,0,0,0,0,0,0,0,0
189193.0,Sato Yoshino,OH,Japan,21.0,177,2022,China,2022-06-19,True,1,1,0,2,0,0,0,0,0,0,0,0,0,0,0,0,0,0,0,0,0,0,0,0
189193.0,Sato Yoshino,OH,Japan,21.0,177,2022,Brazil,2022-07-13,False,0,3,5,8,0,0,1,1,9,4,10,23,0,1,2,3,0,0,0,0,3,3,3,9
150828.0,Savelkoel Fleur,OH,Netherlands,27.0,184,2022,China,2022-06-01,False,0,0,17,17,0,0,1,1,14,7,13,34,0,1,3,4,15,1,36,52,7,5,3,15
150828.0,Savelkoel Fleur,OH,Netherlands,27.0,184,2022,Bulgaria,2022-06-02,False,1,0,8,9,0,0,0,0,10,4,22,36,3,3,1,7,15,2,29,46,10,5,7,22
150828.0,Savelkoel Fleur,OH,Netherlands,27.0,184,2022,Italy,2022-06-03,False,0,0,4,4,0,0,0,0,3,5,10,18,1,0,1,2,1,0,10,11,1,1,0,2
150828.0,Savelkoel Fleur,OH,Netherlands,27.0,184,2022,Serbia,2022-06-05,False,0,0,9,9,0,0,3,3,5,4,8,17,0,1,1,2,6,3,20,29,2,2,4,8
150828.0,Savelkoel Fleur,OH,Netherlands,27.0,184,2022,Germany,2022-06-14,False,2,2,5,9,0,0,0,0,8,0,8,16,3,0,2,5,1,1,9,11,4,0,0,4
150828.0,Savelkoel Fleur,OH,Netherlands,27.0,184,2022,Japan,2022-06-29,True,0,2,21,23,0,0,2,2,17,3,20,40,3,2,1,6,6,1,9,16,8,3,0,11
150828.0,Savelkoel Fleur,OH,Netherlands,27.0,184,2022,Belgium,2022-07-01,True,0,0,15,15,0,0,4,4,15,4,20,39,3,2,0,5,13,1,19,33,15,0,0,15
150828.0,Savelkoel Fleur,OH,Netherlands,27.0,184,2022,Canada,2022-07-03,True,3,2,15,20,0,0,5,5,14,5,18,37,1,3,0,4,12,0,9,21,8,3,0,11
142880.0,Plak Celeste,O,Netherlands,27.0,190,2022,China,2022-06-01,False,0,1,8,9,0,2,2,4,22,5,17,44,2,1,7,10,0,0,0,0,3,6,4,13
142880.0,Plak Celeste,O,Netherlands,27.0,190,2022,Bulgaria,2022-06-02,False,0,0,3,3,0,0,0,0,3,3,6,12,0,2,0,2,0,0,1,1,1,0,0,1
142880.0,Plak Celeste,O,Netherlands,27.0,190,2022,Italy,2022-06-03,False,1,0,4,5,0,0,0,0,4,2,3,9,0,0,0,0,0,0,0,0,1,0,1,2
142880.0,Plak Celeste,O,Netherlands,27.0,190,2022,Serbia,2022-06-05,False,0,3,9,12,0,0,0,0,17,2,17,36,2,3,0,5,3,1,24,28,8,0,1,9
142880.0,Plak Celeste,O,Netherlands,27.0,190,2022,Germany,2022-06-14,False,0,0,1,1,0,0,0,0,0,2,1,3,0,0,0,0,1,0,0,1,2,0,0,2
142880.0,Plak Celeste,O,Netherlands,27.0,190,2022,Japan,2022-06-29,True,0,0,17,17,0,0,1,1,16,4,19,39,0,0,1,1,2,0,0,2,9,1,1,11
142880.0,Plak Celeste,O,Netherlands,27.0,190,2022,Belgium,2022-07-01,True,0,1,3,4,0,0,1,1,2,3,5,10,0,2,0,2,0,0,1,1,2,0,0,2
142880.0,Plak Celeste,O,Netherlands,27.0,190,2022,Canada,2022-07-03,True,1,0,9,10,0,0,3,3,16,7,19,42,2,2,1,5,0,0,0,0,13,1,0,14
167482.0,Knollema Jolien,OH,Netherlands,20.0,189,2022,China,2022-06-01,False,0,0,0,0,0,0,0,0,0,0,1,1,0,0,0,0,0,0,1,1,0,0,0,0
167482.0,Knollema Jolien,OH,Netherlands,20.0,189,2022,Bulgaria,2022-06-02,False,0,0,1,1,0,0,0,0,3,0,3,6,0,0,1,1,1,2,1,4,0,2,0,2
167482.0,Knollema Jolien,OH,Netherlands,20.0,189,2022,Italy,2022-06-03,False,0,0,4,4,0,0,0,0,3,3,6,12,1,2,1,4,2,1,20,23,3,5,1,9
167482.0,Knollema Jolien,OH,Netherlands,20.0,189,2022,Serbia,2022-06-05,False,0,0,0,0,0,0,0,0,0,2,0,2,0,0,0,0,0,0,0,0,0,0,0,0
167482.0,Knollema Jolien,OH,Netherlands,20.0,189,2022,Germany,2022-06-14,False,0,0,0,0,0,0,0,0,0,0,0,0,0,0,0,0,0,0,0,0,0,0,0,0
167482.0,Knollema Jolien,OH,Netherlands,20.0,189,2022,Japan,2022-06-29,True,0,0,0,0,0,0,0,0,0,0,0,0,0,0,0,0,0,0,0,0,0,0,0,0
167482.0,Knollema Jolien,OH,Netherlands,20.0,189,2022,Belgium,2022-07-01,True,0,0,0,0,0,0,0,0,0,0,0,0,0,0,0,0,0,0,0,0,0,0,0,0
167482.0,Knollema Jolien,OH,Netherlands,20.0,189,2022,Canada,2022-07-03,True,0,0,0,0,0,0,0,0,0,0,0,0,0,0,0,0,0,0,0,0,0,0,0,0
151194.0,Lohuis Juliet,MB,Netherlands,26.0,190,2022,China,2022-06-01,False,0,0,12,12,0,0,2,2,9,1,3,13,3,2,5,10,1,0,1,2,0,0,0,0
151194.0,Lohuis Juliet,MB,Netherlands,26.0,190,2022,Bulgaria,2022-06-02,False,0,0,13,13,0,0,6,6,5,1,6,12,3,3,10,16,0,0,0,0,3,2,1,6
151194.0,Lohuis Juliet,MB,Netherlands,26.0,190,2022,Italy,2022-06-03,False,1,1,5,7,1,0,0,1,3,1,7,11,0,6,3,9,0,0,0,0,0,1,0,1
151194.0,Lohuis Juliet,MB,Netherlands,26.0,190,2022,Serbia,2022-06-05,False,0,0,12,12,1,0,1,2,8,0,5,13,3,10,15,28,0,0,3,3,2,1,2,5
151194.0,Lohuis Juliet,MB,Netherlands,26.0,190,2022,Germany,2022-06-14,False,1,2,9,12,0,0,0,0,3,1,5,9,4,6,3,13,0,0,0,0,2,0,0,2
151194.0,Lohuis Juliet,MB,Netherlands,26.0,190,2022,Japan,2022-06-29,True,3,2,13,18,0,0,2,2,9,0,7,16,4,4,4,12,1,0,0,1,1,0,0,1
151194.0,Lohuis Juliet,MB,Netherlands,26.0,190,2022,Belgium,2022-07-01,True,3,0,13,16,0,0,2,2,14,1,5,20,2,3,3,8,0,0,0,0,4,0,0,4
151194.0,Lohuis Juliet,MB,Netherlands,26.0,190,2022,Canada,2022-07-03,True,1,2,8,11,0,0,2,2,4,2,10,16,1,5,3,9,0,0,0,0,2,0,0,2
167777.0,Korevaar Demi,MB,Netherlands,22.0,187,2022,Japan,2022-06-29,True,0,0,0,0,0,0,0,0,0,0,0,0,0,0,0,0,0,0,0,0,0,0,0,0
167777.0,Korevaar Demi,MB,Netherlands,22.0,187,2022,Belgium,2022-07-01,True,0,0,0,0,0,0,0,0,0,0,0,0,0,0,0,0,0,0,0,0,0,0,0,0
167777.0,Korevaar Demi,MB,Netherlands,22.0,187,2022,Canada,2022-07-03,True,0,0,0,0,0,0,0,0,0,0,0,0,0,0,0,0,0,0,0,0,0,0,0,0
123468.0,Schoot Myrthe,L,Netherlands,34.0,182,2022,China,2022-06-01,False,0,0,0,0,0,0,5,5,0,0,0,0,0,0,0,0,3,1,8,12,9,15,14,38
123468.0,Schoot Myrthe,L,Netherlands,34.0,182,2022,Bulgaria,2022-06-02,False,0,0,0,0,0,0,13,13,0,0,0,0,0,0,0,0,5,0,12,17,14,5,7,26
123468.0,Schoot Myrthe,L,Netherlands,34.0,182,2022,Italy,2022-06-03,False,0,0,0,0,1,0,3,4,0,0,0,0,0,0,0,0,5,1,14,20,10,7,3,20
123468.0,Schoot Myrthe,L,Netherlands,34.0,182,2022,Serbia,2022-06-05,False,0,0,0,0,1,0,10,11,0,0,0,0,0,0,0,0,0,0,15,15,20,3,5,28
123468.0,Schoot Myrthe,L,Netherlands,34.0,182,2022,Germany,2022-06-14,False,0,0,0,0,0,0,0,0,0,0,0,0,0,0,0,0,7,0,9,16,8,6,1,15
123468.0,Schoot Myrthe,L,Netherlands,34.0,182,2022,Japan,2022-06-29,True,0,0,0,0,0,0,6,6,0,0,0,0,0,0,0,0,10,1,6,17,18,3,0,21
123468.0,Schoot Myrthe,L,Netherlands,34.0,182,2022,Belgium,2022-07-01,True,0,0,0,0,0,1,8,9,0,0,0,0,0,0,0,0,8,0,9,17,23,3,0,26
123468.0,Schoot Myrthe,L,Netherlands,34.0,182,2022,Canada,2022-07-03,True,0,0,0,0,0,1,13,14,0,0,0,0,0,0,0,0,11,0,6,17,22,2,1,25
162356.0,van Aalen Sarah,S,Netherlands,23.0,186,2022,China,2022-06-01,False,0,0,1,1,0,0,8,8,0,0,0,0,0,0,0,0,0,0,0,0,1,0,0,1
162356.0,van Aalen Sarah,S,Netherlands,23.0,186,2022,Bulgaria,2022-06-02,False,0,0,2,2,3,0,13,16,0,0,0,0,0,0,2,2,0,0,0,0,4,1,1,6
162356.0,van Aalen Sarah,S,Netherlands,23.0,186,2022,Italy,2022-06-03,False,0,0,0,0,0,0,9,9,0,0,0,0,0,0,0,0,0,0,0,0,1,0,0,1
162356.0,van Aalen Sarah,S,Netherlands,23.0,186,2022,Serbia,2022-06-05,False,0,0,0,0,0,0,0,0,0,0,0,0,0,0,0,0,0,0,0,0,0,0,0,0
120503.0,Buijs Anne,OH,Netherlands,31.0,-,2022,Germany,2022-06-14,False,0,0,14,14,0,0,0,0,18,3,17,38,1,3,2,6,12,0,16,28,6,5,1,12
120503.0,Buijs Anne,OH,Netherlands,31.0,-,2022,Japan,2022-06-29,True,0,1,16,17,0,0,1,1,19,4,21,44,3,2,3,8,33,2,18,53,10,3,0,13
120503.0,Buijs Anne,OH,Netherlands,31.0,-,2022,Belgium,2022-07-01,True,0,0,14,14,0,0,3,3,11,4,23,38,0,3,4,7,13,0,9,22,11,1,0,12
120503.0,Buijs Anne,OH,Netherlands,31.0,-,2022,Canada,2022-07-03,True,1,0,18,19,0,0,6,6,12,5,21,38,1,2,1,4,21,2,20,43,18,4,1,23
147432.0,Bongaerts Britt,S,Netherlands,26.0,185,2022,China,2022-06-01,False,0,1,12,13,15,0,96,111,2,1,3,6,1,3,6,10,0,0,0,0,5,3,3,11
147432.0,Bongaerts Britt,S,Netherlands,26.0,185,2022,Bulgaria,2022-06-02,False,0,1,19,20,17,1,81,99,1,0,2,3,0,4,9,13,0,0,0,0,6,6,7,19
147432.0,Bongaerts Britt,S,Netherlands,26.0,185,2022,Italy,2022-06-03,False,0,0,5,5,22,0,45,67,0,0,2,2,1,4,5,10,0,0,0,0,4,2,3,9
147432.0,Bongaerts Britt,S,Netherlands,26.0,185,2022,Serbia,2022-06-05,False,2,0,15,17,64,1,71,136,0,0,4,4,1,1,6,8,0,1,0,1,9,5,4,18
147432.0,Bongaerts Britt,S,Netherlands,26.0,185,2022,Germany,2022-06-14,False,0,0,12,12,27,0,82,109,0,0,1,1,0,3,3,6,0,0,0,0,4,5,0,9
147432.0,Bongaerts Britt,S,Netherlands,26.0,185,2022,Japan,2022-06-29,True,0,1,9,10,24,0,114,138,2,0,1,3,1,3,0,4,0,0,0,0,1,1,0,2
147432.0,Bongaerts Britt,S,Netherlands,26.0,185,2022,Belgium,2022-07-01,True,0,0,16,16,8,1,119,128,2,0,2,4,0,5,1,6,0,0,0,0,15,0,0,15
147432.0,Bongaerts Britt,S,Netherlands,26.0,185,2022,Canada,2022-07-03,True,1,0,17,18,3,1,134,138,1,0,2,3,0,1,1,2,0,0,0,0,11,4,0,15
124070.0,Dijkema Laura,S,Netherlands,33.0,184,2022,Germany,2022-06-14,False,0,0,1,1,1,0,7,8,0,0,0,0,0,0,0,0,0,0,0,0,0,0,0,0
124070.0,Dijkema Laura,S,Netherlands,33.0,184,2022,Japan,2022-06-29,True,0,0,6,6,1,0,12,13,0,0,0,0,0,0,0,0,0,0,0,0,0,0,0,0
124070.0,Dijkema Laura,S,Netherlands,33.0,184,2022,Belgium,2022-07-01,True,0,0,3,3,0,0,3,3,0,0,0,0,0,0,0,0,0,0,0,0,1,0,0,1
124070.0,Dijkema Laura,S,Netherlands,33.0,184,2022,Canada,2022-07-03,True,0,0,0,0,0,0,1,1,0,0,0,0,0,0,0,0,0,0,0,0,0,0,0,0
168148.0,Baijens Indy,MB,Netherlands,22.0,193,2022,China,2022-06-01,False,0,0,0,0,0,0,0,0,0,0,0,0,0,0,0,0,0,0,0,0,0,0,0,0
168148.0,Baijens Indy,MB,Netherlands,22.0,193,2022,Bulgaria,2022-06-02,False,0,0,0,0,0,0,0,0,0,0,0,0,0,0,0,0,0,0,0,0,0,0,0,0
168148.0,Baijens Indy,MB,Netherlands,22.0,193,2022,Italy,2022-06-03,False,0,0,0,0,0,0,0,0,0,0,0,0,0,0,0,0,0,0,0,0,0,0,0,0
168148.0,Baijens Indy,MB,Netherlands,22.0,193,2022,Serbia,2022-06-05,False,0,0,0,0,0,0,0,0,1,0,0,1,0,0,0,0,0,0,0,0,0,0,0,0
168148.0,Baijens Indy,MB,Netherlands,22.0,193,2022,Germany,2022-06-14,False,0,0,0,0,0,0,0,0,0,0,0,0,0,0,0,0,0,0,0,0,0,0,0,0
168148.0,Baijens Indy,MB,Netherlands,22.0,193,2022,Japan,2022-06-29,True,0,0,0,0,0,0,0,0,0,0,0,0,0,0,0,0,0,0,0,0,0,0,0,0
168148.0,Baijens Indy,MB,Netherlands,22.0,193,2022,Belgium,2022-07-01,True,0,0,0,0,0,0,0,0,0,0,0,0,0,0,0,0,0,0,0,0,0,0,0,0
168148.0,Baijens Indy,MB,Netherlands,22.0,193,2022,Canada,2022-07-03,True,0,0,0,0,0,0,0,0,0,0,0,0,0,0,0,0,0,0,0,0,0,0,0,0
181648.0,Vos Iris,OH,Netherlands,20.0,184,2022,China,2022-06-01,False,0,0,0,0,0,0,0,0,0,0,0,0,0,0,0,0,0,0,0,0,0,0,0,0
181648.0,Vos Iris,OH,Netherlands,20.0,184,2022,Bulgaria,2022-06-02,False,0,0,0,0,0,0,0,0,0,0,0,0,0,0,0,0,0,0,0,0,0,0,0,0
181648.0,Vos Iris,OH,Netherlands,20.0,184,2022,Italy,2022-06-03,False,0,0,0,0,0,0,0,0,0,0,0,0,0,0,0,0,0,0,0,0,0,0,0,0
181648.0,Vos Iris,OH,Netherlands,20.0,184,2022,Serbia,2022-06-05,False,0,0,0,0,0,0,0,0,0,0,0,0,0,0,0,0,0,0,0,0,0,0,0,0
159904.0,Jasper Marrit,OH,Netherlands,27.0,180,2022,China,2022-06-01,False,1,0,19,20,0,0,2,2,11,1,9,21,0,2,5,7,4,1,14,19,11,5,9,25
159904.0,Jasper Marrit,OH,Netherlands,27.0,180,2022,Bulgaria,2022-06-02,False,0,0,12,12,0,0,5,5,10,5,12,27,0,1,0,1,4,2,12,18,15,9,3,27
159904.0,Jasper Marrit,OH,Netherlands,27.0,180,2022,Italy,2022-06-03,False,0,1,7,8,0,0,0,0,2,2,4,8,0,0,0,0,3,1,6,10,3,0,0,3
159904.0,Jasper Marrit,OH,Netherlands,27.0,180,2022,Serbia,2022-06-05,False,0,1,19,20,0,0,3,3,6,7,17,30,1,2,2,5,7,0,12,19,11,4,3,18
159904.0,Jasper Marrit,OH,Netherlands,27.0,180,2022,Germany,2022-06-14,False,1,1,6,8,0,0,0,0,1,3,5,9,0,0,1,1,5,0,10,15,1,2,1,4
159904.0,Jasper Marrit,OH,Netherlands,27.0,180,2022,Japan,2022-06-29,True,0,0,0,0,0,0,0,0,0,0,0,0,0,0,0,0,1,0,2,3,1,1,0,2
159904.0,Jasper Marrit,OH,Netherlands,27.0,180,2022,Belgium,2022-07-01,True,0,1,1,2,0,0,0,0,2,2,4,8,2,0,0,2,5,0,1,6,1,2,0,3
159904.0,Jasper Marrit,OH,Netherlands,27.0,180,2022,Canada,2022-07-03,True,0,0,0,0,0,0,1,1,0,0,0,0,0,0,0,0,1,0,2,3,4,0,0,4
150809.0,Daalderop Nika,OH,Netherlands,24.0,189,2022,Germany,2022-06-14,False,0,0,0,0,0,0,0,0,0,0,0,0,0,0,0,0,0,0,0,0,0,0,0,0
172894.0,Timmerman Eline,MB,Netherlands,24.0,192,2022,China,2022-06-01,False,0,0,19,19,0,0,1,1,6,1,6,13,3,9,6,18,0,0,0,0,4,5,4,13
172894.0,Timmerman Eline,MB,Netherlands,24.0,192,2022,Bulgaria,2022-06-02,False,1,0,11,12,0,0,2,2,8,0,4,12,3,9,7,19,0,0,0,0,3,4,1,8
172894.0,Timmerman Eline,MB,Netherlands,24.0,192,2022,Italy,2022-06-03,False,0,2,7,9,0,0,1,1,2,1,4,7,0,3,0,3,1,0,0,1,1,0,1,2
172894.0,Timmerman Eline,MB,Netherlands,24.0,192,2022,Serbia,2022-06-05,False,2,1,14,17,0,0,3,3,11,3,8,22,5,12,17,34,0,0,1,1,4,1,1,6
172894.0,Timmerman Eline,MB,Netherlands,24.0,192,2022,Germany,2022-06-14,False,0,2,13,15,0,0,0,0,6,1,6,13,1,10,6,17,0,0,1,1,2,1,0,3
172894.0,Timmerman Eline,MB,Netherlands,24.0,192,2022,Japan,2022-06-29,True,1,2,17,20,0,0,1,1,12,1,7,20,3,4,1,8,1,1,1,3,1,1,0,2
172894.0,Timmerman Eline,MB,Netherlands,24.0,192,2022,Belgium,2022-07-01,True,1,2,15,18,0,0,2,2,5,2,6,13,4,7,8,19,0,0,0,0,5,1,0,6
172894.0,Timmerman Eline,MB,Netherlands,24.0,192,2022,Canada,2022-07-03,True,0,1,17,18,0,0,2,2,5,1,6,12,6,6,1,13,0,0,0,0,3,2,0,5
162357.0,de Zwart Laura,MB,Netherlands,24.0,199,2022,China,2022-06-01,False,0,0,0,0,0,0,0,0,0,0,0,0,0,0,0,0,0,0,0,0,0,0,0,0
162357.0,de Zwart Laura,MB,Netherlands,24.0,199,2022,Bulgaria,2022-06-02,False,0,0,0,0,0,0,0,0,0,0,0,0,0,0,0,0,0,0,0,0,0,0,0,0
162357.0,de Zwart Laura,MB,Netherlands,24.0,199,2022,Italy,2022-06-03,False,0,0,0,0,0,0,0,0,0,0,0,0,0,0,0,0,0,0,0,0,0,0,0,0
162357.0,de Zwart Laura,MB,Netherlands,24.0,199,2022,Serbia,2022-06-05,False,0,0,0,0,0,0,0,0,0,0,0,0,0,0,0,0,0,0,0,0,0,0,0,0
148581.0,Reesink Florien,L,Netherlands,24.0,174,2022,China,2022-06-01,False,0,0,0,0,0,0,0,0,0,0,1,1,0,0,0,0,0,0,0,0,0,0,0,0
148581.0,Reesink Florien,L,Netherlands,24.0,174,2022,Bulgaria,2022-06-02,False,0,0,0,0,0,0,0,0,0,0,1,1,0,0,0,0,0,0,0,0,1,0,1,2
148581.0,Reesink Florien,L,Netherlands,24.0,174,2022,Italy,2022-06-03,False,0,0,0,0,0,0,0,0,0,0,0,0,0,0,0,0,0,0,0,0,0,0,0,0
148581.0,Reesink Florien,L,Netherlands,24.0,174,2022,Serbia,2022-06-05,False,0,0,0,0,0,0,0,0,0,0,0,0,0,0,0,0,0,0,0,0,0,0,0,0
148581.0,Reesink Florien,L,Netherlands,24.0,174,2022,Germany,2022-06-14,False,0,0,0,0,0,0,0,0,1,0,0,1,0,0,0,0,0,0,0,0,0,0,0,0
148581.0,Reesink Florien,L,Netherlands,24.0,174,2022,Japan,2022-06-29,True,0,0,0,0,0,0,0,0,0,0,0,0,0,0,0,0,0,0,0,0,0,0,0,0
148581.0,Reesink Florien,L,Netherlands,24.0,174,2022,Belgium,2022-07-01,True,0,0,0,0,0,0,0,0,0,0,0,0,0,0,0,0,0,0,0,0,0,0,0,0
148581.0,Reesink Florien,L,Netherlands,24.0,174,2022,Canada,2022-07-03,True,0,0,0,0,0,0,0,0,0,0,0,0,0,0,0,0,0,0,0,0,0,0,0,0
181248.0,Dambrink Elles,O,Netherlands,19.0,184,2022,China,2022-06-01,False,0,0,2,2,0,0,0,0,5,0,3,8,0,0,0,0,0,0,0,0,0,1,1,2
181248.0,Dambrink Elles,O,Netherlands,19.0,184,2022,Bulgaria,2022-06-02,False,0,4,10,14,0,0,2,2,13,5,16,34,1,1,4,6,0,0,0,0,7,3,3,13
181248.0,Dambrink Elles,O,Netherlands,19.0,184,2022,Italy,2022-06-03,False,0,0,9,9,0,0,1,1,11,4,5,20,0,0,1,1,0,0,0,0,4,3,2,9
181248.0,Dambrink Elles,O,Netherlands,19.0,184,2022,Serbia,2022-06-05,False,1,3,13,17,2,0,1,3,17,6,13,36,1,5,3,9,0,0,0,0,14,2,2,18
181248.0,Dambrink Elles,O,Netherlands,19.0,184,2022,Germany,2022-06-14,False,1,3,11,15,0,0,0,0,14,3,19,36,0,1,1,2,0,0,0,0,1,2,1,4
181248.0,Dambrink Elles,O,Netherlands,19.0,184,2022,Japan,2022-06-29,True,0,0,0,0,0,0,1,1,0,0,1,1,2,0,2,4,0,0,0,0,0,0,0,0
181248.0,Dambrink Elles,O,Netherlands,19.0,184,2022,Belgium,2022-07-01,True,1,2,5,8,0,0,5,5,8,3,9,20,3,2,2,7,0,0,0,0,7,1,0,8
181248.0,Dambrink Elles,O,Netherlands,19.0,184,2022,Canada,2022-07-03,True,0,1,2,3,0,1,0,1,2,1,4,7,0,1,0,1,0,0,0,0,1,0,0,1
152233.0,Stenzel Maria,L,Poland,24.0,168,2022,Canada,2022-06-01,True,0,0,0,0,0,0,13,13,0,0,0,0,0,0,0,0,19,0,4,23,23,1,1,25
152233.0,Stenzel Maria,L,Poland,24.0,168,2022,Brazil,2022-06-02,False,0,0,0,0,0,0,11,11,0,0,0,0,0,0,0,0,15,2,4,21,12,2,0,14
152233.0,Stenzel Maria,L,Poland,24.0,168,2022,Germany,2022-06-05,True,0,0,0,0,0,0,8,8,0,0,0,0,0,0,0,0,18,1,12,31,14,3,1,18
152233.0,Stenzel Maria,L,Poland,24.0,168,2022,Japan,2022-06-14,False,0,0,0,0,1,0,7,8,0,0,0,0,0,0,0,0,11,0,7,18,13,3,0,16
152233.0,Stenzel Maria,L,Poland,24.0,168,2022,Thailand,2022-06-16,True,0,0,0,0,1,0,16,17,0,0,0,0,0,0,0,0,10,3,16,29,27,2,2,31
152233.0,Stenzel Maria,L,Poland,24.0,168,2022,USA,2022-06-17,False,0,0,0,0,0,0,10,10,0,0,0,0,0,0,0,0,9,0,16,25,9,1,0,10
152233.0,Stenzel Maria,L,Poland,24.0,168,2022,Belgium,2022-06-18,False,0,0,0,0,0,0,12,12,0,0,0,0,0,0,0,0,6,1,21,28,27,4,2,33
152233.0,Stenzel Maria,L,Poland,24.0,168,2022,Italy,2022-06-29,False,0,0,0,0,7,0,0,7,0,0,0,0,0,0,0,0,5,0,20,25,17,3,1,21
152233.0,Stenzel Maria,L,Poland,24.0,168,2022,China,2022-06-30,False,0,0,0,0,0,0,7,7,0,0,0,0,0,0,0,0,9,2,16,27,8,1,4,13
152233.0,Stenzel Maria,L,Poland,24.0,168,2022,Dominican Republic,2022-07-02,False,0,0,0,0,0,0,4,4,0,0,0,0,0,0,0,0,18,2,29,49,16,4,4,24
152233.0,Stenzel Maria,L,Poland,24.0,168,2022,Bulgaria,2022-07-03,False,0,0,0,0,0,1,2,3,0,0,0,0,0,0,0,0,8,0,16,24,6,2,2,10
172984.0,Obiała Anna,MB,Poland,27.0,187,2022,Italy,2022-06-29,False,1,2,16,19,0,0,0,0,5,5,4,14,0,7,2,9,0,0,0,0,1,1,1,3
172984.0,Obiała Anna,MB,Poland,27.0,187,2022,China,2022-06-30,False,0,0,0,0,0,0,0,0,0,3,0,3,0,0,1,1,0,0,0,0,0,0,0,0
172984.0,Obiała Anna,MB,Poland,27.0,187,2022,Dominican Republic,2022-07-02,False,1,3,18,22,0,0,0,0,5,1,6,12,2,8,2,12,0,0,0,0,3,0,0,3
172984.0,Obiała Anna,MB,Poland,27.0,187,2022,Bulgaria,2022-07-03,False,0,0,0,0,0,0,0,0,0,1,0,1,0,0,0,0,0,0,0,0,0,0,0,0
162398.0,Alagierska-Szczepaniak Klaudia,MB,Poland,27.0,190,2022,Canada,2022-06-01,True,0,1,7,8,0,0,1,1,0,1,1,2,0,3,3,6,0,0,0,0,1,0,0,1
162398.0,Alagierska-Szczepaniak Klaudia,MB,Poland,27.0,190,2022,Brazil,2022-06-02,False,0,0,0,0,0,0,0,0,0,0,0,0,0,0,0,0,0,0,0,0,0,0,0,0
162398.0,Alagierska-Szczepaniak Klaudia,MB,Poland,27.0,190,2022,Germany,2022-06-05,True,0,0,0,0,0,0,0,0,0,0,0,0,0,0,0,0,0,0,0,0,0,0,0,0
162398.0,Alagierska-Szczepaniak Klaudia,MB,Poland,27.0,190,2022,Japan,2022-06-14,False,0,0,2,2,0,0,1,1,2,0,0,2,0,0,1,1,0,0,1,1,1,0,0,1
162398.0,Alagierska-Szczepaniak Klaudia,MB,Poland,27.0,190,2022,Thailand,2022-06-16,True,0,2,8,10,1,0,2,3,11,2,7,20,2,4,5,11,0,0,0,0,1,0,3,4
162398.0,Alagierska-Szczepaniak Klaudia,MB,Poland,27.0,190,2022,USA,2022-06-17,False,0,0,2,2,0,0,1,1,1,0,0,1,1,2,1,4,0,0,0,0,1,1,0,2
162398.0,Alagierska-Szczepaniak Klaudia,MB,Poland,27.0,190,2022,Belgium,2022-06-18,False,0,2,14,16,0,0,1,1,4,3,4,11,3,4,3,10,0,0,0,0,6,2,0,8
136317.0,Korneluk Agnieszka,MB,Poland,28.0,200,2022,Canada,2022-06-01,True,2,2,11,15,0,0,0,0,9,1,6,16,3,4,6,13,0,0,0,0,4,1,0,5
136317.0,Korneluk Agnieszka,MB,Poland,28.0,200,2022,Brazil,2022-06-02,False,1,2,9,12,0,0,0,0,6,0,3,9,2,3,1,6,0,0,0,0,2,0,0,2
136317.0,Korneluk Agnieszka,MB,Poland,28.0,200,2022,Germany,2022-06-05,True,2,3,20,25,0,0,3,3,10,2,6,18,0,7,8,15,0,0,0,0,1,0,0,1
136317.0,Korneluk Agnieszka,MB,Poland,28.0,200,2022,Italy,2022-06-29,False,1,0,10,11,0,0,0,0,4,2,6,12,2,7,7,16,0,2,1,3,1,0,2,3
136317.0,Korneluk Agnieszka,MB,Poland,28.0,200,2022,China,2022-06-30,False,0,1,4,5,0,0,2,2,1,3,0,4,1,0,0,1,0,0,0,0,0,0,0,0
136317.0,Korneluk Agnieszka,MB,Poland,28.0,200,2022,Dominican Republic,2022-07-02,False,2,1,15,18,0,1,1,2,7,3,8,18,8,7,6,21,1,0,1,2,3,1,2,6
136317.0,Korneluk Agnieszka,MB,Poland,28.0,200,2022,Bulgaria,2022-07-03,False,0,2,7,9,0,0,0,0,3,0,3,6,4,4,2,10,0,0,0,0,1,1,0,2
156479.0,Witkowska Kamila,MB,Poland,31.0,191,2022,Canada,2022-06-01,True,0,0,4,4,0,0,0,0,0,1,2,3,1,6,0,7,0,0,0,0,0,1,0,1
156479.0,Witkowska Kamila,MB,Poland,31.0,191,2022,Brazil,2022-06-02,False,0,0,0,0,0,0,0,0,0,0,0,0,0,0,0,0,0,0,0,0,0,0,0,0
156479.0,Witkowska Kamila,MB,Poland,31.0,191,2022,Germany,2022-06-05,True,0,0,3,3,0,0,0,0,2,0,2,4,1,1,2,4,0,0,0,0,0,0,0,0
156479.0,Witkowska Kamila,MB,Poland,31.0,191,2022,Japan,2022-06-14,False,0,0,0,0,0,0,0,0,0,0,0,0,0,0,0,0,0,0,0,0,0,0,0,0
156479.0,Witkowska Kamila,MB,Poland,31.0,191,2022,Thailand,2022-06-16,True,0,1,22,23,0,0,0,0,13,3,5,21,2,3,3,8,0,0,0,0,4,2,0,6
156479.0,Witkowska Kamila,MB,Poland,31.0,191,2022,USA,2022-06-17,False,0,0,1,1,0,0,0,0,1,0,0,1,0,0,0,0,0,0,0,0,0,0,0,0
156479.0,Witkowska Kamila,MB,Poland,31.0,191,2022,Belgium,2022-06-18,False,1,1,12,14,0,0,3,3,7,0,5,12,3,5,3,11,0,0,0,0,2,1,1,4
152223.0,Gorecka Zuzanna,OH,Poland,22.0,181,2022,Canada,2022-06-01,True,1,3,16,20,0,0,1,1,7,5,5,17,1,2,0,3,14,2,6,22,12,1,0,13
152223.0,Gorecka Zuzanna,OH,Poland,22.0,181,2022,Brazil,2022-06-02,False,0,2,8,10,0,0,4,4,10,4,9,23,1,2,0,3,10,1,8,19,5,0,0,5
152223.0,Gorecka Zuzanna,OH,Poland,22.0,181,2022,Germany,2022-06-05,True,0,2,9,11,0,0,3,3,11,3,14,28,0,4,3,7,20,1,6,27,12,4,0,16
152223.0,Gorecka Zuzanna,OH,Poland,22.0,181,2022,Japan,2022-06-14,False,0,1,6,7,0,0,0,0,3,2,4,9,0,2,1,3,3,2,11,16,2,1,0,3
152223.0,Gorecka Zuzanna,OH,Poland,22.0,181,2022,Thailand,2022-06-16,True,1,0,4,5,0,0,3,3,1,0,1,2,0,0,1,1,2,2,8,12,3,1,0,4
152223.0,Gorecka Zuzanna,OH,Poland,22.0,181,2022,USA,2022-06-17,False,0,2,10,12,0,0,1,1,6,3,14,23,0,6,2,8,3,0,3,6,3,1,0,4
152223.0,Gorecka Zuzanna,OH,Poland,22.0,181,2022,Belgium,2022-06-18,False,0,0,0,0,0,0,0,0,0,0,0,0,0,0,0,0,0,0,0,0,0,0,0,0
152223.0,Gorecka Zuzanna,OH,Poland,22.0,181,2022,Italy,2022-06-29,False,0,0,3,3,1,0,0,1,1,0,0,1,0,0,0,0,0,1,0,1,2,1,0,3
152223.0,Gorecka Zuzanna,OH,Poland,22.0,181,2022,China,2022-06-30,False,0,1,6,7,0,0,0,0,4,3,6,13,0,0,0,0,1,0,13,14,2,1,2,5
152223.0,Gorecka Zuzanna,OH,Poland,22.0,181,2022,Dominican Republic,2022-07-02,False,0,0,2,2,0,0,0,0,0,0,1,1,1,0,0,1,0,0,2,2,1,2,0,3
152223.0,Gorecka Zuzanna,OH,Poland,22.0,181,2022,Bulgaria,2022-07-03,False,0,1,5,6,0,0,0,0,2,2,2,6,0,0,1,1,4,1,10,15,1,2,1,4
152231.0,Fedusio Monika,OH,Poland,23.0,183,2022,Canada,2022-06-01,True,0,0,2,2,0,0,0,0,0,0,0,0,0,0,0,0,0,0,0,0,0,1,0,1
152231.0,Fedusio Monika,OH,Poland,23.0,183,2022,Brazil,2022-06-02,False,0,1,2,3,0,0,0,0,0,0,0,0,0,0,0,0,0,0,0,0,0,0,0,0
152231.0,Fedusio Monika,OH,Poland,23.0,183,2022,Germany,2022-06-05,True,0,2,0,2,0,0,0,0,0,2,2,4,0,0,0,0,0,0,2,2,1,0,0,1
152231.0,Fedusio Monika,OH,Poland,23.0,183,2022,Japan,2022-06-14,False,0,0,6,6,0,0,0,0,1,1,2,4,0,0,0,0,0,0,4,4,0,3,0,3
152231.0,Fedusio Monika,OH,Poland,23.0,183,2022,Thailand,2022-06-16,True,0,0,0,0,0,0,0,0,0,0,0,0,0,0,0,0,0,0,0,0,0,0,0,0
152231.0,Fedusio Monika,OH,Poland,23.0,183,2022,USA,2022-06-17,False,0,0,0,0,0,0,0,0,0,0,0,0,0,0,0,0,0,0,0,0,0,0,0,0
152231.0,Fedusio Monika,OH,Poland,23.0,183,2022,Belgium,2022-06-18,False,0,0,0,0,0,0,0,0,0,0,0,0,0,0,0,0,0,0,0,0,0,0,0,0
152231.0,Fedusio Monika,OH,Poland,23.0,183,2022,Italy,2022-06-29,False,0,0,1,1,1,0,0,1,1,0,2,3,0,0,1,1,0,0,5,5,0,0,1,1
152231.0,Fedusio Monika,OH,Poland,23.0,183,2022,China,2022-06-30,False,0,0,1,1,0,0,0,0,1,0,1,2,0,0,0,0,0,0,1,1,0,0,0,0
152231.0,Fedusio Monika,OH,Poland,23.0,183,2022,Dominican Republic,2022-07-02,False,0,0,2,2,0,0,0,0,1,0,0,1,0,0,0,0,0,0,0,0,1,0,0,1
152231.0,Fedusio Monika,OH,Poland,23.0,183,2022,Bulgaria,2022-07-03,False,0,2,10,12,0,0,1,1,9,3,8,20,0,2,4,6,5,0,23,28,6,0,1,7
163098.0,Lukasik Martyna,OH,Poland,23.0,189,2022,Canada,2022-06-01,True,0,3,9,12,0,0,0,0,17,4,15,36,0,5,1,6,13,1,11,25,8,1,0,9
163098.0,Lukasik Martyna,OH,Poland,23.0,189,2022,Brazil,2022-06-02,False,0,2,10,12,0,0,1,1,10,7,8,25,0,1,1,2,12,0,11,23,8,3,0,11
163098.0,Lukasik Martyna,OH,Poland,23.0,189,2022,Germany,2022-06-05,True,1,1,15,17,0,0,2,2,13,5,10,28,2,1,4,7,23,2,5,30,8,3,2,13
163098.0,Lukasik Martyna,OH,Poland,23.0,189,2022,Japan,2022-06-14,False,1,2,6,9,0,0,0,0,2,1,11,14,0,0,0,0,3,0,12,15,1,3,1,5
163098.0,Lukasik Martyna,OH,Poland,23.0,189,2022,Thailand,2022-06-16,True,0,0,0,0,0,0,0,0,0,1,1,2,0,1,2,3,0,0,0,0,0,0,0,0
163098.0,Lukasik Martyna,OH,Poland,23.0,189,2022,USA,2022-06-17,False,0,0,6,6,0,0,0,0,8,2,10,20,0,2,0,2,5,0,27,32,4,5,1,10
163098.0,Lukasik Martyna,OH,Poland,23.0,189,2022,Belgium,2022-06-18,False,2,2,16,20,1,0,2,3,22,9,17,48,1,2,2,5,8,2,12,22,16,2,0,18
163098.0,Lukasik Martyna,OH,Poland,23.0,189,2022,Italy,2022-06-29,False,0,0,0,0,0,0,0,0,0,0,0,0,0,0,0,0,0,0,0,0,0,0,0,0
163098.0,Lukasik Martyna,OH,Poland,23.0,189,2022,China,2022-06-30,False,0,0,0,0,0,0,0,0,0,0,0,0,0,0,0,0,0,0,0,0,0,0,0,0
163098.0,Lukasik Martyna,OH,Poland,23.0,189,2022,Dominican Republic,2022-07-02,False,0,0,0,0,0,0,0,0,0,0,0,0,0,0,0,0,0,0,0,0,0,0,0,0
163098.0,Lukasik Martyna,OH,Poland,23.0,189,2022,Bulgaria,2022-07-03,False,0,0,0,0,0,0,0,0,0,0,0,0,0,0,0,0,0,0,0,0,0,0,0,0
185609.0,Szczyglowska Aleksandra,OH,Poland,25.0,172,2022,Canada,2022-06-01,True,0,0,0,0,0,0,0,0,0,0,0,0,0,0,0,0,0,0,0,0,0,0,0,0
185609.0,Szczyglowska Aleksandra,OH,Poland,25.0,172,2022,Brazil,2022-06-02,False,0,0,0,0,0,0,0,0,0,0,0,0,0,0,0,0,0,0,0,0,0,0,0,0
185609.0,Szczyglowska Aleksandra,OH,Poland,25.0,172,2022,Germany,2022-06-05,True,0,0,0,0,0,0,0,0,0,0,0,0,0,0,0,0,0,0,0,0,0,0,0,0
185609.0,Szczyglowska Aleksandra,OH,Poland,25.0,172,2022,Japan,2022-06-14,False,0,0,0,0,0,0,0,0,0,0,0,0,0,0,0,0,0,0,0,0,0,0,0,0
185609.0,Szczyglowska Aleksandra,OH,Poland,25.0,172,2022,Thailand,2022-06-16,True,0,0,0,0,0,0,0,0,0,0,0,0,0,0,0,0,0,0,0,0,0,0,0,0
185609.0,Szczyglowska Aleksandra,OH,Poland,25.0,172,2022,USA,2022-06-17,False,0,0,0,0,0,0,0,0,0,0,0,0,0,0,0,0,0,0,0,0,0,0,0,0
185609.0,Szczyglowska Aleksandra,OH,Poland,25.0,172,2022,Belgium,2022-06-18,False,0,0,0,0,0,0,0,0,0,0,0,0,0,0,0,0,0,0,0,0,0,0,0,0
185609.0,Szczyglowska Aleksandra,OH,Poland,25.0,172,2022,Italy,2022-06-29,False,0,0,0,0,0,0,0,0,0,0,0,0,0,0,0,0,0,0,0,0,0,0,0,0
185609.0,Szczyglowska Aleksandra,OH,Poland,25.0,172,2022,China,2022-06-30,False,0,0,0,0,0,0,0,0,0,0,0,0,0,0,0,0,0,0,0,0,0,0,0,0
185609.0,Szczyglowska Aleksandra,OH,Poland,25.0,172,2022,Dominican Republic,2022-07-02,False,0,0,0,0,0,0,0,0,0,0,0,0,0,0,0,0,0,0,2,2,1,0,0,1
185609.0,Szczyglowska Aleksandra,OH,Poland,25.0,172,2022,Bulgaria,2022-07-03,False,0,0,0,0,0,0,2,2,0,0,0,0,0,0,0,0,0,0,1,1,1,0,1,2
118591.0,Wolosz Joanna,S,Poland,32.0,181,2022,Canada,2022-06-01,True,0,0,0,0,0,0,0,0,0,0,0,0,0,0,0,0,0,0,0,0,0,0,0,0
118591.0,Wolosz Joanna,S,Poland,32.0,181,2022,Brazil,2022-06-02,False,0,0,0,0,0,0,0,0,0,0,0,0,0,0,0,0,0,0,0,0,0,0,0,0
118591.0,Wolosz Joanna,S,Poland,32.0,181,2022,Germany,2022-06-05,True,2,0,16,18,30,1,80,111,0,2,2,4,2,3,2,7,0,0,1,1,10,3,0,13
118591.0,Wolosz Joanna,S,Poland,32.0,181,2022,Japan,2022-06-14,False,0,1,10,11,36,0,47,83,2,0,1,3,0,1,6,7,0,1,0,1,7,1,0,8
118591.0,Wolosz Joanna,S,Poland,32.0,181,2022,Thailand,2022-06-16,True,1,1,17,19,52,1,90,143,2,0,2,4,4,0,6,10,0,0,1,1,14,3,1,18
118591.0,Wolosz Joanna,S,Poland,32.0,181,2022,USA,2022-06-17,False,0,0,0,0,1,0,2,3,0,0,0,0,0,0,0,0,0,0,0,0,1,1,0,2
118591.0,Wolosz Joanna,S,Poland,32.0,181,2022,Belgium,2022-06-18,False,0,1,20,21,37,2,97,136,0,0,2,2,0,4,8,12,0,0,0,0,10,5,1,16
118591.0,Wolosz Joanna,S,Poland,32.0,181,2022,Italy,2022-06-29,False,1,0,15,16,109,1,2,112,1,0,2,3,2,3,2,7,0,0,0,0,5,2,2,9
118591.0,Wolosz Joanna,S,Poland,32.0,181,2022,China,2022-06-30,False,0,0,7,7,0,2,70,72,0,0,0,0,0,5,0,5,0,0,0,0,3,2,5,10
118591.0,Wolosz Joanna,S,Poland,32.0,181,2022,Dominican Republic,2022-07-02,False,2,0,18,20,24,0,121,145,0,0,0,0,0,3,3,6,0,0,0,0,11,2,1,14
118591.0,Wolosz Joanna,S,Poland,32.0,181,2022,Bulgaria,2022-07-03,False,0,0,5,5,2,0,19,21,0,0,0,0,0,0,0,0,0,0,0,0,2,2,0,4
181268.0,Czyrnianska Martyna,OH,Poland,19.0,191,2022,Japan,2022-06-14,False,0,1,1,2,1,0,0,1,6,3,3,12,1,1,1,3,0,0,0,0,0,1,0,1
181268.0,Czyrnianska Martyna,OH,Poland,19.0,191,2022,Thailand,2022-06-16,True,2,3,16,21,1,0,2,3,16,3,30,49,0,3,4,7,0,0,3,3,11,3,1,15
181268.0,Czyrnianska Martyna,OH,Poland,19.0,191,2022,USA,2022-06-17,False,1,2,5,8,0,1,0,1,10,8,12,30,1,0,2,3,0,0,0,0,4,1,0,5
181268.0,Czyrnianska Martyna,OH,Poland,19.0,191,2022,Belgium,2022-06-18,False,3,4,9,16,0,0,0,0,18,2,13,33,0,0,2,2,1,0,0,1,4,4,0,8
181268.0,Czyrnianska Martyna,OH,Poland,19.0,191,2022,Italy,2022-06-29,False,0,2,9,11,3,0,0,3,10,8,16,34,2,4,0,6,2,0,7,9,7,2,1,10
181268.0,Czyrnianska Martyna,OH,Poland,19.0,191,2022,China,2022-06-30,False,0,3,4,7,0,0,0,0,9,6,20,35,0,1,0,1,0,0,4,4,7,2,3,12
181268.0,Czyrnianska Martyna,OH,Poland,19.0,191,2022,Dominican Republic,2022-07-02,False,3,2,27,32,0,0,2,2,22,8,29,59,2,2,2,6,1,1,2,4,6,2,4,12
181268.0,Czyrnianska Martyna,OH,Poland,19.0,191,2022,Bulgaria,2022-07-03,False,0,0,8,8,0,0,1,1,5,4,9,18,2,0,0,2,0,0,6,6,5,1,0,6
163097.0,Gryka Aleksandra,MB,Poland,23.0,190,2022,Canada,2022-06-01,True,0,0,0,0,0,0,0,0,0,0,0,0,0,0,0,0,0,0,0,0,0,0,0,0
163097.0,Gryka Aleksandra,MB,Poland,23.0,190,2022,Brazil,2022-06-02,False,1,3,5,9,0,0,2,2,9,2,2,13,0,4,2,6,0,0,0,0,5,0,0,5
163097.0,Gryka Aleksandra,MB,Poland,23.0,190,2022,Germany,2022-06-05,True,1,1,10,12,0,0,2,2,6,2,5,13,3,2,3,8,0,0,1,1,3,1,0,4
163097.0,Gryka Aleksandra,MB,Poland,23.0,190,2022,Japan,2022-06-14,False,0,0,7,7,0,0,2,2,7,1,8,16,1,5,5,11,0,0,0,0,2,0,0,2
163097.0,Gryka Aleksandra,MB,Poland,23.0,190,2022,Thailand,2022-06-16,True,0,0,0,0,0,0,0,0,0,0,0,0,0,0,0,0,0,0,0,0,0,0,0,0
163097.0,Gryka Aleksandra,MB,Poland,23.0,190,2022,USA,2022-06-17,False,0,0,4,4,0,0,3,3,2,1,7,10,0,1,2,3,0,0,0,0,2,0,0,2
163097.0,Gryka Aleksandra,MB,Poland,23.0,190,2022,Belgium,2022-06-18,False,0,0,0,0,0,0,0,0,0,0,0,0,0,0,0,0,0,0,0,0,0,0,0,0
163097.0,Gryka Aleksandra,MB,Poland,23.0,190,2022,Italy,2022-06-29,False,0,0,0,0,0,0,0,0,1,0,0,1,0,0,0,0,0,0,0,0,0,0,0,0
163097.0,Gryka Aleksandra,MB,Poland,23.0,190,2022,China,2022-06-30,False,1,2,3,6,0,0,0,0,0,1,0,1,0,0,1,1,0,0,0,0,0,0,0,0
163097.0,Gryka Aleksandra,MB,Poland,23.0,190,2022,Dominican Republic,2022-07-02,False,0,0,0,0,0,0,0,0,0,0,0,0,0,0,0,0,0,0,0,0,0,0,0,0
163097.0,Gryka Aleksandra,MB,Poland,23.0,190,2022,Bulgaria,2022-07-03,False,1,2,11,14,0,0,0,0,9,5,3,17,0,6,2,8,0,0,1,1,0,2,0,2
156480.0,Grabka Alicja,S,Poland,24.0,178,2022,Canada,2022-06-01,True,0,1,3,4,1,0,14,15,0,0,0,0,0,0,0,0,0,0,0,0,1,0,0,1
156480.0,Grabka Alicja,S,Poland,24.0,178,2022,Brazil,2022-06-02,False,0,1,11,12,18,1,68,87,1,0,1,2,2,0,5,7,0,0,0,0,10,1,0,11
156480.0,Grabka Alicja,S,Poland,24.0,178,2022,Germany,2022-06-05,True,0,0,1,1,0,0,0,0,0,0,0,0,0,0,0,0,0,0,0,0,0,0,0,0
156480.0,Grabka Alicja,S,Poland,24.0,178,2022,Italy,2022-06-29,False,0,0,0,0,0,0,0,0,0,0,0,0,0,0,0,0,0,0,0,0,0,0,0,0
156480.0,Grabka Alicja,S,Poland,24.0,178,2022,China,2022-06-30,False,0,0,0,0,0,0,5,5,0,0,0,0,0,1,0,1,0,0,0,0,0,0,0,0
156480.0,Grabka Alicja,S,Poland,24.0,178,2022,Dominican Republic,2022-07-02,False,0,1,1,2,1,0,4,5,0,0,0,0,0,0,0,0,0,0,0,0,0,0,0,0
156480.0,Grabka Alicja,S,Poland,24.0,178,2022,Bulgaria,2022-07-03,False,1,1,8,10,7,0,93,100,0,0,1,1,2,1,4,7,0,0,0,0,4,2,3,9
164107.0,Szlagowska Weronika,OH,Poland,21.0,188,2022,Canada,2022-06-01,True,0,1,1,2,0,0,0,0,3,2,4,9,2,0,3,5,0,0,0,0,0,0,0,0
164107.0,Szlagowska Weronika,OH,Poland,21.0,188,2022,Brazil,2022-06-02,False,0,0,3,3,0,0,1,1,4,2,7,13,1,1,2,4,2,1,2,5,0,0,0,0
164107.0,Szlagowska Weronika,OH,Poland,21.0,188,2022,Germany,2022-06-05,True,0,0,0,0,0,0,1,1,2,2,4,8,0,0,0,0,0,0,0,0,1,0,0,1
164107.0,Szlagowska Weronika,OH,Poland,21.0,188,2022,Japan,2022-06-14,False,0,0,2,2,0,0,0,0,2,2,3,7,0,1,0,1,0,1,3,4,2,0,0,2
164107.0,Szlagowska Weronika,OH,Poland,21.0,188,2022,Thailand,2022-06-16,True,2,6,9,17,2,0,4,6,13,3,14,30,3,0,0,3,9,0,24,33,7,5,1,13
164107.0,Szlagowska Weronika,OH,Poland,21.0,188,2022,USA,2022-06-17,False,0,0,0,0,0,0,0,0,0,0,0,0,0,0,0,0,2,1,2,5,0,1,0,1
164107.0,Szlagowska Weronika,OH,Poland,21.0,188,2022,Belgium,2022-06-18,False,0,3,7,10,0,0,3,3,9,6,10,25,2,7,7,16,11,0,23,34,8,5,0,13
164107.0,Szlagowska Weronika,OH,Poland,21.0,188,2022,Italy,2022-06-29,False,1,2,14,17,2,0,1,3,6,4,16,26,1,4,0,5,2,0,29,31,1,1,1,3
164107.0,Szlagowska Weronika,OH,Poland,21.0,188,2022,China,2022-06-30,False,0,1,2,3,0,0,0,0,2,2,3,7,0,1,0,1,2,1,4,7,1,0,0,1
164107.0,Szlagowska Weronika,OH,Poland,21.0,188,2022,Dominican Republic,2022-07-02,False,0,1,8,9,0,0,0,0,10,4,7,21,2,3,0,5,12,1,24,37,6,4,3,13
164107.0,Szlagowska Weronika,OH,Poland,21.0,188,2022,Bulgaria,2022-07-03,False,0,0,2,2,0,0,0,0,1,3,1,5,0,2,0,2,0,0,3,3,1,0,0,1
181263.0,Wenerska Katarzyna,S,Poland,30.0,180,2022,Canada,2022-06-01,True,2,1,14,17,7,0,82,89,1,0,0,1,0,1,2,3,0,0,1,1,6,3,1,10
181263.0,Wenerska Katarzyna,S,Poland,30.0,180,2022,Brazil,2022-06-02,False,0,0,0,0,0,0,0,0,0,0,0,0,0,0,0,0,0,0,0,0,0,0,0,0
181263.0,Wenerska Katarzyna,S,Poland,30.0,180,2022,Germany,2022-06-05,True,0,0,1,1,0,0,7,7,0,0,0,0,0,0,0,0,0,0,0,0,0,0,0,0
181263.0,Wenerska Katarzyna,S,Poland,30.0,180,2022,Japan,2022-06-14,False,0,0,1,1,0,0,0,0,0,0,0,0,0,0,0,0,0,0,0,0,0,0,0,0
181263.0,Wenerska Katarzyna,S,Poland,30.0,180,2022,Thailand,2022-06-16,True,0,0,3,3,1,0,7,8,0,0,0,0,0,0,0,0,0,0,0,0,1,1,0,2
181263.0,Wenerska Katarzyna,S,Poland,30.0,180,2022,USA,2022-06-17,False,0,2,9,11,3,0,75,78,0,0,1,1,0,2,1,3,0,0,1,1,7,3,1,11
181263.0,Wenerska Katarzyna,S,Poland,30.0,180,2022,Belgium,2022-06-18,False,0,0,0,0,0,0,0,0,0,0,0,0,0,0,0,0,0,0,0,0,0,0,0,0
151231.0,Rozanski Olivia,OH,Poland,25.0,185,2022,Canada,2022-06-01,True,1,1,8,10,0,1,0,1,9,10,23,42,2,0,0,2,0,0,0,0,6,0,0,6
151231.0,Rozanski Olivia,OH,Poland,25.0,185,2022,Brazil,2022-06-02,False,0,1,5,6,0,0,0,0,9,9,8,26,0,4,2,6,0,0,0,0,6,2,0,8
151231.0,Rozanski Olivia,OH,Poland,25.0,185,2022,Germany,2022-06-05,True,0,3,10,13,0,0,1,1,18,2,23,43,4,3,3,10,0,0,0,0,10,1,2,13
151231.0,Rozanski Olivia,OH,Poland,25.0,185,2022,Japan,2022-06-14,False,0,1,7,8,1,0,1,2,8,5,12,25,1,0,2,3,0,0,2,2,1,3,0,4
151231.0,Rozanski Olivia,OH,Poland,25.0,185,2022,Thailand,2022-06-16,True,1,4,9,14,0,0,2,2,17,10,28,55,2,4,2,8,6,0,7,13,16,0,0,16
151231.0,Rozanski Olivia,OH,Poland,25.0,185,2022,USA,2022-06-17,False,0,0,1,1,0,0,0,0,5,1,2,8,0,0,2,2,0,0,0,0,1,0,0,1
151231.0,Rozanski Olivia,OH,Poland,25.0,185,2022,Belgium,2022-06-18,False,0,1,4,5,0,1,1,2,10,2,20,32,3,1,5,9,1,1,7,9,6,1,1,8
151231.0,Rozanski Olivia,OH,Poland,25.0,185,2022,Italy,2022-06-29,False,0,5,8,13,2,0,0,2,17,6,21,44,2,1,1,4,2,1,7,10,11,1,2,14
151231.0,Rozanski Olivia,OH,Poland,25.0,185,2022,China,2022-06-30,False,0,2,5,7,0,0,3,3,8,2,12,22,1,3,1,5,2,0,10,12,4,2,2,8
151231.0,Rozanski Olivia,OH,Poland,25.0,185,2022,Dominican Republic,2022-07-02,False,0,5,3,8,0,0,0,0,19,8,24,51,2,9,5,16,1,0,2,3,11,2,1,14
151231.0,Rozanski Olivia,OH,Poland,25.0,185,2022,Bulgaria,2022-07-03,False,0,2,5,7,1,0,3,4,19,7,20,46,0,3,1,4,2,0,5,7,5,1,0,6
185611.0,Jurczyk Magdalena,MB,Poland,27.0,183,2022,Japan,2022-06-14,False,0,0,10,10,0,0,0,0,8,0,3,11,1,5,5,11,1,0,1,2,2,2,0,4
185611.0,Jurczyk Magdalena,MB,Poland,27.0,183,2022,Thailand,2022-06-16,True,0,0,2,2,0,0,0,0,0,2,2,4,0,0,0,0,0,0,0,0,0,0,0,0
185611.0,Jurczyk Magdalena,MB,Poland,27.0,183,2022,USA,2022-06-17,False,0,1,5,6,0,0,2,2,2,0,3,5,1,4,2,7,0,0,1,1,1,0,0,1
185611.0,Jurczyk Magdalena,MB,Poland,27.0,183,2022,Belgium,2022-06-18,False,0,0,3,3,0,0,1,1,1,0,0,1,0,1,1,2,0,1,0,1,1,0,0,1
185611.0,Jurczyk Magdalena,MB,Poland,27.0,183,2022,Italy,2022-06-29,False,0,0,1,1,0,0,0,0,0,0,0,0,0,0,0,0,0,0,0,0,1,0,0,1
185611.0,Jurczyk Magdalena,MB,Poland,27.0,183,2022,China,2022-06-30,False,0,1,9,10,0,0,0,0,5,0,0,5,2,1,0,3,0,0,0,0,1,1,0,2
185611.0,Jurczyk Magdalena,MB,Poland,27.0,183,2022,Dominican Republic,2022-07-02,False,0,0,0,0,0,0,0,0,0,0,0,0,0,0,0,0,0,0,0,0,0,0,0,0
185611.0,Jurczyk Magdalena,MB,Poland,27.0,183,2022,Bulgaria,2022-07-03,False,0,0,5,5,0,0,0,0,0,0,0,0,0,2,1,3,0,1,0,1,0,0,0,0
136024.0,Busa Bianka,OH,Serbia,28.0,187,2022,Brazil,2022-06-19,False,0,0,1,1,0,0,0,0,1,3,3,7,0,1,0,1,0,1,0,1,0,1,0,1
136024.0,Busa Bianka,OH,Serbia,28.0,187,2022,Germany,2022-06-28,True,1,1,12,14,0,0,2,2,11,2,13,26,1,1,1,3,8,3,23,34,7,1,1,9
136024.0,Busa Bianka,OH,Serbia,28.0,187,2022,Japan,2022-07-02,True,0,1,10,11,0,0,0,0,5,2,6,13,0,1,0,1,4,0,3,7,7,3,0,10
136024.0,Busa Bianka,OH,Serbia,28.0,187,2022,USA,2022-07-13,True,0,0,0,0,0,0,0,0,0,0,0,0,0,0,0,0,0,0,0,0,0,0,0,0
136024.0,Busa Bianka,OH,Serbia,28.0,187,2022,Brazil,2022-07-16,False,0,2,5,7,0,0,0,0,2,0,4,6,0,0,2,2,4,0,3,7,2,1,0,3
152168.0,Lazovic Katarina,OH,Serbia,23.0,182,2022,Belgium,2022-06-01,True,0,1,10,11,0,0,1,1,12,4,17,33,1,4,4,9,6,1,10,17,10,6,1,17
152168.0,Lazovic Katarina,OH,Serbia,23.0,182,2022,Thailand,2022-06-02,False,1,0,9,10,0,0,3,3,4,2,7,13,0,3,1,4,0,0,9,9,4,1,2,7
152168.0,Lazovic Katarina,OH,Serbia,23.0,182,2022,Bulgaria,2022-06-03,True,1,0,11,12,0,0,2,2,11,4,4,19,0,4,1,5,7,0,13,20,8,2,2,12
152168.0,Lazovic Katarina,OH,Serbia,23.0,182,2022,Netherlands,2022-06-05,True,1,0,16,17,1,0,2,3,17,4,13,34,0,1,2,3,12,3,23,38,8,2,5,15
152168.0,Lazovic Katarina,OH,Serbia,23.0,182,2022,Brazil,2022-06-19,False,0,0,2,2,0,0,0,0,0,0,0,0,0,0,0,0,0,0,0,0,0,0,0,0
152168.0,Lazovic Katarina,OH,Serbia,23.0,182,2022,Germany,2022-06-28,True,0,3,9,12,0,0,4,4,11,3,12,26,0,1,2,3,4,1,10,15,7,0,1,8
152168.0,Lazovic Katarina,OH,Serbia,23.0,182,2022,Japan,2022-07-02,True,0,1,17,18,0,1,1,2,20,1,26,47,2,2,1,5,21,2,16,39,14,4,0,18
152168.0,Lazovic Katarina,OH,Serbia,23.0,182,2022,USA,2022-07-13,True,1,1,7,9,0,0,0,0,0,0,0,0,0,0,0,0,0,0,1,1,0,0,0,0
152168.0,Lazovic Katarina,OH,Serbia,23.0,182,2022,Brazil,2022-07-16,False,1,0,2,3,0,0,0,0,1,1,0,2,0,1,0,1,0,1,2,3,0,2,0,2
120326.0,Drca Bojana,S,Serbia,34.0,186,2022,Belgium,2022-06-01,True,1,0,16,17,22,1,71,94,1,0,3,4,0,1,1,2,0,0,0,0,8,1,4,13
120326.0,Drca Bojana,S,Serbia,34.0,186,2022,Thailand,2022-06-02,False,0,0,6,6,3,0,21,24,1,0,0,1,0,0,0,0,0,0,0,0,4,0,0,4
120326.0,Drca Bojana,S,Serbia,34.0,186,2022,Bulgaria,2022-06-03,True,1,1,10,12,14,0,62,76,1,0,1,2,0,3,0,3,0,0,1,1,5,3,3,11
120326.0,Drca Bojana,S,Serbia,34.0,186,2022,Netherlands,2022-06-05,True,1,3,14,18,56,0,56,112,4,1,4,9,1,2,3,6,0,0,0,0,13,4,4,21
120326.0,Drca Bojana,S,Serbia,34.0,186,2022,USA,2022-07-13,True,0,1,14,15,12,2,91,105,3,0,0,3,1,6,1,8,0,0,1,1,11,9,0,20
120326.0,Drca Bojana,S,Serbia,34.0,186,2022,Brazil,2022-07-16,False,0,0,9,9,25,2,62,89,1,0,3,4,2,4,6,12,0,0,1,1,7,5,4,16
136030.0,Popovic Mina,MB,Serbia,28.0,187,2022,USA,2022-07-13,True,0,0,0,0,0,0,0,0,0,0,0,0,0,0,0,0,0,0,0,0,0,0,0,0
136030.0,Popovic Mina,MB,Serbia,28.0,187,2022,Brazil,2022-07-16,False,0,0,2,2,0,0,0,0,1,0,0,1,0,0,0,0,0,0,0,0,0,1,0,1
152169.0,Jaksic Ana,S,Serbia,25.0,178,2022,Brazil,2022-06-19,False,0,0,0,0,2,0,3,5,0,0,0,0,0,0,0,0,0,0,0,0,0,0,0,0
152169.0,Jaksic Ana,S,Serbia,25.0,178,2022,Germany,2022-06-28,True,0,0,1,1,0,0,2,2,0,0,0,0,0,0,0,0,0,0,0,0,1,0,0,1
152169.0,Jaksic Ana,S,Serbia,25.0,178,2022,Japan,2022-07-02,True,0,0,2,2,1,0,4,5,0,0,0,0,0,0,0,0,0,0,0,0,0,0,0,0
136812.0,Mirkovic Sladjana,S,Serbia,27.0,185,2022,Belgium,2022-06-01,True,0,0,6,6,4,0,16,20,0,0,0,0,0,0,0,0,0,0,0,0,1,1,1,3
136812.0,Mirkovic Sladjana,S,Serbia,27.0,185,2022,Thailand,2022-06-02,False,1,0,16,17,15,0,98,113,4,0,1,5,1,0,2,3,0,0,0,0,0,2,2,4
136812.0,Mirkovic Sladjana,S,Serbia,27.0,185,2022,Bulgaria,2022-06-03,True,1,1,2,4,4,0,15,19,0,0,0,0,0,0,0,0,0,0,0,0,2,1,0,3
136812.0,Mirkovic Sladjana,S,Serbia,27.0,185,2022,Netherlands,2022-06-05,True,0,0,4,4,8,0,10,18,0,0,0,0,0,0,0,0,0,0,0,0,2,0,0,2
136812.0,Mirkovic Sladjana,S,Serbia,27.0,185,2022,Brazil,2022-06-19,False,0,1,9,10,19,1,76,96,3,0,1,4,0,2,3,5,0,0,0,0,4,3,1,8
136812.0,Mirkovic Sladjana,S,Serbia,27.0,185,2022,Germany,2022-06-28,True,1,0,19,20,16,0,79,95,6,0,2,8,0,2,0,2,0,0,0,0,8,0,0,8
136812.0,Mirkovic Sladjana,S,Serbia,27.0,185,2022,Japan,2022-07-02,True,1,1,13,15,9,1,120,130,1,1,7,9,1,1,6,8,0,0,0,0,16,1,0,17
136812.0,Mirkovic Sladjana,S,Serbia,27.0,185,2022,USA,2022-07-13,True,0,1,2,3,1,0,18,19,0,0,0,0,0,0,0,0,0,0,0,0,1,2,1,4
136812.0,Mirkovic Sladjana,S,Serbia,27.0,185,2022,Brazil,2022-07-16,False,0,1,4,5,1,1,11,13,2,0,1,3,0,0,0,0,0,0,0,0,1,4,1,6
121593.0,Mihajlovic Brankica,OH,Serbia,31.0,190,2022,Belgium,2022-06-01,True,0,0,0,0,0,0,0,0,0,1,3,4,1,0,0,1,0,1,1,2,1,0,0,1
121593.0,Mihajlovic Brankica,OH,Serbia,31.0,190,2022,Thailand,2022-06-02,False,0,1,2,3,0,1,0,1,5,2,8,15,1,2,2,5,1,0,5,6,2,0,2,4
121593.0,Mihajlovic Brankica,OH,Serbia,31.0,190,2022,Bulgaria,2022-06-03,True,0,0,0,0,0,0,0,0,0,0,0,0,0,0,0,0,0,0,0,0,0,0,0,0
121593.0,Mihajlovic Brankica,OH,Serbia,31.0,190,2022,Netherlands,2022-06-05,True,0,0,4,4,0,0,1,1,3,0,6,9,0,2,0,2,0,0,2,2,2,1,0,3
121593.0,Mihajlovic Brankica,OH,Serbia,31.0,190,2022,USA,2022-07-13,True,0,0,1,1,0,0,0,0,7,4,2,13,0,0,0,0,0,0,0,0,0,0,0,0
121593.0,Mihajlovic Brankica,OH,Serbia,31.0,190,2022,Brazil,2022-07-16,False,0,0,1,1,0,0,0,0,3,1,6,10,2,2,0,4,0,0,0,0,1,0,0,1
123709.0,Pusic Teodora,L,Serbia,30.0,170,2022,Belgium,2022-06-01,True,0,0,0,0,0,0,10,10,0,0,0,0,0,0,0,0,5,1,21,27,11,3,3,17
123709.0,Pusic Teodora,L,Serbia,30.0,170,2022,Thailand,2022-06-02,False,0,0,0,0,0,0,9,9,0,0,0,0,0,0,0,0,5,2,17,24,12,5,1,18
123709.0,Pusic Teodora,L,Serbia,30.0,170,2022,Bulgaria,2022-06-03,True,0,0,0,0,0,0,4,4,0,0,0,0,0,0,0,0,4,1,12,17,19,1,0,20
123709.0,Pusic Teodora,L,Serbia,30.0,170,2022,Netherlands,2022-06-05,True,0,0,0,0,2,0,12,14,0,0,0,0,0,0,0,0,5,0,15,20,16,4,3,23
123709.0,Pusic Teodora,L,Serbia,30.0,170,2022,Brazil,2022-06-19,False,0,0,0,0,0,0,8,8,0,0,0,0,0,0,0,0,4,0,4,8,11,5,2,18
123709.0,Pusic Teodora,L,Serbia,30.0,170,2022,Germany,2022-06-28,True,0,0,0,0,0,0,7,7,0,0,0,0,0,0,0,0,3,0,16,19,13,6,1,20
123709.0,Pusic Teodora,L,Serbia,30.0,170,2022,Japan,2022-07-02,True,0,0,0,0,0,0,19,19,0,0,1,1,0,0,0,0,6,1,8,15,15,2,0,17
123709.0,Pusic Teodora,L,Serbia,30.0,170,2022,USA,2022-07-13,True,0,0,0,0,0,0,5,5,0,0,0,0,0,0,0,0,21,2,25,48,15,2,0,17
123709.0,Pusic Teodora,L,Serbia,30.0,170,2022,Brazil,2022-07-16,False,0,0,0,0,1,0,12,13,0,0,0,0,0,0,0,0,6,0,11,17,12,6,3,21
123694.0,Bjelica Ana,O,Serbia,30.0,190,2022,Belgium,2022-06-01,True,0,0,9,9,0,0,0,0,21,4,21,46,0,2,4,6,0,0,0,0,5,3,1,9
123694.0,Bjelica Ana,O,Serbia,30.0,190,2022,Thailand,2022-06-02,False,0,0,3,3,0,0,0,0,5,1,14,20,1,0,0,1,0,0,0,0,1,0,0,1
123694.0,Bjelica Ana,O,Serbia,30.0,190,2022,Bulgaria,2022-06-03,True,0,1,5,6,0,0,0,0,16,5,18,39,1,3,4,8,0,0,0,0,3,1,1,5
123694.0,Bjelica Ana,O,Serbia,30.0,190,2022,Netherlands,2022-06-05,True,1,0,12,13,0,0,2,2,15,8,22,45,1,3,4,8,0,0,0,0,14,1,2,17
123694.0,Bjelica Ana,O,Serbia,30.0,190,2022,Brazil,2022-06-19,False,0,2,8,10,0,0,1,1,8,9,22,39,0,1,2,3,0,0,0,0,5,1,2,8
123694.0,Bjelica Ana,O,Serbia,30.0,190,2022,Germany,2022-06-28,True,0,3,11,14,0,0,3,3,12,8,15,35,3,2,1,6,0,0,0,0,4,1,1,6
123694.0,Bjelica Ana,O,Serbia,30.0,190,2022,Japan,2022-07-02,True,0,0,0,0,0,0,0,0,0,0,0,0,0,0,0,0,0,0,0,0,0,0,0,0
123694.0,Bjelica Ana,O,Serbia,30.0,190,2022,USA,2022-07-13,True,0,1,8,9,0,0,0,0,17,8,23,48,3,4,1,8,0,0,1,1,3,1,0,4
123694.0,Bjelica Ana,O,Serbia,30.0,190,2022,Brazil,2022-07-16,False,1,1,10,12,0,0,1,1,15,7,18,40,1,0,1,2,0,0,0,0,3,1,3,7
143548.0,Aleksic Maja,MB,Serbia,25.0,188,2022,Belgium,2022-06-01,True,1,2,13,16,0,0,1,1,3,2,1,6,7,4,11,22,0,0,1,1,1,0,1,2
143548.0,Aleksic Maja,MB,Serbia,25.0,188,2022,Thailand,2022-06-02,False,1,2,12,15,0,0,1,1,11,1,5,17,6,6,4,16,0,0,1,1,5,0,0,5
143548.0,Aleksic Maja,MB,Serbia,25.0,188,2022,Bulgaria,2022-06-03,True,0,1,12,13,0,0,2,2,3,0,4,7,4,3,10,17,0,0,0,0,4,1,0,5
143548.0,Aleksic Maja,MB,Serbia,25.0,188,2022,Netherlands,2022-06-05,True,0,2,14,16,0,0,2,2,6,2,5,13,1,3,5,9,0,0,0,0,4,0,3,7
143548.0,Aleksic Maja,MB,Serbia,25.0,188,2022,Brazil,2022-06-19,False,0,0,6,6,0,0,2,2,2,2,2,6,1,4,3,8,0,0,0,0,2,1,0,3
143548.0,Aleksic Maja,MB,Serbia,25.0,188,2022,Germany,2022-06-28,True,1,1,12,14,1,0,1,2,10,1,3,14,2,6,5,13,0,0,2,2,3,0,0,3
143548.0,Aleksic Maja,MB,Serbia,25.0,188,2022,Japan,2022-07-02,True,1,2,14,17,0,0,0,0,12,1,6,19,4,6,6,16,0,0,2,2,4,0,0,4
143548.0,Aleksic Maja,MB,Serbia,25.0,188,2022,USA,2022-07-13,True,0,2,19,21,0,0,2,2,12,2,2,16,2,12,7,21,1,0,1,2,4,1,1,6
143548.0,Aleksic Maja,MB,Serbia,25.0,188,2022,Brazil,2022-07-16,False,1,1,16,18,0,0,1,1,5,2,2,9,2,5,7,14,0,0,0,0,3,1,2,6
123700.0,Stevanovic Jovana,MB,Serbia,30.0,192,2022,Belgium,2022-06-01,True,0,0,11,11,0,0,1,1,4,1,6,11,0,8,12,20,0,0,0,0,6,1,0,7
123700.0,Stevanovic Jovana,MB,Serbia,30.0,192,2022,Thailand,2022-06-02,False,2,0,14,16,0,0,1,1,4,3,13,20,3,8,10,21,0,0,0,0,1,0,0,1
123700.0,Stevanovic Jovana,MB,Serbia,30.0,192,2022,Bulgaria,2022-06-03,True,1,1,12,14,0,0,3,3,3,1,3,7,1,5,6,12,0,0,0,0,1,0,1,2
123700.0,Stevanovic Jovana,MB,Serbia,30.0,192,2022,Netherlands,2022-06-05,True,1,2,15,18,1,0,0,1,4,1,5,10,5,17,10,32,0,0,0,0,3,0,1,4
123700.0,Stevanovic Jovana,MB,Serbia,30.0,192,2022,Brazil,2022-06-19,False,0,1,4,5,0,0,0,0,4,3,4,11,3,2,5,10,0,0,0,0,0,0,0,0
123700.0,Stevanovic Jovana,MB,Serbia,30.0,192,2022,Germany,2022-06-28,True,0,1,11,12,0,0,1,1,7,4,2,13,2,4,7,13,0,0,0,0,4,0,0,4
123700.0,Stevanovic Jovana,MB,Serbia,30.0,192,2022,Japan,2022-07-02,True,0,2,7,9,0,0,3,3,9,0,11,20,3,7,6,16,2,0,1,3,5,1,0,6
123700.0,Stevanovic Jovana,MB,Serbia,30.0,192,2022,USA,2022-07-13,True,2,1,13,16,0,0,0,0,5,4,3,12,2,8,4,14,0,0,0,0,3,2,0,5
123700.0,Stevanovic Jovana,MB,Serbia,30.0,192,2022,Brazil,2022-07-16,False,2,0,11,13,0,0,3,3,9,2,3,14,4,11,7,22,0,0,1,1,3,1,1,5
142478.0,Milenkovic Bojana,OH,Serbia,26.0,185,2022,Brazil,2022-06-19,False,0,0,8,8,0,0,2,2,8,6,17,31,0,2,2,4,4,0,13,17,9,3,0,12
142478.0,Milenkovic Bojana,OH,Serbia,26.0,185,2022,Germany,2022-06-28,True,0,0,0,0,0,0,0,0,1,0,2,3,0,0,0,0,2,1,1,4,0,0,0,0
142478.0,Milenkovic Bojana,OH,Serbia,26.0,185,2022,Japan,2022-07-02,True,0,1,9,10,1,0,4,5,5,1,14,20,0,0,1,1,6,1,7,14,12,3,0,15
142478.0,Milenkovic Bojana,OH,Serbia,26.0,185,2022,USA,2022-07-13,True,0,0,12,12,0,0,2,2,8,5,15,28,2,4,1,7,14,1,20,35,9,4,0,13
142478.0,Milenkovic Bojana,OH,Serbia,26.0,185,2022,Brazil,2022-07-16,False,0,0,8,8,0,0,4,4,4,4,9,17,1,0,0,1,5,1,15,21,1,4,2,7
183533.0,Zelenovic Jovana,O,Serbia,18.0,200,2022,Belgium,2022-06-01,True,0,0,0,0,0,0,0,0,3,0,4,7,1,2,2,5,0,0,0,0,0,1,0,1
183533.0,Zelenovic Jovana,O,Serbia,18.0,200,2022,Thailand,2022-06-02,False,2,2,10,14,0,0,0,0,18,6,26,50,2,3,2,7,0,0,0,0,3,0,2,5
183533.0,Zelenovic Jovana,O,Serbia,18.0,200,2022,Bulgaria,2022-06-03,True,0,0,0,0,0,0,1,1,2,3,1,6,0,0,0,0,0,0,0,0,0,0,0,0
183533.0,Zelenovic Jovana,O,Serbia,18.0,200,2022,Netherlands,2022-06-05,True,0,0,0,0,0,0,0,0,2,1,6,9,0,0,2,2,0,0,0,0,1,0,0,1
152167.0,Kocic Jovana,MB,Serbia,25.0,191,2022,Belgium,2022-06-01,True,0,0,0,0,0,0,0,0,0,0,0,0,0,0,0,0,0,0,0,0,0,0,0,0
152167.0,Kocic Jovana,MB,Serbia,25.0,191,2022,Thailand,2022-06-02,False,0,0,0,0,0,0,0,0,0,0,0,0,0,0,0,0,0,0,0,0,0,0,0,0
152167.0,Kocic Jovana,MB,Serbia,25.0,191,2022,Bulgaria,2022-06-03,True,0,0,0,0,0,0,0,0,0,0,0,0,0,0,0,0,0,0,0,0,0,0,0,0
152167.0,Kocic Jovana,MB,Serbia,25.0,191,2022,Netherlands,2022-06-05,True,0,0,0,0,0,0,0,0,0,0,0,0,0,0,0,0,0,0,0,0,0,0,0,0
152167.0,Kocic Jovana,MB,Serbia,25.0,191,2022,Brazil,2022-06-19,False,0,0,0,0,0,0,0,0,0,0,0,0,0,0,0,0,0,0,0,0,0,0,0,0
152167.0,Kocic Jovana,MB,Serbia,25.0,191,2022,Germany,2022-06-28,True,0,0,0,0,0,0,0,0,0,0,0,0,0,0,0,0,0,0,0,0,0,0,0,0
152167.0,Kocic Jovana,MB,Serbia,25.0,191,2022,Japan,2022-07-02,True,0,0,0,0,0,0,0,0,0,0,0,0,0,0,0,0,0,0,0,0,0,0,0,0
152167.0,Kocic Jovana,MB,Serbia,25.0,191,2022,USA,2022-07-13,True,0,0,0,0,0,0,0,0,0,0,0,0,0,0,0,0,0,0,0,0,0,0,0,0
152167.0,Kocic Jovana,MB,Serbia,25.0,191,2022,Brazil,2022-07-16,False,0,0,0,0,0,0,0,0,0,0,0,0,0,0,0,0,0,0,0,0,0,0,0,0
142479.0,Lozo Sara,O,Serbia,25.0,186,2022,Belgium,2022-06-01,True,1,1,16,18,0,0,0,0,18,4,15,37,0,2,4,6,9,2,15,26,8,5,0,13
142479.0,Lozo Sara,O,Serbia,25.0,186,2022,Thailand,2022-06-02,False,0,1,17,18,0,0,0,0,11,3,19,33,2,3,3,8,16,2,31,49,4,3,0,7
142479.0,Lozo Sara,O,Serbia,25.0,186,2022,Bulgaria,2022-06-03,True,0,1,12,13,0,1,3,4,13,2,13,28,2,4,2,8,3,2,14,19,6,1,4,11
142479.0,Lozo Sara,O,Serbia,25.0,186,2022,Netherlands,2022-06-05,True,1,3,12,16,0,0,3,3,16,4,16,36,4,5,4,13,3,2,30,35,14,1,5,20
142479.0,Lozo Sara,O,Serbia,25.0,186,2022,Brazil,2022-06-19,False,0,1,10,11,0,0,0,0,6,4,5,15,0,0,0,0,17,0,26,43,5,1,1,7
142479.0,Lozo Sara,O,Serbia,25.0,186,2022,USA,2022-07-13,True,3,2,18,23,0,0,2,2,15,9,14,38,4,4,3,11,11,0,6,17,10,2,0,12
142479.0,Lozo Sara,O,Serbia,25.0,186,2022,Brazil,2022-07-16,False,0,1,8,9,0,0,4,4,10,3,9,22,0,0,0,0,10,0,24,34,9,2,1,12
163967.0,Delic Jelena,MB,Serbia,22.0,193,2022,Belgium,2022-06-01,True,0,0,0,0,0,0,0,0,0,0,0,0,0,0,0,0,0,0,0,0,0,0,0,0
163967.0,Delic Jelena,MB,Serbia,22.0,193,2022,Thailand,2022-06-02,False,0,0,0,0,0,0,0,0,0,0,0,0,0,0,0,0,0,0,0,0,0,0,0,0
163967.0,Delic Jelena,MB,Serbia,22.0,193,2022,Bulgaria,2022-06-03,True,0,0,0,0,0,0,0,0,0,0,0,0,0,0,0,0,0,0,0,0,0,0,0,0
163967.0,Delic Jelena,MB,Serbia,22.0,193,2022,Netherlands,2022-06-05,True,0,0,0,0,0,0,0,0,0,0,0,0,0,0,0,0,0,0,0,0,0,0,0,0
163967.0,Delic Jelena,MB,Serbia,22.0,193,2022,Brazil,2022-06-19,False,0,0,0,0,0,0,0,0,0,0,0,0,0,0,0,0,0,0,0,0,0,0,0,0
163967.0,Delic Jelena,MB,Serbia,22.0,193,2022,Germany,2022-06-28,True,0,0,0,0,0,0,0,0,0,0,0,0,0,0,0,0,0,0,0,0,0,0,0,0
163967.0,Delic Jelena,MB,Serbia,22.0,193,2022,Japan,2022-07-02,True,0,0,0,0,0,0,0,0,0,0,0,0,0,0,0,0,0,0,0,0,0,0,0,0
163117.0,Djurdjevic Sanja,L,Serbia,25.0,177,2022,Belgium,2022-06-01,True,0,0,0,0,0,0,0,0,0,0,0,0,0,0,0,0,0,0,0,0,0,0,0,0
163117.0,Djurdjevic Sanja,L,Serbia,25.0,177,2022,Thailand,2022-06-02,False,0,0,0,0,0,0,0,0,0,0,0,0,0,0,0,0,0,0,0,0,0,0,0,0
163117.0,Djurdjevic Sanja,L,Serbia,25.0,177,2022,Bulgaria,2022-06-03,True,0,0,0,0,0,0,0,0,0,0,0,0,0,0,0,0,0,0,0,0,0,0,0,0
163117.0,Djurdjevic Sanja,L,Serbia,25.0,177,2022,Netherlands,2022-06-05,True,0,0,0,0,0,0,0,0,0,0,0,0,0,0,0,0,0,0,0,0,0,0,0,0
163117.0,Djurdjevic Sanja,L,Serbia,25.0,177,2022,Brazil,2022-06-19,False,0,0,0,0,0,0,0,0,0,0,0,0,0,0,0,0,0,0,0,0,0,0,0,0
163117.0,Djurdjevic Sanja,L,Serbia,25.0,177,2022,Germany,2022-06-28,True,0,0,0,0,0,0,0,0,0,0,0,0,0,0,0,0,0,0,0,0,0,0,0,0
163117.0,Djurdjevic Sanja,L,Serbia,25.0,177,2022,Japan,2022-07-02,True,0,0,0,0,0,0,0,0,0,0,0,0,0,0,0,0,0,0,0,0,0,0,0,0
163117.0,Djurdjevic Sanja,L,Serbia,25.0,177,2022,USA,2022-07-13,True,0,0,0,0,0,0,0,0,0,0,0,0,0,0,0,0,0,0,0,0,0,0,0,0
163117.0,Djurdjevic Sanja,L,Serbia,25.0,177,2022,Brazil,2022-07-16,False,0,0,0,0,0,0,0,0,0,0,0,0,0,0,0,0,0,0,0,0,0,0,0,0
163119.0,Mirosavljevic Jovana,OH,Serbia,23.0,183,2022,Belgium,2022-06-01,True,0,0,0,0,0,0,0,0,0,0,0,0,0,0,0,0,0,0,0,0,0,0,0,0
163119.0,Mirosavljevic Jovana,OH,Serbia,23.0,183,2022,Thailand,2022-06-02,False,1,0,4,5,0,0,0,0,4,0,4,8,1,0,0,1,2,0,12,14,1,2,0,3
163119.0,Mirosavljevic Jovana,OH,Serbia,23.0,183,2022,Bulgaria,2022-06-03,True,0,0,2,2,0,0,0,0,1,0,1,2,0,1,1,2,0,0,2,2,0,1,0,1
163119.0,Mirosavljevic Jovana,OH,Serbia,23.0,183,2022,Netherlands,2022-06-05,True,0,0,0,0,0,0,0,0,0,0,0,0,0,0,0,0,0,0,1,1,0,0,0,0
163119.0,Mirosavljevic Jovana,OH,Serbia,23.0,183,2022,Brazil,2022-06-19,False,0,0,0,0,0,0,0,0,0,0,1,1,0,1,0,1,0,0,0,0,0,0,0,0
163119.0,Mirosavljevic Jovana,OH,Serbia,23.0,183,2022,Germany,2022-06-28,True,0,0,4,4,0,0,0,0,0,0,0,0,0,0,0,0,0,0,0,0,0,0,0,0
163119.0,Mirosavljevic Jovana,OH,Serbia,23.0,183,2022,Japan,2022-07-02,True,0,0,8,8,0,1,1,2,8,2,8,18,0,0,1,1,0,0,0,0,11,3,0,14
173179.0,Mijatovic Mina,OH,Serbia,21.0,190,2022,Germany,2022-06-28,True,0,0,0,0,0,0,0,0,1,0,1,2,0,0,0,0,0,0,0,0,0,0,0,0
173179.0,Mijatovic Mina,OH,Serbia,21.0,190,2022,Japan,2022-07-02,True,0,1,5,6,0,0,1,1,4,3,10,17,0,1,3,4,0,0,0,0,3,0,1,4
151120.0,Srithong Wipawee,OH,Thailand,24.0,174,2022,Poland,2022-06-16,False,0,0,3,3,0,0,1,1,0,1,0,1,0,0,0,0,1,0,1,2,1,1,0,2
151120.0,Srithong Wipawee,OH,Thailand,24.0,174,2022,Japan,2022-06-17,False,0,0,0,0,0,0,0,0,0,0,0,0,0,0,0,0,0,0,0,0,0,0,0,0
151120.0,Srithong Wipawee,OH,Thailand,24.0,174,2022,USA,2022-06-19,False,0,0,0,0,0,0,0,0,0,0,0,0,0,0,0,0,0,0,0,0,0,0,0,0
131866.0,Pannoy Piyanut,L,Thailand,33.0,170,2022,Bulgaria,2022-05-31,True,0,0,0,0,0,0,2,2,0,0,0,0,0,0,0,0,4,0,9,13,3,1,1,5
131866.0,Pannoy Piyanut,L,Thailand,33.0,170,2022,Serbia,2022-06-02,True,0,0,0,0,0,0,4,4,0,0,0,0,0,0,0,0,8,1,9,18,9,3,4,16
131866.0,Pannoy Piyanut,L,Thailand,33.0,170,2022,Belgium,2022-06-04,False,0,0,0,0,9,1,6,16,0,0,0,0,0,0,0,0,4,1,11,16,12,2,4,18
131866.0,Pannoy Piyanut,L,Thailand,33.0,170,2022,China,2022-06-05,True,0,0,0,0,2,1,7,10,0,0,0,0,0,0,0,0,11,1,10,22,6,1,3,10
131866.0,Pannoy Piyanut,L,Thailand,33.0,170,2022,Japan,2022-06-17,False,0,0,0,0,0,2,8,10,0,0,0,0,0,0,0,0,2,0,2,4,6,0,1,7
131866.0,Pannoy Piyanut,L,Thailand,33.0,170,2022,USA,2022-06-19,False,0,0,0,0,1,1,12,14,0,0,0,0,0,0,0,0,4,1,12,17,7,3,2,12
131866.0,Pannoy Piyanut,L,Thailand,33.0,170,2022,Dominican Republic,2022-06-30,False,0,0,0,0,6,0,0,6,0,0,0,0,0,0,0,0,5,1,9,15,5,1,7,13
131866.0,Pannoy Piyanut,L,Thailand,33.0,170,2022,Brazil,2022-07-02,False,0,0,0,0,0,0,5,5,0,0,0,0,0,0,0,0,6,0,9,15,7,3,6,16
131866.0,Pannoy Piyanut,L,Thailand,33.0,170,2022,Italy,2022-07-03,False,0,0,0,0,0,0,2,2,0,0,0,0,0,0,0,0,5,0,2,7,2,1,0,3
123019.0,Guedpard Pornpun,S,Thailand,29.0,170,2022,Bulgaria,2022-05-31,True,0,2,8,10,28,0,53,81,0,0,2,2,1,3,4,8,0,0,0,0,3,2,2,7
123019.0,Guedpard Pornpun,S,Thailand,29.0,170,2022,Serbia,2022-06-02,True,2,0,14,16,40,0,117,157,0,1,2,3,1,1,2,4,0,0,0,0,1,4,3,8
123019.0,Guedpard Pornpun,S,Thailand,29.0,170,2022,Belgium,2022-06-04,False,0,1,16,17,80,1,52,133,3,0,0,3,0,1,6,7,0,1,0,1,6,0,3,9
123019.0,Guedpard Pornpun,S,Thailand,29.0,170,2022,China,2022-06-05,True,0,2,9,11,64,2,42,108,1,0,2,3,0,2,2,4,0,0,0,0,8,5,2,15
123019.0,Guedpard Pornpun,S,Thailand,29.0,170,2022,Canada,2022-06-14,True,0,0,5,5,6,0,11,17,0,0,0,0,0,0,0,0,0,0,0,0,0,1,0,1
123019.0,Guedpard Pornpun,S,Thailand,29.0,170,2022,Poland,2022-06-16,False,1,0,21,22,19,1,97,117,0,1,3,4,0,2,6,8,0,0,0,0,10,2,0,12
123019.0,Guedpard Pornpun,S,Thailand,29.0,170,2022,Japan,2022-06-17,False,0,1,8,9,31,2,56,89,1,0,2,3,1,3,5,9,0,0,0,0,4,5,1,10
123019.0,Guedpard Pornpun,S,Thailand,29.0,170,2022,USA,2022-06-19,False,1,0,10,11,22,0,85,107,2,0,0,2,0,4,3,7,0,0,1,1,14,3,2,19
123019.0,Guedpard Pornpun,S,Thailand,29.0,170,2022,Dominican Republic,2022-06-30,False,0,2,6,8,93,0,1,94,0,1,3,4,0,6,1,7,0,0,0,0,6,4,6,16
123019.0,Guedpard Pornpun,S,Thailand,29.0,170,2022,Brazil,2022-07-02,False,0,1,13,14,19,2,108,129,1,0,2,3,1,7,4,12,0,0,0,0,3,1,0,4
123019.0,Guedpard Pornpun,S,Thailand,29.0,170,2022,Italy,2022-07-03,False,0,0,8,8,7,1,70,78,0,0,0,0,0,0,0,0,0,0,1,1,1,1,1,3
142172.0,Nuekjang Thatdao,MB,Thailand,29.0,185,2022,Bulgaria,2022-05-31,True,0,1,9,10,0,0,0,0,5,0,1,6,0,3,2,5,0,0,1,1,1,1,0,2
142172.0,Nuekjang Thatdao,MB,Thailand,29.0,185,2022,Serbia,2022-06-02,True,1,1,18,20,0,0,2,2,6,2,4,12,3,6,2,11,0,0,0,0,0,1,1,2
142172.0,Nuekjang Thatdao,MB,Thailand,29.0,185,2022,Belgium,2022-06-04,False,0,2,1,3,0,0,0,0,1,0,2,3,0,1,2,3,0,0,0,0,3,0,0,3
147187.0,Thipachot Kannika,OH,Thailand,29.0,167,2022,Poland,2022-06-16,False,0,0,2,2,0,0,0,0,1,0,1,2,1,0,0,1,0,0,0,0,1,1,0,2
147187.0,Thipachot Kannika,OH,Thailand,29.0,167,2022,Japan,2022-06-17,False,0,0,0,0,0,0,0,0,0,0,0,0,0,0,0,0,0,0,0,0,0,0,0,0
147187.0,Thipachot Kannika,OH,Thailand,29.0,167,2022,USA,2022-06-19,False,0,0,0,0,0,0,0,0,0,0,0,0,0,0,0,0,0,0,0,0,0,0,0,0
143002.0,Bundasak Jarasporn,MB,Thailand,30.0,182,2022,Poland,2022-06-16,False,2,0,16,18,0,0,1,1,4,1,3,8,3,4,5,12,0,2,0,2,1,0,1,2
143002.0,Bundasak Jarasporn,MB,Thailand,30.0,182,2022,Japan,2022-06-17,False,0,0,10,10,0,0,1,1,5,1,2,8,0,5,4,9,0,0,1,1,0,0,0,0
143002.0,Bundasak Jarasporn,MB,Thailand,30.0,182,2022,USA,2022-06-19,False,0,0,17,17,0,0,4,4,0,2,7,9,0,6,2,8,0,0,0,0,2,1,1,4
143002.0,Bundasak Jarasporn,MB,Thailand,30.0,182,2022,Dominican Republic,2022-06-30,False,1,1,15,17,1,0,1,2,4,0,1,5,2,2,2,6,1,0,0,1,0,1,0,1
143002.0,Bundasak Jarasporn,MB,Thailand,30.0,182,2022,Brazil,2022-07-02,False,0,1,1,2,0,0,0,0,1,2,0,3,0,1,0,1,0,0,0,0,0,0,0,0
143002.0,Bundasak Jarasporn,MB,Thailand,30.0,182,2022,Italy,2022-07-03,False,0,0,4,4,0,0,0,0,1,0,1,2,0,0,0,0,0,0,0,0,0,0,0,0
142180.0,Pinsuwan Darin,OH,Thailand,28.0,171,2022,Poland,2022-06-16,False,0,0,0,0,0,0,1,1,0,0,0,0,0,0,0,0,0,0,1,1,1,0,1,2
142180.0,Pinsuwan Darin,OH,Thailand,28.0,171,2022,Japan,2022-06-17,False,0,0,0,0,0,0,0,0,0,1,2,3,0,0,0,0,0,0,0,0,1,0,0,1
142180.0,Pinsuwan Darin,OH,Thailand,28.0,171,2022,USA,2022-06-19,False,0,0,0,0,0,0,0,0,0,0,0,0,0,0,0,0,0,0,0,0,0,0,0,0
145244.0,Bamrungsuk Hattaya,MB,Thailand,29.0,180,2022,Bulgaria,2022-05-31,True,1,1,9,11,0,0,0,0,7,2,2,11,1,4,3,8,1,0,0,1,0,1,1,2
145244.0,Bamrungsuk Hattaya,MB,Thailand,29.0,180,2022,Serbia,2022-06-02,True,0,2,11,13,0,0,0,0,9,1,13,23,1,2,8,11,1,0,1,2,3,3,1,7
145244.0,Bamrungsuk Hattaya,MB,Thailand,29.0,180,2022,Belgium,2022-06-04,False,0,0,20,20,0,0,2,2,5,2,5,12,3,7,10,20,0,0,1,1,7,1,2,10
145244.0,Bamrungsuk Hattaya,MB,Thailand,29.0,180,2022,China,2022-06-05,True,1,1,14,16,1,0,1,2,2,0,4,6,1,8,6,15,0,0,2,2,6,0,3,9
145244.0,Bamrungsuk Hattaya,MB,Thailand,29.0,180,2022,Canada,2022-06-14,True,0,1,9,10,0,0,2,2,4,0,4,8,1,2,3,6,0,0,0,0,4,0,0,4
145244.0,Bamrungsuk Hattaya,MB,Thailand,29.0,180,2022,Dominican Republic,2022-06-30,False,0,1,9,10,0,1,0,1,3,1,4,8,2,11,2,15,0,0,0,0,2,0,2,4
145244.0,Bamrungsuk Hattaya,MB,Thailand,29.0,180,2022,Brazil,2022-07-02,False,0,2,13,15,0,0,0,0,8,2,6,16,2,5,6,13,0,0,0,0,1,1,1,3
145244.0,Bamrungsuk Hattaya,MB,Thailand,29.0,180,2022,Italy,2022-07-03,False,0,0,10,10,0,0,0,0,5,1,7,13,0,3,3,6,0,0,0,0,3,0,1,4
152179.0,Jaisaen Natthanicha,S,Thailand,24.0,171,2022,Canada,2022-06-14,True,0,0,0,0,0,0,0,0,0,0,0,0,0,0,0,0,0,0,0,0,0,0,0,0
122866.0,Chuewulim Sutadta,OH,Thailand,30.0,173,2022,Bulgaria,2022-05-31,True,0,0,0,0,0,0,0,0,0,0,0,0,0,0,0,0,0,0,0,0,0,0,0,0
122866.0,Chuewulim Sutadta,OH,Thailand,30.0,173,2022,Serbia,2022-06-02,True,0,0,0,0,0,0,0,0,0,0,0,0,0,0,0,0,0,0,3,3,0,0,0,0
122866.0,Chuewulim Sutadta,OH,Thailand,30.0,173,2022,Belgium,2022-06-04,False,0,0,1,1,0,0,2,2,0,0,0,0,0,0,0,0,0,0,1,1,1,0,0,1
122866.0,Chuewulim Sutadta,OH,Thailand,30.0,173,2022,China,2022-06-05,True,0,0,0,0,0,0,0,0,0,0,0,0,0,0,0,0,0,0,0,0,0,0,0,0
122866.0,Chuewulim Sutadta,OH,Thailand,30.0,173,2022,Dominican Republic,2022-06-30,False,0,1,1,2,0,0,0,0,0,0,0,0,0,0,0,0,1,0,1,2,1,1,3,5
122866.0,Chuewulim Sutadta,OH,Thailand,30.0,173,2022,Brazil,2022-07-02,False,0,0,0,0,0,0,0,0,0,0,0,0,0,0,0,0,0,0,0,0,0,0,0,0
122866.0,Chuewulim Sutadta,OH,Thailand,30.0,173,2022,Italy,2022-07-03,False,0,0,1,1,0,0,0,0,0,0,1,1,0,0,0,0,0,0,0,0,1,1,1,3
142185.0,Kamulthala Kaewkalaya,MB,Thailand,28.0,178,2022,Bulgaria,2022-05-31,True,0,0,0,0,0,0,0,0,0,0,0,0,0,0,0,0,0,0,0,0,0,0,0,0
142185.0,Kamulthala Kaewkalaya,MB,Thailand,28.0,178,2022,Serbia,2022-06-02,True,0,0,0,0,0,0,0,0,0,0,0,0,0,0,0,0,0,0,0,0,0,0,0,0
142185.0,Kamulthala Kaewkalaya,MB,Thailand,28.0,178,2022,Belgium,2022-06-04,False,0,1,4,5,0,0,2,2,0,0,4,4,0,2,2,4,0,0,0,0,0,0,1,1
142185.0,Kamulthala Kaewkalaya,MB,Thailand,28.0,178,2022,China,2022-06-05,True,0,1,18,19,2,0,2,4,1,0,4,5,2,4,8,14,0,2,1,3,1,3,4,8
142185.0,Kamulthala Kaewkalaya,MB,Thailand,28.0,178,2022,Canada,2022-06-14,True,0,0,14,14,0,0,0,0,0,1,1,2,0,4,3,7,0,0,0,0,2,0,0,2
142185.0,Kamulthala Kaewkalaya,MB,Thailand,28.0,178,2022,Poland,2022-06-16,False,0,2,11,13,1,0,3,4,1,2,6,9,0,11,13,24,0,0,1,1,2,2,1,5
142185.0,Kamulthala Kaewkalaya,MB,Thailand,28.0,178,2022,Japan,2022-06-17,False,0,0,8,8,1,0,0,1,3,0,14,17,1,3,10,14,1,0,1,2,6,0,0,6
142185.0,Kamulthala Kaewkalaya,MB,Thailand,28.0,178,2022,USA,2022-06-19,False,0,2,7,9,1,0,0,1,3,0,5,8,0,3,7,10,1,0,0,1,2,0,2,4
142185.0,Kamulthala Kaewkalaya,MB,Thailand,28.0,178,2022,Dominican Republic,2022-06-30,False,0,0,0,0,0,0,0,0,0,0,0,0,0,0,0,0,0,0,0,0,0,0,0,0
142185.0,Kamulthala Kaewkalaya,MB,Thailand,28.0,178,2022,Brazil,2022-07-02,False,1,2,9,12,0,0,0,0,5,0,3,8,1,3,3,7,0,0,0,0,2,1,1,4
142185.0,Kamulthala Kaewkalaya,MB,Thailand,28.0,178,2022,Italy,2022-07-03,False,0,0,3,3,0,0,0,0,2,0,1,3,0,0,0,0,0,0,0,0,1,0,0,1
151121.0,Kokram Pimpichaya,O,Thailand,24.0,180,2022,Bulgaria,2022-05-31,True,3,2,16,21,0,0,0,0,7,2,12,21,2,0,6,8,0,0,0,0,7,6,2,15
151121.0,Kokram Pimpichaya,O,Thailand,24.0,180,2022,Serbia,2022-06-02,True,1,0,17,18,0,0,0,0,31,7,19,57,0,2,4,6,0,0,2,2,6,3,5,14
151121.0,Kokram Pimpichaya,O,Thailand,24.0,180,2022,Belgium,2022-06-04,False,1,1,19,21,1,0,2,3,21,9,21,51,2,1,2,5,0,0,0,0,15,3,3,21
151121.0,Kokram Pimpichaya,O,Thailand,24.0,180,2022,China,2022-06-05,True,1,3,10,14,2,0,1,3,27,5,23,55,1,2,6,9,3,0,4,7,6,0,2,8
151121.0,Kokram Pimpichaya,O,Thailand,24.0,180,2022,Canada,2022-06-14,True,1,0,14,15,0,0,2,2,19,1,13,33,0,2,4,6,0,0,0,0,4,1,2,7
151121.0,Kokram Pimpichaya,O,Thailand,24.0,180,2022,Poland,2022-06-16,False,1,2,12,15,0,1,2,3,12,3,15,30,0,1,7,8,0,0,0,0,12,0,1,13
151121.0,Kokram Pimpichaya,O,Thailand,24.0,180,2022,Japan,2022-06-17,False,0,1,9,10,0,0,1,1,8,6,15,29,0,3,3,6,3,0,3,6,14,1,1,16
151121.0,Kokram Pimpichaya,O,Thailand,24.0,180,2022,USA,2022-06-19,False,0,0,11,11,0,0,0,0,8,8,15,31,0,4,2,6,1,0,6,7,8,1,3,12
151121.0,Kokram Pimpichaya,O,Thailand,24.0,180,2022,Dominican Republic,2022-06-30,False,3,1,17,21,2,2,1,5,26,4,17,47,1,3,2,6,0,0,0,0,4,1,3,8
151121.0,Kokram Pimpichaya,O,Thailand,24.0,180,2022,Brazil,2022-07-02,False,0,0,16,16,0,1,0,1,22,7,16,45,1,5,0,6,0,0,0,0,4,0,2,6
151121.0,Kokram Pimpichaya,O,Thailand,24.0,180,2022,Italy,2022-07-03,False,0,1,4,5,0,0,2,2,8,7,14,29,0,0,0,0,0,0,1,1,3,0,2,5
143053.0,Boonlert Tichaya,S,Thailand,26.0,179,2022,Bulgaria,2022-05-31,True,0,0,0,0,0,0,0,0,0,0,0,0,0,0,0,0,0,0,0,0,0,0,0,0
143053.0,Boonlert Tichaya,S,Thailand,26.0,179,2022,Serbia,2022-06-02,True,0,1,0,1,0,0,0,0,0,0,0,0,0,0,0,0,0,0,0,0,0,0,0,0
143053.0,Boonlert Tichaya,S,Thailand,26.0,179,2022,Belgium,2022-06-04,False,0,0,0,0,4,0,4,8,0,0,0,0,0,0,0,0,0,0,0,0,0,0,0,0
143053.0,Boonlert Tichaya,S,Thailand,26.0,179,2022,China,2022-06-05,True,0,1,0,1,4,0,5,9,0,0,0,0,0,1,0,1,0,0,0,0,1,0,0,1
143053.0,Boonlert Tichaya,S,Thailand,26.0,179,2022,Poland,2022-06-16,False,0,0,0,0,0,0,0,0,0,0,0,0,0,0,0,0,0,0,0,0,0,0,0,0
143053.0,Boonlert Tichaya,S,Thailand,26.0,179,2022,Japan,2022-06-17,False,0,0,0,0,3,0,4,7,0,0,0,0,0,0,0,0,0,0,0,0,0,0,0,0
143053.0,Boonlert Tichaya,S,Thailand,26.0,179,2022,USA,2022-06-19,False,0,0,0,0,0,0,0,0,0,0,0,0,0,0,0,0,0,0,0,0,0,0,0,0
133511.0,Kongyot Ajcharaporn,OH,Thailand,27.0,180,2022,Bulgaria,2022-05-31,True,1,1,11,13,0,0,0,0,17,2,13,32,2,4,1,7,2,1,10,13,7,3,0,10
133511.0,Kongyot Ajcharaporn,OH,Thailand,27.0,180,2022,Serbia,2022-06-02,True,0,1,24,25,0,0,0,0,11,9,17,37,3,3,3,9,12,5,43,60,9,1,0,10
133511.0,Kongyot Ajcharaporn,OH,Thailand,27.0,180,2022,Belgium,2022-06-04,False,0,2,14,16,2,0,1,3,16,3,21,40,0,2,6,8,8,2,21,31,21,2,0,23
133511.0,Kongyot Ajcharaporn,OH,Thailand,27.0,180,2022,China,2022-06-05,True,0,0,5,5,1,0,0,1,8,1,7,16,0,1,2,3,1,0,11,12,6,0,1,7
133511.0,Kongyot Ajcharaporn,OH,Thailand,27.0,180,2022,Canada,2022-06-14,True,0,2,10,12,0,0,0,0,6,3,18,27,1,2,1,4,8,2,13,23,5,2,0,7
133511.0,Kongyot Ajcharaporn,OH,Thailand,27.0,180,2022,Poland,2022-06-16,False,0,0,8,8,0,0,5,5,9,7,24,40,0,0,2,2,6,0,9,15,15,2,4,21
133511.0,Kongyot Ajcharaporn,OH,Thailand,27.0,180,2022,Japan,2022-06-17,False,0,1,7,8,0,0,1,1,8,2,21,31,2,0,1,3,6,0,9,15,9,7,1,17
133511.0,Kongyot Ajcharaporn,OH,Thailand,27.0,180,2022,USA,2022-06-19,False,0,0,10,10,0,0,0,0,24,7,21,52,1,1,6,8,3,1,12,16,11,3,3,17
133511.0,Kongyot Ajcharaporn,OH,Thailand,27.0,180,2022,Dominican Republic,2022-06-30,False,0,1,9,10,1,0,0,1,14,4,17,35,1,2,1,4,5,3,19,27,7,1,3,11
133511.0,Kongyot Ajcharaporn,OH,Thailand,27.0,180,2022,Brazil,2022-07-02,False,2,0,12,14,0,0,1,1,14,6,19,39,0,0,0,0,13,0,31,44,9,1,2,12
133511.0,Kongyot Ajcharaporn,OH,Thailand,27.0,180,2022,Italy,2022-07-03,False,0,0,6,6,0,0,1,1,4,1,15,20,0,2,0,2,2,1,12,15,5,1,1,7
147213.0,Moksri Chatchu-On,OH,Thailand,23.0,180,2022,Bulgaria,2022-05-31,True,0,1,7,8,0,0,1,1,11,3,10,24,2,2,0,4,5,0,20,25,8,4,2,14
147213.0,Moksri Chatchu-On,OH,Thailand,23.0,180,2022,Serbia,2022-06-02,True,0,2,15,17,0,0,1,1,24,4,21,49,4,4,2,10,4,2,10,16,8,3,3,14
147213.0,Moksri Chatchu-On,OH,Thailand,23.0,180,2022,Belgium,2022-06-04,False,1,1,14,16,0,0,1,1,21,7,23,51,6,3,4,13,12,2,33,47,13,5,0,18
147213.0,Moksri Chatchu-On,OH,Thailand,23.0,180,2022,China,2022-06-05,True,0,2,15,17,2,0,5,7,16,5,18,39,2,2,4,8,8,2,33,43,11,3,3,17
147213.0,Moksri Chatchu-On,OH,Thailand,23.0,180,2022,Canada,2022-06-14,True,2,3,9,14,0,0,1,1,16,2,14,32,0,2,1,3,5,2,15,22,5,1,2,8
147213.0,Moksri Chatchu-On,OH,Thailand,23.0,180,2022,Poland,2022-06-16,False,1,3,11,15,0,0,2,2,20,5,27,52,5,4,3,12,15,2,42,59,11,1,3,15
147213.0,Moksri Chatchu-On,OH,Thailand,23.0,180,2022,Japan,2022-06-17,False,0,3,5,8,0,0,2,2,9,3,13,25,2,1,2,5,13,0,25,38,10,3,0,13
147213.0,Moksri Chatchu-On,OH,Thailand,23.0,180,2022,USA,2022-06-19,False,2,2,18,22,0,1,4,5,10,3,22,35,1,4,1,6,12,3,22,37,12,3,2,17
147213.0,Moksri Chatchu-On,OH,Thailand,23.0,180,2022,Dominican Republic,2022-06-30,False,2,3,15,20,3,0,1,4,7,4,19,30,0,2,0,2,9,0,31,40,7,3,1,11
147213.0,Moksri Chatchu-On,OH,Thailand,23.0,180,2022,Brazil,2022-07-02,False,0,4,11,15,0,0,0,0,12,4,13,29,2,1,1,4,12,1,22,35,14,2,2,18
147213.0,Moksri Chatchu-On,OH,Thailand,23.0,180,2022,Italy,2022-07-03,False,0,2,4,6,0,0,0,0,10,4,6,20,0,3,0,3,7,5,22,34,6,2,3,11
162681.0,Pairoj Supattra,L,Thailand,32.0,160,2022,Bulgaria,2022-05-31,True,0,0,0,0,0,0,4,4,0,0,0,0,0,0,0,0,0,0,0,0,7,6,1,14
162681.0,Pairoj Supattra,L,Thailand,32.0,160,2022,Serbia,2022-06-02,True,0,0,0,0,0,0,0,0,0,0,0,0,0,0,0,0,0,0,0,0,3,1,0,4
162681.0,Pairoj Supattra,L,Thailand,32.0,160,2022,Belgium,2022-06-04,False,0,0,0,0,0,0,0,0,0,0,0,0,0,0,0,0,0,0,0,0,2,2,0,4
162681.0,Pairoj Supattra,L,Thailand,32.0,160,2022,China,2022-06-05,True,0,0,0,0,1,0,0,1,0,0,0,0,0,0,0,0,0,0,0,0,7,1,1,9
162681.0,Pairoj Supattra,L,Thailand,32.0,160,2022,Dominican Republic,2022-06-30,False,0,0,0,0,3,0,0,3,0,0,0,0,0,0,0,0,0,0,0,0,11,1,0,12
162681.0,Pairoj Supattra,L,Thailand,32.0,160,2022,Brazil,2022-07-02,False,0,0,0,0,0,0,1,1,0,0,0,0,0,0,0,0,0,0,0,0,1,2,1,4
162681.0,Pairoj Supattra,L,Thailand,32.0,160,2022,Italy,2022-07-03,False,0,0,0,0,0,0,0,0,0,0,0,0,0,0,0,0,0,0,0,0,1,3,0,4
152205.0,Sooksod Thanacha,O,Thailand,22.0,180,2022,Bulgaria,2022-05-31,True,0,0,0,0,0,0,0,0,0,0,0,0,0,0,0,0,0,0,0,0,0,0,0,0
152205.0,Sooksod Thanacha,O,Thailand,22.0,180,2022,Serbia,2022-06-02,True,0,0,0,0,0,0,0,0,0,0,0,0,0,0,0,0,0,0,0,0,0,0,0,0
152205.0,Sooksod Thanacha,O,Thailand,22.0,180,2022,Belgium,2022-06-04,False,0,1,0,1,1,0,0,1,2,0,1,3,0,0,2,2,0,0,0,0,0,0,0,0
152205.0,Sooksod Thanacha,O,Thailand,22.0,180,2022,China,2022-06-05,True,0,0,0,0,0,0,0,0,2,0,0,2,0,1,0,1,0,0,1,1,0,0,0,0
152205.0,Sooksod Thanacha,O,Thailand,22.0,180,2022,Canada,2022-06-14,True,0,0,0,0,0,0,0,0,0,0,1,1,0,0,0,0,0,0,0,0,0,0,0,0
152205.0,Sooksod Thanacha,O,Thailand,22.0,180,2022,Poland,2022-06-16,False,0,1,2,3,0,0,2,2,5,4,4,13,0,1,0,1,0,0,1,1,2,2,0,4
152205.0,Sooksod Thanacha,O,Thailand,22.0,180,2022,Japan,2022-06-17,False,0,1,0,1,0,0,0,0,0,0,2,2,0,1,0,1,0,0,0,0,0,0,0,0
152205.0,Sooksod Thanacha,O,Thailand,22.0,180,2022,USA,2022-06-19,False,0,0,0,0,0,0,0,0,0,0,0,0,0,0,0,0,0,0,0,0,0,0,0,0
152205.0,Sooksod Thanacha,O,Thailand,22.0,180,2022,Dominican Republic,2022-06-30,False,0,0,2,2,1,0,0,1,2,0,1,3,0,1,0,1,0,0,0,0,0,1,0,1
152205.0,Sooksod Thanacha,O,Thailand,22.0,180,2022,Brazil,2022-07-02,False,0,1,0,1,0,0,1,1,0,2,0,2,0,0,0,0,0,0,0,0,0,0,0,0
152205.0,Sooksod Thanacha,O,Thailand,22.0,180,2022,Italy,2022-07-03,False,0,0,1,1,0,0,0,0,2,0,1,3,0,1,0,1,0,0,0,0,0,0,0,0
148711.0,Sanitklang Nattaporn,L,Thailand,31.0,166,2022,Canada,2022-06-14,True,0,0,0,0,1,0,5,6,0,0,0,0,0,0,0,0,2,1,5,8,5,0,1,6
148711.0,Sanitklang Nattaporn,L,Thailand,31.0,166,2022,Poland,2022-06-16,False,0,0,0,0,0,0,11,11,0,0,0,0,0,0,0,0,1,3,12,16,11,3,3,17
148711.0,Sanitklang Nattaporn,L,Thailand,31.0,166,2022,Japan,2022-06-17,False,0,0,0,0,0,0,4,4,0,0,0,0,0,0,0,0,0,0,0,0,3,0,1,4
148711.0,Sanitklang Nattaporn,L,Thailand,31.0,166,2022,USA,2022-06-19,False,0,0,0,0,0,0,7,7,0,0,0,0,0,0,0,0,0,0,0,0,9,1,1,11
181410.0,ManaKij Sirima,S,Thailand,32.0,168,2022,Canada,2022-06-14,True,0,0,6,6,12,2,60,74,0,0,0,0,0,2,3,5,0,1,0,1,4,3,1,8
181410.0,ManaKij Sirima,S,Thailand,32.0,168,2022,Poland,2022-06-16,False,0,0,0,0,1,0,5,6,0,0,0,0,0,0,0,0,0,0,0,0,2,0,0,2
181410.0,ManaKij Sirima,S,Thailand,32.0,168,2022,USA,2022-06-19,False,0,0,0,0,0,0,1,1,0,0,0,0,0,0,0,0,0,0,0,0,0,0,1,1
181410.0,ManaKij Sirima,S,Thailand,32.0,168,2022,Dominican Republic,2022-06-30,False,0,0,1,1,4,0,0,4,0,0,0,0,0,0,0,0,0,0,0,0,0,0,0,0
181410.0,ManaKij Sirima,S,Thailand,32.0,168,2022,Brazil,2022-07-02,False,1,0,1,2,0,0,2,2,0,0,0,0,0,0,0,0,0,0,0,0,0,0,0,0
181410.0,ManaKij Sirima,S,Thailand,32.0,168,2022,Italy,2022-07-03,False,0,0,2,2,1,0,13,14,0,0,0,0,0,0,0,0,0,0,0,0,1,0,0,1
163495.0,Boonlert Tichakorn,MB,Thailand,22.0,181,2022,Bulgaria,2022-05-31,True,0,0,0,0,0,0,0,0,0,0,0,0,0,0,0,0,0,0,0,0,0,0,0,0
163495.0,Boonlert Tichakorn,MB,Thailand,22.0,181,2022,Serbia,2022-06-02,True,0,0,0,0,0,0,0,0,0,0,0,0,0,0,0,0,0,0,0,0,0,0,0,0
163495.0,Boonlert Tichakorn,MB,Thailand,22.0,181,2022,Belgium,2022-06-04,False,0,1,5,6,0,0,0,0,1,0,1,2,0,3,5,8,0,0,1,1,1,0,1,2
163495.0,Boonlert Tichakorn,MB,Thailand,22.0,181,2022,China,2022-06-05,True,0,0,2,2,0,0,0,0,1,1,2,4,0,1,0,1,0,0,0,0,1,0,0,1
163495.0,Boonlert Tichakorn,MB,Thailand,22.0,181,2022,Canada,2022-06-14,True,0,0,0,0,0,0,0,0,0,0,0,0,0,0,0,0,0,0,0,0,0,0,0,0
163495.0,Boonlert Tichakorn,MB,Thailand,22.0,181,2022,Dominican Republic,2022-06-30,False,0,1,1,2,1,0,0,1,0,0,0,0,0,0,0,0,0,0,0,0,0,0,0,0
163495.0,Boonlert Tichakorn,MB,Thailand,22.0,181,2022,Brazil,2022-07-02,False,0,0,0,0,0,0,0,0,0,0,0,0,0,0,0,0,0,0,0,0,0,0,0,0
163495.0,Boonlert Tichakorn,MB,Thailand,22.0,181,2022,Italy,2022-07-03,False,0,0,3,3,0,0,0,0,0,0,2,2,0,1,1,2,0,0,0,0,1,1,0,2
180383.0,Janthawisut Sasipapron,OH,Thailand,25.0,175,2022,Bulgaria,2022-05-31,True,0,0,0,0,0,0,0,0,0,0,0,0,0,0,0,0,0,0,0,0,0,0,0,0
180383.0,Janthawisut Sasipapron,OH,Thailand,25.0,175,2022,Serbia,2022-06-02,True,0,0,0,0,0,0,0,0,0,0,0,0,0,0,0,0,0,0,0,0,0,0,0,0
180383.0,Janthawisut Sasipapron,OH,Thailand,25.0,175,2022,Belgium,2022-06-04,False,0,0,0,0,0,0,0,0,0,0,0,0,0,0,0,0,0,0,0,0,0,0,0,0
180383.0,Janthawisut Sasipapron,OH,Thailand,25.0,175,2022,China,2022-06-05,True,0,3,3,6,2,0,2,4,6,2,8,16,0,1,1,2,3,2,10,15,3,5,3,11
180383.0,Janthawisut Sasipapron,OH,Thailand,25.0,175,2022,Canada,2022-06-14,True,0,0,0,0,0,0,0,0,0,0,0,0,0,0,0,0,0,0,0,0,0,0,0,0
180383.0,Janthawisut Sasipapron,OH,Thailand,25.0,175,2022,Dominican Republic,2022-06-30,False,0,0,0,0,0,0,0,0,0,0,0,0,0,0,0,0,0,0,0,0,0,0,0,0
180383.0,Janthawisut Sasipapron,OH,Thailand,25.0,175,2022,Brazil,2022-07-02,False,0,0,0,0,0,0,0,0,0,0,0,0,0,0,0,0,0,0,0,0,0,0,0,0
180383.0,Janthawisut Sasipapron,OH,Thailand,25.0,175,2022,Italy,2022-07-03,False,0,0,1,1,0,0,0,0,2,1,1,4,0,0,0,0,2,1,5,8,1,0,0,1
132835.0,Hancock Micha,S,USA,30.0,180,2022,Bulgaria,2022-06-15,False,1,1,11,13,12,0,61,73,1,0,0,1,1,3,5,9,0,0,1,1,6,1,1,8
132835.0,Hancock Micha,S,USA,30.0,180,2022,Poland,2022-06-17,False,0,0,0,0,0,0,0,0,0,0,0,0,0,0,0,0,0,0,0,0,0,0,0,0
132835.0,Hancock Micha,S,USA,30.0,180,2022,China,2022-06-18,False,3,6,3,12,17,0,68,85,2,0,0,2,0,2,3,5,0,0,0,0,2,1,2,5
132835.0,Hancock Micha,S,USA,30.0,180,2022,Thailand,2022-06-19,False,0,0,2,2,6,0,20,26,0,1,1,2,0,0,2,2,0,0,0,0,2,0,0,2
132835.0,Hancock Micha,S,USA,30.0,180,2022,Germany,2022-07-03,False,1,3,12,16,4,0,99,103,1,1,1,3,0,5,2,7,0,0,1,1,8,0,0,8
143517.0,Poulter Jordyn,S,USA,25.0,188,2022,Germany,2022-07-03,False,0,0,0,0,0,0,0,0,0,0,0,0,0,0,0,0,0,0,0,0,0,0,0,0
143517.0,Poulter Jordyn,S,USA,25.0,188,2022,Serbia,2022-07-13,False,2,1,19,22,18,0,82,100,1,0,0,1,2,3,0,5,0,0,0,0,8,4,0,12
146722.0,Plummer Kathryn,OH,USA,24.0,198,2022,Bulgaria,2022-06-15,False,0,1,8,9,0,0,1,1,7,4,9,20,1,3,2,6,7,4,15,26,9,3,0,12
146722.0,Plummer Kathryn,OH,USA,24.0,198,2022,Poland,2022-06-17,False,0,0,0,0,0,0,0,0,0,0,0,0,0,0,0,0,0,0,0,0,0,0,0,0
146722.0,Plummer Kathryn,OH,USA,24.0,198,2022,China,2022-06-18,False,2,0,10,12,1,0,3,4,18,5,6,29,0,2,1,3,5,0,24,29,6,1,0,7
146722.0,Plummer Kathryn,OH,USA,24.0,198,2022,Thailand,2022-06-19,False,0,0,0,0,0,0,0,0,0,0,0,0,0,0,0,0,0,0,0,0,0,0,0,0
146722.0,Plummer Kathryn,OH,USA,24.0,198,2022,Germany,2022-07-03,False,1,2,8,11,0,0,2,2,7,2,6,15,2,1,2,5,8,2,20,30,7,3,0,10
146722.0,Plummer Kathryn,OH,USA,24.0,198,2022,Serbia,2022-07-13,False,0,2,4,6,0,0,0,0,5,4,4,13,1,3,1,5,11,2,21,34,6,2,1,9
135564.0,Wong-Orantes Justine,L,USA,27.0,168,2022,Bulgaria,2022-06-15,False,0,0,0,0,0,0,5,5,0,0,0,0,0,0,0,0,3,1,8,12,8,1,0,9
135564.0,Wong-Orantes Justine,L,USA,27.0,168,2022,Poland,2022-06-17,False,0,0,0,0,0,0,0,0,0,0,0,0,0,0,0,0,0,0,0,0,0,0,0,0
135564.0,Wong-Orantes Justine,L,USA,27.0,168,2022,China,2022-06-18,False,0,0,0,0,0,0,3,3,0,0,0,0,0,0,0,0,4,2,12,18,11,0,0,11
135564.0,Wong-Orantes Justine,L,USA,27.0,168,2022,Thailand,2022-06-19,False,0,0,0,0,0,0,17,17,0,0,0,0,0,0,0,0,2,1,16,19,16,3,2,21
135564.0,Wong-Orantes Justine,L,USA,27.0,168,2022,Germany,2022-07-03,False,0,0,0,0,0,0,0,0,0,0,0,0,0,0,0,0,0,0,0,0,0,0,0,0
135564.0,Wong-Orantes Justine,L,USA,27.0,168,2022,Serbia,2022-07-13,False,0,0,0,0,0,1,6,7,0,0,0,0,0,0,0,0,6,1,5,12,10,1,0,11
152187.0,Hentz Morgan,L,USA,24.0,175,2022,Japan,2022-06-05,False,0,0,0,0,0,1,15,16,0,0,0,0,0,0,0,0,4,2,3,9,15,5,2,22
152187.0,Hentz Morgan,L,USA,24.0,175,2022,Bulgaria,2022-06-15,False,0,0,0,0,0,0,0,0,0,0,0,0,0,0,0,0,0,0,0,0,0,0,0,0
152187.0,Hentz Morgan,L,USA,24.0,175,2022,Poland,2022-06-17,False,0,0,0,0,0,0,5,5,0,0,0,0,0,0,0,0,3,0,1,4,12,4,0,16
152187.0,Hentz Morgan,L,USA,24.0,175,2022,China,2022-06-18,False,0,0,0,0,0,0,0,0,0,0,0,0,0,0,0,0,0,0,0,0,0,0,0,0
152187.0,Hentz Morgan,L,USA,24.0,175,2022,Thailand,2022-06-19,False,0,0,0,0,0,0,0,0,0,0,0,0,0,0,0,0,0,0,0,0,0,0,0,0
152187.0,Hentz Morgan,L,USA,24.0,175,2022,Germany,2022-07-03,False,0,0,0,0,0,0,9,9,0,0,0,0,0,0,0,0,4,0,11,15,15,3,2,20
152187.0,Hentz Morgan,L,USA,24.0,175,2022,Serbia,2022-07-13,False,0,0,0,0,0,0,0,0,0,0,0,0,0,0,0,0,0,0,0,0,0,0,0,0
145702.0,Dixon Tetori,MB,USA,30.0,191,2022,Japan,2022-06-05,False,0,0,7,7,0,0,0,0,2,1,3,6,0,3,1,4,2,0,0,2,1,1,0,2
145702.0,Dixon Tetori,MB,USA,30.0,191,2022,Germany,2022-07-03,False,1,1,13,15,0,0,1,1,2,0,5,7,2,4,5,11,0,0,0,0,3,1,0,4
132500.0,Carlini Lauren,S,USA,28.0,185,2022,Japan,2022-06-05,False,0,0,14,14,24,1,70,95,1,0,4,5,0,3,2,5,0,0,1,1,16,0,0,16
132500.0,Carlini Lauren,S,USA,28.0,185,2022,Bulgaria,2022-06-15,False,0,0,0,0,0,0,0,0,0,0,0,0,0,0,0,0,0,0,0,0,0,0,0,0
132500.0,Carlini Lauren,S,USA,28.0,185,2022,Poland,2022-06-17,False,1,0,10,11,14,0,60,74,2,0,1,3,1,1,4,6,0,0,0,0,8,1,0,9
132500.0,Carlini Lauren,S,USA,28.0,185,2022,China,2022-06-18,False,0,0,0,0,0,0,0,0,0,0,0,0,0,0,0,0,0,0,0,0,0,0,0,0
132500.0,Carlini Lauren,S,USA,28.0,185,2022,Thailand,2022-06-19,False,1,1,12,14,26,1,56,83,1,0,0,1,1,1,4,6,0,0,0,0,8,1,0,9
132500.0,Carlini Lauren,S,USA,28.0,185,2022,Serbia,2022-07-13,False,0,0,1,1,2,0,0,2,0,0,0,0,0,0,0,0,0,0,0,0,0,0,0,0
160909.0,Tapp Hannah,MB,USA,27.0,191,2022,Bulgaria,2022-06-15,False,1,2,7,10,0,0,2,2,9,1,0,10,1,4,5,10,1,0,0,1,2,1,0,3
160909.0,Tapp Hannah,MB,USA,27.0,191,2022,Poland,2022-06-17,False,0,0,0,0,0,0,0,0,0,0,0,0,0,0,0,0,0,0,0,0,0,0,0,0
160909.0,Tapp Hannah,MB,USA,27.0,191,2022,China,2022-06-18,False,0,1,7,8,0,0,0,0,4,3,1,8,2,2,4,8,1,0,0,1,3,0,0,3
160909.0,Tapp Hannah,MB,USA,27.0,191,2022,Thailand,2022-06-19,False,0,0,0,0,0,0,0,0,0,0,0,0,0,0,0,0,0,0,0,0,0,0,0,0
160909.0,Tapp Hannah,MB,USA,27.0,191,2022,Germany,2022-07-03,False,0,0,0,0,0,0,0,0,0,0,0,0,0,0,0,0,0,0,0,0,0,0,0,0
160909.0,Tapp Hannah,MB,USA,27.0,191,2022,Serbia,2022-07-13,False,0,0,0,0,0,0,0,0,0,0,0,0,0,0,0,0,0,0,0,0,0,0,0,0
135983.0,Rishel Madison Kingdon,OH,USA,29.0,183,2022,Japan,2022-06-05,False,0,0,7,7,0,0,2,2,7,2,14,23,0,2,1,3,6,0,7,13,7,2,0,9
135983.0,Rishel Madison Kingdon,OH,USA,29.0,183,2022,Bulgaria,2022-06-15,False,0,0,0,0,0,0,0,0,0,0,0,0,0,0,0,0,0,0,0,0,0,0,0,0
135983.0,Rishel Madison Kingdon,OH,USA,29.0,183,2022,Poland,2022-06-17,False,0,1,10,11,0,0,2,2,11,3,11,25,1,0,2,3,3,1,17,21,5,1,0,6
135983.0,Rishel Madison Kingdon,OH,USA,29.0,183,2022,China,2022-06-18,False,0,0,0,0,0,0,0,0,0,0,0,0,0,0,0,0,0,0,0,0,0,0,0,0
135983.0,Rishel Madison Kingdon,OH,USA,29.0,183,2022,Thailand,2022-06-19,False,1,1,3,5,0,0,0,0,3,1,6,10,1,0,0,1,2,1,11,14,3,0,0,3
152194.0,Butler Brionne,MB,USA,24.0,194,2022,Japan,2022-06-05,False,0,0,0,0,0,0,0,0,0,0,0,0,0,0,0,0,0,0,0,0,0,0,0,0
155307.0,Drews Andrea,O,USA,29.0,191,2022,Japan,2022-06-05,False,0,2,5,7,0,0,0,0,11,4,18,33,0,4,1,5,0,0,0,0,11,3,1,15
155307.0,Drews Andrea,O,USA,29.0,191,2022,Germany,2022-07-03,False,0,0,0,0,0,0,0,0,0,0,0,0,0,0,0,0,0,0,0,0,0,0,0,0
155307.0,Drews Andrea,O,USA,29.0,191,2022,Serbia,2022-07-13,False,0,1,7,8,0,0,0,0,10,4,5,19,1,6,1,8,0,0,0,0,8,1,1,10
172978.0,Thompson Jordan,O,USA,25.0,193,2022,Japan,2022-06-05,False,0,0,0,0,0,0,0,0,0,0,0,0,0,0,0,0,0,0,0,0,0,0,0,0
172978.0,Thompson Jordan,O,USA,25.0,193,2022,Germany,2022-07-03,False,1,1,11,13,0,0,4,4,12,6,13,31,1,3,1,5,0,0,0,0,8,1,0,9
172978.0,Thompson Jordan,O,USA,25.0,193,2022,Serbia,2022-07-13,False,0,1,6,7,0,0,0,0,9,3,5,17,2,2,1,5,0,0,0,0,1,1,0,2
162942.0,Wilhite Sarah,OH,USA,27.0,185,2022,Japan,2022-06-05,False,0,2,3,5,0,0,1,1,6,1,5,12,0,1,0,1,2,0,2,4,4,1,0,5
162942.0,Wilhite Sarah,OH,USA,27.0,185,2022,Germany,2022-07-03,False,2,0,14,16,0,0,6,6,18,5,20,43,4,3,2,9,7,1,11,19,10,2,0,12
162942.0,Wilhite Sarah,OH,USA,27.0,185,2022,Serbia,2022-07-13,False,0,0,7,7,0,0,0,0,1,0,0,1,0,0,0,0,0,0,0,0,0,0,0,0
140052.0,Washington Haleigh,MB,USA,27.0,190,2022,Bulgaria,2022-06-15,False,4,0,15,19,0,0,0,0,4,1,2,7,2,2,2,6,0,0,0,0,1,1,1,3
140052.0,Washington Haleigh,MB,USA,27.0,190,2022,Poland,2022-06-17,False,0,0,0,0,0,0,0,0,0,0,0,0,0,0,0,0,0,0,0,0,0,0,0,0
140052.0,Washington Haleigh,MB,USA,27.0,190,2022,China,2022-06-18,False,2,1,14,17,0,0,1,1,6,1,5,12,3,3,2,8,0,0,0,0,4,1,1,6
140052.0,Washington Haleigh,MB,USA,27.0,190,2022,Thailand,2022-06-19,False,0,0,0,0,0,0,0,0,0,0,0,0,0,0,0,0,0,0,0,0,0,0,0,0
140052.0,Washington Haleigh,MB,USA,27.0,190,2022,Germany,2022-07-03,False,0,0,0,0,0,0,0,0,0,0,0,0,0,0,0,0,0,0,0,0,0,0,0,0
140052.0,Washington Haleigh,MB,USA,27.0,190,2022,Serbia,2022-07-13,False,1,2,27,30,0,0,2,2,3,1,6,10,3,6,6,15,0,0,2,2,1,2,0,3
172977.0,Rettke Dana,MB,USA,24.0,203,2022,Japan,2022-06-05,False,0,0,3,3,0,0,0,0,1,1,2,4,1,0,5,6,1,0,1,2,0,0,0,0
172977.0,Rettke Dana,MB,USA,24.0,203,2022,Germany,2022-07-03,False,0,1,9,10,0,0,1,1,7,2,3,12,2,5,5,12,0,0,0,0,4,2,0,6
172977.0,Rettke Dana,MB,USA,24.0,203,2022,Serbia,2022-07-13,False,0,0,0,0,0,0,0,0,0,0,0,0,0,0,0,0,0,0,0,0,0,0,0,0
179566.0,Bajema Kara,OH,USA,25.0,190,2022,Japan,2022-06-05,False,0,1,7,8,0,0,2,2,10,2,18,30,0,0,1,1,9,1,14,24,5,1,0,6
179566.0,Bajema Kara,OH,USA,25.0,190,2022,Germany,2022-07-03,False,0,0,0,0,0,0,0,0,0,0,0,0,0,0,0,0,0,0,0,0,0,0,0,0
178951.0,Gray Jenna,S,USA,25.0,185,2022,Japan,2022-06-05,False,0,0,0,0,0,0,0,0,0,0,0,0,0,0,0,0,0,0,0,0,0,0,0,0
143524.0,Cuttino Danielle,O,USA,26.0,195,2022,Bulgaria,2022-06-15,False,0,2,9,11,0,0,2,2,10,1,10,21,2,4,5,11,0,0,0,0,7,3,1,11
143524.0,Cuttino Danielle,O,USA,26.0,195,2022,Poland,2022-06-17,False,0,0,0,0,0,0,0,0,0,0,0,0,0,0,0,0,0,0,0,0,0,0,0,0
143524.0,Cuttino Danielle,O,USA,26.0,195,2022,China,2022-06-18,False,0,2,11,13,0,0,0,0,7,3,11,21,1,4,1,6,0,0,0,0,6,7,0,13
143524.0,Cuttino Danielle,O,USA,26.0,195,2022,Thailand,2022-06-19,False,0,0,1,1,0,0,0,0,0,2,4,6,0,0,1,1,0,0,0,0,1,0,1,2
174134.0,White Kendall,L,USA,25.0,165,2022,Japan,2022-06-05,False,0,0,0,0,0,0,0,0,0,0,0,0,0,0,0,0,0,0,0,0,0,0,0,0
141933.0,Robinson Kelsey,OH,USA,30.0,188,2022,Bulgaria,2022-06-15,False,1,1,9,11,0,0,2,2,13,5,11,29,0,2,2,4,3,1,12,16,4,1,0,5
141933.0,Robinson Kelsey,OH,USA,30.0,188,2022,Poland,2022-06-17,False,0,0,0,0,0,0,0,0,0,0,0,0,0,0,0,0,0,0,0,0,0,0,0,0
141933.0,Robinson Kelsey,OH,USA,30.0,188,2022,China,2022-06-18,False,1,1,9,11,0,0,6,6,13,3,12,28,1,2,1,4,5,1,8,14,6,1,0,7
141933.0,Robinson Kelsey,OH,USA,30.0,188,2022,Thailand,2022-06-19,False,1,3,9,13,1,0,4,5,10,2,16,28,0,3,3,6,7,1,11,19,16,2,1,19
141933.0,Robinson Kelsey,OH,USA,30.0,188,2022,Germany,2022-07-03,False,0,0,5,5,0,0,2,2,4,0,7,11,0,0,2,2,3,0,2,5,3,0,0,3
141933.0,Robinson Kelsey,OH,USA,30.0,188,2022,Serbia,2022-07-13,False,0,0,13,13,0,0,9,9,17,8,14,39,4,4,4,12,6,1,13,20,14,6,1,21
166638.0,Ogbogu Chiaka,MB,USA,27.0,188,2022,Bulgaria,2022-06-15,False,0,0,0,0,0,0,0,0,0,0,0,0,0,0,0,0,0,0,0,0,0,0,0,0
166638.0,Ogbogu Chiaka,MB,USA,27.0,188,2022,Poland,2022-06-17,False,0,1,14,15,0,0,0,0,7,0,4,11,2,6,5,13,0,0,0,0,1,2,1,4
166638.0,Ogbogu Chiaka,MB,USA,27.0,188,2022,China,2022-06-18,False,0,0,0,0,0,0,0,0,0,0,0,0,0,0,0,0,0,0,0,0,0,0,0,0
166638.0,Ogbogu Chiaka,MB,USA,27.0,188,2022,Thailand,2022-06-19,False,1,1,13,15,0,0,1,1,8,0,5,13,1,6,8,15,0,0,0,0,2,0,1,3
166638.0,Ogbogu Chiaka,MB,USA,27.0,188,2022,Serbia,2022-07-13,False,0,1,12,13,0,0,3,3,6,3,2,11,6,9,13,28,0,1,0,1,1,1,0,2
139848.0,Frantti Alexandra,OH,USA,27.0,191,2022,Japan,2022-06-05,False,0,0,1,1,0,0,0,0,1,1,0,2,1,1,0,2,3,1,3,7,2,0,0,2
139848.0,Frantti Alexandra,OH,USA,27.0,191,2022,Bulgaria,2022-06-15,False,0,0,0,0,0,0,0,0,0,0,0,0,0,0,0,0,0,0,0,0,0,0,0,0
139848.0,Frantti Alexandra,OH,USA,27.0,191,2022,Poland,2022-06-17,False,0,0,11,11,0,0,3,3,15,2,2,19,3,1,2,6,7,0,12,19,6,1,1,8
139848.0,Frantti Alexandra,OH,USA,27.0,191,2022,China,2022-06-18,False,0,0,0,0,0,0,0,0,0,0,0,0,0,0,0,0,0,0,0,0,0,0,0,0
139848.0,Frantti Alexandra,OH,USA,27.0,191,2022,Thailand,2022-06-19,False,1,1,15,17,0,0,3,3,24,2,19,45,2,1,2,5,4,0,20,24,10,1,0,11
139848.0,Frantti Alexandra,OH,USA,27.0,191,2022,Serbia,2022-07-13,False,0,0,6,6,0,0,3,3,14,3,5,22,2,0,1,3,11,1,19,31,8,3,0,11
186519.0,Stevenson Anna,MB,USA,23.0,188,2022,Japan,2022-06-05,False,0,2,9,11,0,0,1,1,7,2,4,13,3,0,2,5,3,0,3,6,6,0,0,6
186519.0,Stevenson Anna,MB,USA,23.0,188,2022,Bulgaria,2022-06-15,False,0,0,0,0,0,0,0,0,0,0,0,0,0,0,0,0,0,0,0,0,0,0,0,0
186519.0,Stevenson Anna,MB,USA,23.0,188,2022,Poland,2022-06-17,False,0,1,12,13,0,0,1,1,5,2,3,10,1,2,4,7,0,0,0,0,1,0,0,1
186519.0,Stevenson Anna,MB,USA,23.0,188,2022,China,2022-06-18,False,0,0,0,0,0,0,0,0,0,0,0,0,0,0,0,0,0,0,0,0,0,0,0,0
186519.0,Stevenson Anna,MB,USA,23.0,188,2022,Thailand,2022-06-19,False,0,5,10,15,0,0,2,2,7,3,7,17,3,4,8,15,0,0,0,0,1,0,0,1
143525.0,Reed Nia,O,USA,26.0,185,2022,Bulgaria,2022-06-15,False,0,0,0,0,0,0,0,0,0,0,0,0,0,0,0,0,0,0,0,0,0,0,0,0
143525.0,Reed Nia,O,USA,26.0,185,2022,Poland,2022-06-17,False,0,0,12,12,1,0,0,1,11,2,9,22,1,1,5,7,0,0,0,0,13,1,1,15
143525.0,Reed Nia,O,USA,26.0,185,2022,China,2022-06-18,False,0,0,0,0,0,0,0,0,0,0,0,0,0,0,0,0,0,0,0,0,0,0,0,0
143525.0,Reed Nia,O,USA,26.0,185,2022,Thailand,2022-06-19,False,0,0,9,9,0,0,0,0,8,5,12,25,0,6,6,12,0,0,0,0,9,1,2,12
152119.0,Duarte Alecrim Diana,MB,Brazil,25.0,194,2023,China,2023-05-31,False,1,2,9,12,0,0,0,0,14,0,5,19,1,2,4,7,0,0,0,0,2,0,1,3
152119.0,Duarte Alecrim Diana,MB,Brazil,25.0,194,2023,Netherlands,2023-06-01,True,0,1,9,10,0,0,0,0,2,2,1,5,1,1,6,8,0,0,0,0,1,1,0,2
152119.0,Duarte Alecrim Diana,MB,Brazil,25.0,194,2023,Dominican Republic,2023-06-03,True,1,0,7,8,0,0,1,1,9,4,2,15,2,9,6,17,1,0,0,1,3,0,1,4
152119.0,Duarte Alecrim Diana,MB,Brazil,25.0,194,2023,Croatia,2023-06-04,True,1,2,5,8,0,0,1,1,6,0,2,8,2,0,3,5,0,1,1,2,1,0,1,2
152119.0,Duarte Alecrim Diana,MB,Brazil,25.0,194,2023,Germany,2023-06-17,True,2,0,4,6,0,0,1,1,2,1,1,4,2,10,1,13,0,0,0,0,2,0,1,3
152119.0,Duarte Alecrim Diana,MB,Brazil,25.0,194,2023,USA,2023-06-18,False,0,0,4,4,0,0,0,0,3,0,0,3,3,1,0,4,0,0,0,0,1,0,0,1
152119.0,Duarte Alecrim Diana,MB,Brazil,25.0,194,2023,Italy,2023-06-28,True,0,0,2,2,0,0,0,0,0,0,1,1,0,0,0,0,0,0,0,0,1,0,0,1
152119.0,Duarte Alecrim Diana,MB,Brazil,25.0,194,2023,Canada,2023-06-29,False,0,0,0,0,0,0,0,0,0,0,0,0,0,0,0,0,0,0,0,0,0,0,0,0
152119.0,Duarte Alecrim Diana,MB,Brazil,25.0,194,2023,Thailand,2023-07-02,True,0,0,0,0,0,0,0,0,0,0,0,0,0,0,0,0,0,0,0,0,0,0,0,0
152119.0,Duarte Alecrim Diana,MB,Brazil,25.0,194,2023,China,2023-07-13,False,1,1,8,10,0,0,0,0,1,1,2,4,2,0,2,4,0,0,0,0,3,0,1,4
152135.0,Alexandre Costa Nunes Nyeme Victoria,L,Brazil,25.0,175,2023,Germany,2023-06-17,True,0,0,0,0,0,0,4,4,0,0,0,0,0,0,0,0,6,0,2,8,11,2,2,15
152135.0,Alexandre Costa Nunes Nyeme Victoria,L,Brazil,25.0,175,2023,USA,2023-06-18,False,0,0,0,0,0,0,5,5,0,0,0,0,0,0,0,0,2,2,8,12,6,5,0,11
152135.0,Alexandre Costa Nunes Nyeme Victoria,L,Brazil,25.0,175,2023,Italy,2023-06-28,True,0,0,0,0,0,0,0,0,0,0,0,0,0,0,0,0,0,0,0,0,0,0,0,0
152135.0,Alexandre Costa Nunes Nyeme Victoria,L,Brazil,25.0,175,2023,Canada,2023-06-29,False,0,0,0,0,0,0,7,7,0,0,0,0,0,0,0,0,6,0,19,25,12,1,5,18
152135.0,Alexandre Costa Nunes Nyeme Victoria,L,Brazil,25.0,175,2023,Thailand,2023-07-02,True,0,0,0,0,0,0,3,3,0,0,0,0,0,0,0,0,2,2,6,10,12,4,0,16
152135.0,Alexandre Costa Nunes Nyeme Victoria,L,Brazil,25.0,175,2023,China,2023-07-13,False,0,0,0,0,0,0,0,0,0,0,0,0,0,0,0,0,0,0,0,0,0,0,0,0
115970.0,Zalewski Daroit Priscila,OH,Brazil,35.0,184,2023,Germany,2023-06-17,True,0,0,4,4,0,0,1,1,2,1,2,5,0,1,2,3,1,0,6,7,0,0,1,1
115970.0,Zalewski Daroit Priscila,OH,Brazil,35.0,184,2023,USA,2023-06-18,False,0,0,0,0,0,0,0,0,0,0,0,0,0,0,0,0,0,0,0,0,0,0,0,0
115970.0,Zalewski Daroit Priscila,OH,Brazil,35.0,184,2023,Italy,2023-06-28,True,1,0,10,11,0,0,1,1,3,2,13,18,1,1,4,6,6,1,9,16,8,1,2,11
115970.0,Zalewski Daroit Priscila,OH,Brazil,35.0,184,2023,Canada,2023-06-29,False,0,1,3,4,0,0,1,1,3,2,7,12,1,1,0,2,2,0,5,7,2,1,0,3
115970.0,Zalewski Daroit Priscila,OH,Brazil,35.0,184,2023,Thailand,2023-07-02,True,0,0,0,0,0,0,0,0,0,0,0,0,0,0,0,0,0,0,0,0,0,0,0,0
115970.0,Zalewski Daroit Priscila,OH,Brazil,35.0,184,2023,China,2023-07-13,False,0,0,0,0,0,0,0,0,0,0,0,0,0,0,0,0,0,0,0,0,0,0,0,0
113963.0,Daher de Menezes Thaisa,MB,Brazil,36.0,196,2023,Germany,2023-06-17,True,0,1,5,6,0,0,2,2,3,0,6,9,4,3,3,10,0,0,0,0,3,0,0,3
113963.0,Daher de Menezes Thaisa,MB,Brazil,36.0,196,2023,USA,2023-06-18,False,1,2,4,7,0,0,0,0,10,2,3,15,1,4,3,8,0,0,0,0,2,0,2,4
113963.0,Daher de Menezes Thaisa,MB,Brazil,36.0,196,2023,Italy,2023-06-28,True,1,2,14,17,0,0,0,0,8,0,3,11,3,8,5,16,0,0,0,0,3,2,0,5
113963.0,Daher de Menezes Thaisa,MB,Brazil,36.0,196,2023,Canada,2023-06-29,False,1,4,14,19,0,0,2,2,14,1,7,22,2,6,4,12,0,0,0,0,2,0,0,2
113963.0,Daher de Menezes Thaisa,MB,Brazil,36.0,196,2023,Thailand,2023-07-02,True,1,3,13,17,0,0,3,3,10,1,4,15,0,2,2,4,0,0,1,1,2,1,1,4
113963.0,Daher de Menezes Thaisa,MB,Brazil,36.0,196,2023,China,2023-07-13,False,1,2,9,12,0,0,4,4,17,3,5,25,0,3,3,6,0,1,2,3,1,2,0,3
136897.0,Montibeller Rosamaria,OH,Brazil,29.0,185,2023,Germany,2023-06-17,True,1,0,9,10,0,0,2,2,18,5,12,35,0,3,2,5,0,0,0,0,11,0,0,11
136897.0,Montibeller Rosamaria,OH,Brazil,29.0,185,2023,USA,2023-06-18,False,0,1,1,2,0,0,0,0,2,1,2,5,0,0,1,1,0,0,0,0,1,1,0,2
136897.0,Montibeller Rosamaria,OH,Brazil,29.0,185,2023,Italy,2023-06-28,True,1,2,18,21,0,0,2,2,18,7,17,42,2,6,2,10,0,0,0,0,4,3,1,8
136897.0,Montibeller Rosamaria,OH,Brazil,29.0,185,2023,Canada,2023-06-29,False,2,2,9,13,0,0,2,2,13,10,8,31,0,1,2,3,0,0,0,0,2,2,0,4
136897.0,Montibeller Rosamaria,OH,Brazil,29.0,185,2023,Thailand,2023-07-02,True,0,2,9,11,0,0,1,1,6,2,10,18,2,0,2,4,0,0,0,0,9,1,0,10
136897.0,Montibeller Rosamaria,OH,Brazil,29.0,185,2023,China,2023-07-13,False,0,0,0,0,0,0,0,0,0,0,0,0,0,0,0,0,0,0,0,0,0,0,0,0
151187.0,Silva Carneiro Macris Fernanda,S,Brazil,35.0,178,2023,China,2023-05-31,False,0,1,16,17,11,1,110,122,0,0,1,1,0,0,1,1,0,0,0,0,4,0,2,6
151187.0,Silva Carneiro Macris Fernanda,S,Brazil,35.0,178,2023,Netherlands,2023-06-01,True,0,0,10,10,5,3,73,81,1,0,2,3,0,1,1,2,0,0,0,0,4,0,0,4
151187.0,Silva Carneiro Macris Fernanda,S,Brazil,35.0,178,2023,Dominican Republic,2023-06-03,True,1,0,18,19,8,1,113,122,1,1,2,4,0,1,2,3,0,0,0,0,6,1,2,9
151187.0,Silva Carneiro Macris Fernanda,S,Brazil,35.0,178,2023,Croatia,2023-06-04,True,1,0,5,6,2,0,56,58,1,0,0,1,1,0,1,2,0,0,0,0,2,0,0,2
151187.0,Silva Carneiro Macris Fernanda,S,Brazil,35.0,178,2023,Germany,2023-06-17,True,0,0,4,4,8,0,18,26,0,0,1,1,0,2,1,3,0,0,0,0,0,0,0,0
151187.0,Silva Carneiro Macris Fernanda,S,Brazil,35.0,178,2023,USA,2023-06-18,False,0,0,9,9,5,0,51,56,0,0,2,2,0,2,2,4,0,0,0,0,1,4,1,6
151187.0,Silva Carneiro Macris Fernanda,S,Brazil,35.0,178,2023,Italy,2023-06-28,True,0,0,3,3,5,0,27,32,0,0,0,0,0,0,1,1,0,0,0,0,1,0,0,1
151187.0,Silva Carneiro Macris Fernanda,S,Brazil,35.0,178,2023,Canada,2023-06-29,False,0,1,3,4,12,0,56,68,0,0,0,0,2,2,0,4,0,0,0,0,8,1,2,11
151187.0,Silva Carneiro Macris Fernanda,S,Brazil,35.0,178,2023,Thailand,2023-07-02,True,0,0,9,9,24,0,60,84,1,0,1,2,0,1,3,4,0,0,0,0,2,3,1,6
151187.0,Silva Carneiro Macris Fernanda,S,Brazil,35.0,178,2023,China,2023-07-13,False,2,1,9,12,36,0,72,108,2,0,1,3,0,1,1,2,0,0,0,0,4,2,2,8
119575.0,Ratzke Roberta Silva,S,Brazil,33.0,185,2023,Germany,2023-06-17,True,0,0,11,11,12,0,69,81,1,0,3,4,0,5,3,8,0,0,0,0,9,2,1,12
119575.0,Ratzke Roberta Silva,S,Brazil,33.0,185,2023,USA,2023-06-18,False,0,0,9,9,8,0,20,28,0,0,0,0,0,1,0,1,0,0,0,0,3,3,0,6
119575.0,Ratzke Roberta Silva,S,Brazil,33.0,185,2023,Italy,2023-06-28,True,0,2,11,13,13,1,96,110,0,0,0,0,1,2,6,9,0,0,1,1,2,2,0,4
119575.0,Ratzke Roberta Silva,S,Brazil,33.0,185,2023,Canada,2023-06-29,False,0,0,11,11,23,0,68,91,1,0,0,1,0,0,3,3,0,0,0,0,5,1,1,7
119575.0,Ratzke Roberta Silva,S,Brazil,33.0,185,2023,Thailand,2023-07-02,True,0,0,0,0,1,0,0,1,0,0,0,0,0,0,0,0,0,0,0,0,0,0,0,0
119575.0,Ratzke Roberta Silva,S,Brazil,33.0,185,2023,China,2023-07-13,False,0,0,4,4,8,0,7,15,0,0,0,0,0,0,0,0,0,0,0,0,0,0,0,0
136896.0,Braga Guimaraes Gabriela,OH,Brazil,29.0,180,2023,Italy,2023-06-28,True,0,1,20,21,0,1,1,2,24,9,17,50,1,5,4,10,10,0,11,21,13,6,1,20
136896.0,Braga Guimaraes Gabriela,OH,Brazil,29.0,180,2023,Canada,2023-06-29,False,0,0,25,25,0,0,2,2,19,14,30,63,1,2,2,5,14,1,10,25,14,3,0,17
136896.0,Braga Guimaraes Gabriela,OH,Brazil,29.0,180,2023,Thailand,2023-07-02,True,0,0,13,13,0,0,2,2,17,6,7,30,1,0,3,4,9,0,11,20,5,1,3,9
136896.0,Braga Guimaraes Gabriela,OH,Brazil,29.0,180,2023,China,2023-07-13,False,1,2,12,15,0,0,2,2,14,10,9,33,1,3,1,5,14,0,29,43,12,2,2,16
141651.0,Basso Maiara,OH,Brazil,28.0,189,2023,China,2023-05-31,False,0,0,1,1,0,0,0,0,0,0,0,0,0,0,0,0,0,0,0,0,0,0,0,0
141651.0,Basso Maiara,OH,Brazil,28.0,189,2023,Netherlands,2023-06-01,True,1,0,3,4,0,0,0,0,0,0,0,0,0,0,0,0,0,0,0,0,1,0,0,1
141651.0,Basso Maiara,OH,Brazil,28.0,189,2023,Dominican Republic,2023-06-03,True,0,1,3,4,0,0,0,0,0,0,0,0,0,0,0,0,0,0,0,0,0,0,0,0
141651.0,Basso Maiara,OH,Brazil,28.0,189,2023,Croatia,2023-06-04,True,0,0,4,4,0,0,0,0,0,0,0,0,0,0,0,0,0,0,1,1,1,0,0,1
141651.0,Basso Maiara,OH,Brazil,28.0,189,2023,Germany,2023-06-17,True,1,3,14,18,0,0,6,6,17,3,20,40,0,2,9,11,6,2,8,16,6,1,0,7
141651.0,Basso Maiara,OH,Brazil,28.0,189,2023,USA,2023-06-18,False,0,2,11,13,0,0,2,2,10,2,10,22,1,2,2,5,3,0,6,9,7,4,0,11
141651.0,Basso Maiara,OH,Brazil,28.0,189,2023,Italy,2023-06-28,True,1,0,3,4,0,0,1,1,3,2,6,11,0,0,0,0,2,0,6,8,1,0,0,1
141651.0,Basso Maiara,OH,Brazil,28.0,189,2023,Canada,2023-06-29,False,0,1,9,10,0,0,0,0,10,3,7,20,1,2,1,4,4,0,10,14,6,1,0,7
141651.0,Basso Maiara,OH,Brazil,28.0,189,2023,Thailand,2023-07-02,True,0,0,14,14,0,0,1,1,8,4,8,20,2,2,3,7,9,1,13,23,8,2,2,12
141651.0,Basso Maiara,OH,Brazil,28.0,189,2023,China,2023-07-13,False,0,0,4,4,0,1,3,4,2,2,5,9,0,0,0,0,2,0,12,14,2,2,0,4
164674.0,Araujo Natália,L,Brazil,26.0,162,2023,China,2023-05-31,False,0,0,0,0,0,0,6,6,0,0,0,0,0,0,0,0,8,1,11,20,14,0,1,15
164674.0,Araujo Natália,L,Brazil,26.0,162,2023,Netherlands,2023-06-01,True,0,0,0,0,0,0,8,8,0,0,0,0,0,0,0,0,5,1,10,16,12,0,0,12
164674.0,Araujo Natália,L,Brazil,26.0,162,2023,Dominican Republic,2023-06-03,True,0,0,0,0,0,0,5,5,0,0,0,0,0,0,0,0,14,0,15,29,16,2,4,22
164674.0,Araujo Natália,L,Brazil,26.0,162,2023,Croatia,2023-06-04,True,0,0,0,0,0,0,0,0,0,0,0,0,0,0,0,0,0,0,0,0,0,0,0,0
164674.0,Araujo Natália,L,Brazil,26.0,162,2023,Germany,2023-06-17,True,0,0,0,0,0,0,6,6,0,0,0,0,0,0,0,0,0,0,4,4,9,2,1,12
164674.0,Araujo Natália,L,Brazil,26.0,162,2023,USA,2023-06-18,False,0,0,0,0,0,0,0,0,0,0,0,0,0,0,0,0,0,0,0,0,0,0,0,0
164674.0,Araujo Natália,L,Brazil,26.0,162,2023,Italy,2023-06-28,True,0,0,0,0,0,0,8,8,0,0,0,0,0,0,0,0,12,0,34,46,22,4,0,26
164674.0,Araujo Natália,L,Brazil,26.0,162,2023,Canada,2023-06-29,False,0,0,0,0,0,0,5,5,0,0,0,0,0,0,0,0,6,0,18,24,6,1,1,8
164674.0,Araujo Natália,L,Brazil,26.0,162,2023,Thailand,2023-07-02,True,0,0,0,0,0,0,0,0,0,0,0,0,0,0,0,0,0,0,0,0,0,0,0,0
164674.0,Araujo Natália,L,Brazil,26.0,162,2023,China,2023-07-13,False,0,0,0,0,0,0,12,12,0,0,0,0,0,0,0,0,7,0,3,10,8,5,1,14
144866.0,Da Silva Ana Carolina,MB,Brazil,32.0,183,2023,China,2023-05-31,False,0,1,16,17,0,0,1,1,7,0,7,14,2,2,4,8,0,0,0,0,1,0,2,3
144866.0,Da Silva Ana Carolina,MB,Brazil,32.0,183,2023,Netherlands,2023-06-01,True,3,0,12,15,0,0,0,0,0,2,3,5,0,2,2,4,0,0,0,0,1,0,0,1
144866.0,Da Silva Ana Carolina,MB,Brazil,32.0,183,2023,Dominican Republic,2023-06-03,True,1,2,15,18,0,0,2,2,1,1,4,6,4,3,3,10,0,0,0,0,1,0,2,3
144866.0,Da Silva Ana Carolina,MB,Brazil,32.0,183,2023,Croatia,2023-06-04,True,1,1,11,13,0,0,0,0,6,2,3,11,2,1,2,5,2,0,2,4,2,0,0,2
144866.0,Da Silva Ana Carolina,MB,Brazil,32.0,183,2023,Germany,2023-06-17,True,0,1,13,14,0,0,0,0,7,1,3,11,3,4,0,7,0,0,0,0,1,1,0,2
144866.0,Da Silva Ana Carolina,MB,Brazil,32.0,183,2023,USA,2023-06-18,False,0,1,5,6,0,0,1,1,2,1,3,6,3,3,2,8,0,0,0,0,3,1,0,4
144866.0,Da Silva Ana Carolina,MB,Brazil,32.0,183,2023,Italy,2023-06-28,True,1,1,16,18,0,0,1,1,11,3,6,20,2,6,5,13,0,0,0,0,3,1,0,4
144866.0,Da Silva Ana Carolina,MB,Brazil,32.0,183,2023,Canada,2023-06-29,False,0,1,19,20,0,0,2,2,5,3,4,12,6,4,9,19,0,0,0,0,3,1,1,5
144866.0,Da Silva Ana Carolina,MB,Brazil,32.0,183,2023,Thailand,2023-07-02,True,1,3,6,10,0,0,0,0,8,1,1,10,5,5,7,17,0,0,0,0,0,0,0,0
144866.0,Da Silva Ana Carolina,MB,Brazil,32.0,183,2023,China,2023-07-13,False,0,1,6,7,0,0,2,2,5,1,1,7,2,4,3,9,0,0,0,0,0,1,1,2
171260.0,Nascimento Kisy,O,Brazil,24.0,191,2023,China,2023-05-31,False,1,2,13,16,0,0,1,1,16,3,14,33,4,0,0,4,0,0,0,0,9,0,3,12
171260.0,Nascimento Kisy,O,Brazil,24.0,191,2023,Netherlands,2023-06-01,True,1,2,11,14,0,0,0,0,10,4,5,19,0,1,3,4,0,0,0,0,5,0,1,6
171260.0,Nascimento Kisy,O,Brazil,24.0,191,2023,Dominican Republic,2023-06-03,True,1,0,9,10,0,0,2,2,10,4,17,31,1,3,0,4,0,0,0,0,8,0,0,8
171260.0,Nascimento Kisy,O,Brazil,24.0,191,2023,Croatia,2023-06-04,True,0,0,0,0,0,0,0,0,0,0,0,0,0,0,0,0,0,0,0,0,0,0,0,0
171260.0,Nascimento Kisy,O,Brazil,24.0,191,2023,Germany,2023-06-17,True,0,1,1,2,0,0,0,0,1,1,4,6,0,1,0,1,0,0,0,0,1,1,0,2
171260.0,Nascimento Kisy,O,Brazil,24.0,191,2023,USA,2023-06-18,False,0,1,4,5,0,0,1,1,10,3,13,26,1,3,0,4,0,0,0,0,5,1,1,7
171260.0,Nascimento Kisy,O,Brazil,24.0,191,2023,China,2023-07-13,False,1,1,5,7,0,0,0,0,5,4,9,18,0,1,1,2,0,0,0,0,3,3,0,6
162999.0,Bergmann Julia Isabelle,OH,Brazil,23.0,191,2023,China,2023-05-31,False,0,4,16,20,0,0,1,1,15,8,8,31,1,0,0,1,12,1,26,39,9,1,2,12
162999.0,Bergmann Julia Isabelle,OH,Brazil,23.0,191,2023,Netherlands,2023-06-01,True,1,1,8,10,0,0,0,0,10,4,9,23,2,0,1,3,9,2,22,33,4,0,1,5
162999.0,Bergmann Julia Isabelle,OH,Brazil,23.0,191,2023,Dominican Republic,2023-06-03,True,0,3,14,17,0,0,2,2,11,10,11,32,2,4,3,9,9,2,21,32,7,1,2,10
162999.0,Bergmann Julia Isabelle,OH,Brazil,23.0,191,2023,Croatia,2023-06-04,True,1,1,13,15,0,0,1,1,3,5,9,17,1,0,0,1,3,1,11,15,10,0,0,10
162999.0,Bergmann Julia Isabelle,OH,Brazil,23.0,191,2023,Germany,2023-06-17,True,2,2,13,17,0,0,0,0,9,1,11,21,0,1,2,3,10,1,28,39,4,2,0,6
162999.0,Bergmann Julia Isabelle,OH,Brazil,23.0,191,2023,USA,2023-06-18,False,1,0,9,10,0,0,1,1,6,6,6,18,0,1,0,1,11,5,32,48,2,2,0,4
162999.0,Bergmann Julia Isabelle,OH,Brazil,23.0,191,2023,Italy,2023-06-28,True,0,0,0,0,0,0,0,0,0,0,1,1,0,0,0,0,0,0,0,0,0,0,0,0
162999.0,Bergmann Julia Isabelle,OH,Brazil,23.0,191,2023,Canada,2023-06-29,False,0,1,2,3,0,0,0,0,1,1,2,4,0,1,0,1,1,2,9,12,1,0,0,1
162999.0,Bergmann Julia Isabelle,OH,Brazil,23.0,191,2023,Thailand,2023-07-02,True,0,0,0,0,0,0,0,0,0,0,0,0,0,0,0,0,0,0,0,0,0,0,0,0
162999.0,Bergmann Julia Isabelle,OH,Brazil,23.0,191,2023,China,2023-07-13,False,0,2,8,10,0,0,0,0,4,3,11,18,0,3,0,3,3,0,14,17,9,2,1,12
163000.0,Lemes Santos Tainara,O,Brazil,24.0,190,2023,China,2023-05-31,False,0,0,0,0,0,0,0,0,1,0,1,2,0,0,0,0,0,0,0,0,0,0,1,1
163000.0,Lemes Santos Tainara,O,Brazil,24.0,190,2023,Netherlands,2023-06-01,True,0,0,0,0,0,0,0,0,0,0,0,0,0,0,0,0,0,0,0,0,0,0,0,0
163000.0,Lemes Santos Tainara,O,Brazil,24.0,190,2023,Dominican Republic,2023-06-03,True,0,0,0,0,0,0,0,0,0,0,0,0,0,0,0,0,0,0,0,0,0,0,0,0
163000.0,Lemes Santos Tainara,O,Brazil,24.0,190,2023,Croatia,2023-06-04,True,0,0,0,0,0,0,0,0,2,0,0,2,2,0,0,2,0,0,0,0,1,0,0,1
163000.0,Lemes Santos Tainara,O,Brazil,24.0,190,2023,China,2023-07-13,False,2,3,4,9,0,0,1,1,10,6,9,25,1,2,2,5,0,0,0,0,8,2,1,11
151859.0,Stanchulova Iveta,OH,Bulgaria,26.0,186,2023,Italy,2023-06-14,False,0,0,0,0,0,0,1,1,0,0,0,0,0,0,0,0,1,1,0,2,1,0,0,1
151859.0,Stanchulova Iveta,OH,Bulgaria,26.0,186,2023,Canada,2023-06-15,False,0,2,5,7,0,0,1,1,7,6,14,27,0,1,1,2,3,0,11,14,2,1,0,3
151859.0,Stanchulova Iveta,OH,Bulgaria,26.0,186,2023,China,2023-06-16,False,0,0,1,1,0,0,1,1,0,4,5,9,0,0,0,0,0,1,6,7,0,2,0,2
151859.0,Stanchulova Iveta,OH,Bulgaria,26.0,186,2023,Netherlands,2023-06-18,False,0,0,0,0,0,0,0,0,0,0,0,0,0,0,0,0,0,0,0,0,0,0,0,0
151859.0,Stanchulova Iveta,OH,Bulgaria,26.0,186,2023,USA,2023-06-29,False,0,0,0,0,0,0,0,0,0,0,0,0,0,0,0,0,0,0,0,0,0,0,0,0
151859.0,Stanchulova Iveta,OH,Bulgaria,26.0,186,2023,Poland,2023-06-30,False,0,0,2,2,0,0,1,1,4,1,1,6,0,2,0,2,0,1,6,7,2,1,0,3
151859.0,Stanchulova Iveta,OH,Bulgaria,26.0,186,2023,Serbia,2023-07-02,False,1,1,1,3,0,1,1,2,0,0,1,1,2,0,0,2,0,0,6,6,0,0,0,0
153422.0,Neykova Polina,S,Bulgaria,25.0,182,2023,Croatia,2023-05-31,True,0,0,0,0,0,0,0,0,0,0,0,0,0,0,0,0,0,0,0,0,0,0,0,0
153422.0,Neykova Polina,S,Bulgaria,25.0,182,2023,Dominican Republic,2023-06-01,False,0,0,0,0,3,1,16,20,0,0,0,0,0,0,1,1,0,0,0,0,0,0,0,0
153422.0,Neykova Polina,S,Bulgaria,25.0,182,2023,Japan,2023-06-03,False,0,0,1,1,0,0,16,16,0,0,0,0,1,0,0,1,0,0,0,0,1,0,0,1
153422.0,Neykova Polina,S,Bulgaria,25.0,182,2023,Germany,2023-06-04,False,0,0,1,1,1,0,19,20,0,0,0,0,0,0,0,0,0,0,0,0,1,0,0,1
153422.0,Neykova Polina,S,Bulgaria,25.0,182,2023,Italy,2023-06-14,False,0,1,2,3,2,0,23,25,1,0,1,2,0,0,2,2,0,0,0,0,1,0,1,2
153422.0,Neykova Polina,S,Bulgaria,25.0,182,2023,Canada,2023-06-15,False,0,1,0,1,2,0,25,27,0,1,0,1,1,0,1,2,0,0,0,0,2,1,2,5
153422.0,Neykova Polina,S,Bulgaria,25.0,182,2023,China,2023-06-16,False,0,0,0,0,1,0,7,8,0,0,0,0,0,1,0,1,0,0,0,0,1,0,0,1
153422.0,Neykova Polina,S,Bulgaria,25.0,182,2023,Netherlands,2023-06-18,False,0,0,0,0,0,0,0,0,0,0,0,0,0,0,0,0,0,0,0,0,0,0,0,0
153422.0,Neykova Polina,S,Bulgaria,25.0,182,2023,USA,2023-06-29,False,0,0,1,1,4,1,30,35,0,0,1,1,1,0,0,1,0,0,0,0,0,1,0,1
153422.0,Neykova Polina,S,Bulgaria,25.0,182,2023,Poland,2023-06-30,False,0,0,0,0,0,0,6,6,0,0,0,0,0,0,0,0,0,0,0,0,0,0,0,0
153422.0,Neykova Polina,S,Bulgaria,25.0,182,2023,Serbia,2023-07-02,False,0,0,0,0,0,0,4,4,0,0,0,0,0,0,0,0,0,0,0,0,0,0,0,0
174474.0,Yordanova Maria,OH,Bulgaria,21.0,184,2023,Croatia,2023-05-31,True,3,1,8,12,0,0,1,1,10,6,5,21,0,0,4,4,4,0,14,18,8,0,1,9
174474.0,Yordanova Maria,OH,Bulgaria,21.0,184,2023,Dominican Republic,2023-06-01,False,2,0,12,14,0,0,2,2,12,3,27,42,0,2,3,5,14,2,26,42,17,1,1,19
174474.0,Yordanova Maria,OH,Bulgaria,21.0,184,2023,Japan,2023-06-03,False,1,1,9,11,0,0,4,4,7,3,10,20,0,1,0,1,4,2,19,25,3,0,1,4
174474.0,Yordanova Maria,OH,Bulgaria,21.0,184,2023,Germany,2023-06-04,False,3,2,15,20,0,0,0,0,25,9,25,59,0,0,2,2,5,2,13,20,13,0,3,16
174474.0,Yordanova Maria,OH,Bulgaria,21.0,184,2023,Italy,2023-06-14,False,1,4,5,10,0,0,0,0,11,6,21,38,0,4,4,8,8,0,24,32,6,6,0,12
174474.0,Yordanova Maria,OH,Bulgaria,21.0,184,2023,Canada,2023-06-15,False,0,1,6,7,0,0,4,4,9,3,12,24,0,1,0,1,3,1,13,17,6,1,2,9
174474.0,Yordanova Maria,OH,Bulgaria,21.0,184,2023,China,2023-06-16,False,0,1,7,8,0,1,2,3,5,8,11,24,0,0,0,0,3,2,33,38,4,5,3,12
174474.0,Yordanova Maria,OH,Bulgaria,21.0,184,2023,Netherlands,2023-06-18,False,1,2,7,10,0,0,2,2,9,6,12,27,0,2,0,2,4,2,29,35,6,0,0,6
174474.0,Yordanova Maria,OH,Bulgaria,21.0,184,2023,USA,2023-06-29,False,2,1,8,11,0,0,1,1,8,10,11,29,0,2,3,5,1,0,7,8,6,0,0,6
174474.0,Yordanova Maria,OH,Bulgaria,21.0,184,2023,Poland,2023-06-30,False,2,2,11,15,0,0,4,4,10,5,13,28,0,3,1,4,4,0,24,28,9,1,1,11
174474.0,Yordanova Maria,OH,Bulgaria,21.0,184,2023,Serbia,2023-07-02,False,1,2,12,15,0,0,4,4,9,7,18,34,1,2,5,8,1,1,5,7,6,7,0,13
153421.0,Nikolova Simona,O,Bulgaria,26.0,189,2023,Croatia,2023-05-31,True,0,0,0,0,0,0,0,0,0,0,0,0,0,0,0,0,0,0,0,0,0,0,0,0
153421.0,Nikolova Simona,O,Bulgaria,26.0,189,2023,Dominican Republic,2023-06-01,False,0,0,3,3,0,0,0,0,0,0,3,3,0,0,0,0,0,0,1,1,1,0,0,1
153421.0,Nikolova Simona,O,Bulgaria,26.0,189,2023,Japan,2023-06-03,False,0,1,1,2,0,0,0,0,4,1,2,7,0,0,0,0,0,0,0,0,0,0,0,0
153421.0,Nikolova Simona,O,Bulgaria,26.0,189,2023,Germany,2023-06-04,False,0,2,0,2,0,0,0,0,2,2,3,7,0,0,0,0,0,0,0,0,0,0,0,0
153421.0,Nikolova Simona,O,Bulgaria,26.0,189,2023,Italy,2023-06-14,False,0,0,2,2,0,0,0,0,0,1,0,1,0,0,0,0,0,0,0,0,0,1,1,2
153421.0,Nikolova Simona,O,Bulgaria,26.0,189,2023,Canada,2023-06-15,False,0,0,1,1,0,0,0,0,1,0,3,4,0,0,0,0,0,0,0,0,0,0,0,0
153421.0,Nikolova Simona,O,Bulgaria,26.0,189,2023,China,2023-06-16,False,0,0,1,1,0,0,1,1,2,3,1,6,0,0,0,0,0,0,0,0,1,2,0,3
153421.0,Nikolova Simona,O,Bulgaria,26.0,189,2023,Netherlands,2023-06-18,False,0,0,0,0,0,0,0,0,0,0,0,0,0,0,0,0,0,0,0,0,0,0,0,0
153421.0,Nikolova Simona,O,Bulgaria,26.0,189,2023,USA,2023-06-29,False,0,1,5,6,0,0,0,0,4,3,9,16,1,2,1,4,0,0,0,0,0,0,0,0
153421.0,Nikolova Simona,O,Bulgaria,26.0,189,2023,Poland,2023-06-30,False,0,0,0,0,0,0,0,0,0,1,0,1,0,0,0,0,0,0,0,0,0,0,0,0
153421.0,Nikolova Simona,O,Bulgaria,26.0,189,2023,Serbia,2023-07-02,False,0,0,1,1,0,0,0,0,0,1,0,1,0,1,1,2,0,0,0,0,0,0,0,0
142348.0,Barakova Petya,S,Bulgaria,29.0,180,2023,Croatia,2023-05-31,True,2,0,12,14,2,0,74,76,1,0,0,1,0,0,1,1,0,0,0,0,9,0,0,9
142348.0,Barakova Petya,S,Bulgaria,29.0,180,2023,Dominican Republic,2023-06-01,False,0,0,10,10,3,0,102,105,4,0,4,8,0,4,2,6,0,0,1,1,9,1,4,14
142348.0,Barakova Petya,S,Bulgaria,29.0,180,2023,Japan,2023-06-03,False,0,0,5,5,5,1,55,61,0,0,0,0,1,2,2,5,0,0,0,0,1,0,0,1
142348.0,Barakova Petya,S,Bulgaria,29.0,180,2023,Germany,2023-06-04,False,0,1,11,12,5,0,116,121,2,0,1,3,0,0,2,2,0,0,0,0,11,0,3,14
142348.0,Barakova Petya,S,Bulgaria,29.0,180,2023,Italy,2023-06-14,False,0,0,4,4,6,0,60,66,1,1,1,3,0,1,1,2,0,2,0,2,2,2,0,4
142348.0,Barakova Petya,S,Bulgaria,29.0,180,2023,Canada,2023-06-15,False,0,0,4,4,5,0,51,56,0,0,3,3,0,2,1,3,0,0,0,0,1,1,0,2
142348.0,Barakova Petya,S,Bulgaria,29.0,180,2023,China,2023-06-16,False,0,0,9,9,21,0,60,81,1,0,1,2,0,1,2,3,0,1,0,1,3,1,1,5
142348.0,Barakova Petya,S,Bulgaria,29.0,180,2023,Netherlands,2023-06-18,False,1,0,8,9,9,0,76,85,0,1,1,2,0,3,4,7,0,0,0,0,4,2,0,6
142348.0,Barakova Petya,S,Bulgaria,29.0,180,2023,USA,2023-06-29,False,0,1,0,1,5,0,44,49,0,1,0,1,1,3,0,4,0,0,0,0,2,3,0,5
142348.0,Barakova Petya,S,Bulgaria,29.0,180,2023,Poland,2023-06-30,False,0,0,16,16,6,1,102,109,1,0,1,2,1,3,7,11,0,0,0,0,5,0,1,6
142348.0,Barakova Petya,S,Bulgaria,29.0,180,2023,Serbia,2023-07-02,False,1,1,12,14,9,2,92,103,0,0,4,4,1,5,6,12,0,0,1,1,8,3,2,13
163256.0,Becheva Elena,OH,Bulgaria,25.0,185,2023,Croatia,2023-05-31,True,0,0,3,3,0,0,0,0,1,2,2,5,1,0,0,1,1,0,1,2,0,0,0,0
163256.0,Becheva Elena,OH,Bulgaria,25.0,185,2023,Dominican Republic,2023-06-01,False,0,0,10,10,0,0,0,0,16,4,17,37,1,1,1,3,5,1,25,31,6,0,0,6
163256.0,Becheva Elena,OH,Bulgaria,25.0,185,2023,Japan,2023-06-03,False,1,1,7,9,0,0,2,2,3,2,12,17,2,3,1,6,7,2,10,19,2,0,3,5
163256.0,Becheva Elena,OH,Bulgaria,25.0,185,2023,Germany,2023-06-04,False,0,1,15,16,0,0,2,2,16,4,12,32,0,1,2,3,2,3,33,38,9,0,1,10
163256.0,Becheva Elena,OH,Bulgaria,25.0,185,2023,Italy,2023-06-14,False,2,1,11,14,0,0,4,4,6,4,12,22,1,1,0,2,1,0,27,28,5,4,1,10
163256.0,Becheva Elena,OH,Bulgaria,25.0,185,2023,Canada,2023-06-15,False,0,0,3,3,0,0,0,0,5,6,5,16,0,3,0,3,1,2,11,14,2,1,0,3
163256.0,Becheva Elena,OH,Bulgaria,25.0,185,2023,China,2023-06-16,False,0,2,8,10,0,0,2,2,4,6,10,20,0,1,1,2,5,2,20,27,6,1,4,11
163256.0,Becheva Elena,OH,Bulgaria,25.0,185,2023,Netherlands,2023-06-18,False,0,1,6,7,0,0,4,4,6,9,11,26,0,2,0,2,3,1,16,20,2,1,0,3
163256.0,Becheva Elena,OH,Bulgaria,25.0,185,2023,USA,2023-06-29,False,1,1,5,7,0,0,4,4,5,7,9,21,0,0,0,0,3,3,19,25,11,2,0,13
163256.0,Becheva Elena,OH,Bulgaria,25.0,185,2023,Poland,2023-06-30,False,2,0,8,10,0,0,1,1,7,11,15,33,1,3,0,4,2,2,27,31,6,0,0,6
163256.0,Becheva Elena,OH,Bulgaria,25.0,185,2023,Serbia,2023-07-02,False,1,0,8,9,0,1,1,2,6,4,14,24,0,1,1,2,4,2,28,34,10,3,1,14
142337.0,Todorova Mira,MB,Bulgaria,29.0,187,2023,Croatia,2023-05-31,True,1,0,8,9,0,0,1,1,2,0,6,8,6,3,2,11,0,0,0,0,4,0,0,4
142337.0,Todorova Mira,MB,Bulgaria,29.0,187,2023,Dominican Republic,2023-06-01,False,3,1,14,18,0,0,2,2,3,1,7,11,1,2,0,3,0,0,0,0,4,0,0,4
142337.0,Todorova Mira,MB,Bulgaria,29.0,187,2023,Japan,2023-06-03,False,0,1,6,7,0,0,0,0,5,4,2,11,2,2,1,5,1,0,1,2,3,0,1,4
142337.0,Todorova Mira,MB,Bulgaria,29.0,187,2023,Germany,2023-06-04,False,0,2,11,13,0,0,2,2,6,4,6,16,4,2,5,11,0,0,1,1,5,0,0,5
142337.0,Todorova Mira,MB,Bulgaria,29.0,187,2023,Italy,2023-06-14,False,0,1,6,7,0,0,1,1,6,1,3,10,1,5,1,7,0,0,0,0,0,0,0,0
142337.0,Todorova Mira,MB,Bulgaria,29.0,187,2023,Canada,2023-06-15,False,0,0,3,3,0,0,0,0,2,1,3,6,2,1,3,6,1,0,0,1,0,0,0,0
142337.0,Todorova Mira,MB,Bulgaria,29.0,187,2023,China,2023-06-16,False,0,0,7,7,0,0,0,0,7,2,4,13,2,3,4,9,0,0,0,0,2,2,0,4
142337.0,Todorova Mira,MB,Bulgaria,29.0,187,2023,Netherlands,2023-06-18,False,0,3,5,8,0,0,1,1,7,3,5,15,5,2,5,12,0,0,0,0,3,2,1,6
142337.0,Todorova Mira,MB,Bulgaria,29.0,187,2023,USA,2023-06-29,False,0,1,5,6,0,0,1,1,3,4,3,10,3,2,1,6,0,0,0,0,3,0,0,3
142337.0,Todorova Mira,MB,Bulgaria,29.0,187,2023,Poland,2023-06-30,False,0,1,11,12,0,0,0,0,7,1,5,13,1,6,3,10,0,0,2,2,3,2,0,5
142337.0,Todorova Mira,MB,Bulgaria,29.0,187,2023,Serbia,2023-07-02,False,3,1,12,16,0,0,0,0,3,3,7,13,5,3,5,13,0,0,1,1,4,2,0,6
164660.0,Krivoshiyska Mariya,MB,Bulgaria,22.0,186,2023,Croatia,2023-05-31,True,2,2,13,17,0,0,0,0,0,0,1,1,1,2,2,5,0,0,0,0,2,0,1,3
164660.0,Krivoshiyska Mariya,MB,Bulgaria,22.0,186,2023,Dominican Republic,2023-06-01,False,0,1,5,6,0,0,2,2,1,0,2,3,1,4,4,9,0,0,0,0,0,0,1,1
164660.0,Krivoshiyska Mariya,MB,Bulgaria,22.0,186,2023,Japan,2023-06-03,False,0,0,4,4,0,0,4,4,2,0,3,5,0,0,3,3,0,0,0,0,1,0,0,1
164660.0,Krivoshiyska Mariya,MB,Bulgaria,22.0,186,2023,Germany,2023-06-04,False,0,0,0,0,0,0,0,0,0,0,0,0,0,0,0,0,0,0,0,0,0,0,0,0
164660.0,Krivoshiyska Mariya,MB,Bulgaria,22.0,186,2023,Italy,2023-06-14,False,0,0,0,0,0,0,0,0,0,0,0,0,0,0,0,0,0,0,0,0,0,0,0,0
164660.0,Krivoshiyska Mariya,MB,Bulgaria,22.0,186,2023,Canada,2023-06-15,False,0,0,2,2,0,1,3,4,0,1,3,4,0,1,3,4,0,0,0,0,1,2,1,4
164660.0,Krivoshiyska Mariya,MB,Bulgaria,22.0,186,2023,China,2023-06-16,False,0,0,0,0,0,0,0,0,0,0,0,0,0,0,0,0,0,0,0,0,0,0,0,0
164660.0,Krivoshiyska Mariya,MB,Bulgaria,22.0,186,2023,Netherlands,2023-06-18,False,0,0,0,0,0,0,1,1,0,0,0,0,0,0,0,0,0,0,1,1,0,0,0,0
164660.0,Krivoshiyska Mariya,MB,Bulgaria,22.0,186,2023,USA,2023-06-29,False,0,0,8,8,0,0,1,1,0,0,0,0,0,1,1,2,0,0,0,0,1,0,0,1
164660.0,Krivoshiyska Mariya,MB,Bulgaria,22.0,186,2023,Poland,2023-06-30,False,0,1,4,5,0,0,1,1,0,0,4,4,1,4,2,7,0,0,0,0,0,2,0,2
164660.0,Krivoshiyska Mariya,MB,Bulgaria,22.0,186,2023,Serbia,2023-07-02,False,1,0,9,10,1,0,1,2,3,0,3,6,1,1,3,5,1,0,1,2,2,0,0,2
174478.0,Pashkuleva Mila,L,Bulgaria,20.0,175,2023,Croatia,2023-05-31,True,0,0,0,0,0,0,10,10,0,0,0,0,0,0,0,0,3,1,9,13,14,0,4,18
174478.0,Pashkuleva Mila,L,Bulgaria,20.0,175,2023,Dominican Republic,2023-06-01,False,0,0,0,0,0,0,9,9,0,0,0,0,0,0,0,0,5,1,9,15,20,2,3,25
174478.0,Pashkuleva Mila,L,Bulgaria,20.0,175,2023,Japan,2023-06-03,False,0,0,0,0,0,0,2,2,0,0,0,0,0,0,0,0,3,0,8,11,9,0,0,9
174478.0,Pashkuleva Mila,L,Bulgaria,20.0,175,2023,Germany,2023-06-04,False,0,0,0,0,0,0,15,15,0,0,0,0,0,0,0,0,7,1,23,31,25,1,5,31
174478.0,Pashkuleva Mila,L,Bulgaria,20.0,175,2023,Italy,2023-06-14,False,0,0,0,0,0,0,5,5,0,0,0,0,0,0,0,0,0,0,5,5,14,3,1,18
174478.0,Pashkuleva Mila,L,Bulgaria,20.0,175,2023,Canada,2023-06-15,False,0,0,0,0,0,0,5,5,0,0,0,0,0,0,0,0,1,1,14,16,9,2,0,11
174478.0,Pashkuleva Mila,L,Bulgaria,20.0,175,2023,China,2023-06-16,False,0,0,0,0,0,0,8,8,0,0,0,0,0,0,0,0,2,2,8,12,7,4,1,12
174478.0,Pashkuleva Mila,L,Bulgaria,20.0,175,2023,Netherlands,2023-06-18,False,0,0,0,0,0,0,6,6,0,0,0,0,0,0,0,0,1,0,12,13,15,4,2,21
174478.0,Pashkuleva Mila,L,Bulgaria,20.0,175,2023,USA,2023-06-29,False,0,0,0,0,0,0,7,7,0,0,0,0,0,0,0,0,6,4,20,30,12,4,0,16
174478.0,Pashkuleva Mila,L,Bulgaria,20.0,175,2023,Poland,2023-06-30,False,0,0,0,0,0,1,10,11,0,0,0,0,0,0,0,0,0,1,12,13,14,9,0,23
174478.0,Pashkuleva Mila,L,Bulgaria,20.0,175,2023,Serbia,2023-07-02,False,0,0,0,0,0,0,10,10,0,0,0,0,0,0,0,0,7,5,27,39,14,7,0,21
163261.0,Saykova Borislava,MB,Bulgaria,23.0,187,2023,Croatia,2023-05-31,True,0,0,0,0,0,0,0,0,0,0,0,0,0,0,0,0,0,0,0,0,0,0,0,0
163261.0,Saykova Borislava,MB,Bulgaria,23.0,187,2023,Dominican Republic,2023-06-01,False,1,0,12,13,0,0,1,1,2,0,1,3,1,1,0,2,0,0,1,1,2,0,0,2
163261.0,Saykova Borislava,MB,Bulgaria,23.0,187,2023,Japan,2023-06-03,False,2,1,5,8,0,0,0,0,1,0,5,6,0,2,2,4,0,0,0,0,0,0,0,0
163261.0,Saykova Borislava,MB,Bulgaria,23.0,187,2023,Germany,2023-06-04,False,1,5,15,21,0,0,2,2,1,0,3,4,1,1,3,5,0,0,0,0,3,1,0,4
163261.0,Saykova Borislava,MB,Bulgaria,23.0,187,2023,Italy,2023-06-14,False,1,1,6,8,0,0,0,0,2,2,1,5,0,2,5,7,0,0,0,0,2,0,0,2
163261.0,Saykova Borislava,MB,Bulgaria,23.0,187,2023,Canada,2023-06-15,False,2,1,7,10,0,0,2,2,0,0,2,2,0,2,8,10,0,0,2,2,4,0,1,5
163261.0,Saykova Borislava,MB,Bulgaria,23.0,187,2023,China,2023-06-16,False,0,3,9,12,0,0,0,0,4,0,0,4,2,3,4,9,0,0,0,0,1,1,2,4
163261.0,Saykova Borislava,MB,Bulgaria,23.0,187,2023,Netherlands,2023-06-18,False,0,4,7,11,0,0,1,1,1,0,5,6,0,2,6,8,0,0,0,0,0,0,0,0
163261.0,Saykova Borislava,MB,Bulgaria,23.0,187,2023,USA,2023-06-29,False,0,1,2,3,0,0,0,0,2,1,1,4,0,0,0,0,0,0,0,0,1,0,0,1
163261.0,Saykova Borislava,MB,Bulgaria,23.0,187,2023,Poland,2023-06-30,False,0,2,5,7,0,0,1,1,0,0,2,2,3,4,4,11,0,0,0,0,0,0,0,0
163261.0,Saykova Borislava,MB,Bulgaria,23.0,187,2023,Serbia,2023-07-02,False,0,0,2,2,0,0,1,1,1,0,1,2,2,3,2,7,0,0,0,0,1,0,0,1
163141.0,Marinova Radostina,O,Bulgaria,25.0,186,2023,Croatia,2023-05-31,True,1,2,7,10,0,0,3,3,11,4,19,34,0,1,0,1,0,0,0,0,6,0,0,6
163141.0,Marinova Radostina,O,Bulgaria,25.0,186,2023,Dominican Republic,2023-06-01,False,1,0,13,14,0,0,2,2,11,7,25,43,1,2,3,6,0,0,0,0,5,1,2,8
163141.0,Marinova Radostina,O,Bulgaria,25.0,186,2023,Japan,2023-06-03,False,0,0,2,2,0,1,0,1,3,1,1,5,0,0,1,1,0,0,0,0,3,0,0,3
163141.0,Marinova Radostina,O,Bulgaria,25.0,186,2023,Germany,2023-06-04,False,1,0,18,19,0,0,0,0,13,7,22,42,1,1,2,4,0,0,0,0,9,0,1,10
163141.0,Marinova Radostina,O,Bulgaria,25.0,186,2023,Italy,2023-06-14,False,1,2,7,10,0,0,0,0,10,2,8,20,0,0,1,1,0,0,0,0,5,2,0,7
163141.0,Marinova Radostina,O,Bulgaria,25.0,186,2023,Canada,2023-06-15,False,0,0,2,2,0,0,2,2,2,3,3,8,0,0,0,0,0,0,0,0,2,1,0,3
163141.0,Marinova Radostina,O,Bulgaria,25.0,186,2023,China,2023-06-16,False,0,0,4,4,0,0,0,0,9,1,7,17,1,4,1,6,0,0,0,0,2,1,0,3
163141.0,Marinova Radostina,O,Bulgaria,25.0,186,2023,Netherlands,2023-06-18,False,0,0,0,0,0,0,0,0,0,0,0,0,0,0,0,0,0,0,0,0,0,0,0,0
163141.0,Marinova Radostina,O,Bulgaria,25.0,186,2023,USA,2023-06-29,False,0,1,6,7,0,0,1,1,3,2,13,18,0,0,1,1,0,0,0,0,3,1,0,4
163141.0,Marinova Radostina,O,Bulgaria,25.0,186,2023,Poland,2023-06-30,False,1,1,8,10,0,1,3,4,17,4,27,48,1,2,2,5,0,0,1,1,8,2,0,10
163141.0,Marinova Radostina,O,Bulgaria,25.0,186,2023,Serbia,2023-07-02,False,0,0,15,15,0,0,3,3,18,6,24,48,0,3,4,7,0,0,0,0,8,1,1,10
163144.0,Krasteva Monika,OH,Bulgaria,24.0,183,2023,Croatia,2023-05-31,True,0,0,0,0,0,0,0,0,0,0,0,0,0,0,0,0,0,0,0,0,0,0,0,0
163144.0,Krasteva Monika,OH,Bulgaria,24.0,183,2023,Dominican Republic,2023-06-01,False,0,0,0,0,0,0,0,0,0,0,1,1,0,0,1,1,0,0,3,3,2,0,0,2
163144.0,Krasteva Monika,OH,Bulgaria,24.0,183,2023,Japan,2023-06-03,False,0,0,0,0,0,0,0,0,0,0,0,0,0,0,0,0,0,0,0,0,0,0,0,0
163144.0,Krasteva Monika,OH,Bulgaria,24.0,183,2023,Germany,2023-06-04,False,0,0,0,0,0,0,0,0,0,0,1,1,0,0,0,0,0,0,2,2,2,0,0,2
163144.0,Krasteva Monika,OH,Bulgaria,24.0,183,2023,Italy,2023-06-14,False,0,0,0,0,0,0,0,0,0,0,0,0,0,0,0,0,0,0,0,0,0,0,0,0
163144.0,Krasteva Monika,OH,Bulgaria,24.0,183,2023,Canada,2023-06-15,False,0,0,0,0,0,0,0,0,0,0,0,0,0,0,0,0,0,0,0,0,0,0,0,0
163144.0,Krasteva Monika,OH,Bulgaria,24.0,183,2023,China,2023-06-16,False,0,0,1,1,0,0,0,0,2,0,0,2,0,0,0,0,0,1,2,3,0,0,1,1
163144.0,Krasteva Monika,OH,Bulgaria,24.0,183,2023,Netherlands,2023-06-18,False,0,0,0,0,0,0,0,0,0,0,0,0,0,0,0,0,0,0,0,0,0,0,0,0
163144.0,Krasteva Monika,OH,Bulgaria,24.0,183,2023,USA,2023-06-29,False,0,0,0,0,0,0,1,1,0,0,0,0,0,0,0,0,0,0,0,0,0,1,0,1
163144.0,Krasteva Monika,OH,Bulgaria,24.0,183,2023,Poland,2023-06-30,False,0,0,0,0,0,0,0,0,0,0,0,0,0,0,0,0,0,0,0,0,0,0,0,0
163144.0,Krasteva Monika,OH,Bulgaria,24.0,183,2023,Serbia,2023-07-02,False,0,0,0,0,0,0,1,1,0,1,1,2,0,0,0,0,0,0,0,0,0,0,0,0
174467.0,Karabasheva Galina,L,Bulgaria,21.0,166,2023,Croatia,2023-05-31,True,0,0,0,0,0,0,0,0,0,0,0,0,0,0,0,0,0,0,0,0,0,0,0,0
174467.0,Karabasheva Galina,L,Bulgaria,21.0,166,2023,Dominican Republic,2023-06-01,False,0,0,0,0,0,0,1,1,0,0,0,0,0,0,0,0,0,0,0,0,0,0,0,0
174467.0,Karabasheva Galina,L,Bulgaria,21.0,166,2023,Japan,2023-06-03,False,0,0,0,0,0,0,0,0,0,0,0,0,0,0,0,0,2,0,6,8,4,0,1,5
174467.0,Karabasheva Galina,L,Bulgaria,21.0,166,2023,Germany,2023-06-04,False,0,0,0,0,0,0,0,0,0,0,0,0,0,0,0,0,0,0,0,0,0,0,0,0
174467.0,Karabasheva Galina,L,Bulgaria,21.0,166,2023,Italy,2023-06-14,False,0,0,0,0,0,0,0,0,0,0,0,0,0,0,0,0,0,0,0,0,0,0,0,0
174467.0,Karabasheva Galina,L,Bulgaria,21.0,166,2023,Canada,2023-06-15,False,0,0,0,0,0,0,0,0,0,0,0,0,0,0,0,0,1,0,1,2,2,0,0,2
174467.0,Karabasheva Galina,L,Bulgaria,21.0,166,2023,China,2023-06-16,False,0,0,0,0,0,0,0,0,0,0,0,0,0,0,0,0,0,0,0,0,0,0,0,0
174467.0,Karabasheva Galina,L,Bulgaria,21.0,166,2023,Netherlands,2023-06-18,False,0,0,0,0,0,0,0,0,0,0,0,0,0,0,0,0,0,0,2,2,0,0,0,0
174467.0,Karabasheva Galina,L,Bulgaria,21.0,166,2023,USA,2023-06-29,False,0,0,0,0,0,0,0,0,0,0,0,0,0,0,0,0,0,0,0,0,0,0,0,0
174467.0,Karabasheva Galina,L,Bulgaria,21.0,166,2023,Poland,2023-06-30,False,0,0,0,0,0,0,1,1,0,0,0,0,0,0,0,0,0,2,3,5,2,0,1,3
174467.0,Karabasheva Galina,L,Bulgaria,21.0,166,2023,Serbia,2023-07-02,False,0,0,0,0,0,0,1,1,0,0,0,0,0,0,0,0,0,1,2,3,1,0,1,2
174472.0,Nikolova Merelin,O,Bulgaria,20.0,180,2023,Croatia,2023-05-31,True,0,0,0,0,0,0,0,0,0,0,0,0,0,0,0,0,0,0,0,0,0,0,0,0
174472.0,Nikolova Merelin,O,Bulgaria,20.0,180,2023,Dominican Republic,2023-06-01,False,1,0,2,3,0,0,0,0,3,1,1,5,0,0,0,0,0,0,0,0,1,0,0,1
174472.0,Nikolova Merelin,O,Bulgaria,20.0,180,2023,Japan,2023-06-03,False,0,1,7,8,0,0,1,1,7,7,9,23,0,3,2,5,0,0,1,1,5,1,0,6
174472.0,Nikolova Merelin,O,Bulgaria,20.0,180,2023,Germany,2023-06-04,False,0,0,1,1,0,0,0,0,3,0,0,3,0,0,0,0,0,0,0,0,0,0,0,0
174472.0,Nikolova Merelin,O,Bulgaria,20.0,180,2023,Italy,2023-06-14,False,0,0,3,3,0,0,0,0,1,2,4,7,1,0,0,1,0,0,0,0,2,0,0,2
174472.0,Nikolova Merelin,O,Bulgaria,20.0,180,2023,Canada,2023-06-15,False,1,2,2,5,0,0,3,3,1,4,5,10,0,1,0,1,0,0,0,0,2,0,0,2
174472.0,Nikolova Merelin,O,Bulgaria,20.0,180,2023,China,2023-06-16,False,0,0,5,5,0,0,0,0,2,1,6,9,0,1,0,1,0,1,0,1,3,0,0,3
174472.0,Nikolova Merelin,O,Bulgaria,20.0,180,2023,Netherlands,2023-06-18,False,3,4,7,14,0,0,2,2,14,8,10,32,0,2,0,2,0,0,0,0,5,0,1,6
174472.0,Nikolova Merelin,O,Bulgaria,20.0,180,2023,USA,2023-06-29,False,0,0,1,1,0,0,0,0,0,1,0,1,0,0,0,0,0,0,0,0,0,0,0,0
174472.0,Nikolova Merelin,O,Bulgaria,20.0,180,2023,Poland,2023-06-30,False,0,0,2,2,0,0,0,0,0,2,0,2,0,0,0,0,0,0,0,0,0,1,0,1
174472.0,Nikolova Merelin,O,Bulgaria,20.0,180,2023,Serbia,2023-07-02,False,0,0,0,0,0,0,0,0,0,1,0,1,0,0,0,0,0,0,0,0,0,0,0,0
168355.0,Van Ryk Kiera,OH,Canada,25.0,188,2023,China,2023-06-13,False,0,7,4,11,0,1,2,3,10,10,10,30,0,2,2,4,0,0,0,0,6,6,1,13
168355.0,Van Ryk Kiera,OH,Canada,25.0,188,2023,Bulgaria,2023-06-15,True,1,2,5,8,0,0,1,1,12,1,6,19,2,3,9,14,0,0,0,0,5,2,2,9
168355.0,Van Ryk Kiera,OH,Canada,25.0,188,2023,Dominican Republic,2023-06-17,False,0,3,7,10,0,0,4,4,9,8,12,29,1,2,5,8,0,0,0,0,5,0,0,5
168355.0,Van Ryk Kiera,OH,Canada,25.0,188,2023,Croatia,2023-06-27,True,1,1,8,10,0,0,3,3,9,5,14,28,1,6,0,7,0,0,0,0,8,5,0,13
168355.0,Van Ryk Kiera,OH,Canada,25.0,188,2023,Brazil,2023-06-29,True,1,2,16,19,0,0,1,1,15,7,11,33,3,1,7,11,0,0,0,0,15,1,3,19
168355.0,Van Ryk Kiera,OH,Canada,25.0,188,2023,Italy,2023-06-30,False,2,5,5,12,0,0,4,4,12,7,13,32,1,3,2,6,0,0,0,0,5,4,3,12
168355.0,Van Ryk Kiera,OH,Canada,25.0,188,2023,Netherlands,2023-07-01,True,2,3,12,17,0,0,4,4,8,7,8,23,3,4,4,11,0,0,0,0,10,4,2,16
175158.0,Murmann Julia,L,Canada,21.0,181,2023,Poland,2023-05-30,False,0,0,0,0,0,0,20,20,0,0,0,0,0,0,0,0,0,1,16,17,23,4,2,29
175158.0,Murmann Julia,L,Canada,21.0,181,2023,Thailand,2023-06-01,False,0,0,0,0,1,0,9,10,0,0,0,0,0,0,0,0,2,1,7,10,9,7,2,18
175158.0,Murmann Julia,L,Canada,21.0,181,2023,Serbia,2023-06-04,True,0,0,0,0,0,0,0,0,0,0,0,0,0,0,0,0,0,0,0,0,0,0,0,0
175158.0,Murmann Julia,L,Canada,21.0,181,2023,China,2023-06-13,False,0,0,0,0,0,0,10,10,0,0,0,0,0,0,0,0,0,0,8,8,8,3,1,12
175158.0,Murmann Julia,L,Canada,21.0,181,2023,Bulgaria,2023-06-15,True,0,0,0,0,0,0,6,6,0,0,0,0,0,0,0,0,1,1,6,8,6,2,0,8
175158.0,Murmann Julia,L,Canada,21.0,181,2023,Dominican Republic,2023-06-17,False,0,0,0,0,0,0,15,15,0,0,0,0,0,0,0,0,4,1,26,31,12,2,0,14
175158.0,Murmann Julia,L,Canada,21.0,181,2023,Croatia,2023-06-27,True,0,0,0,0,0,0,12,12,0,0,0,0,0,0,0,0,1,0,15,16,7,2,2,11
175158.0,Murmann Julia,L,Canada,21.0,181,2023,Brazil,2023-06-29,True,0,0,0,0,0,0,0,0,0,0,0,0,0,0,0,0,0,0,0,0,0,0,0,0
175158.0,Murmann Julia,L,Canada,21.0,181,2023,Italy,2023-06-30,False,0,0,0,0,0,0,0,0,0,0,0,0,0,0,0,0,0,0,0,0,0,0,0,0
175158.0,Murmann Julia,L,Canada,21.0,181,2023,Netherlands,2023-07-01,True,0,0,0,0,0,0,0,0,0,0,0,0,0,0,0,0,0,0,0,0,0,0,0,0
153629.0,White Jazmine Ruth,MB,Canada,30.0,186,2023,Poland,2023-05-30,False,0,0,10,10,0,0,2,2,0,3,4,7,1,1,5,7,0,0,0,0,1,0,0,1
153629.0,White Jazmine Ruth,MB,Canada,30.0,186,2023,Thailand,2023-06-01,False,0,0,0,0,0,0,0,0,0,0,0,0,0,0,0,0,0,0,0,0,0,0,0,0
153629.0,White Jazmine Ruth,MB,Canada,30.0,186,2023,Serbia,2023-06-04,True,0,1,13,14,0,0,3,3,8,0,6,14,1,5,4,10,0,0,2,2,2,1,0,3
153629.0,White Jazmine Ruth,MB,Canada,30.0,186,2023,China,2023-06-13,False,0,0,0,0,0,0,0,0,0,0,0,0,0,0,0,0,0,0,0,0,0,0,0,0
153629.0,White Jazmine Ruth,MB,Canada,30.0,186,2023,Bulgaria,2023-06-15,True,0,2,6,8,0,0,1,1,3,1,2,6,3,3,5,11,0,0,0,0,0,0,0,0
153629.0,White Jazmine Ruth,MB,Canada,30.0,186,2023,Dominican Republic,2023-06-17,False,1,1,1,3,0,0,2,2,1,1,4,6,1,1,2,4,0,0,0,0,2,0,0,2
153629.0,White Jazmine Ruth,MB,Canada,30.0,186,2023,Croatia,2023-06-27,True,1,1,12,14,0,1,3,4,5,2,5,12,4,5,6,15,0,0,0,0,7,1,0,8
153629.0,White Jazmine Ruth,MB,Canada,30.0,186,2023,Brazil,2023-06-29,True,1,2,19,22,0,0,2,2,7,3,3,13,4,6,3,13,0,0,1,1,1,0,0,1
153629.0,White Jazmine Ruth,MB,Canada,30.0,186,2023,Italy,2023-06-30,False,0,0,10,10,0,0,2,2,3,0,8,11,1,4,5,10,0,0,0,0,1,3,1,5
153629.0,White Jazmine Ruth,MB,Canada,30.0,186,2023,Netherlands,2023-07-01,True,0,2,13,15,0,0,4,4,5,2,7,14,6,2,4,12,0,0,1,1,2,2,0,4
163360.0,Van Buskirk Layne,MB,Canada,26.0,191,2023,Poland,2023-05-30,False,0,1,3,4,0,0,1,1,2,0,1,3,1,4,3,8,0,0,0,0,0,0,0,0
163360.0,Van Buskirk Layne,MB,Canada,26.0,191,2023,Thailand,2023-06-01,False,0,1,7,8,1,0,1,2,6,4,5,15,4,4,3,11,0,0,0,0,1,1,0,2
163360.0,Van Buskirk Layne,MB,Canada,26.0,191,2023,Serbia,2023-06-04,True,0,1,0,1,0,0,0,0,0,2,1,3,1,1,2,4,0,0,0,0,0,0,0,0
163360.0,Van Buskirk Layne,MB,Canada,26.0,191,2023,China,2023-06-13,False,0,1,3,4,0,0,0,0,3,0,2,5,0,1,1,2,0,0,0,0,0,0,0,0
163360.0,Van Buskirk Layne,MB,Canada,26.0,191,2023,Bulgaria,2023-06-15,True,0,1,1,2,0,0,0,0,0,0,0,0,0,0,1,1,0,0,0,0,0,0,0,0
163360.0,Van Buskirk Layne,MB,Canada,26.0,191,2023,Dominican Republic,2023-06-17,False,0,1,1,2,0,0,0,0,1,3,1,5,0,2,3,5,0,0,0,0,0,0,0,0
163360.0,Van Buskirk Layne,MB,Canada,26.0,191,2023,Croatia,2023-06-27,True,0,0,0,0,0,0,0,0,0,0,0,0,0,0,0,0,0,0,0,0,0,0,0,0
163360.0,Van Buskirk Layne,MB,Canada,26.0,191,2023,Brazil,2023-06-29,True,0,0,0,0,0,0,0,0,0,0,0,0,0,0,0,0,0,0,0,0,0,0,0,0
163360.0,Van Buskirk Layne,MB,Canada,26.0,191,2023,Italy,2023-06-30,False,0,1,5,6,0,0,0,0,2,0,1,3,1,1,1,3,0,0,1,1,2,0,0,2
163360.0,Van Buskirk Layne,MB,Canada,26.0,191,2023,Netherlands,2023-07-01,True,0,0,0,0,0,0,0,0,0,0,0,0,0,0,0,0,0,0,0,0,0,0,0,0
142777.0,Ogoms Alicia,MB,Canada,29.0,194,2023,China,2023-06-13,False,0,0,5,5,0,1,3,4,0,0,0,0,0,0,1,1,1,0,0,1,2,0,0,2
142777.0,Ogoms Alicia,MB,Canada,29.0,194,2023,Bulgaria,2023-06-15,True,0,0,0,0,0,0,0,0,0,0,0,0,0,0,0,0,0,0,0,0,0,0,0,0
142777.0,Ogoms Alicia,MB,Canada,29.0,194,2023,Dominican Republic,2023-06-17,False,0,1,11,12,0,0,2,2,0,1,0,1,1,2,3,6,0,0,0,0,3,2,0,5
142777.0,Ogoms Alicia,MB,Canada,29.0,194,2023,Croatia,2023-06-27,True,0,0,1,1,0,0,1,1,0,0,1,1,1,3,0,4,0,0,0,0,0,0,0,0
142777.0,Ogoms Alicia,MB,Canada,29.0,194,2023,Brazil,2023-06-29,True,0,0,0,0,0,0,0,0,0,0,0,0,0,0,0,0,0,0,0,0,0,0,0,0
142777.0,Ogoms Alicia,MB,Canada,29.0,194,2023,Italy,2023-06-30,False,0,0,1,1,0,0,0,0,0,0,0,0,0,0,0,0,0,0,0,0,0,0,0,0
142777.0,Ogoms Alicia,MB,Canada,29.0,194,2023,Netherlands,2023-07-01,True,0,0,0,0,0,0,0,0,0,0,0,0,0,0,0,0,0,0,0,0,0,0,0,0
132236.0,Gray Alexa,OH,Canada,29.0,185,2023,Poland,2023-05-30,False,0,3,24,27,0,0,2,2,36,6,29,71,1,4,6,11,8,2,34,44,12,3,3,18
132236.0,Gray Alexa,OH,Canada,29.0,185,2023,Thailand,2023-06-01,False,1,1,12,14,0,0,0,0,8,2,25,35,1,1,7,9,5,4,37,46,8,6,0,14
132236.0,Gray Alexa,OH,Canada,29.0,185,2023,Serbia,2023-06-04,True,2,2,13,17,0,0,4,4,20,6,39,65,1,3,1,5,9,2,47,58,11,4,0,15
132236.0,Gray Alexa,OH,Canada,29.0,185,2023,China,2023-06-13,False,0,0,8,8,0,0,3,3,12,6,9,27,1,1,0,2,0,3,26,29,6,5,4,15
132236.0,Gray Alexa,OH,Canada,29.0,185,2023,Bulgaria,2023-06-15,True,2,0,20,22,0,0,2,2,9,2,8,19,0,2,1,3,0,0,25,25,6,1,3,10
132236.0,Gray Alexa,OH,Canada,29.0,185,2023,Dominican Republic,2023-06-17,False,1,3,14,18,0,1,2,3,19,7,25,51,1,4,5,10,7,0,48,55,14,2,0,16
132236.0,Gray Alexa,OH,Canada,29.0,185,2023,Croatia,2023-06-27,True,0,0,10,10,0,0,2,2,17,2,26,45,3,2,3,8,3,0,16,19,10,0,2,12
132236.0,Gray Alexa,OH,Canada,29.0,185,2023,Brazil,2023-06-29,True,1,2,15,18,0,0,6,6,22,8,27,57,2,0,1,3,16,1,54,71,6,2,1,9
132236.0,Gray Alexa,OH,Canada,29.0,185,2023,Italy,2023-06-30,False,1,3,9,13,0,0,4,4,16,8,19,43,1,1,5,7,9,2,37,48,10,2,0,12
132236.0,Gray Alexa,OH,Canada,29.0,185,2023,Netherlands,2023-07-01,True,1,1,15,17,0,0,6,6,23,11,17,51,1,2,2,5,6,0,18,24,10,3,1,14
173581.0,Mitrovic Andrea,OH,Canada,24.0,187,2023,Poland,2023-05-30,False,0,0,7,7,0,0,1,1,5,4,5,14,0,2,2,4,2,0,10,12,9,0,2,11
173581.0,Mitrovic Andrea,OH,Canada,24.0,187,2023,Thailand,2023-06-01,False,0,2,4,6,1,0,5,6,8,2,9,19,0,2,1,3,2,1,6,9,11,2,1,14
173581.0,Mitrovic Andrea,OH,Canada,24.0,187,2023,Serbia,2023-06-04,True,0,0,2,2,0,0,0,0,2,0,5,7,0,1,1,2,1,0,0,1,2,2,0,4
173581.0,Mitrovic Andrea,OH,Canada,24.0,187,2023,China,2023-06-13,False,0,1,0,1,0,0,0,0,0,0,0,0,0,1,0,1,0,0,0,0,1,0,0,1
173581.0,Mitrovic Andrea,OH,Canada,24.0,187,2023,Bulgaria,2023-06-15,True,0,0,1,1,0,0,0,0,0,0,1,1,0,0,0,0,0,0,0,0,1,0,1,2
173581.0,Mitrovic Andrea,OH,Canada,24.0,187,2023,Dominican Republic,2023-06-17,False,0,1,0,1,0,0,0,0,2,2,2,6,0,1,2,3,0,0,1,1,1,0,0,1
173581.0,Mitrovic Andrea,OH,Canada,24.0,187,2023,Croatia,2023-06-27,True,2,0,12,14,0,0,1,1,2,4,8,14,0,0,1,1,1,0,14,15,6,1,1,8
173581.0,Mitrovic Andrea,OH,Canada,24.0,187,2023,Brazil,2023-06-29,True,0,0,12,12,0,1,1,2,8,1,15,24,0,1,2,3,3,0,6,9,11,0,1,12
173581.0,Mitrovic Andrea,OH,Canada,24.0,187,2023,Italy,2023-06-30,False,0,0,13,13,0,0,0,0,8,4,9,21,0,0,2,2,2,0,8,10,7,3,1,11
173581.0,Mitrovic Andrea,OH,Canada,24.0,187,2023,Netherlands,2023-07-01,True,1,0,4,5,0,0,0,0,1,2,7,10,1,0,0,1,1,0,9,10,2,1,0,3
173585.0,King Brie,S,Canada,26.0,183,2023,Poland,2023-05-30,False,2,1,18,21,22,1,94,117,3,0,3,6,2,7,3,12,0,0,0,0,10,5,1,16
173585.0,King Brie,S,Canada,26.0,183,2023,Thailand,2023-06-01,False,0,0,12,12,29,3,60,92,0,0,0,0,1,1,4,6,0,0,0,0,10,6,2,18
173585.0,King Brie,S,Canada,26.0,183,2023,Serbia,2023-06-04,True,1,1,22,24,14,3,126,143,4,1,2,7,1,6,3,10,0,0,0,0,11,2,0,13
173585.0,King Brie,S,Canada,26.0,183,2023,China,2023-06-13,False,2,0,7,9,23,1,55,79,0,0,3,3,1,0,2,3,0,1,0,1,10,5,0,15
173585.0,King Brie,S,Canada,26.0,183,2023,Bulgaria,2023-06-15,True,0,0,13,13,14,0,33,47,0,0,1,1,3,1,1,5,0,1,0,1,11,2,2,15
173585.0,King Brie,S,Canada,26.0,183,2023,Dominican Republic,2023-06-17,False,1,0,12,13,43,0,87,130,2,1,3,6,0,4,2,6,0,0,0,0,15,7,2,24
173585.0,King Brie,S,Canada,26.0,183,2023,Croatia,2023-06-27,True,0,1,11,12,22,1,74,97,3,0,3,6,0,2,4,6,0,0,0,0,10,1,2,13
173585.0,King Brie,S,Canada,26.0,183,2023,Brazil,2023-06-29,True,0,1,20,21,29,1,115,145,2,0,1,3,1,2,7,10,0,0,1,1,9,5,3,17
173585.0,King Brie,S,Canada,26.0,183,2023,Italy,2023-06-30,False,0,0,17,17,23,2,96,121,1,1,0,2,1,2,2,5,0,0,0,0,7,3,1,11
173585.0,King Brie,S,Canada,26.0,183,2023,Netherlands,2023-07-01,True,0,0,17,17,20,1,95,116,1,1,0,2,0,3,4,7,0,1,0,1,10,1,1,12
174676.0,Howe Hilary,OH,Canada,25.0,185,2023,Poland,2023-05-30,False,0,2,13,15,0,0,4,4,13,9,21,43,2,2,6,10,1,0,11,12,5,3,2,10
174676.0,Howe Hilary,OH,Canada,25.0,185,2023,Thailand,2023-06-01,False,0,0,3,3,0,0,1,1,7,2,9,18,1,2,2,5,0,0,1,1,7,4,1,12
174676.0,Howe Hilary,OH,Canada,25.0,185,2023,Serbia,2023-06-04,True,0,2,11,13,0,0,2,2,18,6,26,50,6,5,0,11,2,2,21,25,12,5,2,19
174676.0,Howe Hilary,OH,Canada,25.0,185,2023,China,2023-06-13,False,0,1,11,12,0,0,2,2,11,2,11,24,1,2,1,4,2,1,27,30,4,3,4,11
174676.0,Howe Hilary,OH,Canada,25.0,185,2023,Bulgaria,2023-06-15,True,1,1,6,8,0,0,0,0,9,0,9,18,3,0,3,6,0,0,1,1,3,1,0,4
174676.0,Howe Hilary,OH,Canada,25.0,185,2023,Dominican Republic,2023-06-17,False,0,1,13,14,0,0,3,3,12,11,15,38,3,4,3,10,0,0,9,9,3,2,1,6
174676.0,Howe Hilary,OH,Canada,25.0,185,2023,Croatia,2023-06-27,True,0,0,1,1,0,0,0,0,1,2,6,9,1,0,1,2,1,2,9,12,2,0,0,2
174676.0,Howe Hilary,OH,Canada,25.0,185,2023,Brazil,2023-06-29,True,0,0,6,6,0,0,1,1,5,3,6,14,3,1,0,4,0,1,5,6,6,1,0,7
174676.0,Howe Hilary,OH,Canada,25.0,185,2023,Italy,2023-06-30,False,2,0,9,11,0,0,1,1,4,5,4,13,1,1,0,2,1,1,5,7,4,2,1,7
174676.0,Howe Hilary,OH,Canada,25.0,185,2023,Netherlands,2023-07-01,True,0,3,14,17,0,0,3,3,10,7,10,27,1,1,1,3,5,1,15,21,12,1,1,14
166581.0,Joseph Shainah,O,Canada,28.0,183,2023,Poland,2023-05-30,False,0,0,0,0,0,0,0,0,0,0,0,0,0,0,0,0,0,0,0,0,0,0,0,0
166581.0,Joseph Shainah,O,Canada,28.0,183,2023,Thailand,2023-06-01,False,0,0,0,0,0,0,0,0,0,1,2,3,0,1,1,2,0,0,0,0,0,1,0,1
166581.0,Joseph Shainah,O,Canada,28.0,183,2023,Serbia,2023-06-04,True,0,1,12,13,0,0,2,2,7,1,9,17,0,3,4,7,0,0,0,0,6,8,0,14
166581.0,Joseph Shainah,O,Canada,28.0,183,2023,China,2023-06-13,False,0,0,0,0,0,0,0,0,0,0,0,0,0,0,0,0,0,0,0,0,0,0,0,0
166581.0,Joseph Shainah,O,Canada,28.0,183,2023,Bulgaria,2023-06-15,True,0,0,0,0,0,0,0,0,1,0,1,2,0,1,1,2,0,0,0,0,0,1,0,1
166581.0,Joseph Shainah,O,Canada,28.0,183,2023,Dominican Republic,2023-06-17,False,0,0,3,3,0,0,1,1,2,3,4,9,0,0,0,0,0,0,0,0,3,1,0,4
166581.0,Joseph Shainah,O,Canada,28.0,183,2023,Croatia,2023-06-27,True,0,0,0,0,0,0,0,0,0,0,0,0,0,0,0,0,0,0,0,0,0,0,0,0
166581.0,Joseph Shainah,O,Canada,28.0,183,2023,Brazil,2023-06-29,True,0,0,0,0,0,0,0,0,0,0,0,0,0,0,0,0,0,0,0,0,0,0,0,0
166581.0,Joseph Shainah,O,Canada,28.0,183,2023,Italy,2023-06-30,False,0,0,1,1,0,0,0,0,0,0,1,1,0,0,0,0,0,0,0,0,0,0,0,0
166581.0,Joseph Shainah,O,Canada,28.0,183,2023,Netherlands,2023-07-01,True,0,0,2,2,0,0,2,2,0,0,1,1,0,1,0,1,0,0,1,1,1,0,0,1
174680.0,Livingston Caroline,OH,Canada,27.0,188,2023,Poland,2023-05-30,False,0,1,3,4,0,0,1,1,0,0,0,0,0,0,0,0,0,0,0,0,0,0,0,0
174680.0,Livingston Caroline,OH,Canada,27.0,188,2023,Thailand,2023-06-01,False,0,0,6,6,0,0,0,0,0,0,0,0,0,0,0,0,0,0,1,1,0,1,0,1
174680.0,Livingston Caroline,OH,Canada,27.0,188,2023,Serbia,2023-06-04,True,0,1,0,1,0,0,0,0,0,0,0,0,0,0,0,0,0,0,0,0,0,0,0,0
174680.0,Livingston Caroline,OH,Canada,27.0,188,2023,China,2023-06-13,False,0,0,3,3,0,0,1,1,0,0,0,0,0,0,0,0,0,0,0,0,0,1,0,1
174680.0,Livingston Caroline,OH,Canada,27.0,188,2023,Bulgaria,2023-06-15,True,0,0,2,2,0,0,0,0,0,0,0,0,0,0,0,0,0,0,0,0,0,0,0,0
174680.0,Livingston Caroline,OH,Canada,27.0,188,2023,Dominican Republic,2023-06-17,False,0,0,3,3,0,0,0,0,0,0,0,0,0,0,0,0,0,0,0,0,1,0,0,1
174680.0,Livingston Caroline,OH,Canada,27.0,188,2023,Croatia,2023-06-27,True,0,0,0,0,0,0,0,0,0,0,0,0,0,0,0,0,2,0,2,4,0,0,0,0
174680.0,Livingston Caroline,OH,Canada,27.0,188,2023,Brazil,2023-06-29,True,0,0,1,1,0,0,0,0,0,0,0,0,0,0,0,0,0,0,0,0,0,0,0,0
174680.0,Livingston Caroline,OH,Canada,27.0,188,2023,Italy,2023-06-30,False,0,0,1,1,0,0,0,0,0,0,0,0,0,0,0,0,0,0,0,0,1,0,0,1
174680.0,Livingston Caroline,OH,Canada,27.0,188,2023,Netherlands,2023-07-01,True,0,0,0,0,0,0,0,0,0,0,0,0,0,0,0,0,0,0,0,0,0,0,0,0
192389.0,Jost Kacey,L,Canada,24.0,173,2023,Poland,2023-05-30,False,0,0,0,0,0,0,0,0,0,0,0,0,0,0,0,0,0,0,0,0,0,0,0,0
192389.0,Jost Kacey,L,Canada,24.0,173,2023,Thailand,2023-06-01,False,0,0,0,0,0,0,0,0,0,0,0,0,0,0,0,0,0,0,0,0,0,0,0,0
192389.0,Jost Kacey,L,Canada,24.0,173,2023,Serbia,2023-06-04,True,0,0,0,0,0,0,19,19,0,0,0,0,0,0,0,0,4,1,15,20,12,5,1,18
192389.0,Jost Kacey,L,Canada,24.0,173,2023,Croatia,2023-06-27,True,0,0,0,0,0,0,0,0,0,0,0,0,0,0,0,0,0,0,0,0,0,0,0,0
192389.0,Jost Kacey,L,Canada,24.0,173,2023,Brazil,2023-06-29,True,0,0,0,0,0,0,8,8,0,0,0,0,0,0,0,0,4,2,9,15,9,7,1,17
192389.0,Jost Kacey,L,Canada,24.0,173,2023,Italy,2023-06-30,False,0,0,0,0,0,0,9,9,0,0,0,0,0,0,0,0,8,3,16,27,13,6,3,22
192389.0,Jost Kacey,L,Canada,24.0,173,2023,Netherlands,2023-07-01,True,0,0,0,0,0,0,12,12,0,0,0,0,0,0,0,0,7,1,16,24,10,4,1,15
168354.0,Maglio Emily,MB,Canada,27.0,191,2023,Poland,2023-05-30,False,0,3,8,11,0,0,1,1,5,2,3,10,1,8,15,24,1,0,3,4,6,0,1,7
168354.0,Maglio Emily,MB,Canada,27.0,191,2023,Thailand,2023-06-01,False,0,0,10,10,1,0,1,2,5,2,7,14,4,3,3,10,0,0,0,0,3,0,0,3
168354.0,Maglio Emily,MB,Canada,27.0,191,2023,Serbia,2023-06-04,True,1,4,13,18,0,0,4,4,6,4,8,18,3,8,11,22,0,0,0,0,4,1,1,6
168354.0,Maglio Emily,MB,Canada,27.0,191,2023,China,2023-06-13,False,0,3,6,9,0,0,2,2,5,1,5,11,0,2,1,3,0,0,0,0,3,1,0,4
168354.0,Maglio Emily,MB,Canada,27.0,191,2023,Bulgaria,2023-06-15,True,0,1,8,9,0,0,3,3,4,1,3,8,2,2,7,11,0,0,0,0,4,0,0,4
168354.0,Maglio Emily,MB,Canada,27.0,191,2023,Dominican Republic,2023-06-17,False,0,1,10,11,0,0,0,0,9,2,5,16,2,8,7,17,0,0,1,1,5,0,0,5
168354.0,Maglio Emily,MB,Canada,27.0,191,2023,Croatia,2023-06-27,True,0,1,13,14,0,0,3,3,5,1,2,8,3,3,4,10,0,0,0,0,3,0,2,5
168354.0,Maglio Emily,MB,Canada,27.0,191,2023,Brazil,2023-06-29,True,0,3,15,18,0,0,3,3,5,1,14,20,8,5,11,24,0,0,0,0,3,1,2,6
168354.0,Maglio Emily,MB,Canada,27.0,191,2023,Italy,2023-06-30,False,2,1,10,13,0,0,0,0,7,2,2,11,4,5,3,12,2,0,1,3,0,0,0,0
168354.0,Maglio Emily,MB,Canada,27.0,191,2023,Netherlands,2023-07-01,True,1,0,16,17,0,0,1,1,9,1,6,16,4,1,4,9,0,0,4,4,2,0,0,2
183258.0,Pelland Quinn,S,Canada,24.0,179,2023,China,2023-06-13,False,0,0,0,0,0,0,0,0,0,0,0,0,0,0,0,0,0,0,0,0,0,0,0,0
183258.0,Pelland Quinn,S,Canada,24.0,179,2023,Bulgaria,2023-06-15,True,0,0,0,0,1,0,4,5,0,0,0,0,0,0,0,0,0,0,0,0,0,0,1,1
183258.0,Pelland Quinn,S,Canada,24.0,179,2023,Dominican Republic,2023-06-17,False,0,0,0,0,0,0,0,0,0,0,0,0,0,0,0,0,0,0,0,0,0,0,0,0
183258.0,Pelland Quinn,S,Canada,24.0,179,2023,Croatia,2023-06-27,True,0,0,0,0,0,0,0,0,0,0,0,0,0,0,0,0,0,0,0,0,0,0,0,0
183258.0,Pelland Quinn,S,Canada,24.0,179,2023,Brazil,2023-06-29,True,0,0,0,0,0,0,0,0,0,0,0,0,0,0,0,0,0,0,0,0,0,0,0,0
183258.0,Pelland Quinn,S,Canada,24.0,179,2023,Italy,2023-06-30,False,0,0,0,0,0,0,0,0,0,0,0,0,0,0,0,0,0,0,0,0,0,0,0,0
183258.0,Pelland Quinn,S,Canada,24.0,179,2023,Netherlands,2023-07-01,True,0,0,0,0,0,0,0,0,0,0,0,0,0,0,0,0,0,0,0,0,0,0,0,0
135746.0,Yuan Xinyue,MB,China,27.0,202,2023,Brazil,2023-05-31,True,0,1,14,15,0,0,1,1,9,2,10,21,3,3,2,8,0,0,0,0,3,0,1,4
135746.0,Yuan Xinyue,MB,China,27.0,202,2023,Germany,2023-06-02,True,0,2,7,9,0,0,0,0,7,0,6,13,4,2,4,10,0,0,0,0,6,0,1,7
135746.0,Yuan Xinyue,MB,China,27.0,202,2023,Netherlands,2023-06-03,True,0,2,9,11,0,0,2,2,8,0,7,15,3,1,2,6,0,0,1,1,2,0,0,2
135746.0,Yuan Xinyue,MB,China,27.0,202,2023,Japan,2023-06-04,True,2,0,8,10,0,0,3,3,7,2,7,16,1,4,5,10,0,0,2,2,2,0,0,2
135746.0,Yuan Xinyue,MB,China,27.0,202,2023,Canada,2023-06-13,True,0,1,6,7,0,0,0,0,6,0,2,8,3,4,3,10,0,0,1,1,1,0,0,1
135746.0,Yuan Xinyue,MB,China,27.0,202,2023,Bulgaria,2023-06-16,True,0,0,9,9,0,0,2,2,10,1,6,17,3,3,3,9,1,0,0,1,1,0,0,1
135746.0,Yuan Xinyue,MB,China,27.0,202,2023,Poland,2023-06-17,False,0,1,10,11,0,1,2,3,7,1,2,10,0,5,3,8,0,0,1,1,0,1,0,1
135746.0,Yuan Xinyue,MB,China,27.0,202,2023,Italy,2023-06-18,False,1,1,14,16,0,0,2,2,13,0,9,22,1,5,4,10,0,0,0,0,3,2,1,6
135746.0,Yuan Xinyue,MB,China,27.0,202,2023,Serbia,2023-06-28,False,1,1,10,12,0,0,4,4,9,2,6,17,3,8,2,13,0,0,1,1,2,1,0,3
135746.0,Yuan Xinyue,MB,China,27.0,202,2023,Dominican Republic,2023-06-30,False,1,0,11,12,0,0,3,3,13,3,7,23,2,5,6,13,0,0,0,0,3,4,0,7
135746.0,Yuan Xinyue,MB,China,27.0,202,2023,USA,2023-07-02,True,1,0,10,11,0,0,1,1,9,0,6,15,3,6,4,13,0,0,2,2,0,3,2,5
135746.0,Yuan Xinyue,MB,China,27.0,202,2023,Brazil,2023-07-13,True,0,2,10,12,0,0,2,2,6,1,12,19,7,6,6,19,0,0,0,0,2,0,0,2
135746.0,Yuan Xinyue,MB,China,27.0,202,2023,Poland,2023-07-15,True,1,0,7,8,0,0,1,1,10,0,2,12,2,6,6,14,0,0,0,0,0,1,0,1
162354.0,Diao Linyu,S,China,29.0,183,2023,Brazil,2023-05-31,True,1,2,15,18,12,2,108,122,0,0,1,1,1,1,2,4,0,0,0,0,4,0,3,7
162354.0,Diao Linyu,S,China,29.0,183,2023,Germany,2023-06-02,True,0,0,13,13,10,0,64,74,0,0,0,0,0,0,0,0,0,0,0,0,9,1,1,11
162354.0,Diao Linyu,S,China,29.0,183,2023,Netherlands,2023-06-03,True,0,1,14,15,8,1,92,101,0,0,1,1,1,0,3,4,0,0,2,2,13,0,3,16
162354.0,Diao Linyu,S,China,29.0,183,2023,Japan,2023-06-04,True,0,0,7,7,2,0,79,81,0,1,0,1,4,3,0,7,0,0,1,1,6,0,1,7
162354.0,Diao Linyu,S,China,29.0,183,2023,Canada,2023-06-13,True,2,1,17,20,20,1,40,61,1,0,2,3,0,4,3,7,0,0,0,0,4,5,2,11
162354.0,Diao Linyu,S,China,29.0,183,2023,Bulgaria,2023-06-16,True,3,0,18,21,34,0,46,80,1,0,0,1,0,3,3,6,0,0,0,0,4,2,1,7
162354.0,Diao Linyu,S,China,29.0,183,2023,Poland,2023-06-17,False,0,0,8,8,24,0,44,68,0,0,0,0,0,4,2,6,0,0,0,0,7,2,0,9
162354.0,Diao Linyu,S,China,29.0,183,2023,Italy,2023-06-18,False,0,0,22,22,36,2,78,116,2,0,3,5,1,3,1,5,0,0,0,0,8,3,2,13
162354.0,Diao Linyu,S,China,29.0,183,2023,Serbia,2023-06-28,False,2,0,10,12,29,2,57,88,1,0,1,2,0,3,4,7,0,0,0,0,3,5,1,9
162354.0,Diao Linyu,S,China,29.0,183,2023,Dominican Republic,2023-06-30,False,0,0,10,10,33,0,58,91,0,0,0,0,0,4,2,6,0,0,1,1,7,3,0,10
162354.0,Diao Linyu,S,China,29.0,183,2023,USA,2023-07-02,True,0,0,12,12,15,1,81,97,1,0,0,1,2,4,2,8,0,0,2,2,5,6,4,15
162354.0,Diao Linyu,S,China,29.0,183,2023,Brazil,2023-07-13,True,0,1,11,12,24,0,65,89,0,1,1,2,3,4,5,12,0,0,0,0,12,8,1,21
162354.0,Diao Linyu,S,China,29.0,183,2023,Poland,2023-07-15,True,0,1,10,11,26,1,32,59,0,0,2,2,0,4,3,7,0,0,0,0,5,1,0,6
152337.0,Yang Hanyu,MB,China,24.0,196,2023,Brazil,2023-05-31,True,0,0,0,0,0,0,0,0,0,0,0,0,0,0,0,0,0,0,0,0,0,0,0,0
152337.0,Yang Hanyu,MB,China,24.0,196,2023,Germany,2023-06-02,True,0,0,0,0,0,0,0,0,0,0,0,0,0,0,0,0,0,0,0,0,0,0,0,0
152337.0,Yang Hanyu,MB,China,24.0,196,2023,Netherlands,2023-06-03,True,0,0,0,0,0,0,0,0,0,0,0,0,0,0,0,0,0,0,0,0,0,0,0,0
152337.0,Yang Hanyu,MB,China,24.0,196,2023,Japan,2023-06-04,True,0,0,0,0,0,0,0,0,0,0,0,0,0,0,0,0,0,0,0,0,0,0,0,0
152337.0,Yang Hanyu,MB,China,24.0,196,2023,Canada,2023-06-13,True,0,0,0,0,0,0,0,0,0,0,0,0,0,0,0,0,0,0,0,0,0,0,0,0
152337.0,Yang Hanyu,MB,China,24.0,196,2023,Bulgaria,2023-06-16,True,0,0,0,0,0,0,0,0,1,0,0,1,0,0,0,0,0,0,0,0,0,0,0,0
152337.0,Yang Hanyu,MB,China,24.0,196,2023,Poland,2023-06-17,False,0,0,6,6,0,0,1,1,1,0,5,6,1,5,3,9,0,0,1,1,1,1,0,2
152337.0,Yang Hanyu,MB,China,24.0,196,2023,Italy,2023-06-18,False,0,0,0,0,0,0,0,0,0,0,0,0,0,0,0,0,0,0,0,0,0,0,0,0
152337.0,Yang Hanyu,MB,China,24.0,196,2023,Serbia,2023-06-28,False,0,0,11,11,0,0,2,2,8,1,2,11,3,5,5,13,3,0,1,4,0,0,2,2
152337.0,Yang Hanyu,MB,China,24.0,196,2023,Dominican Republic,2023-06-30,False,0,1,7,8,0,0,1,1,1,1,5,7,0,2,0,2,0,1,0,1,0,2,0,2
152337.0,Yang Hanyu,MB,China,24.0,196,2023,USA,2023-07-02,True,0,0,0,0,0,0,0,0,0,0,0,0,0,0,0,0,0,0,0,0,0,0,0,0
152337.0,Yang Hanyu,MB,China,24.0,196,2023,Brazil,2023-07-13,True,0,0,0,0,0,0,0,0,0,0,0,0,0,0,0,0,0,0,0,0,0,0,0,0
152337.0,Yang Hanyu,MB,China,24.0,196,2023,Poland,2023-07-15,True,0,0,0,0,0,0,0,0,0,0,0,0,0,0,0,0,0,0,0,0,0,0,0,0
152332.0,Gao Yi,MB,China,25.0,194,2023,Brazil,2023-05-31,True,0,0,0,0,0,0,0,0,0,0,0,0,0,0,0,0,0,0,0,0,0,0,0,0
152332.0,Gao Yi,MB,China,25.0,194,2023,Germany,2023-06-02,True,0,0,0,0,0,0,0,0,0,0,0,0,0,0,0,0,0,0,0,0,0,0,0,0
152332.0,Gao Yi,MB,China,25.0,194,2023,Netherlands,2023-06-03,True,0,0,0,0,0,0,0,0,0,0,0,0,0,0,0,0,0,0,0,0,0,0,0,0
152332.0,Gao Yi,MB,China,25.0,194,2023,Japan,2023-06-04,True,0,0,0,0,0,0,0,0,0,0,0,0,0,0,0,0,0,0,0,0,0,0,0,0
152332.0,Gao Yi,MB,China,25.0,194,2023,Canada,2023-06-13,True,0,0,0,0,0,0,0,0,0,0,0,0,0,0,0,0,0,0,0,0,0,0,0,0
152332.0,Gao Yi,MB,China,25.0,194,2023,Bulgaria,2023-06-16,True,0,0,2,2,0,0,0,0,1,0,0,1,0,0,0,0,0,0,0,0,0,0,0,0
152332.0,Gao Yi,MB,China,25.0,194,2023,Poland,2023-06-17,False,0,0,1,1,0,0,0,0,0,0,0,0,0,0,0,0,0,0,0,0,0,0,0,0
152332.0,Gao Yi,MB,China,25.0,194,2023,Italy,2023-06-18,False,0,0,0,0,0,0,0,0,0,0,0,0,0,0,0,0,0,0,0,0,0,0,0,0
152332.0,Gao Yi,MB,China,25.0,194,2023,Serbia,2023-06-28,False,0,0,0,0,0,0,0,0,0,0,0,0,0,0,0,0,0,0,0,0,0,0,0,0
152332.0,Gao Yi,MB,China,25.0,194,2023,Dominican Republic,2023-06-30,False,0,0,0,0,0,0,0,0,0,0,0,0,0,0,0,0,0,0,0,0,0,0,0,0
152332.0,Gao Yi,MB,China,25.0,194,2023,USA,2023-07-02,True,0,2,6,8,0,0,1,1,4,1,7,12,3,1,5,9,1,0,0,1,3,1,0,4
152332.0,Gao Yi,MB,China,25.0,194,2023,Brazil,2023-07-13,True,0,0,0,0,0,0,0,0,0,0,0,0,0,0,0,0,0,0,0,0,0,0,0,0
152332.0,Gao Yi,MB,China,25.0,194,2023,Poland,2023-07-15,True,0,0,0,0,0,0,0,0,0,0,0,0,0,0,0,0,0,0,0,0,0,0,0,0
143206.0,Gong Xiangyu,O,China,26.0,189,2023,Brazil,2023-05-31,True,1,1,17,19,0,0,0,0,15,8,12,35,2,0,0,2,6,1,8,15,11,1,0,12
143206.0,Gong Xiangyu,O,China,26.0,189,2023,Germany,2023-06-02,True,0,0,18,18,0,0,1,1,9,4,8,21,0,1,3,4,6,1,6,13,5,0,0,5
143206.0,Gong Xiangyu,O,China,26.0,189,2023,Netherlands,2023-06-03,True,0,1,8,9,0,0,2,2,8,7,6,21,1,1,1,3,1,1,9,11,14,0,0,14
143206.0,Gong Xiangyu,O,China,26.0,189,2023,Japan,2023-06-04,True,1,1,14,16,0,0,1,1,8,2,12,22,0,0,0,0,2,0,3,5,10,0,1,11
143206.0,Gong Xiangyu,O,China,26.0,189,2023,Canada,2023-06-13,True,1,0,10,11,0,0,0,0,5,2,7,14,1,1,2,4,1,1,5,7,7,2,3,12
143206.0,Gong Xiangyu,O,China,26.0,189,2023,Bulgaria,2023-06-16,True,2,0,3,5,0,1,1,2,3,0,3,6,0,0,3,3,0,0,1,1,4,1,0,5
143206.0,Gong Xiangyu,O,China,26.0,189,2023,Poland,2023-06-17,False,1,1,9,11,0,1,3,4,12,4,8,24,0,3,1,4,2,0,7,9,9,1,1,11
143206.0,Gong Xiangyu,O,China,26.0,189,2023,Italy,2023-06-18,False,1,0,15,16,0,0,5,5,12,7,17,36,3,2,0,5,7,1,11,19,10,1,1,12
143206.0,Gong Xiangyu,O,China,26.0,189,2023,Serbia,2023-06-28,False,0,0,15,15,0,0,3,3,10,4,14,28,0,2,2,4,6,1,14,21,9,2,3,14
143206.0,Gong Xiangyu,O,China,26.0,189,2023,Dominican Republic,2023-06-30,False,0,0,11,11,0,0,3,3,8,2,18,28,1,1,0,2,3,1,4,8,16,3,2,21
143206.0,Gong Xiangyu,O,China,26.0,189,2023,USA,2023-07-02,True,0,1,19,20,0,0,7,7,12,2,8,22,1,3,5,9,4,0,17,21,8,4,3,15
143206.0,Gong Xiangyu,O,China,26.0,189,2023,Brazil,2023-07-13,True,0,1,12,13,0,1,1,2,14,3,4,21,0,3,5,8,3,2,16,21,10,2,1,13
143206.0,Gong Xiangyu,O,China,26.0,189,2023,Poland,2023-07-15,True,0,1,12,13,0,0,4,4,9,4,7,20,0,2,1,3,2,1,5,8,7,1,2,10
143201.0,Wang Yuanyuan,MB,China,26.0,196,2023,Brazil,2023-05-31,True,0,2,11,13,0,0,0,0,8,0,7,15,1,3,5,9,0,0,0,0,0,0,1,1
143201.0,Wang Yuanyuan,MB,China,26.0,196,2023,Germany,2023-06-02,True,0,0,11,11,0,0,4,4,11,0,4,15,0,2,2,4,0,0,0,0,1,0,1,2
143201.0,Wang Yuanyuan,MB,China,26.0,196,2023,Netherlands,2023-06-03,True,1,0,21,22,0,1,4,5,11,0,4,15,4,5,0,9,0,0,0,0,3,0,0,3
143201.0,Wang Yuanyuan,MB,China,26.0,196,2023,Japan,2023-06-04,True,0,0,11,11,0,0,1,1,10,0,3,13,1,1,3,5,1,0,3,4,2,0,1,3
143201.0,Wang Yuanyuan,MB,China,26.0,196,2023,Canada,2023-06-13,True,0,0,11,11,0,0,0,0,8,0,4,12,1,2,4,7,0,0,0,0,1,2,2,5
143201.0,Wang Yuanyuan,MB,China,26.0,196,2023,Bulgaria,2023-06-16,True,0,2,11,13,0,1,1,2,6,1,8,15,3,3,0,6,0,0,0,0,3,0,0,3
143201.0,Wang Yuanyuan,MB,China,26.0,196,2023,Poland,2023-06-17,False,1,0,2,3,0,0,1,1,3,0,0,3,1,2,0,3,0,0,0,0,2,1,0,3
143201.0,Wang Yuanyuan,MB,China,26.0,196,2023,Italy,2023-06-18,False,0,2,14,16,0,0,2,2,11,2,5,18,2,3,7,12,0,0,2,2,6,0,1,7
143201.0,Wang Yuanyuan,MB,China,26.0,196,2023,Serbia,2023-06-28,False,0,0,0,0,0,0,0,0,0,0,0,0,0,0,0,0,0,0,0,0,0,0,0,0
143201.0,Wang Yuanyuan,MB,China,26.0,196,2023,Dominican Republic,2023-06-30,False,0,1,6,7,0,0,0,0,7,0,5,12,2,0,4,6,0,1,0,1,1,1,0,2
143201.0,Wang Yuanyuan,MB,China,26.0,196,2023,USA,2023-07-02,True,0,0,3,3,0,0,1,1,2,0,2,4,0,2,0,2,0,0,2,2,0,0,0,0
143201.0,Wang Yuanyuan,MB,China,26.0,196,2023,Brazil,2023-07-13,True,1,0,17,18,0,0,3,3,6,0,3,9,2,1,1,4,0,0,2,2,1,3,1,5
143201.0,Wang Yuanyuan,MB,China,26.0,196,2023,Poland,2023-07-15,True,0,0,8,8,0,0,3,3,5,1,3,9,1,3,5,9,0,0,0,0,1,0,0,1
162979.0,Xu Xiaoting,S,China,26.0,183,2023,Brazil,2023-05-31,True,0,0,0,0,0,1,9,10,0,0,0,0,0,0,0,0,0,0,0,0,1,0,0,1
162979.0,Xu Xiaoting,S,China,26.0,183,2023,Germany,2023-06-02,True,0,0,0,0,0,0,0,0,0,0,0,0,0,0,0,0,0,0,0,0,0,0,0,0
162979.0,Xu Xiaoting,S,China,26.0,183,2023,Netherlands,2023-06-03,True,0,0,0,0,0,0,0,0,0,0,0,0,0,0,0,0,0,0,0,0,0,0,0,0
162979.0,Xu Xiaoting,S,China,26.0,183,2023,Japan,2023-06-04,True,0,0,0,0,0,0,5,5,0,0,0,0,0,0,0,0,0,0,0,0,0,0,0,0
162979.0,Xu Xiaoting,S,China,26.0,183,2023,Canada,2023-06-13,True,1,0,0,1,3,0,6,9,0,0,0,0,0,0,0,0,0,0,0,0,0,0,0,0
162979.0,Xu Xiaoting,S,China,26.0,183,2023,Bulgaria,2023-06-16,True,1,0,3,4,1,0,3,4,0,0,0,0,0,0,0,0,0,0,0,0,0,0,0,0
162979.0,Xu Xiaoting,S,China,26.0,183,2023,Poland,2023-06-17,False,0,0,0,0,4,0,4,8,0,0,0,0,0,0,0,0,0,0,0,0,0,0,0,0
162979.0,Xu Xiaoting,S,China,26.0,183,2023,Italy,2023-06-18,False,0,0,0,0,2,0,1,3,0,0,0,0,0,0,0,0,0,0,0,0,0,0,0,0
162979.0,Xu Xiaoting,S,China,26.0,183,2023,Serbia,2023-06-28,False,0,0,1,1,5,0,5,10,0,0,1,1,0,0,0,0,0,0,0,0,0,1,0,1
162979.0,Xu Xiaoting,S,China,26.0,183,2023,Dominican Republic,2023-06-30,False,1,0,4,5,11,0,22,33,0,1,0,1,0,0,0,0,0,0,0,0,0,1,0,1
162979.0,Xu Xiaoting,S,China,26.0,183,2023,USA,2023-07-02,True,0,0,0,0,1,2,7,10,0,0,1,1,0,1,1,2,0,0,0,0,1,0,0,1
162979.0,Xu Xiaoting,S,China,26.0,183,2023,Brazil,2023-07-13,True,0,0,0,0,1,0,2,3,0,0,0,0,0,0,0,0,0,0,0,0,1,1,0,2
162979.0,Xu Xiaoting,S,China,26.0,183,2023,Poland,2023-07-15,True,0,0,0,0,0,0,0,0,0,0,0,0,0,0,0,0,0,0,0,0,0,0,0,0
135740.0,Wang Yunlu,OH,China,27.0,191,2023,Brazil,2023-05-31,True,1,1,19,21,0,0,0,0,9,7,12,28,0,1,0,1,7,1,18,26,13,0,1,14
135740.0,Wang Yunlu,OH,China,27.0,191,2023,Germany,2023-06-02,True,0,1,8,9,0,0,2,2,8,2,7,17,1,1,1,3,4,1,4,9,8,1,3,12
135740.0,Wang Yunlu,OH,China,27.0,191,2023,Netherlands,2023-06-03,True,0,2,9,11,0,0,0,0,13,4,7,24,1,0,3,4,5,0,16,21,4,0,2,6
135740.0,Wang Yunlu,OH,China,27.0,191,2023,Japan,2023-06-04,True,0,0,14,14,0,0,0,0,4,3,7,14,1,0,2,3,3,3,13,19,6,0,0,6
135740.0,Wang Yunlu,OH,China,27.0,191,2023,Canada,2023-06-13,True,1,5,7,13,0,0,1,1,5,2,9,16,1,2,2,5,0,1,13,14,6,1,0,7
135740.0,Wang Yunlu,OH,China,27.0,191,2023,Bulgaria,2023-06-16,True,1,1,11,13,0,0,2,2,8,6,8,22,1,5,0,6,10,0,15,25,6,4,0,10
135740.0,Wang Yunlu,OH,China,27.0,191,2023,Poland,2023-06-17,False,1,1,8,10,0,0,3,3,6,4,7,17,2,3,1,6,4,0,17,21,4,3,1,8
135740.0,Wang Yunlu,OH,China,27.0,191,2023,Italy,2023-06-18,False,0,2,13,15,0,0,3,3,5,7,5,17,1,2,1,4,10,0,26,36,5,4,2,11
135740.0,Wang Yunlu,OH,China,27.0,191,2023,Serbia,2023-06-28,False,0,2,10,12,0,0,1,1,7,4,9,20,0,1,4,5,12,4,13,29,6,5,0,11
135740.0,Wang Yunlu,OH,China,27.0,191,2023,Dominican Republic,2023-06-30,False,3,1,16,20,0,0,2,2,6,4,9,19,0,1,2,3,9,3,14,26,4,5,1,10
135740.0,Wang Yunlu,OH,China,27.0,191,2023,USA,2023-07-02,True,0,2,19,21,0,0,0,0,12,2,14,28,0,4,6,10,5,1,10,16,7,3,1,11
135740.0,Wang Yunlu,OH,China,27.0,191,2023,Brazil,2023-07-13,True,0,0,16,16,0,0,2,2,5,3,12,20,2,3,3,8,4,2,13,19,3,1,0,4
135740.0,Wang Yunlu,OH,China,27.0,191,2023,Poland,2023-07-15,True,0,0,15,15,0,0,3,3,11,1,4,16,2,3,3,8,8,2,11,21,5,2,2,9
152920.0,Zhong Hui,OH,China,26.0,184,2023,Brazil,2023-05-31,True,0,0,0,0,0,0,0,0,0,0,0,0,0,0,0,0,0,0,0,0,0,0,0,0
152920.0,Zhong Hui,OH,China,26.0,184,2023,Germany,2023-06-02,True,0,0,0,0,0,0,0,0,0,0,0,0,0,0,0,0,0,0,0,0,0,0,0,0
152920.0,Zhong Hui,OH,China,26.0,184,2023,Netherlands,2023-06-03,True,0,1,1,2,0,0,0,0,0,0,4,4,0,0,1,1,0,0,2,2,1,0,0,1
152920.0,Zhong Hui,OH,China,26.0,184,2023,Japan,2023-06-04,True,0,1,4,5,0,0,0,0,1,2,2,5,1,0,0,1,0,0,3,3,3,0,0,3
152920.0,Zhong Hui,OH,China,26.0,184,2023,Canada,2023-06-13,True,0,0,0,0,0,0,0,0,0,0,0,0,0,0,0,0,0,0,0,0,0,0,0,0
152920.0,Zhong Hui,OH,China,26.0,184,2023,Bulgaria,2023-06-16,True,0,0,0,0,0,0,0,0,0,1,1,2,0,0,0,0,0,0,0,0,0,0,0,0
152920.0,Zhong Hui,OH,China,26.0,184,2023,Poland,2023-06-17,False,0,0,0,0,0,0,0,0,0,0,0,0,0,0,0,0,0,0,0,0,0,0,0,0
152920.0,Zhong Hui,OH,China,26.0,184,2023,Italy,2023-06-18,False,0,0,2,2,0,0,0,0,0,1,0,1,0,0,0,0,1,0,4,5,1,1,0,2
152920.0,Zhong Hui,OH,China,26.0,184,2023,Serbia,2023-06-28,False,0,1,3,4,0,0,0,0,2,0,3,5,0,2,0,2,3,1,1,5,0,0,0,0
152920.0,Zhong Hui,OH,China,26.0,184,2023,Dominican Republic,2023-06-30,False,0,0,6,6,0,0,0,0,1,0,2,3,0,0,0,0,0,1,3,4,4,0,0,4
152920.0,Zhong Hui,OH,China,26.0,184,2023,USA,2023-07-02,True,0,0,0,0,0,0,0,0,0,0,0,0,0,0,0,0,0,0,0,0,0,0,0,0
152920.0,Zhong Hui,OH,China,26.0,184,2023,Brazil,2023-07-13,True,0,0,0,0,0,0,0,0,0,0,0,0,0,0,0,0,0,0,0,0,0,0,0,0
152920.0,Zhong Hui,OH,China,26.0,184,2023,Poland,2023-07-15,True,0,0,0,0,0,0,0,0,0,0,0,0,0,0,0,0,0,0,0,0,0,0,0,0
152318.0,Li Yingying,OH,China,24.0,192,2023,Brazil,2023-05-31,True,1,2,16,19,0,0,1,1,25,4,12,41,0,2,0,2,11,0,23,34,11,2,2,15
152318.0,Li Yingying,OH,China,24.0,192,2023,Germany,2023-06-02,True,0,1,13,14,0,0,1,1,14,2,10,26,0,0,0,0,7,1,12,20,6,0,1,7
152318.0,Li Yingying,OH,China,24.0,192,2023,Netherlands,2023-06-03,True,4,3,14,21,0,0,0,0,20,5,13,38,3,0,0,3,13,4,10,27,5,0,6,11
152318.0,Li Yingying,OH,China,24.0,192,2023,Japan,2023-06-04,True,0,1,11,12,0,0,0,0,19,3,11,33,1,2,1,4,2,1,6,9,9,0,1,10
152318.0,Li Yingying,OH,China,24.0,192,2023,Canada,2023-06-13,True,0,2,10,12,0,0,3,3,13,2,13,28,1,2,3,6,3,0,5,8,1,2,1,4
152318.0,Li Yingying,OH,China,24.0,192,2023,Bulgaria,2023-06-16,True,3,2,15,20,0,0,3,3,15,1,10,26,0,4,4,8,2,0,15,17,11,1,1,13
152318.0,Li Yingying,OH,China,24.0,192,2023,Poland,2023-06-17,False,0,2,9,11,0,0,3,3,12,5,15,32,1,9,2,12,5,1,10,16,4,0,0,4
152318.0,Li Yingying,OH,China,24.0,192,2023,Italy,2023-06-18,False,1,1,17,19,0,0,1,1,20,8,18,46,3,3,0,6,2,1,6,9,12,4,1,17
152318.0,Li Yingying,OH,China,24.0,192,2023,Serbia,2023-06-28,False,0,2,13,15,0,0,3,3,18,3,13,34,0,5,2,7,3,3,10,16,3,2,0,5
152318.0,Li Yingying,OH,China,24.0,192,2023,Dominican Republic,2023-06-30,False,0,2,16,18,0,0,3,3,22,9,15,46,2,4,1,7,17,0,10,27,5,8,0,13
152318.0,Li Yingying,OH,China,24.0,192,2023,USA,2023-07-02,True,2,2,19,23,0,0,1,1,26,7,13,46,0,1,4,5,6,1,12,19,7,3,3,13
152318.0,Li Yingying,OH,China,24.0,192,2023,Brazil,2023-07-13,True,0,2,17,19,0,0,2,2,16,5,19,40,0,1,0,1,7,3,13,23,6,4,2,12
152318.0,Li Yingying,OH,China,24.0,192,2023,Poland,2023-07-15,True,0,1,15,16,0,0,4,4,13,3,8,24,1,1,4,6,2,0,10,12,4,0,1,5
135742.0,Zheng Yixin,O,China,28.0,189,2023,Brazil,2023-05-31,True,0,0,0,0,0,0,0,0,2,0,2,4,0,0,1,1,0,0,0,0,1,0,0,1
135742.0,Zheng Yixin,O,China,28.0,189,2023,Germany,2023-06-02,True,0,0,0,0,0,0,0,0,0,0,0,0,0,0,0,0,0,0,0,0,0,0,0,0
135742.0,Zheng Yixin,O,China,28.0,189,2023,Netherlands,2023-06-03,True,1,1,3,5,0,0,0,0,1,1,3,5,1,0,0,1,0,0,1,1,0,0,0,0
135742.0,Zheng Yixin,O,China,28.0,189,2023,Japan,2023-06-04,True,0,0,0,0,0,0,0,0,0,0,0,0,0,0,0,0,0,0,0,0,0,0,0,0
135742.0,Zheng Yixin,O,China,28.0,189,2023,Canada,2023-06-13,True,0,0,2,2,0,0,0,0,1,0,0,1,0,0,0,0,0,0,0,0,1,1,0,2
135742.0,Zheng Yixin,O,China,28.0,189,2023,Bulgaria,2023-06-16,True,0,0,7,7,0,0,0,0,6,3,3,12,2,0,6,8,0,0,0,0,2,1,1,4
135742.0,Zheng Yixin,O,China,28.0,189,2023,Poland,2023-06-17,False,0,1,2,3,0,0,0,0,3,0,0,3,1,0,1,2,0,0,0,0,3,0,0,3
135742.0,Zheng Yixin,O,China,28.0,189,2023,Italy,2023-06-18,False,0,0,0,0,0,0,0,0,1,0,0,1,0,0,0,0,0,0,0,0,0,0,0,0
135742.0,Zheng Yixin,O,China,28.0,189,2023,Serbia,2023-06-28,False,0,0,0,0,0,0,0,0,0,0,0,0,0,0,1,1,0,0,0,0,0,0,0,0
135742.0,Zheng Yixin,O,China,28.0,189,2023,Dominican Republic,2023-06-30,False,0,0,6,6,0,0,0,0,1,0,5,6,0,0,2,2,1,0,1,2,2,5,0,7
135742.0,Zheng Yixin,O,China,28.0,189,2023,USA,2023-07-02,True,0,0,2,2,0,0,0,0,0,0,4,4,0,0,1,1,0,0,2,2,0,0,0,0
135742.0,Zheng Yixin,O,China,28.0,189,2023,Brazil,2023-07-13,True,0,1,0,1,0,0,0,0,2,0,0,2,1,0,1,2,0,0,0,0,0,0,0,0
135742.0,Zheng Yixin,O,China,28.0,189,2023,Poland,2023-07-15,True,0,0,0,0,0,0,0,0,0,0,0,0,0,0,0,0,0,0,0,0,0,0,0,0
163909.0,Ni Feifan,L,China,23.0,177,2023,Brazil,2023-05-31,True,0,0,0,0,0,0,0,0,0,0,0,0,0,0,0,0,0,0,0,0,0,0,0,0
163909.0,Ni Feifan,L,China,23.0,177,2023,Germany,2023-06-02,True,0,0,0,0,0,0,0,0,0,0,0,0,0,0,0,0,0,0,0,0,0,0,0,0
163909.0,Ni Feifan,L,China,23.0,177,2023,Netherlands,2023-06-03,True,0,0,0,0,0,0,0,0,0,0,0,0,0,0,0,0,0,0,0,0,0,0,0,0
163909.0,Ni Feifan,L,China,23.0,177,2023,Japan,2023-06-04,True,0,0,0,0,0,0,0,0,0,0,0,0,0,0,0,0,0,0,0,0,0,0,0,0
163909.0,Ni Feifan,L,China,23.0,177,2023,Canada,2023-06-13,True,0,0,0,0,0,0,0,0,0,0,0,0,0,0,0,0,0,0,0,0,0,0,0,0
163909.0,Ni Feifan,L,China,23.0,177,2023,Bulgaria,2023-06-16,True,0,0,0,0,0,0,0,0,0,0,0,0,0,0,0,0,0,0,0,0,0,0,0,0
163909.0,Ni Feifan,L,China,23.0,177,2023,Poland,2023-06-17,False,0,0,0,0,0,0,0,0,0,0,0,0,0,0,0,0,0,0,0,0,0,0,0,0
163909.0,Ni Feifan,L,China,23.0,177,2023,Italy,2023-06-18,False,0,0,0,0,0,0,0,0,0,0,0,0,0,0,0,0,0,0,0,0,5,1,0,6
163909.0,Ni Feifan,L,China,23.0,177,2023,Serbia,2023-06-28,False,0,0,0,0,0,0,1,1,0,0,0,0,0,0,0,0,0,0,0,0,11,0,1,12
163909.0,Ni Feifan,L,China,23.0,177,2023,Dominican Republic,2023-06-30,False,0,0,0,0,0,0,3,3,0,0,0,0,0,0,0,0,0,0,0,0,7,5,0,12
163909.0,Ni Feifan,L,China,23.0,177,2023,USA,2023-07-02,True,0,0,0,0,0,0,2,2,0,0,0,0,0,0,0,0,0,0,0,0,1,1,1,3
163909.0,Ni Feifan,L,China,23.0,177,2023,Brazil,2023-07-13,True,0,0,1,1,0,0,0,0,0,0,0,0,0,0,0,0,0,0,0,0,0,1,0,1
163909.0,Ni Feifan,L,China,23.0,177,2023,Poland,2023-07-15,True,0,0,0,0,0,0,0,0,0,0,0,0,0,0,0,0,0,0,0,0,0,0,0,0
135745.0,Wang Mengjie,L,China,28.0,173,2023,Brazil,2023-05-31,True,0,0,0,0,0,0,6,6,0,0,0,0,0,0,0,0,9,0,8,17,15,0,3,18
135745.0,Wang Mengjie,L,China,28.0,173,2023,Germany,2023-06-02,True,0,0,0,0,0,0,11,11,0,0,0,0,0,0,0,0,2,2,7,11,13,1,2,16
135745.0,Wang Mengjie,L,China,28.0,173,2023,Netherlands,2023-06-03,True,0,0,0,0,0,0,9,9,0,0,0,0,0,0,0,0,3,0,15,18,6,1,2,9
135745.0,Wang Mengjie,L,China,28.0,173,2023,Japan,2023-06-04,True,0,0,0,0,0,0,7,7,0,0,0,0,0,0,0,0,5,1,11,17,7,0,1,8
135745.0,Wang Mengjie,L,China,28.0,173,2023,Canada,2023-06-13,True,0,0,0,0,0,0,4,4,0,0,0,0,0,0,0,0,3,0,14,17,9,5,2,16
135745.0,Wang Mengjie,L,China,28.0,173,2023,Bulgaria,2023-06-16,True,0,0,0,0,0,0,7,7,0,0,0,0,0,0,0,0,1,0,7,8,16,5,1,22
135745.0,Wang Mengjie,L,China,28.0,173,2023,Poland,2023-06-17,False,0,0,0,0,0,0,8,8,0,0,0,0,0,0,0,0,5,1,13,19,7,3,0,10
135745.0,Wang Mengjie,L,China,28.0,173,2023,Italy,2023-06-18,False,0,0,0,0,0,0,7,7,0,0,0,0,0,0,0,0,6,1,13,20,10,1,1,12
135745.0,Wang Mengjie,L,China,28.0,173,2023,Serbia,2023-06-28,False,0,0,0,0,0,0,7,7,0,0,0,0,0,0,0,0,1,0,7,8,7,2,0,9
135745.0,Wang Mengjie,L,China,28.0,173,2023,Dominican Republic,2023-06-30,False,0,0,0,0,0,0,8,8,0,0,0,0,0,0,0,0,13,1,10,24,10,4,0,14
135745.0,Wang Mengjie,L,China,28.0,173,2023,USA,2023-07-02,True,0,0,0,0,0,0,8,8,0,0,0,0,0,0,0,0,4,0,13,17,13,1,1,15
135745.0,Wang Mengjie,L,China,28.0,173,2023,Brazil,2023-07-13,True,0,0,0,0,0,0,9,9,0,0,0,0,0,0,0,0,2,1,9,12,10,2,2,14
135745.0,Wang Mengjie,L,China,28.0,173,2023,Poland,2023-07-15,True,0,0,0,0,0,0,4,4,0,0,0,0,0,0,0,0,3,1,7,11,10,5,2,17
143198.0,Du Qingqing,OH,China,27.0,189,2023,Brazil,2023-05-31,True,0,1,1,2,0,0,0,0,0,0,0,0,0,0,0,0,0,0,0,0,0,0,0,0
143198.0,Du Qingqing,OH,China,27.0,189,2023,Germany,2023-06-02,True,0,0,0,0,0,0,0,0,0,0,0,0,0,0,0,0,0,0,0,0,0,0,0,0
143198.0,Du Qingqing,OH,China,27.0,189,2023,Netherlands,2023-06-03,True,0,0,3,3,0,0,0,0,0,0,0,0,0,0,0,0,0,0,0,0,0,0,0,0
143198.0,Du Qingqing,OH,China,27.0,189,2023,Japan,2023-06-04,True,0,0,2,2,0,0,0,0,0,0,0,0,0,0,0,0,0,0,0,0,0,0,0,0
143198.0,Du Qingqing,OH,China,27.0,189,2023,Canada,2023-06-13,True,0,0,1,1,0,0,0,0,0,0,0,0,0,0,0,0,0,0,0,0,0,0,0,0
143198.0,Du Qingqing,OH,China,27.0,189,2023,Bulgaria,2023-06-16,True,0,0,0,0,0,0,0,0,0,0,0,0,0,0,0,0,0,0,0,0,0,0,0,0
143198.0,Du Qingqing,OH,China,27.0,189,2023,Poland,2023-06-17,False,0,0,2,2,0,0,0,0,0,0,0,0,0,0,0,0,0,0,0,0,0,0,0,0
143198.0,Du Qingqing,OH,China,27.0,189,2023,Italy,2023-06-18,False,0,1,1,2,0,0,0,0,0,0,0,0,0,0,0,0,0,0,0,0,1,0,0,1
143198.0,Du Qingqing,OH,China,27.0,189,2023,Serbia,2023-06-28,False,0,0,0,0,0,0,0,0,0,0,0,0,0,0,0,0,0,0,0,0,0,0,0,0
143198.0,Du Qingqing,OH,China,27.0,189,2023,Dominican Republic,2023-06-30,False,0,1,0,1,0,0,0,0,0,0,0,0,0,0,0,0,0,0,0,0,0,0,0,0
143198.0,Du Qingqing,OH,China,27.0,189,2023,USA,2023-07-02,True,0,0,2,2,0,0,0,0,0,0,0,0,0,0,0,0,0,0,0,0,0,0,0,0
143198.0,Du Qingqing,OH,China,27.0,189,2023,Brazil,2023-07-13,True,0,0,2,2,0,0,0,0,0,0,0,0,0,0,0,0,0,0,0,0,0,0,0,0
143198.0,Du Qingqing,OH,China,27.0,189,2023,Poland,2023-07-15,True,0,0,3,3,0,0,0,0,0,0,0,0,0,0,0,0,0,0,0,0,0,0,0,0
194499.0,Antunović Karla,S,Croatia,21.0,180,2023,Bulgaria,2023-05-31,False,0,1,2,3,7,1,36,44,0,0,0,0,1,0,1,2,0,0,0,0,4,0,0,4
194499.0,Antunović Karla,S,Croatia,21.0,180,2023,Germany,2023-06-01,False,0,0,10,10,8,0,66,74,0,1,0,1,0,1,0,1,0,0,0,0,8,3,0,11
194499.0,Antunović Karla,S,Croatia,21.0,180,2023,Japan,2023-06-02,False,2,1,6,9,3,0,103,106,0,0,0,0,2,0,3,5,0,0,0,0,3,0,1,4
194499.0,Antunović Karla,S,Croatia,21.0,180,2023,Brazil,2023-06-04,False,0,0,8,8,9,1,70,80,0,0,0,0,0,1,4,5,0,0,0,0,3,0,1,4
194499.0,Antunović Karla,S,Croatia,21.0,180,2023,USA,2023-06-13,False,2,2,9,13,13,0,100,113,3,0,4,7,0,0,9,9,0,0,0,0,7,5,2,14
194499.0,Antunović Karla,S,Croatia,21.0,180,2023,Thailand,2023-06-18,True,1,0,9,10,17,0,75,92,0,0,2,2,0,4,4,8,0,0,0,0,5,3,1,9
194499.0,Antunović Karla,S,Croatia,21.0,180,2023,Canada,2023-06-27,False,0,1,9,10,18,1,82,101,1,0,2,3,1,4,3,8,0,0,0,0,6,2,1,9
194499.0,Antunović Karla,S,Croatia,21.0,180,2023,Netherlands,2023-06-29,False,0,0,6,6,9,4,59,72,0,1,0,1,0,1,0,1,0,0,1,1,7,3,1,11
194499.0,Antunović Karla,S,Croatia,21.0,180,2023,Italy,2023-07-01,False,0,1,0,1,6,0,32,38,0,0,3,3,0,3,3,6,0,0,0,0,2,0,0,2
194498.0,Mihaljević Andrea,O,Croatia,21.0,183,2023,Bulgaria,2023-05-31,False,0,2,5,7,0,0,1,1,7,8,13,28,1,1,1,3,0,0,0,0,5,1,1,7
194498.0,Mihaljević Andrea,O,Croatia,21.0,183,2023,Germany,2023-06-01,False,1,2,6,9,0,0,1,1,16,1,13,30,1,0,3,4,0,0,0,0,7,1,1,9
194498.0,Mihaljević Andrea,O,Croatia,21.0,183,2023,Japan,2023-06-02,False,0,2,6,8,0,1,0,1,8,10,27,45,0,0,3,3,0,0,1,1,6,0,3,9
194498.0,Mihaljević Andrea,O,Croatia,21.0,183,2023,Brazil,2023-06-04,False,2,1,6,9,0,0,1,1,10,6,15,31,2,2,2,6,0,0,1,1,4,0,1,5
194498.0,Mihaljević Andrea,O,Croatia,21.0,183,2023,USA,2023-06-13,False,0,4,3,7,0,0,1,1,13,5,20,38,1,0,7,8,0,0,0,0,8,2,1,11
194498.0,Mihaljević Andrea,O,Croatia,21.0,183,2023,Thailand,2023-06-18,True,0,2,4,6,0,0,1,1,17,1,16,34,2,1,5,8,0,0,0,0,8,4,2,14
194498.0,Mihaljević Andrea,O,Croatia,21.0,183,2023,Canada,2023-06-27,False,1,0,3,4,0,0,2,2,4,2,7,13,0,0,2,2,0,0,0,0,1,2,0,3
194498.0,Mihaljević Andrea,O,Croatia,21.0,183,2023,Netherlands,2023-06-29,False,0,2,5,7,0,0,1,1,9,8,12,29,1,2,1,4,0,0,0,0,2,6,2,10
194498.0,Mihaljević Andrea,O,Croatia,21.0,183,2023,Italy,2023-07-01,False,0,0,5,5,0,0,2,2,5,4,16,25,2,2,1,5,1,1,14,16,5,4,0,9
156438.0,Strunjak Ema,MB,Croatia,24.0,187,2023,Bulgaria,2023-05-31,False,1,0,7,8,0,0,0,0,3,3,5,11,1,4,5,10,0,0,0,0,0,0,0,0
156438.0,Strunjak Ema,MB,Croatia,24.0,187,2023,Germany,2023-06-01,False,0,0,5,5,0,0,2,2,2,0,5,7,4,4,2,10,0,0,1,1,2,0,0,2
156438.0,Strunjak Ema,MB,Croatia,24.0,187,2023,Japan,2023-06-02,False,0,2,7,9,0,0,0,0,3,1,6,10,3,0,1,4,1,0,0,1,3,0,0,3
156438.0,Strunjak Ema,MB,Croatia,24.0,187,2023,Brazil,2023-06-04,False,0,0,8,8,0,0,0,0,4,2,2,8,4,1,3,8,0,0,0,0,4,0,0,4
156438.0,Strunjak Ema,MB,Croatia,24.0,187,2023,USA,2023-06-13,False,0,1,11,12,0,0,2,2,3,1,8,12,3,5,3,11,0,0,0,0,2,1,0,3
156438.0,Strunjak Ema,MB,Croatia,24.0,187,2023,Thailand,2023-06-18,True,2,1,13,16,0,0,3,3,3,2,3,8,1,1,6,8,0,0,0,0,4,0,1,5
156438.0,Strunjak Ema,MB,Croatia,24.0,187,2023,Canada,2023-06-27,False,1,0,13,14,0,0,1,1,6,0,5,11,3,6,3,12,0,0,0,0,4,1,1,6
156438.0,Strunjak Ema,MB,Croatia,24.0,187,2023,Netherlands,2023-06-29,False,0,0,6,6,0,0,0,0,3,1,3,7,1,2,3,6,0,0,0,0,1,1,0,2
156438.0,Strunjak Ema,MB,Croatia,24.0,187,2023,Italy,2023-07-01,False,0,1,7,8,0,0,1,1,2,0,3,5,0,6,5,11,0,0,0,0,0,1,0,1
162957.0,Butigan Božana,MB,Croatia,23.0,192,2023,Canada,2023-06-27,False,0,0,0,0,0,0,0,0,0,0,0,0,0,0,0,0,0,0,0,0,0,0,0,0
162957.0,Butigan Božana,MB,Croatia,23.0,192,2023,Netherlands,2023-06-29,False,0,0,0,0,0,0,0,0,0,0,0,0,0,0,0,0,0,0,0,0,0,0,0,0
162957.0,Butigan Božana,MB,Croatia,23.0,192,2023,Italy,2023-07-01,False,0,0,0,0,0,0,0,0,0,0,0,0,0,0,0,0,0,0,0,0,0,0,0,0
173970.0,Deak Lea,S,Croatia,23.0,177,2023,Bulgaria,2023-05-31,False,0,0,6,6,8,1,36,45,0,0,1,1,1,0,0,1,0,0,0,0,1,0,0,1
173970.0,Deak Lea,S,Croatia,23.0,177,2023,Germany,2023-06-01,False,0,0,1,1,1,0,4,5,0,0,0,0,0,0,0,0,0,0,0,0,0,0,0,0
173970.0,Deak Lea,S,Croatia,23.0,177,2023,Japan,2023-06-02,False,1,0,5,6,0,0,2,2,0,0,0,0,0,0,0,0,0,0,0,0,0,0,0,0
173970.0,Deak Lea,S,Croatia,23.0,177,2023,Brazil,2023-06-04,False,0,1,0,1,0,0,0,0,0,0,0,0,0,0,0,0,0,0,0,0,0,0,0,0
173970.0,Deak Lea,S,Croatia,23.0,177,2023,USA,2023-06-13,False,0,0,1,1,0,0,5,5,0,0,0,0,0,0,0,0,0,0,0,0,0,0,0,0
173970.0,Deak Lea,S,Croatia,23.0,177,2023,Thailand,2023-06-18,True,0,0,0,0,0,0,0,0,0,0,0,0,0,0,0,0,0,0,0,0,0,0,0,0
173970.0,Deak Lea,S,Croatia,23.0,177,2023,Canada,2023-06-27,False,0,0,0,0,0,0,6,6,0,0,0,0,0,0,0,0,0,0,0,0,0,0,0,0
173970.0,Deak Lea,S,Croatia,23.0,177,2023,Netherlands,2023-06-29,False,0,0,2,2,1,0,6,7,0,0,1,1,0,1,1,2,0,0,0,0,0,0,0,0
173970.0,Deak Lea,S,Croatia,23.0,177,2023,Italy,2023-07-01,False,1,0,6,7,9,0,37,46,1,0,1,2,0,0,0,0,0,1,0,1,1,1,1,3
170571.0,Miloš Laura,OH,Croatia,29.0,178,2023,Bulgaria,2023-05-31,False,0,3,2,5,0,0,0,0,5,3,17,25,0,3,5,8,0,0,8,8,5,0,2,7
170571.0,Miloš Laura,OH,Croatia,29.0,178,2023,Germany,2023-06-01,False,0,0,2,2,0,0,0,0,1,3,7,11,0,0,0,0,2,0,2,4,1,0,0,1
170571.0,Miloš Laura,OH,Croatia,29.0,178,2023,Japan,2023-06-02,False,0,1,7,8,0,0,0,0,7,3,7,17,0,2,1,3,2,2,10,14,7,0,2,9
170571.0,Miloš Laura,OH,Croatia,29.0,178,2023,Brazil,2023-06-04,False,0,2,6,8,0,0,1,1,1,5,10,16,1,0,3,4,6,3,9,18,5,0,1,6
170571.0,Miloš Laura,OH,Croatia,29.0,178,2023,USA,2023-06-13,False,0,1,13,14,0,0,1,1,15,6,14,35,0,1,4,5,5,1,24,30,10,3,0,13
170571.0,Miloš Laura,OH,Croatia,29.0,178,2023,Thailand,2023-06-18,True,1,0,12,13,0,0,1,1,9,3,12,24,0,1,3,4,5,1,8,14,7,2,0,9
170571.0,Miloš Laura,OH,Croatia,29.0,178,2023,Canada,2023-06-27,False,0,0,9,9,0,0,1,1,9,3,11,23,0,1,3,4,5,2,18,25,8,1,0,9
170571.0,Miloš Laura,OH,Croatia,29.0,178,2023,Netherlands,2023-06-29,False,0,0,6,6,0,0,0,0,3,1,3,7,0,2,0,2,2,2,2,6,0,2,1,3
170571.0,Miloš Laura,OH,Croatia,29.0,178,2023,Italy,2023-07-01,False,1,0,2,3,0,0,0,0,0,1,2,3,0,0,0,0,1,2,4,7,0,0,0,0
147402.0,Mlinar Lucija,OH,Croatia,28.0,180,2023,USA,2023-06-13,False,0,0,2,2,0,0,0,0,1,2,0,3,0,0,0,0,1,0,6,7,0,1,1,2
147402.0,Mlinar Lucija,OH,Croatia,28.0,180,2023,Thailand,2023-06-18,True,0,0,6,6,0,0,0,0,0,0,0,0,0,0,0,0,0,0,0,0,1,0,0,1
147402.0,Mlinar Lucija,OH,Croatia,28.0,180,2023,Canada,2023-06-27,False,0,1,8,9,0,0,3,3,4,3,10,17,0,0,1,1,4,0,10,14,2,1,0,3
147402.0,Mlinar Lucija,OH,Croatia,28.0,180,2023,Netherlands,2023-06-29,False,0,0,4,4,0,0,0,0,3,2,6,11,0,0,0,0,3,2,15,20,0,4,0,4
147402.0,Mlinar Lucija,OH,Croatia,28.0,180,2023,Italy,2023-07-01,False,0,0,7,7,0,0,2,2,1,1,5,7,1,0,0,1,3,0,11,14,4,0,0,4
189437.0,Karatović Dijana,OH,Croatia,20.0,182,2023,Bulgaria,2023-05-31,False,0,0,11,11,0,0,0,0,3,0,7,10,0,3,0,3,3,2,16,21,5,0,0,5
189437.0,Karatović Dijana,OH,Croatia,20.0,182,2023,Germany,2023-06-01,False,0,0,17,17,0,0,2,2,4,0,12,16,0,1,0,1,5,3,16,24,7,0,0,7
189437.0,Karatović Dijana,OH,Croatia,20.0,182,2023,Japan,2023-06-02,False,0,0,9,9,0,0,2,2,9,0,14,23,1,0,2,3,4,1,18,23,6,0,2,8
189437.0,Karatović Dijana,OH,Croatia,20.0,182,2023,Brazil,2023-06-04,False,0,1,7,8,0,0,0,0,4,7,6,17,2,0,1,3,0,0,23,23,4,0,2,6
189437.0,Karatović Dijana,OH,Croatia,20.0,182,2023,USA,2023-06-13,False,2,0,15,17,0,0,3,3,11,4,8,23,1,1,0,2,5,1,25,31,5,6,2,13
189437.0,Karatović Dijana,OH,Croatia,20.0,182,2023,Thailand,2023-06-18,True,1,0,16,17,0,0,3,3,7,2,12,21,1,2,0,3,6,0,19,25,12,3,1,16
189437.0,Karatović Dijana,OH,Croatia,20.0,182,2023,Canada,2023-06-27,False,0,0,5,5,0,0,0,0,0,4,1,5,0,0,0,0,2,2,4,8,4,1,2,7
189437.0,Karatović Dijana,OH,Croatia,20.0,182,2023,Netherlands,2023-06-29,False,0,0,2,2,0,0,2,2,2,0,4,6,0,1,0,1,2,0,18,20,7,1,1,9
189437.0,Karatović Dijana,OH,Croatia,20.0,182,2023,Italy,2023-07-01,False,0,0,3,3,0,0,1,1,0,4,9,13,0,0,1,1,0,0,5,5,2,1,0,3
189256.0,Marković Josipa,L,Croatia,23.0,185,2023,Bulgaria,2023-05-31,False,0,0,2,2,0,0,0,0,1,3,3,7,0,2,0,2,2,3,5,10,1,1,0,2
189256.0,Marković Josipa,L,Croatia,23.0,185,2023,Germany,2023-06-01,False,0,1,1,2,0,0,3,3,1,0,5,6,1,0,1,2,1,0,6,7,2,0,1,3
189256.0,Marković Josipa,L,Croatia,23.0,185,2023,Japan,2023-06-02,False,0,0,0,0,0,0,0,0,0,1,3,4,0,0,0,0,0,0,0,0,1,0,0,1
189256.0,Marković Josipa,L,Croatia,23.0,185,2023,Brazil,2023-06-04,False,0,0,1,1,0,0,0,0,0,0,1,1,0,0,0,0,0,1,3,4,1,0,0,1
189256.0,Marković Josipa,L,Croatia,23.0,185,2023,USA,2023-06-13,False,0,0,0,0,0,0,0,0,0,1,0,1,0,0,0,0,0,0,1,1,0,0,0,0
189256.0,Marković Josipa,L,Croatia,23.0,185,2023,Thailand,2023-06-18,True,0,0,0,0,0,0,0,0,0,0,0,0,0,0,0,0,0,0,0,0,0,0,0,0
189256.0,Marković Josipa,L,Croatia,23.0,185,2023,Canada,2023-06-27,False,0,0,1,1,0,0,0,0,1,0,0,1,0,0,0,0,1,0,0,1,0,0,0,0
189256.0,Marković Josipa,L,Croatia,23.0,185,2023,Netherlands,2023-06-29,False,0,0,2,2,0,0,3,3,1,4,6,11,0,0,1,1,1,0,8,9,4,0,0,4
189256.0,Marković Josipa,L,Croatia,23.0,185,2023,Italy,2023-07-01,False,0,0,0,0,0,0,0,0,0,0,0,0,0,0,0,0,0,0,0,0,0,0,0,0
140914.0,Fabris Samanta,O,Croatia,32.0,190,2023,Canada,2023-06-27,False,0,0,10,10,0,0,0,0,8,11,13,32,1,0,7,8,0,0,0,0,7,3,2,12
140914.0,Fabris Samanta,O,Croatia,32.0,190,2023,Netherlands,2023-06-29,False,0,0,0,0,0,0,0,0,0,0,0,0,0,0,0,0,0,0,0,0,0,0,0,0
140914.0,Fabris Samanta,O,Croatia,32.0,190,2023,Italy,2023-07-01,False,0,1,10,11,0,0,0,0,8,8,18,34,0,2,1,3,0,0,1,1,10,2,1,13
136824.0,Šamadan Martina,MB,Croatia,30.0,193,2023,Bulgaria,2023-05-31,False,0,1,6,7,0,0,1,1,9,2,4,15,1,3,0,4,0,0,0,0,2,0,0,2
136824.0,Šamadan Martina,MB,Croatia,30.0,193,2023,Germany,2023-06-01,False,0,0,11,11,0,1,2,3,7,0,6,13,0,0,3,3,0,0,1,1,2,0,0,2
136824.0,Šamadan Martina,MB,Croatia,30.0,193,2023,Japan,2023-06-02,False,0,1,2,3,0,0,0,0,2,1,10,13,0,1,1,2,0,0,0,0,0,0,1,1
136824.0,Šamadan Martina,MB,Croatia,30.0,193,2023,Brazil,2023-06-04,False,1,1,7,9,0,0,1,1,7,1,2,10,3,0,1,4,1,0,0,1,1,1,0,2
136824.0,Šamadan Martina,MB,Croatia,30.0,193,2023,USA,2023-06-13,False,0,2,12,14,0,0,3,3,8,2,10,20,1,6,9,16,0,0,0,0,4,1,0,5
136824.0,Šamadan Martina,MB,Croatia,30.0,193,2023,Thailand,2023-06-18,True,1,0,7,8,0,0,2,2,10,2,4,16,3,0,4,7,0,0,0,0,1,1,2,4
136824.0,Šamadan Martina,MB,Croatia,30.0,193,2023,Canada,2023-06-27,False,0,2,6,8,0,0,0,0,10,4,3,17,0,2,5,7,0,0,0,0,3,0,2,5
136824.0,Šamadan Martina,MB,Croatia,30.0,193,2023,Netherlands,2023-06-29,False,1,0,6,7,0,0,4,4,8,3,7,18,2,2,3,7,0,0,1,1,0,0,1,1
136824.0,Šamadan Martina,MB,Croatia,30.0,193,2023,Italy,2023-07-01,False,0,1,4,5,0,0,0,0,3,2,4,9,3,5,8,16,0,0,0,0,1,1,0,2
186153.0,Trcol Viktoria Ana,MB,Croatia,19.0,186,2023,Bulgaria,2023-05-31,False,0,0,0,0,0,0,0,0,0,0,0,0,0,0,0,0,0,0,0,0,0,0,0,0
186153.0,Trcol Viktoria Ana,MB,Croatia,19.0,186,2023,Germany,2023-06-01,False,1,0,4,5,0,0,0,0,0,0,0,0,0,0,0,0,0,0,0,0,0,0,1,1
186153.0,Trcol Viktoria Ana,MB,Croatia,19.0,186,2023,Japan,2023-06-02,False,0,1,4,5,0,0,0,0,0,0,3,3,1,0,1,2,0,0,0,0,1,0,0,1
186153.0,Trcol Viktoria Ana,MB,Croatia,19.0,186,2023,Brazil,2023-06-04,False,0,0,0,0,0,0,0,0,0,0,0,0,0,0,0,0,0,0,0,0,0,0,0,0
186153.0,Trcol Viktoria Ana,MB,Croatia,19.0,186,2023,USA,2023-06-13,False,0,0,0,0,0,0,0,0,0,0,0,0,0,0,0,0,0,0,0,0,0,0,0,0
186153.0,Trcol Viktoria Ana,MB,Croatia,19.0,186,2023,Thailand,2023-06-18,True,0,0,0,0,0,0,0,0,0,0,0,0,0,0,0,0,0,0,0,0,0,0,0,0
186153.0,Trcol Viktoria Ana,MB,Croatia,19.0,186,2023,Canada,2023-06-27,False,0,0,0,0,0,0,0,0,0,0,0,0,0,0,0,0,0,0,0,0,0,0,0,0
186153.0,Trcol Viktoria Ana,MB,Croatia,19.0,186,2023,Netherlands,2023-06-29,False,0,0,3,3,0,0,1,1,0,1,0,1,0,0,0,0,0,0,0,0,0,0,0,0
186153.0,Trcol Viktoria Ana,MB,Croatia,19.0,186,2023,Italy,2023-07-01,False,0,0,0,0,0,0,0,0,0,0,0,0,0,0,0,0,0,0,0,0,0,0,0,0
164734.0,Đapić Barbara,O,Croatia,29.0,193,2023,USA,2023-06-13,False,0,0,0,0,0,0,0,0,0,1,0,1,0,0,0,0,0,0,0,0,0,0,0,0
164734.0,Đapić Barbara,O,Croatia,29.0,193,2023,Thailand,2023-06-18,True,0,0,0,0,0,0,0,0,0,0,0,0,0,0,0,0,0,0,0,0,0,0,0,0
164734.0,Đapić Barbara,O,Croatia,29.0,193,2023,Canada,2023-06-27,False,0,0,0,0,0,0,0,0,0,0,0,0,0,0,0,0,0,0,0,0,0,0,0,0
164734.0,Đapić Barbara,O,Croatia,29.0,193,2023,Netherlands,2023-06-29,False,1,1,0,2,0,0,0,0,3,1,2,6,0,0,0,0,0,0,0,0,0,0,0,0
164734.0,Đapić Barbara,O,Croatia,29.0,193,2023,Italy,2023-07-01,False,0,0,0,0,0,0,0,0,0,0,0,0,0,0,0,0,0,0,0,0,0,0,0,0
189270.0,Štimac Izabela,L,Croatia,23.0,171,2023,Bulgaria,2023-05-31,False,0,0,0,0,0,0,7,7,0,0,0,0,0,0,0,0,7,4,16,27,13,2,2,17
189270.0,Štimac Izabela,L,Croatia,23.0,171,2023,Germany,2023-06-01,False,0,0,0,0,0,0,9,9,0,0,0,0,0,0,0,0,7,0,4,11,14,1,4,19
189270.0,Štimac Izabela,L,Croatia,23.0,171,2023,Japan,2023-06-02,False,0,0,0,0,0,0,5,5,0,0,0,0,0,0,0,0,15,1,10,26,22,0,4,26
189270.0,Štimac Izabela,L,Croatia,23.0,171,2023,Brazil,2023-06-04,False,0,0,0,0,0,0,3,3,0,0,0,0,0,0,0,0,5,3,13,21,6,1,3,10
189270.0,Štimac Izabela,L,Croatia,23.0,171,2023,USA,2023-06-13,False,0,0,0,0,0,0,8,8,0,0,0,0,0,0,0,0,5,1,8,14,14,8,1,23
189270.0,Štimac Izabela,L,Croatia,23.0,171,2023,Thailand,2023-06-18,True,0,0,0,0,0,0,5,5,0,0,0,0,0,0,0,0,8,0,4,12,14,5,1,20
189270.0,Štimac Izabela,L,Croatia,23.0,171,2023,Canada,2023-06-27,False,0,0,0,0,0,0,10,10,0,0,0,0,0,0,0,0,6,0,18,24,18,5,0,23
189270.0,Štimac Izabela,L,Croatia,23.0,171,2023,Netherlands,2023-06-29,False,0,0,0,0,0,0,11,11,0,0,0,0,0,0,0,0,4,2,8,14,9,1,0,10
189270.0,Štimac Izabela,L,Croatia,23.0,171,2023,Italy,2023-07-01,False,0,0,0,0,0,0,10,10,0,0,0,0,0,0,0,0,7,2,15,24,9,5,0,14
158817.0,Rodriguez Duran Yaneirys,L,Dominican Republic,23.0,171,2023,Japan,2023-05-30,False,0,0,0,0,1,0,9,10,0,0,0,0,0,0,0,0,2,2,8,12,22,4,2,28
158817.0,Rodriguez Duran Yaneirys,L,Dominican Republic,23.0,171,2023,Bulgaria,2023-06-01,True,0,0,0,0,0,0,9,9,0,0,0,0,0,0,0,0,6,3,6,15,11,1,2,14
158817.0,Rodriguez Duran Yaneirys,L,Dominican Republic,23.0,171,2023,Netherlands,2023-06-02,True,0,0,0,0,1,0,6,7,0,0,0,0,0,0,0,0,5,2,21,28,16,0,2,18
158817.0,Rodriguez Duran Yaneirys,L,Dominican Republic,23.0,171,2023,Brazil,2023-06-03,False,0,1,2,3,0,0,7,7,0,0,0,0,0,0,0,0,4,1,20,25,7,0,1,8
158817.0,Rodriguez Duran Yaneirys,L,Dominican Republic,23.0,171,2023,Poland,2023-06-13,False,0,0,0,0,0,0,0,0,0,0,0,0,0,0,0,0,0,0,0,0,0,0,0,0
158817.0,Rodriguez Duran Yaneirys,L,Dominican Republic,23.0,171,2023,Italy,2023-06-15,False,0,0,0,0,0,0,0,0,0,0,0,0,0,0,0,0,0,0,0,0,0,0,0,0
158817.0,Rodriguez Duran Yaneirys,L,Dominican Republic,23.0,171,2023,Canada,2023-06-17,True,0,0,0,0,0,0,0,0,0,0,0,0,0,0,0,0,0,0,0,0,0,0,0,0
158817.0,Rodriguez Duran Yaneirys,L,Dominican Republic,23.0,171,2023,Germany,2023-06-27,False,0,0,3,3,0,0,0,0,0,0,0,0,0,0,0,0,0,0,3,3,5,0,1,6
158817.0,Rodriguez Duran Yaneirys,L,Dominican Republic,23.0,171,2023,China,2023-06-30,True,0,1,8,9,0,0,3,3,0,0,0,0,0,0,0,0,2,0,5,7,3,3,0,6
158817.0,Rodriguez Duran Yaneirys,L,Dominican Republic,23.0,171,2023,Serbia,2023-07-01,True,0,1,6,7,0,0,1,1,0,0,0,0,0,0,0,0,1,0,3,4,1,1,1,3
119591.0,Eve Mejia Lisvel Elisa,MB,Dominican Republic,32.0,194,2023,Japan,2023-05-30,False,1,0,11,12,0,0,8,8,6,1,7,14,3,5,6,14,0,0,1,1,2,0,0,2
119591.0,Eve Mejia Lisvel Elisa,MB,Dominican Republic,32.0,194,2023,Bulgaria,2023-06-01,True,1,1,17,19,0,0,5,5,9,1,2,12,3,4,4,11,0,2,0,2,5,0,0,5
119591.0,Eve Mejia Lisvel Elisa,MB,Dominican Republic,32.0,194,2023,Netherlands,2023-06-02,True,2,1,22,25,0,0,6,6,2,2,1,5,6,2,5,13,0,0,0,0,3,0,0,3
119591.0,Eve Mejia Lisvel Elisa,MB,Dominican Republic,32.0,194,2023,Brazil,2023-06-03,False,0,0,13,13,0,0,0,0,6,3,4,13,2,2,3,7,0,0,0,0,6,0,1,7
119591.0,Eve Mejia Lisvel Elisa,MB,Dominican Republic,32.0,194,2023,Poland,2023-06-13,False,1,2,14,17,0,0,1,1,1,1,5,7,1,4,8,13,0,0,0,0,2,1,1,4
119591.0,Eve Mejia Lisvel Elisa,MB,Dominican Republic,32.0,194,2023,Italy,2023-06-15,False,0,0,0,0,0,0,0,0,0,0,0,0,0,0,0,0,0,0,0,0,0,0,0,0
119591.0,Eve Mejia Lisvel Elisa,MB,Dominican Republic,32.0,194,2023,Canada,2023-06-17,True,0,0,0,0,0,0,0,0,0,0,0,0,0,0,0,0,0,0,0,0,0,0,0,0
119591.0,Eve Mejia Lisvel Elisa,MB,Dominican Republic,32.0,194,2023,Germany,2023-06-27,False,0,0,0,0,0,0,0,0,0,0,0,0,0,0,0,0,0,0,0,0,0,0,0,0
119591.0,Eve Mejia Lisvel Elisa,MB,Dominican Republic,32.0,194,2023,China,2023-06-30,True,0,0,0,0,0,0,0,0,0,0,0,0,0,0,0,0,0,0,0,0,0,0,0,0
119591.0,Eve Mejia Lisvel Elisa,MB,Dominican Republic,32.0,194,2023,Serbia,2023-07-01,True,0,0,0,0,0,0,0,0,0,0,0,0,0,0,0,0,0,0,0,0,0,0,0,0
151087.0,Peralta Luna Vielka Michelle,OH,Dominican Republic,24.0,186,2023,Japan,2023-05-30,False,0,0,0,0,0,0,0,0,0,0,0,0,0,0,0,0,0,0,1,1,0,0,0,0
151087.0,Peralta Luna Vielka Michelle,OH,Dominican Republic,24.0,186,2023,Bulgaria,2023-06-01,True,0,0,0,0,0,0,1,1,1,0,0,1,0,0,0,0,0,0,0,0,1,0,0,1
151087.0,Peralta Luna Vielka Michelle,OH,Dominican Republic,24.0,186,2023,Netherlands,2023-06-02,True,0,0,2,2,0,0,0,0,0,1,0,1,0,0,0,0,0,0,0,0,0,0,1,1
151087.0,Peralta Luna Vielka Michelle,OH,Dominican Republic,24.0,186,2023,Brazil,2023-06-03,False,0,0,3,3,0,0,0,0,0,0,0,0,0,0,0,0,0,0,0,0,0,0,0,0
151087.0,Peralta Luna Vielka Michelle,OH,Dominican Republic,24.0,186,2023,Poland,2023-06-13,False,0,0,4,4,0,0,0,0,0,0,0,0,0,0,0,0,0,0,0,0,0,1,1,2
151087.0,Peralta Luna Vielka Michelle,OH,Dominican Republic,24.0,186,2023,Italy,2023-06-15,False,0,0,3,3,0,0,0,0,0,0,0,0,0,0,0,0,0,0,0,0,0,1,0,1
151087.0,Peralta Luna Vielka Michelle,OH,Dominican Republic,24.0,186,2023,Canada,2023-06-17,True,0,0,2,2,0,0,1,1,0,0,0,0,0,0,0,0,0,0,0,0,0,1,0,1
151087.0,Peralta Luna Vielka Michelle,OH,Dominican Republic,24.0,186,2023,Germany,2023-06-27,False,0,0,0,0,0,1,0,1,0,0,2,2,0,0,1,1,0,0,1,1,0,0,0,0
151087.0,Peralta Luna Vielka Michelle,OH,Dominican Republic,24.0,186,2023,China,2023-06-30,True,0,0,3,3,0,1,0,1,2,3,1,6,0,0,0,0,0,0,3,3,3,0,0,3
151087.0,Peralta Luna Vielka Michelle,OH,Dominican Republic,24.0,186,2023,Serbia,2023-07-01,True,0,0,0,0,0,0,0,0,0,0,0,0,0,0,0,0,0,0,0,0,0,0,0,0
119039.0,Castillo Brenda,L,Dominican Republic,31.0,167,2023,Poland,2023-06-13,False,0,0,0,0,0,0,27,27,0,0,0,0,0,0,0,0,5,0,12,17,13,8,1,22
119039.0,Castillo Brenda,L,Dominican Republic,31.0,167,2023,Italy,2023-06-15,False,0,0,0,0,0,0,23,23,0,0,0,0,0,0,0,0,1,0,9,10,16,6,0,22
119039.0,Castillo Brenda,L,Dominican Republic,31.0,167,2023,Canada,2023-06-17,True,0,0,0,0,0,0,35,35,0,0,0,0,0,0,0,0,3,1,11,15,16,3,2,21
119039.0,Castillo Brenda,L,Dominican Republic,31.0,167,2023,Germany,2023-06-27,False,0,0,0,0,0,1,21,22,0,0,0,0,0,0,0,0,4,2,12,18,12,7,2,21
119039.0,Castillo Brenda,L,Dominican Republic,31.0,167,2023,China,2023-06-30,True,0,0,0,0,0,1,21,22,0,0,0,0,0,0,0,0,9,3,17,29,19,10,0,29
119039.0,Castillo Brenda,L,Dominican Republic,31.0,167,2023,Serbia,2023-07-01,True,0,0,0,0,0,0,26,26,0,0,0,0,0,0,0,0,6,0,12,18,19,2,3,24
119585.0,Marte Frica Niverka Dharlenis,S,Dominican Republic,33.0,178,2023,Japan,2023-05-30,False,0,0,9,9,24,1,98,123,0,0,1,1,1,1,6,8,0,0,0,0,5,1,2,8
119585.0,Marte Frica Niverka Dharlenis,S,Dominican Republic,33.0,178,2023,Bulgaria,2023-06-01,True,0,1,20,21,5,2,96,103,2,0,2,4,0,2,3,5,0,0,0,0,12,0,4,16
119585.0,Marte Frica Niverka Dharlenis,S,Dominican Republic,33.0,178,2023,Netherlands,2023-06-02,True,0,0,15,15,5,3,108,116,1,0,1,2,0,0,2,2,0,0,0,0,13,0,3,16
119585.0,Marte Frica Niverka Dharlenis,S,Dominican Republic,33.0,178,2023,Brazil,2023-06-03,False,0,2,11,13,10,1,87,98,0,0,1,1,1,1,2,4,0,0,0,0,4,0,1,5
119585.0,Marte Frica Niverka Dharlenis,S,Dominican Republic,33.0,178,2023,Poland,2023-06-13,False,0,1,18,19,6,0,92,98,1,0,0,1,0,1,2,3,0,0,0,0,9,1,5,15
119585.0,Marte Frica Niverka Dharlenis,S,Dominican Republic,33.0,178,2023,Italy,2023-06-15,False,0,0,18,18,16,1,85,102,0,1,0,1,0,2,5,7,0,0,0,0,14,1,2,17
119585.0,Marte Frica Niverka Dharlenis,S,Dominican Republic,33.0,178,2023,Canada,2023-06-17,True,0,1,14,15,11,1,76,88,1,2,0,3,0,3,3,6,0,0,0,0,5,2,0,7
119585.0,Marte Frica Niverka Dharlenis,S,Dominican Republic,33.0,178,2023,Germany,2023-06-27,False,0,1,17,18,9,1,79,89,1,0,1,2,0,1,1,2,0,0,1,1,9,3,3,15
119585.0,Marte Frica Niverka Dharlenis,S,Dominican Republic,33.0,178,2023,China,2023-06-30,True,0,1,17,18,22,1,90,113,0,0,3,3,0,1,1,2,0,0,0,0,8,2,1,11
119585.0,Marte Frica Niverka Dharlenis,S,Dominican Republic,33.0,178,2023,Serbia,2023-07-01,True,0,0,16,16,7,0,102,109,1,0,1,2,1,5,6,12,0,0,2,2,8,6,1,15
183317.0,Tapia Cruz Alondra Denis,O,Dominican Republic,19.0,193,2023,Japan,2023-05-30,False,0,0,0,0,0,0,0,0,0,0,0,0,0,0,0,0,0,0,0,0,0,0,0,0
183317.0,Tapia Cruz Alondra Denis,O,Dominican Republic,19.0,193,2023,Bulgaria,2023-06-01,True,0,0,0,0,0,0,0,0,0,0,0,0,0,0,0,0,0,0,0,0,0,0,0,0
183317.0,Tapia Cruz Alondra Denis,O,Dominican Republic,19.0,193,2023,Netherlands,2023-06-02,True,0,0,0,0,0,0,0,0,0,0,0,0,0,0,0,0,0,0,0,0,0,0,0,0
183317.0,Tapia Cruz Alondra Denis,O,Dominican Republic,19.0,193,2023,Brazil,2023-06-03,False,0,0,0,0,0,0,1,1,0,0,0,0,0,0,0,0,0,0,0,0,0,0,0,0
183317.0,Tapia Cruz Alondra Denis,O,Dominican Republic,19.0,193,2023,Poland,2023-06-13,False,0,0,0,0,0,0,0,0,1,0,1,2,0,0,1,1,0,0,0,0,0,0,0,0
183317.0,Tapia Cruz Alondra Denis,O,Dominican Republic,19.0,193,2023,Italy,2023-06-15,False,0,0,0,0,0,0,0,0,0,0,1,1,0,1,1,2,0,0,0,0,0,0,0,0
183317.0,Tapia Cruz Alondra Denis,O,Dominican Republic,19.0,193,2023,Canada,2023-06-17,True,0,0,0,0,0,0,0,0,0,0,0,0,0,0,0,0,0,0,0,0,0,0,0,0
183317.0,Tapia Cruz Alondra Denis,O,Dominican Republic,19.0,193,2023,Germany,2023-06-27,False,0,0,0,0,0,0,0,0,0,0,0,0,0,0,0,0,0,0,0,0,0,0,0,0
183317.0,Tapia Cruz Alondra Denis,O,Dominican Republic,19.0,193,2023,Serbia,2023-07-01,True,0,0,0,0,0,0,0,0,0,0,2,2,0,0,0,0,0,0,0,0,0,0,0,0
143961.0,Hinojosa Diaz Angelica Maria,MB,Dominican Republic,27.0,186,2023,Japan,2023-05-30,False,0,0,0,0,0,0,0,0,0,0,0,0,0,0,0,0,0,0,0,0,0,0,0,0
143961.0,Hinojosa Diaz Angelica Maria,MB,Dominican Republic,27.0,186,2023,Bulgaria,2023-06-01,True,0,0,0,0,0,0,0,0,0,0,0,0,0,0,0,0,0,0,0,0,0,0,0,0
143961.0,Hinojosa Diaz Angelica Maria,MB,Dominican Republic,27.0,186,2023,Netherlands,2023-06-02,True,0,0,0,0,0,0,0,0,0,0,0,0,0,0,0,0,0,0,0,0,0,0,0,0
143961.0,Hinojosa Diaz Angelica Maria,MB,Dominican Republic,27.0,186,2023,Brazil,2023-06-03,False,0,0,0,0,0,0,0,0,0,0,0,0,0,0,0,0,0,0,0,0,0,0,0,0
143961.0,Hinojosa Diaz Angelica Maria,MB,Dominican Republic,27.0,186,2023,Poland,2023-06-13,False,0,0,0,0,0,0,0,0,0,0,0,0,0,0,0,0,0,0,0,0,0,0,0,0
143961.0,Hinojosa Diaz Angelica Maria,MB,Dominican Republic,27.0,186,2023,Italy,2023-06-15,False,0,0,0,0,0,0,0,0,0,0,0,0,0,0,0,0,0,0,0,0,0,0,0,0
143961.0,Hinojosa Diaz Angelica Maria,MB,Dominican Republic,27.0,186,2023,Canada,2023-06-17,True,0,0,0,0,0,0,0,0,0,0,0,0,0,0,0,0,0,0,0,0,0,0,0,0
143961.0,Hinojosa Diaz Angelica Maria,MB,Dominican Republic,27.0,186,2023,Germany,2023-06-27,False,1,1,6,8,0,0,0,0,1,1,2,4,0,0,0,0,0,0,0,0,0,1,0,1
143961.0,Hinojosa Diaz Angelica Maria,MB,Dominican Republic,27.0,186,2023,China,2023-06-30,True,0,0,0,0,1,0,2,3,0,0,0,0,0,0,0,0,0,0,0,0,0,0,0,0
143961.0,Hinojosa Diaz Angelica Maria,MB,Dominican Republic,27.0,186,2023,Serbia,2023-07-01,True,0,0,0,0,0,0,0,0,0,0,0,0,0,0,0,0,0,0,0,0,0,0,0,0
149530.0,Gonzalez Geraldine Sthefany,MB,Dominican Republic,21.0,200,2023,Japan,2023-05-30,False,0,0,0,0,0,0,0,0,0,0,0,0,0,0,1,1,0,0,0,0,0,0,0,0
149530.0,Gonzalez Geraldine Sthefany,MB,Dominican Republic,21.0,200,2023,Bulgaria,2023-06-01,True,0,0,0,0,0,0,0,0,0,0,0,0,0,0,0,0,0,0,0,0,0,0,0,0
149530.0,Gonzalez Geraldine Sthefany,MB,Dominican Republic,21.0,200,2023,Netherlands,2023-06-02,True,0,0,0,0,0,0,1,1,0,0,0,0,0,1,0,1,0,0,0,0,0,0,0,0
149530.0,Gonzalez Geraldine Sthefany,MB,Dominican Republic,21.0,200,2023,Brazil,2023-06-03,False,0,0,0,0,0,0,5,5,0,0,0,0,0,0,0,0,0,0,0,0,0,0,0,0
149530.0,Gonzalez Geraldine Sthefany,MB,Dominican Republic,21.0,200,2023,Poland,2023-06-13,False,0,0,0,0,0,0,0,0,0,0,0,0,0,0,0,0,0,0,0,0,1,0,0,1
149530.0,Gonzalez Geraldine Sthefany,MB,Dominican Republic,21.0,200,2023,Italy,2023-06-15,False,0,1,7,8,0,0,4,4,7,2,4,13,5,5,8,18,0,1,4,5,1,1,0,2
149530.0,Gonzalez Geraldine Sthefany,MB,Dominican Republic,21.0,200,2023,Canada,2023-06-17,True,0,4,11,15,0,0,2,2,1,2,5,8,4,8,5,17,0,0,0,0,3,1,2,6
149530.0,Gonzalez Geraldine Sthefany,MB,Dominican Republic,21.0,200,2023,Germany,2023-06-27,False,0,1,3,4,0,0,2,2,1,1,1,3,0,1,0,1,0,2,1,3,1,0,1,2
149530.0,Gonzalez Geraldine Sthefany,MB,Dominican Republic,21.0,200,2023,China,2023-06-30,True,0,3,4,7,0,0,2,2,3,1,7,11,2,4,5,11,0,0,0,0,2,1,1,4
149530.0,Gonzalez Geraldine Sthefany,MB,Dominican Republic,21.0,200,2023,Serbia,2023-07-01,True,0,2,7,9,0,0,2,2,1,3,5,9,1,4,4,9,0,0,4,4,1,1,0,2
139912.0,Perez Javier Yokaty,S,Dominican Republic,25.0,178,2023,Japan,2023-05-30,False,0,0,0,0,0,0,0,0,0,0,0,0,0,0,0,0,0,0,0,0,0,0,0,0
139912.0,Perez Javier Yokaty,S,Dominican Republic,25.0,178,2023,Bulgaria,2023-06-01,True,0,0,1,1,0,0,5,5,0,0,0,0,0,0,0,0,0,0,0,0,0,0,0,0
139912.0,Perez Javier Yokaty,S,Dominican Republic,25.0,178,2023,Netherlands,2023-06-02,True,0,0,0,0,0,0,2,2,0,0,0,0,0,0,0,0,0,0,0,0,0,0,0,0
139912.0,Perez Javier Yokaty,S,Dominican Republic,25.0,178,2023,Brazil,2023-06-03,False,0,0,1,1,0,0,0,0,0,0,0,0,0,0,0,0,0,0,0,0,0,0,0,0
139912.0,Perez Javier Yokaty,S,Dominican Republic,25.0,178,2023,Poland,2023-06-13,False,0,0,0,0,1,0,0,1,0,0,0,0,0,0,0,0,0,0,0,0,0,0,0,0
139912.0,Perez Javier Yokaty,S,Dominican Republic,25.0,178,2023,Italy,2023-06-15,False,0,0,0,0,0,0,6,6,0,0,0,0,0,0,0,0,0,0,0,0,0,1,0,1
139912.0,Perez Javier Yokaty,S,Dominican Republic,25.0,178,2023,Canada,2023-06-17,True,0,0,1,1,1,0,3,4,0,0,0,0,0,0,0,0,0,0,0,0,0,0,0,0
139912.0,Perez Javier Yokaty,S,Dominican Republic,25.0,178,2023,Germany,2023-06-27,False,0,0,0,0,0,0,6,6,0,0,0,0,0,0,0,0,0,0,0,0,0,1,0,1
139912.0,Perez Javier Yokaty,S,Dominican Republic,25.0,178,2023,China,2023-06-30,True,0,0,0,0,0,0,0,0,0,0,0,0,0,0,0,0,0,0,0,0,0,0,0,0
139912.0,Perez Javier Yokaty,S,Dominican Republic,25.0,178,2023,Serbia,2023-07-01,True,0,0,0,0,0,0,0,0,0,0,0,0,0,0,0,0,0,0,0,0,0,0,0,0
123978.0,Peña Isabel Yonkaira Paola,OH,Dominican Republic,30.0,190,2023,Japan,2023-05-30,False,0,3,13,16,0,0,4,4,12,12,16,40,1,4,2,7,4,2,27,33,18,2,2,22
123978.0,Peña Isabel Yonkaira Paola,OH,Dominican Republic,30.0,190,2023,Bulgaria,2023-06-01,True,1,3,16,20,0,0,3,3,13,7,14,34,2,2,5,9,7,1,28,36,19,0,3,22
123978.0,Peña Isabel Yonkaira Paola,OH,Dominican Republic,30.0,190,2023,Netherlands,2023-06-02,True,1,3,13,17,0,0,1,1,13,4,16,33,0,2,1,3,8,0,17,25,12,0,3,15
123978.0,Peña Isabel Yonkaira Paola,OH,Dominican Republic,30.0,190,2023,Brazil,2023-06-03,False,1,1,19,21,0,0,5,5,11,5,13,29,1,1,1,3,5,1,19,25,9,0,2,11
123978.0,Peña Isabel Yonkaira Paola,OH,Dominican Republic,30.0,190,2023,Poland,2023-06-13,False,1,3,8,12,0,0,3,3,12,7,9,28,1,5,4,10,5,1,34,40,9,6,1,16
123978.0,Peña Isabel Yonkaira Paola,OH,Dominican Republic,30.0,190,2023,Italy,2023-06-15,False,1,1,14,16,0,0,3,3,11,7,15,33,2,2,3,7,6,0,31,37,14,4,0,18
123978.0,Peña Isabel Yonkaira Paola,OH,Dominican Republic,30.0,190,2023,Canada,2023-06-17,True,0,2,19,21,0,0,3,3,18,1,13,32,2,1,4,7,3,1,37,41,14,2,2,18
123978.0,Peña Isabel Yonkaira Paola,OH,Dominican Republic,30.0,190,2023,Germany,2023-06-27,False,0,1,13,14,0,0,4,4,7,4,17,28,2,1,1,4,7,3,21,31,5,2,2,9
123978.0,Peña Isabel Yonkaira Paola,OH,Dominican Republic,30.0,190,2023,China,2023-06-30,True,0,1,7,8,0,0,0,0,4,5,11,20,3,2,0,5,7,0,20,27,7,2,0,9
123978.0,Peña Isabel Yonkaira Paola,OH,Dominican Republic,30.0,190,2023,Serbia,2023-07-01,True,1,1,27,29,0,0,1,1,19,3,16,38,0,3,2,5,5,2,31,38,6,4,1,11
123982.0,Martinez Brayelin Elizabeth,OH,Dominican Republic,27.0,201,2023,Japan,2023-05-30,False,2,0,13,15,0,0,0,0,13,3,26,42,2,0,2,4,1,1,32,34,15,4,5,24
123982.0,Martinez Brayelin Elizabeth,OH,Dominican Republic,27.0,201,2023,Bulgaria,2023-06-01,True,0,1,10,11,0,0,5,5,24,5,20,49,2,2,3,7,5,2,26,33,14,0,4,18
123982.0,Martinez Brayelin Elizabeth,OH,Dominican Republic,27.0,201,2023,Netherlands,2023-06-02,True,0,1,14,15,0,0,2,2,22,2,22,46,3,3,3,9,1,3,17,21,12,1,7,20
123982.0,Martinez Brayelin Elizabeth,OH,Dominican Republic,27.0,201,2023,Brazil,2023-06-03,False,0,3,13,16,0,0,2,2,12,5,14,31,3,3,2,8,6,2,18,26,16,1,2,19
123982.0,Martinez Brayelin Elizabeth,OH,Dominican Republic,27.0,201,2023,Poland,2023-06-13,False,0,1,13,14,0,0,0,0,19,7,21,47,2,5,2,9,2,2,22,26,5,2,0,7
123982.0,Martinez Brayelin Elizabeth,OH,Dominican Republic,27.0,201,2023,Italy,2023-06-15,False,1,2,17,20,0,0,3,3,14,7,21,42,3,3,1,7,3,0,25,28,9,5,2,16
123982.0,Martinez Brayelin Elizabeth,OH,Dominican Republic,27.0,201,2023,Canada,2023-06-17,True,1,2,18,21,0,0,5,5,12,3,22,37,4,1,4,9,1,1,19,21,9,2,1,12
123982.0,Martinez Brayelin Elizabeth,OH,Dominican Republic,27.0,201,2023,Germany,2023-06-27,False,0,1,15,16,0,0,2,2,18,2,16,36,3,3,1,7,5,1,16,22,8,4,1,13
123982.0,Martinez Brayelin Elizabeth,OH,Dominican Republic,27.0,201,2023,China,2023-06-30,True,1,2,15,18,0,0,3,3,18,6,20,44,0,2,2,4,5,1,22,28,5,3,1,9
123982.0,Martinez Brayelin Elizabeth,OH,Dominican Republic,27.0,201,2023,Serbia,2023-07-01,True,1,2,12,15,0,0,5,5,25,3,23,51,1,3,2,6,1,0,15,16,10,0,0,10
139910.0,Martinez Jineiry,MB,Dominican Republic,26.0,192,2023,Japan,2023-05-30,False,0,2,10,12,0,0,5,5,6,0,7,13,3,3,4,10,0,0,2,2,2,0,0,2
139910.0,Martinez Jineiry,MB,Dominican Republic,26.0,192,2023,Bulgaria,2023-06-01,True,0,0,11,11,0,0,4,4,14,1,4,19,2,1,5,8,0,0,0,0,3,0,2,5
139910.0,Martinez Jineiry,MB,Dominican Republic,26.0,192,2023,Netherlands,2023-06-02,True,1,3,11,15,0,0,2,2,6,1,9,16,1,6,5,12,0,0,0,0,6,0,0,6
139910.0,Martinez Jineiry,MB,Dominican Republic,26.0,192,2023,Brazil,2023-06-03,False,1,2,8,11,0,0,3,3,7,1,6,14,4,4,10,18,0,0,0,0,3,0,1,4
139910.0,Martinez Jineiry,MB,Dominican Republic,26.0,192,2023,Poland,2023-06-13,False,0,4,7,11,0,0,2,2,4,1,5,10,3,4,10,17,0,0,0,0,0,2,0,2
139910.0,Martinez Jineiry,MB,Dominican Republic,26.0,192,2023,Italy,2023-06-15,False,1,3,11,15,0,0,3,3,12,2,2,16,3,4,9,16,0,0,2,2,2,1,0,3
139910.0,Martinez Jineiry,MB,Dominican Republic,26.0,192,2023,Canada,2023-06-17,True,0,1,7,8,0,0,0,0,11,1,8,20,7,7,9,23,0,0,0,0,2,1,0,3
139910.0,Martinez Jineiry,MB,Dominican Republic,26.0,192,2023,Germany,2023-06-27,False,1,1,4,6,0,0,1,1,4,3,8,15,2,4,10,16,0,1,2,3,5,1,0,6
139910.0,Martinez Jineiry,MB,Dominican Republic,26.0,192,2023,China,2023-06-30,True,4,1,12,17,0,0,3,3,17,1,3,21,1,2,9,12,0,0,1,1,4,1,0,5
139910.0,Martinez Jineiry,MB,Dominican Republic,26.0,192,2023,Serbia,2023-07-01,True,0,3,8,11,0,0,2,2,5,2,6,13,4,3,7,14,0,0,1,1,2,0,0,2
139927.0,Gonzalez Lopez Gaila Ceneida,O,Dominican Republic,26.0,190,2023,Japan,2023-05-30,False,0,5,13,18,0,0,5,5,11,4,24,39,3,4,7,14,0,0,3,3,14,2,3,19
139927.0,Gonzalez Lopez Gaila Ceneida,O,Dominican Republic,26.0,190,2023,Bulgaria,2023-06-01,True,2,3,15,20,0,0,4,4,16,6,14,36,1,3,5,9,0,0,3,3,11,0,1,12
139927.0,Gonzalez Lopez Gaila Ceneida,O,Dominican Republic,26.0,190,2023,Netherlands,2023-06-02,True,2,2,14,18,0,0,1,1,17,5,16,38,3,2,2,7,1,0,2,3,5,0,2,7
139927.0,Gonzalez Lopez Gaila Ceneida,O,Dominican Republic,26.0,190,2023,Brazil,2023-06-03,False,1,2,13,16,0,0,1,1,18,12,18,48,3,4,3,10,3,0,1,4,3,0,3,6
139927.0,Gonzalez Lopez Gaila Ceneida,O,Dominican Republic,26.0,190,2023,Poland,2023-06-13,False,1,2,12,15,0,0,2,2,17,9,12,38,1,2,1,4,0,0,0,0,7,5,0,12
139927.0,Gonzalez Lopez Gaila Ceneida,O,Dominican Republic,26.0,190,2023,Italy,2023-06-15,False,0,4,12,16,0,0,2,2,11,8,16,35,3,4,6,13,0,0,4,4,7,5,0,12
139927.0,Gonzalez Lopez Gaila Ceneida,O,Dominican Republic,26.0,190,2023,Canada,2023-06-17,True,0,3,16,19,0,0,3,3,14,7,17,38,3,4,5,12,0,0,0,0,9,2,2,13
139927.0,Gonzalez Lopez Gaila Ceneida,O,Dominican Republic,26.0,190,2023,Germany,2023-06-27,False,1,4,7,12,0,1,2,3,15,9,13,37,1,2,3,6,0,0,0,0,8,1,1,10
139927.0,Gonzalez Lopez Gaila Ceneida,O,Dominican Republic,26.0,190,2023,China,2023-06-30,True,3,3,12,18,0,0,6,6,29,8,14,51,3,6,1,10,0,1,1,2,5,7,1,13
139927.0,Gonzalez Lopez Gaila Ceneida,O,Dominican Republic,26.0,190,2023,Serbia,2023-07-01,True,3,3,13,19,0,0,2,2,20,7,13,40,3,3,6,12,0,0,0,0,13,6,3,22
139913.0,Martinez Caro Larysmer,L,Dominican Republic,27.0,174,2023,Japan,2023-05-30,False,0,0,0,0,0,0,0,0,0,0,0,0,0,0,0,0,0,0,0,0,0,0,0,0
139913.0,Martinez Caro Larysmer,L,Dominican Republic,27.0,174,2023,Bulgaria,2023-06-01,True,0,0,0,0,0,0,1,1,0,0,0,0,0,0,0,0,0,0,0,0,0,0,0,0
139913.0,Martinez Caro Larysmer,L,Dominican Republic,27.0,174,2023,Netherlands,2023-06-02,True,0,0,0,0,0,0,0,0,0,0,0,0,0,0,0,0,2,1,3,6,3,0,0,3
139913.0,Martinez Caro Larysmer,L,Dominican Republic,27.0,174,2023,Brazil,2023-06-03,False,0,0,0,0,0,0,2,2,0,0,0,0,0,0,0,0,4,0,3,7,4,0,1,5
139913.0,Martinez Caro Larysmer,L,Dominican Republic,27.0,174,2023,Poland,2023-06-13,False,0,1,1,2,0,0,0,0,0,0,0,0,0,0,0,0,0,0,1,1,0,0,0,0
139913.0,Martinez Caro Larysmer,L,Dominican Republic,27.0,174,2023,Italy,2023-06-15,False,0,0,3,3,0,1,0,1,0,0,0,0,0,0,0,0,1,0,0,1,1,0,0,1
139913.0,Martinez Caro Larysmer,L,Dominican Republic,27.0,174,2023,Canada,2023-06-17,True,0,0,8,8,0,0,0,0,0,0,0,0,0,0,0,0,0,0,1,1,1,1,0,2
139913.0,Martinez Caro Larysmer,L,Dominican Republic,27.0,174,2023,Germany,2023-06-27,False,0,1,1,2,0,0,0,0,0,0,0,0,0,0,0,0,0,0,0,0,0,0,0,0
139913.0,Martinez Caro Larysmer,L,Dominican Republic,27.0,174,2023,China,2023-06-30,True,0,0,8,8,0,0,0,0,0,0,0,0,0,0,0,0,1,0,0,1,4,0,0,4
139913.0,Martinez Caro Larysmer,L,Dominican Republic,27.0,174,2023,Serbia,2023-07-01,True,0,1,3,4,0,0,0,0,0,0,0,0,0,0,0,0,0,0,4,4,2,2,0,4
151011.0,Agbortabi Vanessa,OH,Germany,25.0,181,2023,Netherlands,2023-05-30,True,0,0,0,0,0,0,2,2,0,0,0,0,0,0,0,0,0,0,1,1,1,0,1,2
151011.0,Agbortabi Vanessa,OH,Germany,25.0,181,2023,Croatia,2023-06-01,True,0,0,0,0,0,0,0,0,0,0,0,0,0,0,0,0,0,0,0,0,0,0,0,0
151011.0,Agbortabi Vanessa,OH,Germany,25.0,181,2023,China,2023-06-02,False,0,0,0,0,0,0,0,0,0,0,0,0,0,0,0,0,0,0,0,0,0,0,0,0
151011.0,Agbortabi Vanessa,OH,Germany,25.0,181,2023,Bulgaria,2023-06-04,True,0,0,0,0,0,0,0,0,0,0,0,0,0,0,0,0,0,0,0,0,0,0,0,0
151011.0,Agbortabi Vanessa,OH,Germany,25.0,181,2023,Thailand,2023-06-14,True,0,0,1,1,0,0,0,0,0,0,0,0,0,0,0,0,0,0,0,0,0,0,0,0
151011.0,Agbortabi Vanessa,OH,Germany,25.0,181,2023,Japan,2023-06-16,True,0,0,0,0,0,0,0,0,0,0,0,0,0,0,0,0,0,0,1,1,0,0,0,0
151011.0,Agbortabi Vanessa,OH,Germany,25.0,181,2023,Brazil,2023-06-17,False,1,0,14,15,0,0,7,7,9,6,16,31,2,4,3,9,2,2,22,26,8,2,0,10
151011.0,Agbortabi Vanessa,OH,Germany,25.0,181,2023,Dominican Republic,2023-06-27,True,0,0,0,0,0,0,0,0,0,0,0,0,0,0,0,0,0,0,0,0,0,0,0,0
151011.0,Agbortabi Vanessa,OH,Germany,25.0,181,2023,Poland,2023-06-29,False,0,0,0,0,0,0,0,0,0,0,0,0,0,0,0,0,0,0,0,0,0,0,0,0
151011.0,Agbortabi Vanessa,OH,Germany,25.0,181,2023,Serbia,2023-06-30,False,0,0,1,1,0,0,0,0,1,0,0,1,0,0,0,0,0,0,2,2,0,0,0,0
151011.0,Agbortabi Vanessa,OH,Germany,25.0,181,2023,USA,2023-07-01,False,0,1,0,1,0,0,0,0,0,0,0,0,0,0,0,0,1,0,1,2,1,0,1,2
151011.0,Agbortabi Vanessa,OH,Germany,25.0,181,2023,Poland,2023-07-12,False,0,0,0,0,0,0,0,0,0,0,0,0,0,0,0,0,0,0,0,0,0,0,0,0
150973.0,Kästner Pia,S,Germany,25.0,182,2023,Netherlands,2023-05-30,True,0,1,15,16,26,0,81,107,0,0,1,1,0,5,2,7,0,0,0,0,10,3,3,16
150973.0,Kästner Pia,S,Germany,25.0,182,2023,Croatia,2023-06-01,True,2,1,9,12,8,0,89,97,0,0,1,1,0,0,2,2,0,0,0,0,7,0,1,8
150973.0,Kästner Pia,S,Germany,25.0,182,2023,China,2023-06-02,False,2,0,8,10,11,1,66,78,0,0,1,1,0,1,1,2,0,0,0,0,2,0,0,2
150973.0,Kästner Pia,S,Germany,25.0,182,2023,Bulgaria,2023-06-04,True,1,2,17,20,9,0,122,131,0,1,0,1,0,4,2,6,0,0,1,1,7,0,1,8
150973.0,Kästner Pia,S,Germany,25.0,182,2023,Thailand,2023-06-14,True,1,1,16,18,40,2,70,112,1,0,0,1,3,0,5,8,0,0,0,0,6,2,2,10
150973.0,Kästner Pia,S,Germany,25.0,182,2023,Japan,2023-06-16,True,1,0,16,17,42,1,84,127,0,0,3,3,1,4,3,8,0,0,0,0,10,4,2,16
150973.0,Kästner Pia,S,Germany,25.0,182,2023,Brazil,2023-06-17,False,0,0,0,0,0,0,0,0,0,0,0,0,0,0,0,0,0,0,0,0,0,0,0,0
150973.0,Kästner Pia,S,Germany,25.0,182,2023,Dominican Republic,2023-06-27,True,3,2,8,13,41,1,60,102,1,0,0,1,0,1,2,3,0,0,0,0,9,6,3,18
150973.0,Kästner Pia,S,Germany,25.0,182,2023,Poland,2023-06-29,False,0,1,13,14,25,1,92,118,0,0,1,1,0,2,2,4,0,0,0,0,10,6,0,16
150973.0,Kästner Pia,S,Germany,25.0,182,2023,Serbia,2023-06-30,False,1,0,12,13,23,0,60,83,1,0,1,2,0,0,2,2,0,0,1,1,7,10,0,17
150973.0,Kästner Pia,S,Germany,25.0,182,2023,USA,2023-07-01,False,1,0,12,13,11,0,70,81,0,0,1,1,1,0,1,2,0,0,0,0,8,3,2,13
150973.0,Kästner Pia,S,Germany,25.0,182,2023,Poland,2023-07-12,False,1,0,13,14,33,3,89,125,0,0,3,3,0,2,5,7,0,0,0,0,4,1,2,7
158238.0,Cesar Annie,L,Germany,26.0,173,2023,Netherlands,2023-05-30,True,0,0,0,0,0,0,0,0,0,0,0,0,0,0,0,0,0,0,0,0,0,0,0,0
158238.0,Cesar Annie,L,Germany,26.0,173,2023,Croatia,2023-06-01,True,0,0,0,0,0,0,0,0,0,0,0,0,0,0,0,0,0,0,0,0,0,0,0,0
158238.0,Cesar Annie,L,Germany,26.0,173,2023,China,2023-06-02,False,0,0,0,0,0,0,0,0,0,0,0,0,0,0,0,0,0,0,0,0,1,0,0,1
158238.0,Cesar Annie,L,Germany,26.0,173,2023,Bulgaria,2023-06-04,True,0,0,0,0,0,0,0,0,0,0,0,0,0,0,0,0,0,0,0,0,0,0,0,0
158238.0,Cesar Annie,L,Germany,26.0,173,2023,Thailand,2023-06-14,True,0,0,0,0,0,0,0,0,0,0,0,0,0,0,0,0,0,0,0,0,0,0,1,1
158238.0,Cesar Annie,L,Germany,26.0,173,2023,Japan,2023-06-16,True,0,0,0,0,0,0,0,0,0,0,0,0,0,0,0,0,0,0,0,0,0,0,0,0
158238.0,Cesar Annie,L,Germany,26.0,173,2023,Brazil,2023-06-17,False,0,0,0,0,0,0,11,11,0,0,0,0,0,0,0,0,4,0,22,26,14,6,3,23
158238.0,Cesar Annie,L,Germany,26.0,173,2023,Dominican Republic,2023-06-27,True,0,0,0,0,0,0,0,0,0,0,0,0,0,0,0,0,0,0,0,0,0,0,0,0
158238.0,Cesar Annie,L,Germany,26.0,173,2023,Poland,2023-06-29,False,0,0,0,0,0,0,0,0,0,0,0,0,0,0,0,0,0,0,0,0,0,0,0,0
158238.0,Cesar Annie,L,Germany,26.0,173,2023,Serbia,2023-06-30,False,0,0,0,0,0,0,0,0,0,0,0,0,0,0,0,0,0,0,0,0,0,0,0,0
158238.0,Cesar Annie,L,Germany,26.0,173,2023,USA,2023-07-01,False,0,0,0,0,0,0,0,0,0,0,0,0,0,0,0,0,0,0,0,0,0,1,0,1
158238.0,Cesar Annie,L,Germany,26.0,173,2023,Poland,2023-07-12,False,0,0,0,0,0,0,0,0,0,0,0,0,0,0,0,0,0,0,0,0,0,0,0,0
136671.0,Pogany Anna,L,Germany,29.0,170,2023,Netherlands,2023-05-30,True,0,0,0,0,0,0,11,11,0,0,0,0,0,0,0,0,6,1,7,14,9,8,7,24
136671.0,Pogany Anna,L,Germany,29.0,170,2023,Croatia,2023-06-01,True,0,0,0,0,0,0,6,6,0,0,0,0,0,0,0,0,7,0,11,18,12,0,1,13
136671.0,Pogany Anna,L,Germany,29.0,170,2023,China,2023-06-02,False,0,0,0,0,0,0,7,7,0,0,0,0,0,0,0,0,5,0,16,21,11,1,1,13
136671.0,Pogany Anna,L,Germany,29.0,170,2023,Bulgaria,2023-06-04,True,0,0,0,0,0,0,13,13,0,0,0,0,0,0,0,0,3,1,13,17,16,0,3,19
136671.0,Pogany Anna,L,Germany,29.0,170,2023,Thailand,2023-06-14,True,0,0,0,0,0,0,10,10,0,0,0,0,0,0,0,0,5,0,13,18,12,5,3,20
136671.0,Pogany Anna,L,Germany,29.0,170,2023,Japan,2023-06-16,True,0,0,0,0,0,0,14,14,0,0,0,0,0,0,0,0,6,2,12,20,23,3,1,27
136671.0,Pogany Anna,L,Germany,29.0,170,2023,Brazil,2023-06-17,False,0,0,0,0,0,0,0,0,0,0,0,0,0,0,0,0,0,0,2,2,1,2,1,4
136671.0,Pogany Anna,L,Germany,29.0,170,2023,Dominican Republic,2023-06-27,True,0,0,0,0,0,0,13,13,0,0,0,0,0,0,0,0,14,1,13,28,15,7,4,26
136671.0,Pogany Anna,L,Germany,29.0,170,2023,Poland,2023-06-29,False,0,0,0,0,0,0,13,13,0,0,0,0,0,0,0,0,7,0,16,23,15,11,2,28
136671.0,Pogany Anna,L,Germany,29.0,170,2023,Serbia,2023-06-30,False,0,0,0,0,0,0,8,8,0,0,0,0,0,0,0,0,3,0,20,23,11,6,0,17
136671.0,Pogany Anna,L,Germany,29.0,170,2023,USA,2023-07-01,False,0,0,0,0,0,0,17,17,0,0,0,0,0,0,0,0,2,0,12,14,15,6,4,25
136671.0,Pogany Anna,L,Germany,29.0,170,2023,Poland,2023-07-12,False,0,0,0,0,0,0,6,6,0,0,0,0,0,0,0,0,8,1,11,20,14,10,2,26
163661.0,Glaab Corina,S,Germany,23.0,180,2023,Netherlands,2023-05-30,True,0,0,0,0,0,0,0,0,0,0,0,0,0,0,0,0,0,0,0,0,0,0,0,0
163661.0,Glaab Corina,S,Germany,23.0,180,2023,Croatia,2023-06-01,True,0,0,0,0,0,0,0,0,0,0,0,0,0,0,0,0,0,0,0,0,0,0,0,0
163661.0,Glaab Corina,S,Germany,23.0,180,2023,China,2023-06-02,False,0,0,0,0,2,0,11,13,0,0,0,0,0,0,0,0,0,0,0,0,1,0,0,1
163661.0,Glaab Corina,S,Germany,23.0,180,2023,Bulgaria,2023-06-04,True,0,0,0,0,0,0,0,0,0,0,0,0,0,0,0,0,0,0,0,0,0,0,0,0
163661.0,Glaab Corina,S,Germany,23.0,180,2023,Thailand,2023-06-14,True,0,0,0,0,0,0,0,0,0,0,0,0,0,0,0,0,0,0,0,0,0,0,0,0
163661.0,Glaab Corina,S,Germany,23.0,180,2023,Japan,2023-06-16,True,0,0,0,0,0,0,3,3,0,0,0,0,0,1,0,1,0,0,0,0,1,0,0,1
163661.0,Glaab Corina,S,Germany,23.0,180,2023,Brazil,2023-06-17,False,0,2,11,13,32,1,82,115,0,0,1,1,0,3,4,7,0,0,0,0,7,4,3,14
163661.0,Glaab Corina,S,Germany,23.0,180,2023,Dominican Republic,2023-06-27,True,0,0,1,1,2,0,4,6,0,0,0,0,0,0,1,1,0,0,0,0,1,0,0,1
163661.0,Glaab Corina,S,Germany,23.0,180,2023,Poland,2023-06-29,False,0,0,0,0,0,0,0,0,0,0,0,0,0,0,0,0,0,0,0,0,0,0,0,0
163661.0,Glaab Corina,S,Germany,23.0,180,2023,Serbia,2023-06-30,False,0,0,3,3,3,0,17,20,0,0,0,0,1,0,2,3,0,0,0,0,1,2,2,5
163661.0,Glaab Corina,S,Germany,23.0,180,2023,USA,2023-07-01,False,0,0,2,2,4,0,11,15,0,0,1,1,0,0,0,0,0,0,0,0,2,1,0,3
163661.0,Glaab Corina,S,Germany,23.0,180,2023,Poland,2023-07-12,False,0,0,1,1,0,0,2,2,0,0,0,0,0,0,0,0,0,0,0,0,0,0,0,0
157403.0,Stautz Antonia,OH,Germany,30.0,180,2023,Netherlands,2023-05-30,True,1,0,4,5,0,0,0,0,0,0,0,0,0,0,0,0,0,0,0,0,0,0,0,0
157403.0,Stautz Antonia,OH,Germany,30.0,180,2023,Croatia,2023-06-01,True,1,0,4,5,0,0,0,0,0,0,0,0,0,0,0,0,0,0,0,0,1,0,0,1
157403.0,Stautz Antonia,OH,Germany,30.0,180,2023,China,2023-06-02,False,0,2,2,4,0,0,0,0,0,0,0,0,0,0,0,0,1,0,1,2,0,0,1,1
157403.0,Stautz Antonia,OH,Germany,30.0,180,2023,Bulgaria,2023-06-04,True,0,0,9,9,0,0,0,0,0,0,1,1,0,0,0,0,0,0,0,0,0,0,0,0
157403.0,Stautz Antonia,OH,Germany,30.0,180,2023,Thailand,2023-06-14,True,0,0,7,7,0,0,1,1,0,0,3,3,0,0,1,1,0,0,4,4,1,2,0,3
157403.0,Stautz Antonia,OH,Germany,30.0,180,2023,Japan,2023-06-16,True,0,1,6,7,0,0,0,0,0,0,0,0,0,0,0,0,1,2,0,3,1,0,0,1
157403.0,Stautz Antonia,OH,Germany,30.0,180,2023,Brazil,2023-06-17,False,1,2,11,14,0,0,3,3,10,3,15,28,0,2,0,2,3,3,17,23,9,3,1,13
157403.0,Stautz Antonia,OH,Germany,30.0,180,2023,Dominican Republic,2023-06-27,True,0,0,6,6,0,0,1,1,1,2,3,6,0,0,0,0,0,0,2,2,5,1,0,6
157403.0,Stautz Antonia,OH,Germany,30.0,180,2023,Poland,2023-06-29,False,0,0,6,6,0,0,0,0,0,0,0,0,0,0,0,0,0,0,0,0,1,1,0,2
157403.0,Stautz Antonia,OH,Germany,30.0,180,2023,Serbia,2023-06-30,False,1,1,7,9,0,0,1,1,0,1,1,2,0,1,0,1,2,0,7,9,0,2,0,2
157403.0,Stautz Antonia,OH,Germany,30.0,180,2023,USA,2023-07-01,False,0,2,4,6,0,0,1,1,2,1,2,5,0,0,3,3,1,1,10,12,1,0,1,2
157403.0,Stautz Antonia,OH,Germany,30.0,180,2023,Poland,2023-07-12,False,0,0,2,2,0,0,0,0,0,0,0,0,0,0,0,0,0,0,0,0,0,0,0,0
163658.0,Alsmeier Lina,OH,Germany,23.0,189,2023,Netherlands,2023-05-30,True,0,0,16,16,0,0,1,1,10,4,18,32,5,2,2,9,8,3,22,33,4,3,7,14
163658.0,Alsmeier Lina,OH,Germany,23.0,189,2023,Croatia,2023-06-01,True,0,0,7,7,0,0,2,2,6,9,14,29,0,0,0,0,10,2,18,30,11,1,4,16
163658.0,Alsmeier Lina,OH,Germany,23.0,189,2023,China,2023-06-02,False,0,2,7,9,0,0,0,0,8,2,11,21,1,1,0,2,1,0,5,6,3,0,0,3
163658.0,Alsmeier Lina,OH,Germany,23.0,189,2023,Bulgaria,2023-06-04,True,2,3,12,17,0,0,1,1,11,4,15,30,3,1,2,6,10,1,20,31,15,0,4,19
163658.0,Alsmeier Lina,OH,Germany,23.0,189,2023,Thailand,2023-06-14,True,0,1,7,8,1,0,2,3,6,4,11,21,2,4,2,8,2,0,2,4,9,1,3,13
163658.0,Alsmeier Lina,OH,Germany,23.0,189,2023,Japan,2023-06-16,True,1,0,17,18,0,0,5,5,14,5,14,33,1,3,2,6,10,0,17,27,10,4,3,17
163658.0,Alsmeier Lina,OH,Germany,23.0,189,2023,Brazil,2023-06-17,False,0,0,0,0,0,0,0,0,0,0,0,0,0,0,0,0,0,0,0,0,0,0,0,0
163658.0,Alsmeier Lina,OH,Germany,23.0,189,2023,Dominican Republic,2023-06-27,True,2,1,8,11,0,0,1,1,2,3,21,26,0,2,2,4,2,0,4,6,11,3,0,14
163658.0,Alsmeier Lina,OH,Germany,23.0,189,2023,Poland,2023-06-29,False,0,1,14,15,0,0,1,1,20,6,12,38,2,1,1,4,11,1,16,28,9,3,2,14
163658.0,Alsmeier Lina,OH,Germany,23.0,189,2023,Serbia,2023-06-30,False,0,2,7,9,0,0,3,3,13,2,17,32,1,3,2,6,5,2,5,12,3,3,1,7
163658.0,Alsmeier Lina,OH,Germany,23.0,189,2023,USA,2023-07-01,False,0,2,10,12,0,0,5,5,8,2,12,22,0,4,3,7,11,4,20,35,5,2,2,9
163658.0,Alsmeier Lina,OH,Germany,23.0,189,2023,Poland,2023-07-12,False,1,2,10,13,0,0,3,3,14,3,23,40,0,1,0,1,5,0,13,18,12,5,1,18
144980.0,Stigrot Lena,OH,Germany,29.0,184,2023,Netherlands,2023-05-30,True,1,0,10,11,0,0,2,2,8,6,14,28,0,2,4,6,9,2,17,28,7,0,4,11
144980.0,Stigrot Lena,OH,Germany,29.0,184,2023,Croatia,2023-06-01,True,2,0,10,12,0,0,4,4,8,2,9,19,1,1,0,2,1,0,6,7,4,0,0,4
144980.0,Stigrot Lena,OH,Germany,29.0,184,2023,China,2023-06-02,False,0,0,7,7,0,0,2,2,5,2,10,17,0,1,1,2,3,0,9,12,8,0,1,9
144980.0,Stigrot Lena,OH,Germany,29.0,184,2023,Bulgaria,2023-06-04,True,1,0,10,11,0,0,2,2,15,2,19,36,1,3,3,7,3,2,21,26,8,0,0,8
144980.0,Stigrot Lena,OH,Germany,29.0,184,2023,Thailand,2023-06-14,True,0,2,12,14,0,0,2,2,12,0,11,23,1,3,1,5,5,0,22,27,8,4,1,13
144980.0,Stigrot Lena,OH,Germany,29.0,184,2023,Japan,2023-06-16,True,0,1,11,12,0,0,5,5,8,2,22,32,2,3,2,7,4,1,31,36,13,3,1,17
144980.0,Stigrot Lena,OH,Germany,29.0,184,2023,Brazil,2023-06-17,False,0,0,3,3,0,0,0,0,1,0,1,2,0,2,1,3,1,1,6,8,1,1,0,2
144980.0,Stigrot Lena,OH,Germany,29.0,184,2023,Dominican Republic,2023-06-27,True,1,0,10,11,0,0,1,1,17,4,10,31,1,1,1,3,6,0,8,14,5,4,0,9
144980.0,Stigrot Lena,OH,Germany,29.0,184,2023,Poland,2023-06-29,False,2,0,14,16,0,0,5,5,13,4,14,31,1,4,4,9,6,2,23,31,11,2,0,13
144980.0,Stigrot Lena,OH,Germany,29.0,184,2023,Serbia,2023-06-30,False,0,1,6,7,0,0,2,2,7,4,11,22,0,1,1,2,14,1,18,33,7,4,1,12
144980.0,Stigrot Lena,OH,Germany,29.0,184,2023,USA,2023-07-01,False,0,1,5,6,0,0,10,10,10,3,20,33,0,1,5,6,2,1,8,11,6,1,0,7
144980.0,Stigrot Lena,OH,Germany,29.0,184,2023,Poland,2023-07-12,False,0,0,9,9,0,0,2,2,8,3,9,20,2,3,4,9,16,0,23,39,7,5,1,13
151016.0,Orthmann Hanna,OH,Germany,25.0,-,2023,Netherlands,2023-05-30,True,5,2,11,18,0,0,2,2,18,5,14,37,1,1,5,7,0,0,0,0,8,1,3,12
151016.0,Orthmann Hanna,OH,Germany,25.0,-,2023,Croatia,2023-06-01,True,3,2,7,12,0,0,1,1,20,4,13,37,0,3,0,3,0,0,4,4,7,1,0,8
151016.0,Orthmann Hanna,OH,Germany,25.0,-,2023,China,2023-06-02,False,2,2,7,11,0,0,0,0,15,7,14,36,2,0,3,5,10,0,19,29,6,0,4,10
151016.0,Orthmann Hanna,OH,Germany,25.0,-,2023,Bulgaria,2023-06-04,True,0,6,8,14,0,0,1,1,13,6,20,39,0,1,1,2,3,1,12,16,9,1,4,14
151016.0,Orthmann Hanna,OH,Germany,25.0,-,2023,Thailand,2023-06-14,True,1,5,1,7,0,0,0,0,13,5,15,33,2,3,1,6,7,1,14,22,9,1,1,11
151016.0,Orthmann Hanna,OH,Germany,25.0,-,2023,Japan,2023-06-16,True,1,4,7,12,0,0,3,3,21,6,25,52,1,1,7,9,0,1,6,7,8,1,2,11
151016.0,Orthmann Hanna,OH,Germany,25.0,-,2023,Brazil,2023-06-17,False,0,0,0,0,0,0,0,0,2,3,3,8,0,0,1,1,0,0,3,3,1,0,0,1
151016.0,Orthmann Hanna,OH,Germany,25.0,-,2023,Dominican Republic,2023-06-27,True,0,4,11,15,0,0,2,2,16,8,12,36,3,2,2,7,11,1,8,20,5,0,0,5
151016.0,Orthmann Hanna,OH,Germany,25.0,-,2023,Poland,2023-06-29,False,1,3,11,15,0,0,7,7,16,9,25,50,2,1,4,7,0,1,6,7,8,4,1,13
151016.0,Orthmann Hanna,OH,Germany,25.0,-,2023,Serbia,2023-06-30,False,0,4,4,8,0,0,2,2,7,4,12,23,1,2,1,4,1,0,6,7,4,6,1,11
151016.0,Orthmann Hanna,OH,Germany,25.0,-,2023,USA,2023-07-01,False,0,1,5,6,0,1,1,2,13,3,18,34,0,5,2,7,4,0,8,12,6,4,2,12
151016.0,Orthmann Hanna,OH,Germany,25.0,-,2023,Poland,2023-07-12,False,1,3,7,11,0,0,1,1,21,8,21,50,0,0,4,4,4,0,7,11,6,1,1,8
150812.0,Schölzel Marie,MB,Germany,26.0,190,2023,Netherlands,2023-05-30,True,0,0,2,2,0,0,0,0,2,2,1,5,0,3,2,5,0,0,0,0,0,0,1,1
150812.0,Schölzel Marie,MB,Germany,26.0,190,2023,Croatia,2023-06-01,True,1,0,4,5,0,0,2,2,7,1,4,12,1,5,2,8,1,0,0,1,4,1,0,5
150812.0,Schölzel Marie,MB,Germany,26.0,190,2023,China,2023-06-02,False,0,0,3,3,0,0,0,0,5,2,4,11,0,0,4,4,0,0,0,0,2,0,0,2
150812.0,Schölzel Marie,MB,Germany,26.0,190,2023,Bulgaria,2023-06-04,True,0,1,7,8,0,0,1,1,8,2,6,16,4,6,6,16,0,0,0,0,2,0,1,3
150812.0,Schölzel Marie,MB,Germany,26.0,190,2023,Thailand,2023-06-14,True,1,1,14,16,0,0,1,1,12,3,10,25,1,3,4,8,0,0,0,0,1,1,0,2
150812.0,Schölzel Marie,MB,Germany,26.0,190,2023,Japan,2023-06-16,True,0,1,8,9,0,0,0,0,11,2,6,19,5,5,6,16,0,0,0,0,5,1,0,6
150812.0,Schölzel Marie,MB,Germany,26.0,190,2023,Brazil,2023-06-17,False,0,0,0,0,0,0,0,0,0,0,0,0,0,0,0,0,0,0,0,0,0,0,0,0
150812.0,Schölzel Marie,MB,Germany,26.0,190,2023,Dominican Republic,2023-06-27,True,0,0,1,1,0,0,0,0,2,2,1,5,0,3,2,5,0,0,0,0,1,0,0,1
150812.0,Schölzel Marie,MB,Germany,26.0,190,2023,Poland,2023-06-29,False,0,0,0,0,0,0,0,0,0,0,0,0,0,0,0,0,0,0,0,0,0,0,0,0
150812.0,Schölzel Marie,MB,Germany,26.0,190,2023,Serbia,2023-06-30,False,0,1,5,6,0,0,1,1,5,0,2,7,0,1,2,3,0,0,0,0,2,0,1,3
150812.0,Schölzel Marie,MB,Germany,26.0,190,2023,USA,2023-07-01,False,0,1,4,5,0,0,0,0,5,1,6,12,2,7,4,13,0,0,0,0,0,3,0,3
150812.0,Schölzel Marie,MB,Germany,26.0,190,2023,Poland,2023-07-12,False,0,1,5,6,0,0,2,2,4,2,4,10,0,2,4,6,0,0,0,0,2,0,0,2
177765.0,Cekulaev Anastasia,MB,Germany,20.0,187,2023,Netherlands,2023-05-30,True,0,0,0,0,0,0,0,0,0,0,0,0,0,0,0,0,0,0,0,0,0,0,0,0
177765.0,Cekulaev Anastasia,MB,Germany,20.0,187,2023,Croatia,2023-06-01,True,0,0,0,0,0,0,0,0,0,0,0,0,0,0,0,0,0,0,0,0,0,0,0,0
177765.0,Cekulaev Anastasia,MB,Germany,20.0,187,2023,China,2023-06-02,False,0,0,0,0,0,0,0,0,0,0,0,0,0,0,0,0,0,0,0,0,0,0,0,0
177765.0,Cekulaev Anastasia,MB,Germany,20.0,187,2023,Bulgaria,2023-06-04,True,0,0,0,0,0,0,0,0,0,0,0,0,0,0,0,0,0,0,0,0,0,0,0,0
177765.0,Cekulaev Anastasia,MB,Germany,20.0,187,2023,Thailand,2023-06-14,True,0,0,0,0,0,0,0,0,0,0,0,0,0,0,0,0,0,0,0,0,0,0,0,0
177765.0,Cekulaev Anastasia,MB,Germany,20.0,187,2023,Japan,2023-06-16,True,0,0,0,0,0,0,0,0,0,0,0,0,0,0,0,0,0,0,0,0,0,0,0,0
177765.0,Cekulaev Anastasia,MB,Germany,20.0,187,2023,Brazil,2023-06-17,False,0,3,5,8,0,0,0,0,0,1,4,5,0,5,1,6,0,0,0,0,2,1,0,3
177765.0,Cekulaev Anastasia,MB,Germany,20.0,187,2023,Poland,2023-07-12,False,0,0,0,0,0,0,1,1,0,0,0,0,0,0,0,0,0,0,0,0,0,0,0,0
163939.0,Weske Emilia,O,Germany,22.0,188,2023,Thailand,2023-06-14,True,0,0,3,3,0,0,0,0,0,1,3,4,1,0,1,2,0,0,0,0,3,0,1,4
163939.0,Weske Emilia,O,Germany,22.0,188,2023,Japan,2023-06-16,True,0,0,2,2,0,0,0,0,3,0,1,4,0,0,0,0,0,0,0,0,0,0,0,0
163939.0,Weske Emilia,O,Germany,22.0,188,2023,Brazil,2023-06-17,False,0,1,11,12,0,0,0,0,26,5,13,44,2,3,3,8,0,0,0,0,13,2,4,19
163939.0,Weske Emilia,O,Germany,22.0,188,2023,Dominican Republic,2023-06-27,True,0,0,1,1,0,0,0,0,2,2,3,7,0,0,1,1,0,0,0,0,1,0,0,1
163939.0,Weske Emilia,O,Germany,22.0,188,2023,Poland,2023-06-29,False,0,0,0,0,0,0,0,0,0,0,0,0,0,0,1,1,0,0,0,0,0,0,0,0
163939.0,Weske Emilia,O,Germany,22.0,188,2023,Serbia,2023-06-30,False,0,0,7,7,0,0,0,0,3,4,4,11,1,0,0,1,0,0,0,0,2,2,0,4
163939.0,Weske Emilia,O,Germany,22.0,188,2023,USA,2023-07-01,False,2,1,6,9,0,0,0,0,1,1,6,8,2,0,1,3,0,0,0,0,3,0,0,3
163939.0,Weske Emilia,O,Germany,22.0,188,2023,Poland,2023-07-12,False,1,0,5,6,0,0,0,0,0,2,3,5,0,2,0,2,0,0,0,0,0,0,0,0
153929.0,Weitzel Camilla,MB,Germany,23.0,195,2023,Netherlands,2023-05-30,True,1,2,11,14,0,0,2,2,7,2,5,14,4,4,9,17,0,0,0,0,2,1,3,6
153929.0,Weitzel Camilla,MB,Germany,23.0,195,2023,Croatia,2023-06-01,True,1,2,12,15,0,0,1,1,9,1,9,19,3,1,8,12,1,0,1,2,5,0,0,5
153929.0,Weitzel Camilla,MB,Germany,23.0,195,2023,China,2023-06-02,False,1,3,10,14,0,0,2,2,6,0,8,14,1,4,1,6,0,0,0,0,2,0,0,2
153929.0,Weitzel Camilla,MB,Germany,23.0,195,2023,Bulgaria,2023-06-04,True,2,1,16,19,0,0,1,1,9,1,10,20,3,3,3,9,0,0,0,0,3,0,0,3
153929.0,Weitzel Camilla,MB,Germany,23.0,195,2023,Thailand,2023-06-14,True,1,0,15,16,0,0,3,3,13,0,11,24,3,5,9,17,0,0,0,0,4,0,1,5
153929.0,Weitzel Camilla,MB,Germany,23.0,195,2023,Japan,2023-06-16,True,3,2,13,18,0,0,2,2,8,2,12,22,2,9,8,19,0,0,0,0,4,4,1,9
153929.0,Weitzel Camilla,MB,Germany,23.0,195,2023,Brazil,2023-06-17,False,1,0,4,5,0,0,5,5,1,0,0,1,4,1,3,8,0,0,0,0,0,0,0,0
153929.0,Weitzel Camilla,MB,Germany,23.0,195,2023,Dominican Republic,2023-06-27,True,2,1,15,18,0,0,1,1,5,0,9,14,0,5,7,12,0,0,0,0,1,0,0,1
153929.0,Weitzel Camilla,MB,Germany,23.0,195,2023,Poland,2023-06-29,False,1,2,17,20,0,0,5,5,11,0,8,19,4,10,8,22,1,0,0,1,7,0,1,8
153929.0,Weitzel Camilla,MB,Germany,23.0,195,2023,Serbia,2023-06-30,False,2,1,12,15,0,1,6,7,14,1,11,26,0,3,9,12,0,0,0,0,3,1,2,6
153929.0,Weitzel Camilla,MB,Germany,23.0,195,2023,USA,2023-07-01,False,0,2,14,16,0,0,7,7,8,1,12,21,7,6,10,23,0,0,0,0,3,0,1,4
153929.0,Weitzel Camilla,MB,Germany,23.0,195,2023,Poland,2023-07-12,False,2,2,10,14,0,0,1,1,10,0,3,13,1,4,6,11,0,1,0,1,4,0,0,4
182628.0,Strubbe Monique,MB,Germany,22.0,189,2023,Netherlands,2023-05-30,True,1,1,10,12,0,0,0,0,3,1,4,8,1,1,2,4,0,0,0,0,1,0,1,2
182628.0,Strubbe Monique,MB,Germany,22.0,189,2023,Croatia,2023-06-01,True,0,1,4,5,0,0,1,1,0,0,0,0,0,1,1,2,0,0,0,0,0,0,0,0
182628.0,Strubbe Monique,MB,Germany,22.0,189,2023,China,2023-06-02,False,0,0,4,4,0,0,0,0,0,1,0,1,0,1,0,1,0,0,0,0,0,0,0,0
182628.0,Strubbe Monique,MB,Germany,22.0,189,2023,Bulgaria,2023-06-04,True,0,1,2,3,0,0,0,0,0,0,0,0,0,0,0,0,0,0,0,0,1,0,0,1
182628.0,Strubbe Monique,MB,Germany,22.0,189,2023,Thailand,2023-06-14,True,0,0,3,3,0,0,1,1,0,0,0,0,0,0,0,0,0,0,0,0,1,0,0,1
182628.0,Strubbe Monique,MB,Germany,22.0,189,2023,Japan,2023-06-16,True,0,0,3,3,0,0,0,0,0,0,0,0,0,0,0,0,0,0,0,0,0,0,0,0
182628.0,Strubbe Monique,MB,Germany,22.0,189,2023,Brazil,2023-06-17,False,0,1,12,13,0,0,2,2,7,2,10,19,0,3,12,15,0,0,0,0,1,2,2,5
182628.0,Strubbe Monique,MB,Germany,22.0,189,2023,Dominican Republic,2023-06-27,True,1,1,13,15,0,0,1,1,3,1,3,7,2,2,6,10,0,0,0,0,2,0,0,2
182628.0,Strubbe Monique,MB,Germany,22.0,189,2023,Poland,2023-06-29,False,0,1,17,18,0,0,2,2,5,2,5,12,3,9,9,21,0,0,0,0,3,1,2,6
182628.0,Strubbe Monique,MB,Germany,22.0,189,2023,Serbia,2023-06-30,False,1,0,6,7,0,0,0,0,0,1,2,3,1,1,3,5,0,0,0,0,1,1,1,3
182628.0,Strubbe Monique,MB,Germany,22.0,189,2023,USA,2023-07-01,False,2,0,5,7,0,0,1,1,1,0,0,1,0,0,0,0,0,0,0,0,0,2,0,2
182628.0,Strubbe Monique,MB,Germany,22.0,189,2023,Poland,2023-07-12,False,0,1,6,7,0,0,2,2,0,1,2,3,2,3,4,9,0,0,0,0,4,0,1,5
143370.0,Degradi Alice Carlotta,OH,Italy,27.0,182,2023,Thailand,2023-05-30,True,2,2,6,10,0,0,2,2,7,6,10,23,1,2,3,6,4,1,18,23,5,2,1,8
143370.0,Degradi Alice Carlotta,OH,Italy,27.0,182,2023,Poland,2023-06-01,False,0,4,3,7,0,0,1,1,9,5,11,25,2,2,4,8,5,0,18,23,3,1,0,4
143370.0,Degradi Alice Carlotta,OH,Italy,27.0,182,2023,USA,2023-06-02,False,0,0,0,0,0,0,0,0,0,0,0,0,0,0,0,0,0,0,0,0,0,0,0,0
143370.0,Degradi Alice Carlotta,OH,Italy,27.0,182,2023,Bulgaria,2023-06-14,True,0,0,0,0,0,0,0,0,0,0,0,0,0,0,0,0,0,0,0,0,0,0,0,0
143370.0,Degradi Alice Carlotta,OH,Italy,27.0,182,2023,Dominican Republic,2023-06-15,True,0,0,2,2,0,0,0,0,1,1,1,3,0,1,0,1,0,0,4,4,0,1,0,1
143370.0,Degradi Alice Carlotta,OH,Italy,27.0,182,2023,Netherlands,2023-06-17,True,0,0,0,0,0,0,0,0,0,0,0,0,0,0,0,0,0,0,0,0,0,0,0,0
143370.0,Degradi Alice Carlotta,OH,Italy,27.0,182,2023,China,2023-06-18,True,0,2,5,7,0,0,0,0,14,4,4,22,0,0,0,0,2,0,19,21,3,2,1,6
143370.0,Degradi Alice Carlotta,OH,Italy,27.0,182,2023,Brazil,2023-06-28,False,0,2,0,2,0,0,2,2,2,3,3,8,0,0,1,1,1,1,6,8,0,0,1,1
143370.0,Degradi Alice Carlotta,OH,Italy,27.0,182,2023,Canada,2023-06-30,True,4,1,15,20,0,0,3,3,15,5,13,33,2,2,4,8,2,2,15,19,7,1,1,9
143370.0,Degradi Alice Carlotta,OH,Italy,27.0,182,2023,Croatia,2023-07-01,True,2,2,8,12,0,1,4,5,11,4,11,26,0,0,6,6,6,1,19,26,11,0,0,11
143370.0,Degradi Alice Carlotta,OH,Italy,27.0,182,2023,Japan,2023-07-02,True,0,2,1,3,0,0,1,1,5,3,7,15,1,0,1,2,2,0,13,15,6,0,1,7
142394.0,Villani Francesca,OH,Italy,28.0,186,2023,Brazil,2023-06-28,False,0,2,11,13,0,0,6,6,19,4,16,39,2,0,1,3,4,2,26,32,10,4,1,15
142394.0,Villani Francesca,OH,Italy,28.0,186,2023,Canada,2023-06-30,True,1,4,13,18,0,0,4,4,19,6,13,38,1,1,1,3,12,2,23,37,11,2,1,14
142394.0,Villani Francesca,OH,Italy,28.0,186,2023,Croatia,2023-07-01,True,1,0,5,6,0,0,7,7,3,2,6,11,1,0,1,2,4,0,4,8,1,0,0,1
142394.0,Villani Francesca,OH,Italy,28.0,186,2023,Japan,2023-07-02,True,0,1,0,1,0,0,1,1,2,4,2,8,0,0,0,0,0,2,7,9,1,2,0,3
151986.0,Bosio Francesca,S,Italy,26.0,-,2023,Thailand,2023-05-30,True,0,0,19,19,25,0,110,135,1,0,0,1,2,3,4,9,0,0,0,0,5,4,4,13
151986.0,Bosio Francesca,S,Italy,26.0,-,2023,Poland,2023-06-01,False,2,0,10,12,17,1,74,92,0,0,0,0,0,3,3,6,0,0,0,0,2,2,2,6
151986.0,Bosio Francesca,S,Italy,26.0,-,2023,USA,2023-06-02,False,0,1,13,14,3,2,97,102,2,0,1,3,2,0,5,7,0,0,0,0,6,1,4,11
151986.0,Bosio Francesca,S,Italy,26.0,-,2023,Bulgaria,2023-06-14,True,0,0,11,11,12,0,57,69,2,1,0,3,1,5,8,14,0,1,0,1,9,3,0,12
151986.0,Bosio Francesca,S,Italy,26.0,-,2023,Dominican Republic,2023-06-15,True,0,0,12,12,32,1,81,114,0,0,0,0,2,3,7,12,0,0,0,0,6,4,0,10
151986.0,Bosio Francesca,S,Italy,26.0,-,2023,Netherlands,2023-06-17,True,0,0,15,15,21,0,95,116,0,0,1,1,2,2,3,7,0,0,0,0,7,5,1,13
151986.0,Bosio Francesca,S,Italy,26.0,-,2023,China,2023-06-18,True,0,1,12,13,27,0,89,116,0,0,2,2,1,1,3,5,0,0,0,0,7,1,2,10
151986.0,Bosio Francesca,S,Italy,26.0,-,2023,Brazil,2023-06-28,False,0,1,11,12,13,0,93,106,1,1,2,4,2,4,5,11,0,0,0,0,6,3,0,9
151986.0,Bosio Francesca,S,Italy,26.0,-,2023,Canada,2023-06-30,True,1,0,15,16,26,0,95,121,0,0,0,0,2,1,0,3,0,0,0,0,3,4,0,7
151986.0,Bosio Francesca,S,Italy,26.0,-,2023,Croatia,2023-07-01,True,0,0,14,14,11,0,63,74,2,1,0,3,2,1,2,5,0,0,0,0,11,0,1,12
151986.0,Bosio Francesca,S,Italy,26.0,-,2023,Japan,2023-07-02,True,1,0,16,17,11,0,96,107,0,0,2,2,2,3,6,11,0,0,0,0,4,1,1,6
173402.0,Fersino Eleonora,L,Italy,24.0,-,2023,Bulgaria,2023-06-14,True,0,0,0,0,0,0,0,0,0,0,0,0,0,0,0,0,2,0,0,2,0,1,0,1
173402.0,Fersino Eleonora,L,Italy,24.0,-,2023,Dominican Republic,2023-06-15,True,0,0,0,0,0,0,3,3,0,0,0,0,0,0,0,0,1,0,2,3,1,2,0,3
173402.0,Fersino Eleonora,L,Italy,24.0,-,2023,Netherlands,2023-06-17,True,0,0,0,0,0,0,1,1,0,0,0,0,0,0,0,0,2,1,2,5,0,0,2,2
173402.0,Fersino Eleonora,L,Italy,24.0,-,2023,China,2023-06-18,True,0,0,0,0,0,1,4,5,0,0,0,0,0,0,0,0,4,0,4,8,15,2,3,20
173402.0,Fersino Eleonora,L,Italy,24.0,-,2023,Brazil,2023-06-28,False,0,0,0,0,0,0,12,12,0,0,0,0,0,0,0,0,3,0,11,14,8,4,4,16
173402.0,Fersino Eleonora,L,Italy,24.0,-,2023,Canada,2023-06-30,True,0,0,0,0,0,0,6,6,0,0,0,0,0,0,0,0,9,1,13,23,18,3,2,23
173402.0,Fersino Eleonora,L,Italy,24.0,-,2023,Croatia,2023-07-01,True,0,0,0,0,0,0,0,0,0,0,0,0,0,0,0,0,0,0,0,0,0,0,0,0
136694.0,Danesi Anna,MB,Italy,27.0,-,2023,Thailand,2023-05-30,True,0,1,14,15,0,0,1,1,9,2,4,15,3,6,9,18,0,0,0,0,3,2,0,5
136694.0,Danesi Anna,MB,Italy,27.0,-,2023,Poland,2023-06-01,False,0,0,10,10,0,0,0,0,5,1,4,10,2,4,3,9,0,0,0,0,0,0,0,0
136694.0,Danesi Anna,MB,Italy,27.0,-,2023,USA,2023-06-02,False,0,1,10,11,0,0,1,1,2,2,3,7,2,3,4,9,0,1,1,2,0,2,0,2
136694.0,Danesi Anna,MB,Italy,27.0,-,2023,Bulgaria,2023-06-14,True,0,1,12,13,0,0,0,0,6,0,2,8,0,0,4,4,2,0,1,3,0,0,1,1
136694.0,Danesi Anna,MB,Italy,27.0,-,2023,Dominican Republic,2023-06-15,True,1,3,11,15,0,0,2,2,8,3,4,15,2,6,7,15,0,0,2,2,0,2,0,2
136694.0,Danesi Anna,MB,Italy,27.0,-,2023,Netherlands,2023-06-17,True,2,1,14,17,0,0,1,1,10,1,2,13,5,6,5,16,0,0,0,0,2,2,0,4
136694.0,Danesi Anna,MB,Italy,27.0,-,2023,China,2023-06-18,True,0,0,15,15,0,0,3,3,8,4,3,15,2,2,3,7,0,0,0,0,2,1,0,3
136694.0,Danesi Anna,MB,Italy,27.0,-,2023,Brazil,2023-06-28,False,0,0,12,12,0,0,1,1,5,0,5,10,0,7,1,8,0,0,0,0,3,4,0,7
136694.0,Danesi Anna,MB,Italy,27.0,-,2023,Canada,2023-06-30,True,0,3,16,19,0,0,0,0,7,2,4,13,3,6,4,13,0,0,0,0,3,1,0,4
136694.0,Danesi Anna,MB,Italy,27.0,-,2023,Croatia,2023-07-01,True,2,0,10,12,0,0,1,1,3,1,3,7,4,2,2,8,1,0,0,1,1,1,0,2
136694.0,Danesi Anna,MB,Italy,27.0,-,2023,Japan,2023-07-02,True,1,1,15,17,0,0,2,2,4,1,8,13,4,3,5,12,0,0,0,0,5,0,0,5
151661.0,Mazzaro Alessia,MB,Italy,25.0,184,2023,Thailand,2023-05-30,True,1,1,21,23,0,0,1,1,7,1,7,15,0,2,5,7,0,0,0,0,6,2,4,12
151661.0,Mazzaro Alessia,MB,Italy,25.0,184,2023,Poland,2023-06-01,False,0,0,1,1,0,0,0,0,0,0,0,0,0,2,0,2,0,0,0,0,0,0,0,0
151661.0,Mazzaro Alessia,MB,Italy,25.0,184,2023,USA,2023-06-02,False,0,1,2,3,0,0,0,0,1,0,0,1,0,1,1,2,0,0,0,0,0,0,0,0
151661.0,Mazzaro Alessia,MB,Italy,25.0,184,2023,Bulgaria,2023-06-14,True,1,1,13,15,0,0,0,0,3,0,6,9,4,3,2,9,0,0,0,0,3,0,1,4
151661.0,Mazzaro Alessia,MB,Italy,25.0,184,2023,Dominican Republic,2023-06-15,True,0,1,5,6,0,0,0,0,2,0,1,3,0,1,2,3,0,0,0,0,1,0,0,1
151661.0,Mazzaro Alessia,MB,Italy,25.0,184,2023,Netherlands,2023-06-17,True,0,0,13,13,0,0,0,0,3,1,4,8,1,2,4,7,0,0,1,1,3,1,2,6
151661.0,Mazzaro Alessia,MB,Italy,25.0,184,2023,China,2023-06-18,True,1,2,10,13,0,0,1,1,6,0,4,10,3,3,4,10,0,0,0,0,5,1,2,8
151661.0,Mazzaro Alessia,MB,Italy,25.0,184,2023,Brazil,2023-06-28,False,0,0,11,11,0,0,3,3,5,0,2,7,3,4,9,16,0,0,0,0,3,0,1,4
151661.0,Mazzaro Alessia,MB,Italy,25.0,184,2023,Canada,2023-06-30,True,0,0,11,11,0,0,1,1,7,1,2,10,6,0,7,13,0,0,0,0,5,3,1,9
151661.0,Mazzaro Alessia,MB,Italy,25.0,184,2023,Croatia,2023-07-01,True,1,2,8,11,0,0,2,2,3,1,3,7,0,1,3,4,1,0,1,2,2,0,0,2
151661.0,Mazzaro Alessia,MB,Italy,25.0,184,2023,Japan,2023-07-02,True,0,1,9,10,0,0,0,0,2,0,0,2,2,1,3,6,0,1,1,2,3,0,2,5
151664.0,Nwakalor Sylvia Chinelo,O,Italy,24.0,176,2023,Thailand,2023-05-30,True,1,3,7,11,0,0,2,2,19,5,17,41,4,1,2,7,0,0,0,0,2,2,0,4
151664.0,Nwakalor Sylvia Chinelo,O,Italy,24.0,176,2023,Poland,2023-06-01,False,1,1,10,12,0,0,1,1,15,3,13,31,1,2,6,9,0,0,0,0,4,3,1,8
151664.0,Nwakalor Sylvia Chinelo,O,Italy,24.0,176,2023,USA,2023-06-02,False,0,2,20,22,0,0,1,1,17,7,15,39,3,3,1,7,0,0,0,0,15,1,2,18
151664.0,Nwakalor Sylvia Chinelo,O,Italy,24.0,176,2023,Bulgaria,2023-06-14,True,1,1,14,16,0,0,3,3,15,2,8,25,2,6,6,14,0,0,0,0,5,4,1,10
151664.0,Nwakalor Sylvia Chinelo,O,Italy,24.0,176,2023,Dominican Republic,2023-06-15,True,0,2,16,18,0,0,4,4,18,7,17,42,3,3,5,11,0,0,0,0,10,2,0,12
151664.0,Nwakalor Sylvia Chinelo,O,Italy,24.0,176,2023,Netherlands,2023-06-17,True,0,1,17,18,0,0,1,1,22,9,16,47,1,5,0,6,0,0,0,0,10,6,2,18
151664.0,Nwakalor Sylvia Chinelo,O,Italy,24.0,176,2023,China,2023-06-18,True,0,3,11,14,0,0,3,3,12,5,16,33,3,0,0,3,0,0,0,0,8,0,1,9
151664.0,Nwakalor Sylvia Chinelo,O,Italy,24.0,176,2023,Brazil,2023-06-28,False,0,2,15,17,0,0,0,0,20,7,14,41,1,3,3,7,0,0,1,1,5,6,4,15
151664.0,Nwakalor Sylvia Chinelo,O,Italy,24.0,176,2023,Canada,2023-06-30,True,0,4,15,19,0,0,2,2,14,6,17,37,3,3,0,6,0,0,0,0,3,1,0,4
151664.0,Nwakalor Sylvia Chinelo,O,Italy,24.0,176,2023,Croatia,2023-07-01,True,0,0,10,10,0,0,1,1,17,7,10,34,3,2,1,6,0,0,0,0,8,1,1,10
151664.0,Nwakalor Sylvia Chinelo,O,Italy,24.0,176,2023,Japan,2023-07-02,True,0,1,14,15,0,0,4,4,18,6,18,42,5,5,10,20,0,0,0,0,9,3,1,13
143391.0,D'Odorico Sofia,OH,Italy,27.0,186,2023,Thailand,2023-05-30,True,0,3,8,11,0,0,3,3,8,2,7,17,1,0,2,3,6,0,17,23,6,3,3,12
143391.0,D'Odorico Sofia,OH,Italy,27.0,186,2023,Poland,2023-06-01,False,0,2,4,6,0,0,1,1,3,2,6,11,1,2,0,3,2,1,10,13,2,0,0,2
143391.0,D'Odorico Sofia,OH,Italy,27.0,186,2023,USA,2023-06-02,False,0,0,0,0,0,0,0,0,0,0,0,0,0,0,0,0,0,0,0,0,0,0,0,0
143391.0,D'Odorico Sofia,OH,Italy,27.0,186,2023,Bulgaria,2023-06-14,True,0,0,0,0,0,0,0,0,0,0,0,0,0,0,0,0,0,0,0,0,0,0,0,0
143391.0,D'Odorico Sofia,OH,Italy,27.0,186,2023,Dominican Republic,2023-06-15,True,0,0,0,0,0,0,0,0,0,0,0,0,0,0,0,0,0,0,0,0,0,0,0,0
143391.0,D'Odorico Sofia,OH,Italy,27.0,186,2023,Netherlands,2023-06-17,True,0,0,0,0,0,0,0,0,0,0,0,0,0,0,0,0,0,0,0,0,0,0,0,0
143391.0,D'Odorico Sofia,OH,Italy,27.0,186,2023,China,2023-06-18,True,1,0,3,4,0,0,0,0,0,0,0,0,0,0,0,0,1,1,0,2,2,0,0,2
143391.0,D'Odorico Sofia,OH,Italy,27.0,186,2023,Brazil,2023-06-28,False,0,2,0,2,0,0,0,0,0,0,0,0,0,0,0,0,1,1,1,3,1,0,0,1
143391.0,D'Odorico Sofia,OH,Italy,27.0,186,2023,Canada,2023-06-30,True,0,0,0,0,0,0,0,0,0,0,0,0,0,0,0,0,0,0,0,0,0,0,0,0
143391.0,D'Odorico Sofia,OH,Italy,27.0,186,2023,Croatia,2023-07-01,True,0,0,2,2,0,0,1,1,2,0,1,3,0,0,0,0,0,0,1,1,3,0,0,3
143391.0,D'Odorico Sofia,OH,Italy,27.0,186,2023,Japan,2023-07-02,True,0,2,2,4,0,0,2,2,8,2,9,19,0,2,3,5,4,4,18,26,5,0,1,6
136701.0,Sylla Myriam Fatime,OH,Italy,29.0,184,2023,Thailand,2023-05-30,True,0,0,0,0,0,0,0,0,0,0,0,0,0,0,0,0,0,0,0,0,0,0,0,0
136701.0,Sylla Myriam Fatime,OH,Italy,29.0,184,2023,Poland,2023-06-01,False,0,0,0,0,0,0,0,0,0,0,0,0,0,0,0,0,0,0,0,0,0,0,0,0
136701.0,Sylla Myriam Fatime,OH,Italy,29.0,184,2023,USA,2023-06-02,False,0,1,13,14,0,0,11,11,16,6,15,37,0,4,1,5,1,0,10,11,6,5,5,16
136701.0,Sylla Myriam Fatime,OH,Italy,29.0,184,2023,Bulgaria,2023-06-14,True,0,1,6,7,0,0,6,6,10,3,6,19,0,1,4,5,3,2,18,23,8,3,0,11
136701.0,Sylla Myriam Fatime,OH,Italy,29.0,184,2023,Dominican Republic,2023-06-15,True,0,1,17,18,0,0,7,7,14,5,17,36,1,2,1,4,18,2,35,55,11,6,3,20
136701.0,Sylla Myriam Fatime,OH,Italy,29.0,184,2023,Netherlands,2023-06-17,True,1,2,16,19,0,0,6,6,23,5,12,40,2,5,1,8,11,3,42,56,11,7,3,21
136701.0,Sylla Myriam Fatime,OH,Italy,29.0,184,2023,China,2023-06-18,True,0,0,16,16,0,0,8,8,15,2,20,37,0,0,1,1,11,1,24,36,5,5,2,12
173917.0,Squarcini Federica,MB,Italy,23.0,181,2023,Thailand,2023-05-30,True,1,2,3,6,0,0,0,0,0,0,0,0,0,0,0,0,0,0,0,0,1,1,0,2
173917.0,Squarcini Federica,MB,Italy,23.0,181,2023,Poland,2023-06-01,False,1,5,4,10,0,0,0,0,7,3,5,15,2,5,5,12,0,0,0,0,1,0,0,1
173917.0,Squarcini Federica,MB,Italy,23.0,181,2023,USA,2023-06-02,False,3,6,7,16,0,0,2,2,5,4,9,18,2,6,6,14,0,0,0,0,1,0,1,2
173917.0,Squarcini Federica,MB,Italy,23.0,181,2023,Bulgaria,2023-06-14,True,0,0,0,0,0,0,0,0,0,0,0,0,0,0,0,0,0,0,0,0,0,0,0,0
173917.0,Squarcini Federica,MB,Italy,23.0,181,2023,Dominican Republic,2023-06-15,True,0,5,8,13,0,0,0,0,4,1,5,10,2,1,3,6,0,0,0,0,1,1,0,2
173917.0,Squarcini Federica,MB,Italy,23.0,181,2023,Netherlands,2023-06-17,True,0,3,5,8,0,0,0,0,2,0,1,3,0,1,0,1,0,0,0,0,0,0,0,0
173917.0,Squarcini Federica,MB,Italy,23.0,181,2023,China,2023-06-18,True,0,3,5,8,0,0,0,0,4,0,0,4,0,0,0,0,0,0,2,2,0,1,0,1
173917.0,Squarcini Federica,MB,Italy,23.0,181,2023,Brazil,2023-06-28,False,0,0,0,0,0,0,0,0,0,0,0,0,0,0,0,0,0,0,0,0,0,0,0,0
173917.0,Squarcini Federica,MB,Italy,23.0,181,2023,Canada,2023-06-30,True,0,2,3,5,0,0,0,0,0,0,0,0,0,0,0,0,0,0,0,0,0,0,0,0
173917.0,Squarcini Federica,MB,Italy,23.0,181,2023,Croatia,2023-07-01,True,0,0,0,0,0,0,0,0,0,0,0,0,0,0,0,0,0,0,0,0,0,0,0,0
173917.0,Squarcini Federica,MB,Italy,23.0,181,2023,Japan,2023-07-02,True,0,2,2,4,0,0,0,0,1,2,0,3,2,0,4,6,0,0,0,0,0,0,1,1
136689.0,Parrocchiale Beatrice,L,Italy,28.0,168,2023,Thailand,2023-05-30,True,0,0,0,0,0,0,8,8,0,0,0,0,0,0,0,0,6,0,18,24,21,9,2,32
136689.0,Parrocchiale Beatrice,L,Italy,28.0,168,2023,USA,2023-06-02,False,0,0,0,0,0,0,0,0,0,0,0,0,0,0,0,0,0,0,0,0,0,0,0,0
136689.0,Parrocchiale Beatrice,L,Italy,28.0,168,2023,Bulgaria,2023-06-14,True,0,0,0,0,0,0,11,11,0,0,0,0,0,0,0,0,0,0,2,2,12,2,0,14
136689.0,Parrocchiale Beatrice,L,Italy,28.0,168,2023,Dominican Republic,2023-06-15,True,0,0,0,0,0,0,6,6,0,0,0,0,0,0,0,0,1,0,6,7,21,9,1,31
136689.0,Parrocchiale Beatrice,L,Italy,28.0,168,2023,Netherlands,2023-06-17,True,0,0,0,0,0,0,12,12,0,0,0,0,0,0,0,0,3,2,10,15,11,5,0,16
136689.0,Parrocchiale Beatrice,L,Italy,28.0,168,2023,China,2023-06-18,True,0,0,0,0,0,0,0,0,0,0,0,0,0,0,0,0,0,0,0,0,0,0,0,0
136689.0,Parrocchiale Beatrice,L,Italy,28.0,168,2023,Brazil,2023-06-28,False,0,0,0,0,0,0,0,0,0,0,0,0,0,0,0,0,0,0,0,0,0,0,0,0
136689.0,Parrocchiale Beatrice,L,Italy,28.0,168,2023,Canada,2023-06-30,True,0,0,0,0,0,0,0,0,0,0,0,0,0,0,0,0,0,0,0,0,0,0,0,0
136689.0,Parrocchiale Beatrice,L,Italy,28.0,168,2023,Croatia,2023-07-01,True,0,0,0,0,0,0,6,6,0,0,0,0,0,0,0,0,1,0,3,4,18,2,0,20
136689.0,Parrocchiale Beatrice,L,Italy,28.0,168,2023,Japan,2023-07-02,True,0,0,0,0,0,0,11,11,0,0,0,0,0,0,0,0,5,1,9,15,22,4,1,27
173730.0,Omoruyi Oghosasere Loveth,OH,Italy,21.0,184,2023,Thailand,2023-05-30,True,2,0,18,20,0,0,3,3,16,4,18,38,4,2,1,7,6,1,25,32,18,2,1,21
173730.0,Omoruyi Oghosasere Loveth,OH,Italy,21.0,184,2023,Poland,2023-06-01,False,1,1,13,15,0,0,2,2,7,5,11,23,1,2,1,4,6,2,31,39,13,2,1,16
173730.0,Omoruyi Oghosasere Loveth,OH,Italy,21.0,184,2023,USA,2023-06-02,False,1,1,10,12,0,0,4,4,16,3,14,33,0,5,2,7,6,2,53,61,7,2,2,11
173730.0,Omoruyi Oghosasere Loveth,OH,Italy,21.0,184,2023,Bulgaria,2023-06-14,True,1,1,10,12,0,0,0,0,6,5,12,23,1,3,1,5,3,2,15,20,8,6,2,16
173730.0,Omoruyi Oghosasere Loveth,OH,Italy,21.0,184,2023,Dominican Republic,2023-06-15,True,0,1,14,15,0,0,1,1,11,5,17,33,3,0,0,3,3,1,12,16,7,2,2,11
173730.0,Omoruyi Oghosasere Loveth,OH,Italy,21.0,184,2023,Netherlands,2023-06-17,True,1,1,16,18,0,0,3,3,16,4,16,36,2,3,2,7,2,2,20,24,6,7,1,14
173730.0,Omoruyi Oghosasere Loveth,OH,Italy,21.0,184,2023,China,2023-06-18,True,0,1,5,6,0,0,5,5,6,6,9,21,2,1,1,4,5,1,26,32,4,1,0,5
173730.0,Omoruyi Oghosasere Loveth,OH,Italy,21.0,184,2023,Brazil,2023-06-28,False,1,2,26,29,0,0,3,3,11,8,14,33,2,2,2,6,7,1,36,44,7,6,1,14
173730.0,Omoruyi Oghosasere Loveth,OH,Italy,21.0,184,2023,Canada,2023-06-30,True,0,0,2,2,0,0,0,0,2,0,6,8,0,2,0,2,0,2,7,9,4,2,0,6
173730.0,Omoruyi Oghosasere Loveth,OH,Italy,21.0,184,2023,Croatia,2023-07-01,True,0,1,5,6,0,0,4,4,3,2,8,13,1,2,4,7,1,1,2,4,2,0,0,2
173730.0,Omoruyi Oghosasere Loveth,OH,Italy,21.0,184,2023,Japan,2023-07-02,True,0,1,14,15,0,0,4,4,16,4,16,36,2,1,2,5,6,0,14,20,11,0,0,11
143396.0,Gennari Giulia,S,Italy,27.0,184,2023,Bulgaria,2023-06-14,True,0,0,0,0,0,0,0,0,0,0,0,0,0,0,0,0,0,0,0,0,0,0,0,0
143396.0,Gennari Giulia,S,Italy,27.0,184,2023,Dominican Republic,2023-06-15,True,0,0,0,0,3,0,5,8,0,0,0,0,0,0,0,0,0,0,0,0,2,0,0,2
143396.0,Gennari Giulia,S,Italy,27.0,184,2023,Netherlands,2023-06-17,True,0,1,0,1,0,0,0,0,0,0,0,0,0,0,0,0,0,0,0,0,0,0,0,0
143396.0,Gennari Giulia,S,Italy,27.0,184,2023,China,2023-06-18,True,1,0,3,4,0,0,1,1,0,0,0,0,0,0,0,0,0,0,0,0,0,0,0,0
143396.0,Gennari Giulia,S,Italy,27.0,184,2023,Brazil,2023-06-28,False,0,1,4,5,5,0,17,22,0,0,0,0,1,0,2,3,0,0,0,0,4,0,1,5
143396.0,Gennari Giulia,S,Italy,27.0,184,2023,Canada,2023-06-30,True,0,1,0,1,0,0,2,2,0,0,0,0,0,0,0,0,0,0,0,0,1,0,0,1
143396.0,Gennari Giulia,S,Italy,27.0,184,2023,Croatia,2023-07-01,True,0,0,0,0,1,0,1,2,0,0,0,0,0,0,0,0,0,0,0,0,0,2,0,2
143396.0,Gennari Giulia,S,Italy,27.0,184,2023,Japan,2023-07-02,True,1,0,3,4,1,0,13,14,0,0,0,0,0,1,0,1,0,0,0,0,0,1,0,1
173731.0,Malual Adhuoljok John Majak,O,Italy,23.0,188,2023,Thailand,2023-05-30,True,0,1,3,4,0,0,2,2,4,4,5,13,1,1,0,2,0,0,0,0,2,0,0,2
173731.0,Malual Adhuoljok John Majak,O,Italy,23.0,188,2023,Poland,2023-06-01,False,0,1,1,2,0,0,0,0,1,2,3,6,0,1,0,1,0,0,0,0,0,0,0,0
173731.0,Malual Adhuoljok John Majak,O,Italy,23.0,188,2023,USA,2023-06-02,False,0,2,1,3,0,0,0,0,1,1,0,2,0,1,0,1,0,0,0,0,0,0,0,0
173731.0,Malual Adhuoljok John Majak,O,Italy,23.0,188,2023,Bulgaria,2023-06-14,True,0,0,0,0,0,0,0,0,0,0,0,0,0,0,0,0,0,0,0,0,0,0,0,0
173731.0,Malual Adhuoljok John Majak,O,Italy,23.0,188,2023,Dominican Republic,2023-06-15,True,0,0,2,2,0,0,0,0,1,3,0,4,0,0,1,1,0,0,0,0,0,0,0,0
173731.0,Malual Adhuoljok John Majak,O,Italy,23.0,188,2023,Netherlands,2023-06-17,True,0,0,0,0,0,0,0,0,0,0,0,0,0,0,0,0,0,0,0,0,0,0,0,0
173731.0,Malual Adhuoljok John Majak,O,Italy,23.0,188,2023,China,2023-06-18,True,0,2,3,5,0,0,1,1,3,2,1,6,0,2,0,2,0,0,0,0,0,1,0,1
173731.0,Malual Adhuoljok John Majak,O,Italy,23.0,188,2023,Brazil,2023-06-28,False,0,0,1,1,0,0,0,0,6,2,5,13,0,1,2,3,0,0,0,0,1,0,0,1
173731.0,Malual Adhuoljok John Majak,O,Italy,23.0,188,2023,Canada,2023-06-30,True,0,0,0,0,0,0,0,0,0,0,1,1,0,0,0,0,0,0,0,0,1,0,0,1
173731.0,Malual Adhuoljok John Majak,O,Italy,23.0,188,2023,Croatia,2023-07-01,True,0,0,0,0,0,0,0,0,1,0,0,1,0,0,0,0,0,0,0,0,0,0,0,0
173731.0,Malual Adhuoljok John Majak,O,Italy,23.0,188,2023,Japan,2023-07-02,True,0,0,1,1,0,0,0,0,2,1,3,6,0,1,0,1,0,0,1,1,0,0,0,0
119385.0,Nagaoka Miyu,O,Japan,32.0,179,2023,Netherlands,2023-06-30,False,0,1,0,1,0,0,0,0,0,0,0,0,0,0,0,0,0,0,0,0,0,0,0,0
119385.0,Nagaoka Miyu,O,Japan,32.0,179,2023,Thailand,2023-07-01,True,0,0,0,0,0,0,0,0,0,0,0,0,0,0,0,0,0,0,0,0,0,0,0,0
119385.0,Nagaoka Miyu,O,Japan,32.0,179,2023,Italy,2023-07-02,False,0,0,12,12,0,0,4,4,13,6,24,43,2,3,3,8,0,0,0,0,10,6,4,20
151953.0,Hayashi Kotona,OH,Japan,24.0,173,2023,Dominican Republic,2023-05-30,True,1,1,19,21,0,0,5,5,9,3,13,25,0,1,4,5,2,0,5,7,23,2,1,26
151953.0,Hayashi Kotona,OH,Japan,24.0,173,2023,Croatia,2023-06-02,True,0,1,8,9,0,0,2,2,11,1,10,22,1,0,3,4,4,0,2,6,6,0,7,13
151953.0,Hayashi Kotona,OH,Japan,24.0,173,2023,Bulgaria,2023-06-03,True,0,1,3,4,0,0,1,1,10,1,7,18,1,1,1,3,6,1,6,13,5,1,0,6
151953.0,Hayashi Kotona,OH,Japan,24.0,173,2023,China,2023-06-04,False,0,0,11,11,0,0,6,6,13,3,7,23,0,1,1,2,2,0,7,9,7,0,3,10
151953.0,Hayashi Kotona,OH,Japan,24.0,173,2023,Germany,2023-06-16,False,0,0,9,9,0,0,8,8,12,2,18,32,0,4,1,5,5,2,18,25,14,3,1,18
151953.0,Hayashi Kotona,OH,Japan,24.0,173,2023,USA,2023-06-17,True,0,0,0,0,0,0,0,0,0,0,0,0,0,0,0,0,0,0,0,0,0,0,0,0
151953.0,Hayashi Kotona,OH,Japan,24.0,173,2023,Netherlands,2023-06-30,False,1,1,12,14,0,0,5,5,7,8,6,21,0,2,0,2,12,1,15,28,7,2,2,11
151953.0,Hayashi Kotona,OH,Japan,24.0,173,2023,Thailand,2023-07-01,True,0,0,6,6,0,0,1,1,13,1,14,28,0,0,4,4,2,0,7,9,10,1,0,11
151953.0,Hayashi Kotona,OH,Japan,24.0,173,2023,Italy,2023-07-02,False,0,0,0,0,0,0,0,0,0,0,0,0,0,0,0,0,4,0,5,9,2,0,0,2
143437.0,Nishida Sarina,OH,Japan,27.0,180,2023,Dominican Republic,2023-05-30,True,1,2,12,15,0,0,4,4,18,7,26,51,3,4,2,9,1,1,12,14,11,1,0,12
143437.0,Nishida Sarina,OH,Japan,27.0,180,2023,Croatia,2023-06-02,True,3,2,10,15,0,0,3,3,13,4,14,31,2,1,1,4,2,2,9,13,11,1,1,13
143437.0,Nishida Sarina,OH,Japan,27.0,180,2023,Bulgaria,2023-06-03,True,1,2,11,14,0,0,2,2,11,4,10,25,2,1,2,5,5,2,6,13,9,0,3,12
143437.0,Nishida Sarina,OH,Japan,27.0,180,2023,China,2023-06-04,False,2,1,10,13,0,0,1,1,16,4,13,33,1,0,0,1,1,1,10,12,10,0,3,13
143437.0,Nishida Sarina,OH,Japan,27.0,180,2023,Germany,2023-06-16,False,2,2,21,25,0,0,5,5,20,6,31,57,2,1,0,3,1,1,8,10,12,1,0,13
143437.0,Nishida Sarina,OH,Japan,27.0,180,2023,USA,2023-06-17,True,0,1,22,23,0,0,4,4,12,5,26,43,0,0,1,1,6,1,13,20,17,9,1,27
143437.0,Nishida Sarina,OH,Japan,27.0,180,2023,Netherlands,2023-06-30,False,2,2,10,14,0,0,3,3,13,4,18,35,1,3,2,6,3,1,10,14,8,5,2,15
143437.0,Nishida Sarina,OH,Japan,27.0,180,2023,Thailand,2023-07-01,True,2,0,12,14,0,0,3,3,14,3,20,37,3,1,4,8,1,0,12,13,13,0,1,14
143437.0,Nishida Sarina,OH,Japan,27.0,180,2023,Italy,2023-07-02,False,1,1,7,9,0,0,0,0,6,4,12,22,1,3,0,4,5,1,9,15,2,0,1,3
162218.0,Ishikawa Mayu,OH,Japan,23.0,174,2023,Germany,2023-06-16,False,2,1,6,9,0,0,0,0,0,1,1,2,0,0,0,0,0,0,1,1,0,0,1,1
162218.0,Ishikawa Mayu,OH,Japan,23.0,174,2023,USA,2023-06-17,True,2,2,11,15,0,0,3,3,16,7,24,47,1,0,1,2,6,0,11,17,16,12,1,29
162218.0,Ishikawa Mayu,OH,Japan,23.0,174,2023,Netherlands,2023-06-30,False,0,1,8,9,0,0,2,2,6,2,17,25,0,2,3,5,3,0,5,8,3,3,1,7
162218.0,Ishikawa Mayu,OH,Japan,23.0,174,2023,Thailand,2023-07-01,True,0,2,12,14,0,0,3,3,8,5,16,29,1,1,2,4,2,0,5,7,10,2,0,12
162218.0,Ishikawa Mayu,OH,Japan,23.0,174,2023,Italy,2023-07-02,False,2,0,13,15,0,0,2,2,5,2,7,14,0,1,2,3,7,0,12,19,6,2,2,10
151944.0,Seki Nanami,S,Japan,24.0,171,2023,Dominican Republic,2023-05-30,True,2,0,18,20,41,0,87,128,2,1,2,5,1,3,2,6,0,0,1,1,8,2,0,10
151944.0,Seki Nanami,S,Japan,24.0,171,2023,Croatia,2023-06-02,True,1,2,13,16,2,0,79,81,1,0,1,2,0,0,2,2,0,1,0,1,5,0,1,6
151944.0,Seki Nanami,S,Japan,24.0,171,2023,Bulgaria,2023-06-03,True,1,0,12,13,4,1,58,63,0,0,1,1,0,1,1,2,0,0,0,0,6,0,2,8
151944.0,Seki Nanami,S,Japan,24.0,171,2023,China,2023-06-04,False,1,1,8,10,13,1,72,86,0,0,1,1,0,0,0,0,0,0,1,1,5,0,1,6
151944.0,Seki Nanami,S,Japan,24.0,171,2023,Germany,2023-06-16,False,2,1,15,18,52,0,79,131,2,0,1,3,0,1,1,2,0,0,0,0,18,4,1,23
151944.0,Seki Nanami,S,Japan,24.0,171,2023,USA,2023-06-17,True,0,1,0,1,0,0,0,0,0,0,0,0,0,0,0,0,0,0,0,0,0,0,0,0
151944.0,Seki Nanami,S,Japan,24.0,171,2023,Netherlands,2023-06-30,False,1,0,5,6,11,1,21,33,0,0,0,0,0,0,0,0,0,1,0,1,3,3,1,7
151944.0,Seki Nanami,S,Japan,24.0,171,2023,Thailand,2023-07-01,True,1,2,12,15,23,3,67,93,0,1,2,3,0,4,2,6,0,0,0,0,12,2,1,15
151944.0,Seki Nanami,S,Japan,24.0,171,2023,Italy,2023-07-02,False,3,1,20,24,11,1,114,126,0,0,1,1,0,2,4,6,0,0,0,0,5,3,2,10
152457.0,Shibata Mika,S,Japan,29.0,171,2023,Germany,2023-06-16,False,0,0,0,0,2,0,1,3,0,0,0,0,0,0,0,0,0,0,0,0,0,1,0,1
152457.0,Shibata Mika,S,Japan,29.0,171,2023,USA,2023-06-17,True,1,0,20,21,12,1,117,130,2,1,2,5,0,1,2,3,0,0,0,0,20,8,3,31
142372.0,Inoue Arisa,OH,Japan,28.0,178,2023,Dominican Republic,2023-05-30,True,0,2,8,10,0,0,4,4,14,2,29,45,1,0,4,5,0,2,10,12,14,3,1,18
142372.0,Inoue Arisa,OH,Japan,28.0,178,2023,Croatia,2023-06-02,True,0,1,13,14,0,0,1,1,9,2,13,24,0,0,2,2,2,0,5,7,11,0,5,16
142372.0,Inoue Arisa,OH,Japan,28.0,178,2023,Bulgaria,2023-06-03,True,0,2,6,8,0,1,2,3,13,4,12,29,1,2,0,3,2,1,4,7,7,0,0,7
142372.0,Inoue Arisa,OH,Japan,28.0,178,2023,China,2023-06-04,False,0,0,2,2,0,0,0,0,1,1,5,7,0,0,1,1,0,0,5,5,1,0,0,1
142372.0,Inoue Arisa,OH,Japan,28.0,178,2023,Germany,2023-06-16,False,0,2,8,10,0,0,2,2,20,8,21,49,0,3,5,8,1,1,7,9,8,2,1,11
142372.0,Inoue Arisa,OH,Japan,28.0,178,2023,USA,2023-06-17,True,0,0,0,0,0,0,0,0,0,0,0,0,0,0,0,0,0,0,0,0,0,0,0,0
142372.0,Inoue Arisa,OH,Japan,28.0,178,2023,Netherlands,2023-06-30,False,0,0,2,2,0,0,0,0,0,1,4,5,0,1,0,1,0,0,0,0,1,2,0,3
142372.0,Inoue Arisa,OH,Japan,28.0,178,2023,Thailand,2023-07-01,True,0,0,0,0,0,0,0,0,0,0,0,0,0,0,0,0,0,0,0,0,0,0,0,0
142372.0,Inoue Arisa,OH,Japan,28.0,178,2023,Italy,2023-07-02,False,1,1,6,8,0,0,1,1,4,3,13,20,0,0,3,3,2,0,9,11,4,0,0,4
162227.0,Yamada Nichika,MB,Japan,24.0,184,2023,Germany,2023-06-16,False,0,1,15,16,0,0,2,2,6,1,7,14,4,3,1,8,0,0,1,1,7,2,1,10
162227.0,Yamada Nichika,MB,Japan,24.0,184,2023,USA,2023-06-17,True,0,1,11,12,0,0,0,0,6,3,4,13,2,7,4,13,0,0,3,3,7,1,0,8
162227.0,Yamada Nichika,MB,Japan,24.0,184,2023,Netherlands,2023-06-30,False,2,1,8,11,0,0,3,3,7,1,8,16,0,3,3,6,0,0,0,0,0,1,1,2
162227.0,Yamada Nichika,MB,Japan,24.0,184,2023,Thailand,2023-07-01,True,0,1,9,10,0,0,4,4,8,1,5,14,3,2,4,9,0,0,0,0,1,0,2,3
162227.0,Yamada Nichika,MB,Japan,24.0,184,2023,Italy,2023-07-02,False,0,0,6,6,0,0,1,1,4,3,6,13,1,5,9,15,0,0,0,0,2,1,1,4
189198.0,Fukudome Satomi,L,Japan,26.0,162,2023,Netherlands,2023-06-30,False,0,0,0,0,0,0,8,8,0,0,0,0,0,0,0,0,3,0,10,13,5,2,2,9
189198.0,Fukudome Satomi,L,Japan,26.0,162,2023,Thailand,2023-07-01,True,0,0,0,0,0,0,0,0,0,0,0,0,0,0,0,0,0,0,0,0,0,0,0,0
189198.0,Fukudome Satomi,L,Japan,26.0,162,2023,Italy,2023-07-02,False,0,0,0,0,0,0,5,5,0,0,0,0,0,0,0,0,1,2,6,9,11,2,1,14
187806.0,Meguro Yuka,L,Japan,28.0,170,2023,Germany,2023-06-16,False,0,0,0,0,0,0,0,0,0,0,0,0,0,0,0,0,0,0,0,0,0,0,0,0
187806.0,Meguro Yuka,L,Japan,28.0,170,2023,USA,2023-06-17,True,0,0,0,0,0,0,0,0,0,0,0,0,0,0,0,0,0,0,0,0,0,0,0,0
146519.0,Miyabe Airi,OH,Japan,25.0,181,2023,Netherlands,2023-06-30,False,0,0,3,3,0,0,0,0,0,0,0,0,0,2,0,2,0,0,0,0,0,0,0,0
146519.0,Miyabe Airi,OH,Japan,25.0,181,2023,Thailand,2023-07-01,True,0,0,0,0,0,0,1,1,0,0,0,0,0,0,0,0,0,0,0,0,0,0,0,0
146519.0,Miyabe Airi,OH,Japan,25.0,181,2023,Italy,2023-07-02,False,1,3,7,11,0,0,1,1,10,2,10,22,5,6,6,17,0,0,1,1,4,0,0,4
151947.0,Irisawa Mai,MB,Japan,24.0,188,2023,Dominican Republic,2023-05-30,True,0,1,7,8,0,0,2,2,7,4,2,13,4,3,10,17,0,0,0,0,3,0,0,3
151947.0,Irisawa Mai,MB,Japan,24.0,188,2023,Croatia,2023-06-02,True,0,3,5,8,0,0,0,0,2,0,1,3,1,1,1,3,0,0,0,0,1,0,0,1
151947.0,Irisawa Mai,MB,Japan,24.0,188,2023,Bulgaria,2023-06-03,True,0,1,11,12,0,0,0,0,2,1,2,5,0,1,3,4,0,0,0,0,3,0,0,3
151947.0,Irisawa Mai,MB,Japan,24.0,188,2023,China,2023-06-04,False,1,2,7,10,0,0,0,0,1,3,3,7,0,1,4,5,1,0,1,2,1,0,0,1
151947.0,Irisawa Mai,MB,Japan,24.0,188,2023,Germany,2023-06-16,False,0,0,0,0,0,0,0,0,0,0,0,0,0,1,0,1,0,0,0,0,0,0,0,0
151947.0,Irisawa Mai,MB,Japan,24.0,188,2023,USA,2023-06-17,True,1,1,6,8,0,0,0,0,0,0,0,0,0,0,0,0,0,0,0,0,0,1,0,1
151947.0,Irisawa Mai,MB,Japan,24.0,188,2023,Netherlands,2023-06-30,False,0,1,3,4,0,0,0,0,1,1,3,5,0,1,0,1,0,0,0,0,1,0,0,1
151947.0,Irisawa Mai,MB,Japan,24.0,188,2023,Thailand,2023-07-01,True,1,0,5,6,0,0,0,0,1,1,1,3,0,2,3,5,0,0,0,0,1,0,0,1
151947.0,Irisawa Mai,MB,Japan,24.0,188,2023,Italy,2023-07-02,False,0,0,0,0,0,0,0,0,0,0,0,0,0,0,0,0,0,0,0,0,0,0,0,0
189509.0,Nishimura Minami,L,Japan,24.0,169,2023,Dominican Republic,2023-05-30,True,0,0,0,0,0,0,9,9,0,0,0,0,0,0,0,0,8,0,30,38,26,2,5,33
189509.0,Nishimura Minami,L,Japan,24.0,169,2023,Croatia,2023-06-02,True,0,0,0,0,0,0,2,2,0,0,0,0,0,0,0,0,7,0,14,21,17,0,2,19
189509.0,Nishimura Minami,L,Japan,24.0,169,2023,Bulgaria,2023-06-03,True,0,0,0,0,0,0,5,5,0,0,0,0,0,0,0,0,5,0,12,17,13,0,0,13
189509.0,Nishimura Minami,L,Japan,24.0,169,2023,China,2023-06-04,False,0,0,0,0,0,0,4,4,0,0,0,0,0,0,0,0,8,1,25,34,8,1,1,10
189509.0,Nishimura Minami,L,Japan,24.0,169,2023,Germany,2023-06-16,False,0,0,0,0,0,0,17,17,0,0,0,0,0,0,0,0,11,2,28,41,19,9,2,30
189509.0,Nishimura Minami,L,Japan,24.0,169,2023,USA,2023-06-17,True,0,0,0,0,0,0,26,26,0,0,0,0,0,0,0,0,10,2,30,42,17,7,2,26
189509.0,Nishimura Minami,L,Japan,24.0,169,2023,Netherlands,2023-06-30,False,0,0,0,0,0,0,7,7,0,0,0,0,0,0,0,0,4,0,14,18,7,3,2,12
189509.0,Nishimura Minami,L,Japan,24.0,169,2023,Thailand,2023-07-01,True,0,0,0,0,0,0,11,11,0,0,0,0,0,0,0,0,7,1,18,26,10,3,2,15
189509.0,Nishimura Minami,L,Japan,24.0,169,2023,Italy,2023-07-02,False,0,0,0,0,0,0,8,8,0,0,0,0,0,0,0,0,2,0,6,8,9,4,0,13
174243.0,Wada Yukiko,OH,Japan,22.0,174,2023,Dominican Republic,2023-05-30,True,0,0,1,1,0,0,0,0,0,0,0,0,0,0,0,0,0,0,0,0,0,0,0,0
174243.0,Wada Yukiko,OH,Japan,22.0,174,2023,Croatia,2023-06-02,True,0,0,1,1,0,0,0,0,2,1,1,4,0,0,0,0,0,0,0,0,1,0,1,2
174243.0,Wada Yukiko,OH,Japan,22.0,174,2023,Bulgaria,2023-06-03,True,1,0,1,2,0,0,1,1,3,0,4,7,0,0,2,2,0,0,0,0,0,0,0,0
174243.0,Wada Yukiko,OH,Japan,22.0,174,2023,China,2023-06-04,False,0,3,1,4,0,0,0,0,9,4,6,19,0,1,0,1,0,0,4,4,0,0,0,0
174243.0,Wada Yukiko,OH,Japan,22.0,174,2023,Germany,2023-06-16,False,0,1,4,5,0,0,0,0,1,0,1,2,0,0,0,0,0,0,0,0,1,0,0,1
174243.0,Wada Yukiko,OH,Japan,22.0,174,2023,USA,2023-06-17,True,1,3,16,20,0,0,5,5,28,3,21,52,3,1,3,7,0,0,2,2,8,5,1,14
174243.0,Wada Yukiko,OH,Japan,22.0,174,2023,Netherlands,2023-06-30,False,0,2,7,9,0,0,1,1,17,5,12,34,1,0,0,1,0,0,6,6,5,3,1,9
174243.0,Wada Yukiko,OH,Japan,22.0,174,2023,Thailand,2023-07-01,True,0,1,1,2,0,0,0,0,0,0,0,0,0,0,0,0,0,0,0,0,0,0,0,0
174243.0,Wada Yukiko,OH,Japan,22.0,174,2023,Italy,2023-07-02,False,0,0,9,9,0,0,0,0,8,4,6,18,0,1,1,2,2,0,6,8,6,3,0,9
124071.0,Knip Kirsten,L,Netherlands,31.0,175,2023,Germany,2023-05-30,False,0,0,0,0,0,0,5,5,0,0,0,0,0,0,0,0,1,2,9,12,7,7,6,20
124071.0,Knip Kirsten,L,Netherlands,31.0,175,2023,Brazil,2023-06-01,False,0,0,0,0,0,0,4,4,0,0,0,0,0,0,0,0,2,0,6,8,8,2,2,12
124071.0,Knip Kirsten,L,Netherlands,31.0,175,2023,Dominican Republic,2023-06-02,False,0,0,0,0,0,0,7,7,0,0,0,0,0,0,0,0,5,1,28,34,15,0,1,16
124071.0,Knip Kirsten,L,Netherlands,31.0,175,2023,China,2023-06-03,False,0,0,0,0,0,0,0,0,0,0,0,0,0,0,0,0,0,0,0,0,0,0,0,0
124071.0,Knip Kirsten,L,Netherlands,31.0,175,2023,Poland,2023-06-16,True,0,0,0,0,0,0,0,0,0,0,0,0,0,0,0,0,0,0,0,0,0,0,0,0
124071.0,Knip Kirsten,L,Netherlands,31.0,175,2023,Italy,2023-06-17,False,0,0,0,0,0,0,0,0,0,0,0,0,0,0,0,0,0,0,0,0,0,0,0,0
124071.0,Knip Kirsten,L,Netherlands,31.0,175,2023,Bulgaria,2023-06-18,True,0,0,0,0,0,0,6,6,0,0,0,0,0,0,0,0,3,4,16,23,9,3,1,13
124071.0,Knip Kirsten,L,Netherlands,31.0,175,2023,Thailand,2023-06-27,True,0,0,0,0,0,0,0,0,0,0,0,0,0,0,0,0,0,0,0,0,0,0,0,0
124071.0,Knip Kirsten,L,Netherlands,31.0,175,2023,Croatia,2023-06-29,True,0,0,0,0,0,0,3,3,0,0,0,0,0,0,0,0,2,0,6,8,13,3,1,17
124071.0,Knip Kirsten,L,Netherlands,31.0,175,2023,Japan,2023-06-30,True,0,0,0,0,0,0,0,0,0,0,0,0,0,0,0,0,0,0,0,0,1,0,0,1
124071.0,Knip Kirsten,L,Netherlands,31.0,175,2023,Canada,2023-07-01,False,0,0,1,1,0,0,5,5,0,0,0,0,0,0,0,0,4,1,14,19,4,4,0,8
167778.0,Jasper Hester,OH,Netherlands,22.0,175,2023,Germany,2023-05-30,False,0,2,7,9,0,0,2,2,5,5,9,19,0,1,0,1,3,1,15,19,7,1,2,10
167778.0,Jasper Hester,OH,Netherlands,22.0,175,2023,Brazil,2023-06-01,False,0,0,0,0,0,0,0,0,0,0,0,0,0,0,0,0,0,0,0,0,1,0,0,1
167778.0,Jasper Hester,OH,Netherlands,22.0,175,2023,Dominican Republic,2023-06-02,False,0,0,0,0,0,0,0,0,0,0,0,0,0,0,0,0,0,0,1,1,0,0,0,0
167778.0,Jasper Hester,OH,Netherlands,22.0,175,2023,China,2023-06-03,False,0,0,0,0,0,0,0,0,0,0,0,0,0,0,0,0,0,0,0,0,0,0,0,0
167778.0,Jasper Hester,OH,Netherlands,22.0,175,2023,Thailand,2023-06-27,True,0,0,0,0,0,0,0,0,0,0,0,0,0,0,0,0,0,0,0,0,0,0,0,0
167778.0,Jasper Hester,OH,Netherlands,22.0,175,2023,Croatia,2023-06-29,True,0,0,0,0,0,0,2,2,0,0,0,0,0,0,0,0,0,1,2,3,0,0,0,0
167778.0,Jasper Hester,OH,Netherlands,22.0,175,2023,Japan,2023-06-30,True,0,0,0,0,0,0,0,0,0,0,0,0,0,0,0,0,0,0,0,0,0,0,0,0
167778.0,Jasper Hester,OH,Netherlands,22.0,175,2023,Canada,2023-07-01,False,0,0,0,0,0,0,0,0,0,0,0,0,0,0,0,0,0,0,0,0,0,0,0,0
142880.0,Plak Celeste,O,Netherlands,28.0,190,2023,Poland,2023-06-16,True,0,0,0,0,0,0,0,0,0,0,0,0,0,0,0,0,0,0,0,0,0,0,0,0
142880.0,Plak Celeste,O,Netherlands,28.0,190,2023,Italy,2023-06-17,False,0,0,0,0,0,0,0,0,0,0,0,0,0,0,0,0,0,0,0,0,0,0,0,0
142880.0,Plak Celeste,O,Netherlands,28.0,190,2023,Bulgaria,2023-06-18,True,0,1,4,5,0,0,0,0,9,3,6,18,1,2,4,7,0,0,1,1,3,3,1,7
142880.0,Plak Celeste,O,Netherlands,28.0,190,2023,Thailand,2023-06-27,True,0,2,10,12,0,0,0,0,7,1,16,24,2,3,2,7,0,0,0,0,9,1,1,11
142880.0,Plak Celeste,O,Netherlands,28.0,190,2023,Croatia,2023-06-29,True,0,1,5,6,0,0,1,1,10,0,9,19,3,0,4,7,0,0,0,0,7,0,1,8
142880.0,Plak Celeste,O,Netherlands,28.0,190,2023,Japan,2023-06-30,True,0,0,12,12,0,0,3,3,20,3,12,35,4,12,5,21,0,0,0,0,9,3,0,12
142880.0,Plak Celeste,O,Netherlands,28.0,190,2023,Canada,2023-07-01,False,0,1,9,10,0,0,1,1,2,3,6,11,1,5,1,7,0,0,0,0,1,0,0,1
167482.0,Knollema Jolien,OH,Netherlands,21.0,189,2023,Germany,2023-05-30,False,0,0,10,10,0,0,1,1,11,3,20,34,2,0,1,3,6,5,28,39,5,1,6,12
167482.0,Knollema Jolien,OH,Netherlands,21.0,189,2023,Brazil,2023-06-01,False,1,1,12,14,0,0,0,0,8,6,12,26,2,0,1,3,3,5,19,27,16,2,1,19
167482.0,Knollema Jolien,OH,Netherlands,21.0,189,2023,Dominican Republic,2023-06-02,False,1,2,16,19,0,0,2,2,11,4,12,27,2,1,2,5,11,4,25,40,14,1,4,19
167482.0,Knollema Jolien,OH,Netherlands,21.0,189,2023,China,2023-06-03,False,1,2,13,16,0,0,2,2,14,5,12,31,2,0,0,2,6,3,27,36,9,0,2,11
167482.0,Knollema Jolien,OH,Netherlands,21.0,189,2023,Poland,2023-06-16,True,1,0,14,15,0,0,1,1,14,3,10,27,2,2,7,11,9,0,13,22,3,4,1,8
167482.0,Knollema Jolien,OH,Netherlands,21.0,189,2023,Italy,2023-06-17,False,1,0,13,14,0,0,0,0,9,3,7,19,0,2,0,2,5,0,15,20,8,0,1,9
167482.0,Knollema Jolien,OH,Netherlands,21.0,189,2023,Bulgaria,2023-06-18,True,0,0,9,9,0,0,3,3,7,3,9,19,4,1,2,7,1,0,10,11,3,1,1,5
167482.0,Knollema Jolien,OH,Netherlands,21.0,189,2023,Thailand,2023-06-27,True,1,1,8,10,0,0,0,0,12,1,6,19,2,1,2,5,4,0,23,27,9,3,1,13
167482.0,Knollema Jolien,OH,Netherlands,21.0,189,2023,Croatia,2023-06-29,True,2,0,9,11,0,0,1,1,8,1,3,12,2,0,0,2,4,0,12,16,3,1,3,7
167482.0,Knollema Jolien,OH,Netherlands,21.0,189,2023,Japan,2023-06-30,True,0,0,0,0,0,0,0,0,0,0,0,0,0,0,0,0,0,0,0,0,0,0,0,0
151194.0,Lohuis Juliet,MB,Netherlands,27.0,190,2023,Poland,2023-06-16,True,0,1,4,5,0,0,0,0,0,0,0,0,0,0,0,0,0,0,0,0,1,0,0,1
151194.0,Lohuis Juliet,MB,Netherlands,27.0,190,2023,Italy,2023-06-17,False,2,0,10,12,0,0,0,0,3,0,0,3,1,2,4,7,0,0,0,0,3,2,1,6
151194.0,Lohuis Juliet,MB,Netherlands,27.0,190,2023,Bulgaria,2023-06-18,True,0,0,10,10,0,0,1,1,3,0,6,9,5,3,9,17,0,0,0,0,0,0,1,1
151194.0,Lohuis Juliet,MB,Netherlands,27.0,190,2023,Thailand,2023-06-27,True,1,1,10,12,0,0,5,5,5,0,6,11,1,2,7,10,0,0,1,1,1,0,1,2
151194.0,Lohuis Juliet,MB,Netherlands,27.0,190,2023,Croatia,2023-06-29,True,0,0,0,0,0,0,0,0,0,0,0,0,0,0,0,0,0,0,0,0,0,0,0,0
151194.0,Lohuis Juliet,MB,Netherlands,27.0,190,2023,Japan,2023-06-30,True,0,1,18,19,0,0,4,4,2,0,3,5,7,4,6,17,0,0,0,0,3,1,1,5
151194.0,Lohuis Juliet,MB,Netherlands,27.0,190,2023,Canada,2023-07-01,False,0,0,8,8,0,0,2,2,6,1,1,8,1,2,7,10,0,0,0,0,3,1,0,4
162356.0,van Aalen Sarah,S,Netherlands,24.0,186,2023,Germany,2023-05-30,False,0,0,4,4,7,0,43,50,1,0,0,1,0,2,1,3,0,0,0,0,1,0,3,4
162356.0,van Aalen Sarah,S,Netherlands,24.0,186,2023,Brazil,2023-06-01,False,1,1,8,10,4,0,60,64,1,0,0,1,1,2,0,3,0,0,0,0,3,0,1,4
162356.0,van Aalen Sarah,S,Netherlands,24.0,186,2023,Dominican Republic,2023-06-02,False,1,3,11,15,5,1,69,75,3,1,1,5,0,2,1,3,0,0,1,1,3,0,0,3
162356.0,van Aalen Sarah,S,Netherlands,24.0,186,2023,China,2023-06-03,False,0,1,13,14,6,2,105,113,0,1,0,1,1,2,4,7,0,0,1,1,3,0,1,4
162356.0,van Aalen Sarah,S,Netherlands,24.0,186,2023,Poland,2023-06-16,True,0,0,0,0,2,0,5,7,1,0,0,1,0,0,2,2,0,0,0,0,0,0,0,0
162356.0,van Aalen Sarah,S,Netherlands,24.0,186,2023,Italy,2023-06-17,False,0,0,9,9,11,0,47,58,0,0,1,1,1,0,0,1,0,0,0,0,1,1,0,2
162356.0,van Aalen Sarah,S,Netherlands,24.0,186,2023,Bulgaria,2023-06-18,True,0,0,3,3,7,1,9,17,0,0,0,0,1,1,1,3,0,0,0,0,0,0,0,0
162356.0,van Aalen Sarah,S,Netherlands,24.0,186,2023,Thailand,2023-06-27,True,0,0,0,0,0,0,0,0,0,0,0,0,0,0,0,0,0,0,0,0,0,0,0,0
162356.0,van Aalen Sarah,S,Netherlands,24.0,186,2023,Croatia,2023-06-29,True,1,0,10,11,9,0,49,58,2,1,1,4,0,0,0,0,0,0,0,0,3,1,1,5
162356.0,van Aalen Sarah,S,Netherlands,24.0,186,2023,Japan,2023-06-30,True,1,0,4,5,4,1,29,34,0,0,0,0,0,2,4,6,0,0,0,0,1,1,0,2
162356.0,van Aalen Sarah,S,Netherlands,24.0,186,2023,Canada,2023-07-01,False,0,1,16,17,16,1,98,115,0,0,0,0,0,5,2,7,0,2,0,2,5,2,2,9
147432.0,Bongaerts Britt,S,Netherlands,27.0,185,2023,Poland,2023-06-16,True,0,0,11,11,22,1,56,79,5,0,2,7,0,2,6,8,0,0,0,0,8,5,0,13
147432.0,Bongaerts Britt,S,Netherlands,27.0,185,2023,Italy,2023-06-17,False,1,1,10,12,18,0,54,72,0,0,1,1,0,6,2,8,0,0,0,0,3,4,1,8
147432.0,Bongaerts Britt,S,Netherlands,27.0,185,2023,Bulgaria,2023-06-18,True,0,0,11,11,18,0,27,45,1,0,2,3,2,3,1,6,0,0,0,0,3,3,1,7
147432.0,Bongaerts Britt,S,Netherlands,27.0,185,2023,Thailand,2023-06-27,True,4,1,13,18,26,0,66,92,0,0,3,3,1,3,2,6,0,0,0,0,6,2,0,8
147432.0,Bongaerts Britt,S,Netherlands,27.0,185,2023,Croatia,2023-06-29,True,0,0,4,4,2,0,5,7,0,0,0,0,1,0,0,1,0,0,0,0,0,0,0,0
147432.0,Bongaerts Britt,S,Netherlands,27.0,185,2023,Japan,2023-06-30,True,0,0,9,9,21,2,44,67,0,0,0,0,1,3,0,4,0,0,0,0,4,3,0,7
147432.0,Bongaerts Britt,S,Netherlands,27.0,185,2023,Canada,2023-07-01,False,0,0,4,4,0,1,14,15,0,0,0,0,0,0,0,0,0,0,0,0,0,1,0,1
168148.0,Baijens Indy,MB,Netherlands,23.0,193,2023,Germany,2023-05-30,False,0,4,5,9,0,0,1,1,14,3,6,23,3,5,6,14,0,0,1,1,2,1,2,5
168148.0,Baijens Indy,MB,Netherlands,23.0,193,2023,Brazil,2023-06-01,False,0,2,1,3,0,0,0,0,6,2,4,12,0,0,0,0,0,0,1,1,1,0,0,1
168148.0,Baijens Indy,MB,Netherlands,23.0,193,2023,Dominican Republic,2023-06-02,False,0,2,7,9,0,0,1,1,9,4,8,21,3,5,6,14,0,0,0,0,3,0,2,5
168148.0,Baijens Indy,MB,Netherlands,23.0,193,2023,China,2023-06-03,False,0,2,5,7,0,0,0,0,7,3,4,14,1,0,1,2,0,0,0,0,2,0,0,2
168148.0,Baijens Indy,MB,Netherlands,23.0,193,2023,Poland,2023-06-16,True,0,2,5,7,0,0,0,0,8,1,5,14,2,2,3,7,0,0,1,1,1,0,1,2
168148.0,Baijens Indy,MB,Netherlands,23.0,193,2023,Italy,2023-06-17,False,0,0,11,11,0,0,0,0,9,3,5,17,1,4,8,13,0,0,0,0,1,2,0,3
168148.0,Baijens Indy,MB,Netherlands,23.0,193,2023,Bulgaria,2023-06-18,True,0,1,0,1,0,0,0,0,2,0,1,3,0,1,0,1,0,0,0,0,0,0,0,0
168148.0,Baijens Indy,MB,Netherlands,23.0,193,2023,Thailand,2023-06-27,True,0,2,5,7,0,0,1,1,9,2,6,17,4,6,7,17,0,0,0,0,2,0,1,3
168148.0,Baijens Indy,MB,Netherlands,23.0,193,2023,Croatia,2023-06-29,True,2,0,8,10,0,0,0,0,9,0,4,13,5,5,10,20,0,0,1,1,0,1,0,1
168148.0,Baijens Indy,MB,Netherlands,23.0,193,2023,Japan,2023-06-30,True,1,0,10,11,0,0,0,0,10,1,5,16,0,2,4,6,0,0,0,0,1,2,1,4
168148.0,Baijens Indy,MB,Netherlands,23.0,193,2023,Canada,2023-07-01,False,2,4,6,12,0,0,0,0,13,3,3,19,4,5,2,11,0,0,0,0,0,0,0,0
181648.0,Vos Iris,OH,Netherlands,21.0,184,2023,Germany,2023-05-30,False,0,0,2,2,0,0,0,0,0,0,1,1,0,0,0,0,0,0,1,1,1,0,2,3
181648.0,Vos Iris,OH,Netherlands,21.0,184,2023,Brazil,2023-06-01,False,0,0,0,0,0,0,0,0,0,0,0,0,0,0,0,0,0,1,2,3,0,0,0,0
181648.0,Vos Iris,OH,Netherlands,21.0,184,2023,Dominican Republic,2023-06-02,False,0,0,0,0,0,0,0,0,0,0,0,0,0,0,0,0,0,0,1,1,1,0,0,1
181648.0,Vos Iris,OH,Netherlands,21.0,184,2023,China,2023-06-03,False,0,0,0,0,0,0,0,0,0,0,0,0,0,0,0,0,0,0,0,0,0,0,0,0
181648.0,Vos Iris,OH,Netherlands,21.0,184,2023,Poland,2023-06-16,True,0,0,0,0,0,0,0,0,0,0,0,0,0,0,0,0,0,0,0,0,0,0,0,0
181648.0,Vos Iris,OH,Netherlands,21.0,184,2023,Italy,2023-06-17,False,0,0,0,0,0,0,0,0,0,0,0,0,0,0,0,0,0,0,0,0,0,0,0,0
181648.0,Vos Iris,OH,Netherlands,21.0,184,2023,Bulgaria,2023-06-18,True,0,1,0,1,0,0,0,0,0,0,2,2,0,0,1,1,0,1,0,1,0,1,0,1
181648.0,Vos Iris,OH,Netherlands,21.0,184,2023,Thailand,2023-06-27,True,0,0,0,0,0,0,0,0,0,0,0,0,0,0,0,0,0,0,0,0,0,0,0,0
181648.0,Vos Iris,OH,Netherlands,21.0,184,2023,Croatia,2023-06-29,True,0,0,0,0,0,0,0,0,0,1,3,4,0,0,1,1,0,0,0,0,0,1,0,1
181648.0,Vos Iris,OH,Netherlands,21.0,184,2023,Japan,2023-06-30,True,0,0,0,0,0,0,0,0,0,0,0,0,0,0,0,0,0,0,0,0,0,0,0,0
181648.0,Vos Iris,OH,Netherlands,21.0,184,2023,Canada,2023-07-01,False,0,0,0,0,0,0,0,0,0,0,0,0,0,0,0,0,0,0,0,0,0,0,0,0
150809.0,Daalderop Nika,OH,Netherlands,25.0,189,2023,Poland,2023-06-16,True,0,1,11,12,0,0,2,2,13,2,10,25,0,1,1,2,5,1,14,20,4,3,0,7
150809.0,Daalderop Nika,OH,Netherlands,25.0,189,2023,Italy,2023-06-17,False,2,2,11,15,0,0,3,3,19,6,13,38,1,7,4,12,3,0,24,27,12,3,3,18
150809.0,Daalderop Nika,OH,Netherlands,25.0,189,2023,Bulgaria,2023-06-18,True,0,0,0,0,0,0,0,0,0,0,0,0,0,0,0,0,0,0,0,0,0,0,0,0
150809.0,Daalderop Nika,OH,Netherlands,25.0,189,2023,Thailand,2023-06-27,True,1,2,11,14,0,0,0,0,9,3,20,32,1,4,4,9,2,0,13,15,10,3,0,13
150809.0,Daalderop Nika,OH,Netherlands,25.0,189,2023,Croatia,2023-06-29,True,0,0,0,0,0,0,0,0,0,0,0,0,0,0,0,0,0,0,0,0,0,0,0,0
150809.0,Daalderop Nika,OH,Netherlands,25.0,189,2023,Japan,2023-06-30,True,0,2,10,12,0,0,2,2,12,2,13,27,4,3,3,10,9,4,31,44,11,5,4,20
150809.0,Daalderop Nika,OH,Netherlands,25.0,189,2023,Canada,2023-07-01,False,1,3,12,16,0,0,2,2,13,9,15,37,3,4,3,10,10,0,23,33,8,4,2,14
172894.0,Timmerman Eline,MB,Netherlands,25.0,192,2023,Germany,2023-05-30,False,1,3,10,14,0,0,1,1,10,0,4,14,2,5,8,15,1,0,0,1,3,1,3,7
172894.0,Timmerman Eline,MB,Netherlands,25.0,192,2023,Brazil,2023-06-01,False,0,1,11,12,0,0,1,1,2,3,4,9,1,1,2,4,0,0,0,0,1,0,0,1
172894.0,Timmerman Eline,MB,Netherlands,25.0,192,2023,Dominican Republic,2023-06-02,False,2,2,17,21,0,0,0,0,3,1,4,8,1,5,8,14,0,0,2,2,7,0,2,9
172894.0,Timmerman Eline,MB,Netherlands,25.0,192,2023,China,2023-06-03,False,0,1,15,16,0,0,2,2,7,0,7,14,0,0,1,1,0,0,0,0,4,0,0,4
172894.0,Timmerman Eline,MB,Netherlands,25.0,192,2023,Poland,2023-06-16,True,0,1,6,7,0,0,0,0,6,0,3,9,0,6,4,10,1,0,0,1,2,1,1,4
172894.0,Timmerman Eline,MB,Netherlands,25.0,192,2023,Italy,2023-06-17,False,1,0,8,9,0,0,0,0,4,1,4,9,1,9,3,13,0,0,1,1,1,1,0,2
172894.0,Timmerman Eline,MB,Netherlands,25.0,192,2023,Bulgaria,2023-06-18,True,3,0,19,22,0,0,1,1,1,0,1,2,3,2,2,7,0,0,0,0,4,1,0,5
172894.0,Timmerman Eline,MB,Netherlands,25.0,192,2023,Thailand,2023-06-27,True,0,0,4,4,0,0,0,0,0,0,0,0,0,1,0,1,0,0,0,0,0,0,0,0
172894.0,Timmerman Eline,MB,Netherlands,25.0,192,2023,Croatia,2023-06-29,True,1,1,18,20,0,0,1,1,4,2,1,7,2,2,9,13,0,0,0,0,3,1,0,4
172894.0,Timmerman Eline,MB,Netherlands,25.0,192,2023,Japan,2023-06-30,True,1,0,2,3,0,0,0,0,0,0,0,0,0,0,0,0,0,0,0,0,0,1,0,1
172894.0,Timmerman Eline,MB,Netherlands,25.0,192,2023,Canada,2023-07-01,False,0,1,4,5,0,0,0,0,2,2,5,9,2,2,3,7,0,0,1,1,3,0,0,3
148581.0,Reesink Florien,L,Netherlands,25.0,174,2023,Germany,2023-05-30,False,0,0,0,0,0,0,0,0,0,0,0,0,0,0,0,0,0,0,0,0,0,0,0,0
148581.0,Reesink Florien,L,Netherlands,25.0,174,2023,Brazil,2023-06-01,False,0,0,0,0,0,0,0,0,0,0,0,0,0,0,0,0,0,1,1,2,0,0,0,0
148581.0,Reesink Florien,L,Netherlands,25.0,174,2023,Dominican Republic,2023-06-02,False,0,0,0,0,0,0,0,0,0,0,0,0,0,0,0,0,0,0,0,0,1,0,0,1
148581.0,Reesink Florien,L,Netherlands,25.0,174,2023,China,2023-06-03,False,0,0,0,0,0,0,8,8,0,0,0,0,0,0,0,0,4,2,8,14,9,2,2,13
148581.0,Reesink Florien,L,Netherlands,25.0,174,2023,Poland,2023-06-16,True,0,0,0,0,0,0,6,6,0,0,0,0,0,0,0,0,5,1,9,15,13,9,4,26
148581.0,Reesink Florien,L,Netherlands,25.0,174,2023,Italy,2023-06-17,False,0,0,0,0,0,0,8,8,0,0,0,0,0,0,0,0,14,2,22,38,8,9,5,22
148581.0,Reesink Florien,L,Netherlands,25.0,174,2023,Bulgaria,2023-06-18,True,0,0,0,0,0,0,0,0,0,0,0,0,0,0,0,0,0,0,0,0,0,0,0,0
148581.0,Reesink Florien,L,Netherlands,25.0,174,2023,Thailand,2023-06-27,True,0,0,0,0,0,0,6,6,0,0,0,0,0,0,0,0,7,0,6,13,10,7,1,18
148581.0,Reesink Florien,L,Netherlands,25.0,174,2023,Croatia,2023-06-29,True,0,0,0,0,0,0,0,0,0,0,0,0,0,0,0,0,0,0,0,0,0,0,0,0
148581.0,Reesink Florien,L,Netherlands,25.0,174,2023,Japan,2023-06-30,True,0,0,0,0,0,0,7,7,0,0,0,0,0,0,0,0,3,0,4,7,12,8,4,24
148581.0,Reesink Florien,L,Netherlands,25.0,174,2023,Canada,2023-07-01,False,0,0,0,0,0,0,6,6,0,0,0,0,0,0,0,0,4,1,5,10,9,4,0,13
162372.0,Scholten Iris,O,Netherlands,24.0,191,2023,Poland,2023-06-16,True,0,0,1,1,0,0,0,0,1,0,1,2,0,1,0,1,0,0,0,0,1,1,1,3
162372.0,Scholten Iris,O,Netherlands,24.0,191,2023,Italy,2023-06-17,False,0,0,1,1,0,0,0,0,4,1,0,5,0,3,0,3,0,0,0,0,0,0,0,0
162372.0,Scholten Iris,O,Netherlands,24.0,191,2023,Bulgaria,2023-06-18,True,0,0,5,5,0,0,0,0,2,2,2,6,0,2,0,2,0,0,0,0,1,1,0,2
162372.0,Scholten Iris,O,Netherlands,24.0,191,2023,Thailand,2023-06-27,True,0,0,0,0,0,0,0,0,0,0,0,0,0,0,0,0,0,0,0,0,0,0,0,0
162372.0,Scholten Iris,O,Netherlands,24.0,191,2023,Croatia,2023-06-29,True,0,0,0,0,0,0,0,0,0,1,1,2,0,0,0,0,0,0,0,0,0,0,0,0
162372.0,Scholten Iris,O,Netherlands,24.0,191,2023,Japan,2023-06-30,True,0,0,0,0,0,0,0,0,0,0,0,0,0,0,0,0,0,0,0,0,0,0,0,0
162372.0,Scholten Iris,O,Netherlands,24.0,191,2023,Canada,2023-07-01,False,0,2,7,9,0,0,1,1,5,4,11,20,1,0,3,4,0,0,0,0,8,0,0,8
164777.0,Marring Nova,OH,Netherlands,22.0,184,2023,Germany,2023-05-30,False,2,2,9,13,0,0,1,1,8,1,7,16,0,0,1,1,2,1,10,13,1,0,1,2
164777.0,Marring Nova,OH,Netherlands,22.0,184,2023,Brazil,2023-06-01,False,1,0,8,9,0,0,0,0,8,4,15,27,0,0,0,0,2,0,22,24,6,0,0,6
164777.0,Marring Nova,OH,Netherlands,22.0,184,2023,Dominican Republic,2023-06-02,False,2,3,11,16,0,0,5,5,13,8,20,41,1,2,3,6,6,1,11,18,13,1,2,16
164777.0,Marring Nova,OH,Netherlands,22.0,184,2023,China,2023-06-03,False,4,3,20,27,0,0,1,1,17,4,8,29,0,1,1,2,8,1,28,37,12,0,4,16
164777.0,Marring Nova,OH,Netherlands,22.0,184,2023,Poland,2023-06-16,True,0,0,1,1,0,0,0,0,0,0,0,0,0,0,0,0,0,0,0,0,0,0,0,0
164777.0,Marring Nova,OH,Netherlands,22.0,184,2023,Italy,2023-06-17,False,1,3,6,10,0,0,0,0,9,3,5,17,0,2,0,2,3,2,9,14,4,0,1,5
164777.0,Marring Nova,OH,Netherlands,22.0,184,2023,Bulgaria,2023-06-18,True,0,1,7,8,0,0,2,2,7,1,9,17,0,3,1,4,2,0,7,9,12,2,2,16
164777.0,Marring Nova,OH,Netherlands,22.0,184,2023,Thailand,2023-06-27,True,0,0,0,0,0,0,0,0,0,0,0,0,0,0,0,0,0,0,0,0,0,0,0,0
164777.0,Marring Nova,OH,Netherlands,22.0,184,2023,Croatia,2023-06-29,True,0,1,11,12,0,0,1,1,7,2,8,17,1,4,1,6,1,1,14,16,3,6,1,10
164777.0,Marring Nova,OH,Netherlands,22.0,184,2023,Japan,2023-06-30,True,1,4,20,25,0,0,1,1,10,5,13,28,1,0,3,4,4,2,16,22,6,1,3,10
164777.0,Marring Nova,OH,Netherlands,22.0,184,2023,Canada,2023-07-01,False,0,3,16,19,0,0,2,2,15,7,25,47,2,0,0,2,6,1,26,33,11,1,0,12
152233.0,Stenzel Maria,L,Poland,25.0,168,2023,Canada,2023-05-30,True,0,0,0,0,1,0,19,20,0,0,0,0,0,0,0,0,7,1,17,25,16,3,3,22
152233.0,Stenzel Maria,L,Poland,25.0,168,2023,Italy,2023-06-01,True,0,0,0,0,0,0,12,12,0,0,0,0,0,0,0,0,2,2,16,20,16,2,0,18
152233.0,Stenzel Maria,L,Poland,25.0,168,2023,Thailand,2023-06-02,True,0,0,0,0,0,0,5,5,0,0,0,0,0,0,0,0,3,0,6,9,9,3,1,13
152233.0,Stenzel Maria,L,Poland,25.0,168,2023,Serbia,2023-06-03,True,0,0,0,0,0,0,8,8,0,0,0,0,0,0,0,0,6,1,10,17,8,2,2,12
152233.0,Stenzel Maria,L,Poland,25.0,168,2023,Dominican Republic,2023-06-13,True,0,0,0,0,0,0,9,9,0,0,0,0,0,0,0,0,11,1,14,26,12,7,1,20
152233.0,Stenzel Maria,L,Poland,25.0,168,2023,Netherlands,2023-06-16,False,0,0,0,0,0,0,11,11,0,0,0,0,0,0,0,0,3,0,14,17,12,2,3,17
152233.0,Stenzel Maria,L,Poland,25.0,168,2023,China,2023-06-17,True,0,0,0,0,0,0,7,7,0,0,0,0,0,0,0,0,6,0,9,15,10,3,0,13
152233.0,Stenzel Maria,L,Poland,25.0,168,2023,USA,2023-06-28,False,0,0,0,0,0,0,19,19,0,0,0,0,0,0,0,0,9,0,17,26,18,8,2,28
152233.0,Stenzel Maria,L,Poland,25.0,168,2023,Germany,2023-06-29,True,0,0,0,0,0,2,11,13,0,0,0,0,0,0,0,0,8,0,11,19,15,9,2,26
152233.0,Stenzel Maria,L,Poland,25.0,168,2023,Bulgaria,2023-06-30,True,0,0,0,0,0,0,12,12,0,0,0,0,0,0,0,0,3,2,10,15,10,1,0,11
152233.0,Stenzel Maria,L,Poland,25.0,168,2023,Germany,2023-07-12,True,0,0,0,0,0,0,15,15,0,0,0,0,0,0,0,0,3,1,9,13,15,4,1,20
152233.0,Stenzel Maria,L,Poland,25.0,168,2023,China,2023-07-15,False,0,0,0,0,0,0,12,12,0,0,0,0,0,0,0,0,6,0,16,22,8,2,1,11
152233.0,Stenzel Maria,L,Poland,25.0,168,2023,USA,2023-07-16,True,0,0,0,0,0,1,15,16,0,0,0,0,0,0,0,0,12,0,12,24,17,4,0,21
136317.0,Korneluk Agnieszka,MB,Poland,29.0,200,2023,Canada,2023-05-30,True,0,1,23,24,0,0,6,6,11,1,7,19,4,10,7,21,0,0,0,0,4,2,0,6
136317.0,Korneluk Agnieszka,MB,Poland,29.0,200,2023,Italy,2023-06-01,True,2,0,16,18,0,0,3,3,7,0,6,13,4,7,8,19,0,0,0,0,2,0,1,3
136317.0,Korneluk Agnieszka,MB,Poland,29.0,200,2023,Thailand,2023-06-02,True,2,1,19,22,0,0,4,4,6,3,0,9,1,1,3,5,0,0,0,0,0,0,0,0
136317.0,Korneluk Agnieszka,MB,Poland,29.0,200,2023,Serbia,2023-06-03,True,0,1,12,13,0,0,4,4,6,1,4,11,7,2,9,18,0,0,0,0,5,1,3,9
136317.0,Korneluk Agnieszka,MB,Poland,29.0,200,2023,Dominican Republic,2023-06-13,True,1,2,18,21,0,0,2,2,6,0,11,17,4,5,3,12,0,0,0,0,3,0,2,5
136317.0,Korneluk Agnieszka,MB,Poland,29.0,200,2023,Netherlands,2023-06-16,False,0,1,6,7,0,1,0,1,5,2,4,11,0,2,8,10,0,0,0,0,2,3,0,5
136317.0,Korneluk Agnieszka,MB,Poland,29.0,200,2023,China,2023-06-17,True,1,0,12,13,0,0,5,5,6,0,1,7,3,7,6,16,0,0,0,0,2,2,0,4
136317.0,Korneluk Agnieszka,MB,Poland,29.0,200,2023,USA,2023-06-28,False,1,3,13,17,0,0,5,5,12,0,8,20,5,3,5,13,0,0,0,0,4,2,1,7
136317.0,Korneluk Agnieszka,MB,Poland,29.0,200,2023,Germany,2023-06-29,True,0,0,12,12,0,0,1,1,10,2,7,19,5,7,2,14,0,0,0,0,2,1,0,3
136317.0,Korneluk Agnieszka,MB,Poland,29.0,200,2023,Bulgaria,2023-06-30,True,0,2,12,14,0,0,1,1,8,1,3,12,3,5,6,14,0,0,0,0,1,3,2,6
136317.0,Korneluk Agnieszka,MB,Poland,29.0,200,2023,Germany,2023-07-12,True,0,3,11,14,0,0,1,1,8,1,2,11,0,4,5,9,0,0,0,0,1,1,0,2
136317.0,Korneluk Agnieszka,MB,Poland,29.0,200,2023,China,2023-07-15,False,2,2,5,9,0,0,0,0,9,2,3,14,2,3,3,8,0,0,0,0,0,0,1,1
136317.0,Korneluk Agnieszka,MB,Poland,29.0,200,2023,USA,2023-07-16,True,1,2,10,13,0,0,3,3,9,2,3,14,3,8,2,13,0,0,0,0,3,2,1,6
143465.0,Galkowska Monika,O,Poland,27.0,185,2023,Canada,2023-05-30,True,0,0,4,4,0,0,0,0,1,2,6,9,1,2,1,4,0,0,0,0,1,0,0,1
143465.0,Galkowska Monika,O,Poland,27.0,185,2023,Italy,2023-06-01,True,0,0,0,0,0,0,0,0,0,0,0,0,0,0,0,0,0,0,0,0,0,0,0,0
143465.0,Galkowska Monika,O,Poland,27.0,185,2023,Thailand,2023-06-02,True,0,0,2,2,0,0,0,0,2,0,2,4,1,1,1,3,0,0,0,0,0,1,0,1
143465.0,Galkowska Monika,O,Poland,27.0,185,2023,Serbia,2023-06-03,True,0,0,0,0,0,0,0,0,0,0,2,2,0,0,0,0,0,0,0,0,0,0,0,0
143465.0,Galkowska Monika,O,Poland,27.0,185,2023,Dominican Republic,2023-06-13,True,0,0,0,0,0,0,0,0,2,1,3,6,1,1,1,3,0,0,0,0,0,1,0,1
143465.0,Galkowska Monika,O,Poland,27.0,185,2023,Netherlands,2023-06-16,False,0,0,1,1,0,0,0,0,2,1,1,4,0,1,0,1,0,0,0,0,1,0,0,1
143465.0,Galkowska Monika,O,Poland,27.0,185,2023,China,2023-06-17,True,0,0,0,0,0,0,0,0,2,0,2,4,0,1,1,2,0,0,0,0,1,0,0,1
143465.0,Galkowska Monika,O,Poland,27.0,185,2023,USA,2023-06-28,False,0,0,0,0,0,0,0,0,0,2,3,5,0,0,1,1,0,0,0,0,1,0,0,1
143465.0,Galkowska Monika,O,Poland,27.0,185,2023,Germany,2023-06-29,True,0,1,0,1,0,0,0,0,4,0,3,7,0,0,2,2,0,0,0,0,2,0,1,3
143465.0,Galkowska Monika,O,Poland,27.0,185,2023,Bulgaria,2023-06-30,True,1,0,3,4,0,0,1,1,2,1,3,6,0,1,1,2,0,0,0,0,0,0,0,0
143465.0,Galkowska Monika,O,Poland,27.0,185,2023,Germany,2023-07-12,True,0,0,0,0,0,0,0,0,0,0,1,1,0,0,0,0,0,0,0,0,0,0,0,0
143465.0,Galkowska Monika,O,Poland,27.0,185,2023,China,2023-07-15,False,1,0,2,3,0,0,0,0,1,1,3,5,0,0,0,0,0,0,0,0,2,1,0,3
143465.0,Galkowska Monika,O,Poland,27.0,185,2023,USA,2023-07-16,True,0,0,2,2,0,0,1,1,3,2,3,8,0,2,0,2,0,0,0,0,1,0,0,1
152217.0,Stysiak Magdalena,O,Poland,23.0,203,2023,Canada,2023-05-30,True,1,1,12,14,0,1,0,1,15,10,25,50,5,2,3,10,0,0,0,0,7,1,1,9
152217.0,Stysiak Magdalena,O,Poland,23.0,203,2023,Italy,2023-06-01,True,0,2,9,11,0,0,0,0,22,8,19,49,2,3,4,9,0,0,0,0,7,1,0,8
152217.0,Stysiak Magdalena,O,Poland,23.0,203,2023,Thailand,2023-06-02,True,0,1,4,5,0,0,0,0,9,4,9,22,0,1,1,2,0,0,0,0,3,1,3,7
152217.0,Stysiak Magdalena,O,Poland,23.0,203,2023,Serbia,2023-06-03,True,0,4,4,8,0,0,3,3,17,10,11,38,3,1,1,5,0,0,0,0,6,3,2,11
152217.0,Stysiak Magdalena,O,Poland,23.0,203,2023,Dominican Republic,2023-06-13,True,0,5,12,17,0,0,1,1,24,5,20,49,4,2,0,6,0,0,0,0,11,4,1,16
152217.0,Stysiak Magdalena,O,Poland,23.0,203,2023,Netherlands,2023-06-16,False,1,1,8,10,0,0,1,1,15,2,12,29,2,0,0,2,0,0,0,0,7,4,2,13
152217.0,Stysiak Magdalena,O,Poland,23.0,203,2023,China,2023-06-17,True,0,2,4,6,0,0,1,1,19,5,11,35,1,0,5,6,0,0,0,0,7,2,0,9
152217.0,Stysiak Magdalena,O,Poland,23.0,203,2023,USA,2023-06-28,False,1,5,13,19,0,0,2,2,24,6,20,50,3,4,4,11,0,0,0,0,7,6,0,13
152217.0,Stysiak Magdalena,O,Poland,23.0,203,2023,Germany,2023-06-29,True,1,3,13,17,0,0,2,2,19,8,16,43,2,2,3,7,0,0,0,0,9,2,1,12
152217.0,Stysiak Magdalena,O,Poland,23.0,203,2023,Bulgaria,2023-06-30,True,0,3,14,17,0,0,3,3,14,5,8,27,5,4,5,14,0,0,0,0,16,2,2,20
152217.0,Stysiak Magdalena,O,Poland,23.0,203,2023,Germany,2023-07-12,True,1,2,13,16,0,0,2,2,17,4,17,38,0,4,2,6,0,0,0,0,21,1,0,22
152217.0,Stysiak Magdalena,O,Poland,23.0,203,2023,China,2023-07-15,False,0,3,5,8,0,0,0,0,15,5,14,34,0,4,3,7,0,0,0,0,4,1,1,6
152217.0,Stysiak Magdalena,O,Poland,23.0,203,2023,USA,2023-07-16,True,2,3,12,17,0,0,3,3,20,13,20,53,1,1,7,9,0,0,0,0,10,2,1,13
152231.0,Fedusio Monika,OH,Poland,24.0,183,2023,Canada,2023-05-30,True,0,0,1,1,0,0,0,0,0,0,0,0,0,0,0,0,0,1,1,2,0,0,0,0
152231.0,Fedusio Monika,OH,Poland,24.0,183,2023,Italy,2023-06-01,True,0,0,0,0,0,0,0,0,0,0,0,0,0,0,0,0,0,0,0,0,0,0,0,0
152231.0,Fedusio Monika,OH,Poland,24.0,183,2023,Thailand,2023-06-02,True,0,1,1,2,0,0,0,0,1,2,1,4,2,0,0,2,0,0,1,1,1,0,0,1
152231.0,Fedusio Monika,OH,Poland,24.0,183,2023,Serbia,2023-06-03,True,0,0,1,1,0,0,0,0,2,0,0,2,0,0,0,0,1,0,1,2,0,1,0,1
152231.0,Fedusio Monika,OH,Poland,24.0,183,2023,Dominican Republic,2023-06-13,True,0,0,3,3,0,0,0,0,0,0,0,0,0,0,0,0,0,0,0,0,0,1,1,2
152231.0,Fedusio Monika,OH,Poland,24.0,183,2023,Netherlands,2023-06-16,False,0,0,7,7,0,0,1,1,4,2,4,10,0,1,0,1,2,0,9,11,4,2,0,6
152231.0,Fedusio Monika,OH,Poland,24.0,183,2023,China,2023-06-17,True,0,1,1,2,0,0,1,1,0,0,0,0,0,0,0,0,0,0,0,0,0,0,0,0
152231.0,Fedusio Monika,OH,Poland,24.0,183,2023,USA,2023-06-28,False,0,1,0,1,0,0,0,0,0,0,0,0,0,1,1,2,1,0,5,6,0,1,0,1
152231.0,Fedusio Monika,OH,Poland,24.0,183,2023,Germany,2023-06-29,True,0,0,0,0,0,0,0,0,0,0,0,0,0,0,0,0,0,0,0,0,0,0,0,0
152231.0,Fedusio Monika,OH,Poland,24.0,183,2023,Bulgaria,2023-06-30,True,1,0,1,2,0,0,1,1,0,0,0,0,0,0,0,0,0,0,4,4,0,0,0,0
152231.0,Fedusio Monika,OH,Poland,24.0,183,2023,Germany,2023-07-12,True,0,0,3,3,0,0,0,0,0,0,0,0,0,0,0,0,1,1,2,4,0,2,0,2
152231.0,Fedusio Monika,OH,Poland,24.0,183,2023,China,2023-07-15,False,0,0,1,1,0,0,0,0,0,0,0,0,0,0,0,0,0,0,0,0,0,0,0,0
152231.0,Fedusio Monika,OH,Poland,24.0,183,2023,USA,2023-07-16,True,1,1,1,3,0,0,0,0,0,1,1,2,0,0,0,0,0,0,3,3,2,1,0,3
163098.0,Lukasik Martyna,OH,Poland,24.0,189,2023,Canada,2023-05-30,True,0,1,5,6,0,0,4,4,10,5,14,29,0,1,2,3,2,0,13,15,10,3,3,16
163098.0,Lukasik Martyna,OH,Poland,24.0,189,2023,Italy,2023-06-01,True,0,2,9,11,0,0,1,1,10,5,13,28,3,1,3,7,12,2,17,31,10,4,0,14
163098.0,Lukasik Martyna,OH,Poland,24.0,189,2023,Thailand,2023-06-02,True,2,0,12,14,0,0,2,2,7,1,12,20,2,2,1,5,2,0,12,14,8,1,1,10
163098.0,Lukasik Martyna,OH,Poland,24.0,189,2023,Serbia,2023-06-03,True,1,0,11,12,0,0,2,2,10,2,11,23,0,1,2,3,1,1,5,7,7,4,1,12
163098.0,Lukasik Martyna,OH,Poland,24.0,189,2023,Dominican Republic,2023-06-13,True,2,2,16,20,0,0,4,4,7,3,5,15,1,6,3,10,10,1,19,30,6,4,1,11
163098.0,Lukasik Martyna,OH,Poland,24.0,189,2023,Netherlands,2023-06-16,False,0,0,0,0,0,0,1,1,0,1,5,6,0,1,0,1,0,0,1,1,1,0,1,2
163098.0,Lukasik Martyna,OH,Poland,24.0,189,2023,China,2023-06-17,True,0,1,9,10,0,0,1,1,10,1,8,19,3,2,0,5,3,2,17,22,6,1,0,7
163098.0,Lukasik Martyna,OH,Poland,24.0,189,2023,USA,2023-06-28,False,0,0,16,16,0,0,6,6,13,3,21,37,3,1,5,9,17,2,32,51,5,3,1,9
163098.0,Lukasik Martyna,OH,Poland,24.0,189,2023,Germany,2023-06-29,True,0,0,3,3,0,0,2,2,5,1,4,10,0,0,1,1,6,2,14,22,2,4,0,6
163098.0,Lukasik Martyna,OH,Poland,24.0,189,2023,Bulgaria,2023-06-30,True,0,0,4,4,0,1,2,3,2,2,11,15,0,1,0,1,1,1,11,13,0,0,0,0
163098.0,Lukasik Martyna,OH,Poland,24.0,189,2023,Germany,2023-07-12,True,0,0,27,27,0,0,5,5,15,2,12,29,0,6,2,8,9,3,24,36,8,5,1,14
163098.0,Lukasik Martyna,OH,Poland,24.0,189,2023,China,2023-07-15,False,1,3,10,14,0,0,2,2,8,1,9,18,0,1,0,1,8,1,18,27,3,1,1,5
163098.0,Lukasik Martyna,OH,Poland,24.0,189,2023,USA,2023-07-16,True,1,3,14,18,0,0,4,4,12,4,17,33,1,0,6,7,5,2,16,23,6,3,3,12
185609.0,Szczyglowska Aleksandra,OH,Poland,26.0,172,2023,Canada,2023-05-30,True,0,0,0,0,0,0,1,1,0,0,0,0,0,0,0,0,2,0,4,6,0,1,0,1
185609.0,Szczyglowska Aleksandra,OH,Poland,26.0,172,2023,Italy,2023-06-01,True,0,0,0,0,0,0,2,2,0,0,0,0,0,0,0,0,0,0,1,1,0,1,0,1
185609.0,Szczyglowska Aleksandra,OH,Poland,26.0,172,2023,Thailand,2023-06-02,True,0,0,0,0,0,0,0,0,0,0,0,0,0,0,0,0,0,0,0,0,0,0,0,0
185609.0,Szczyglowska Aleksandra,OH,Poland,26.0,172,2023,Serbia,2023-06-03,True,0,0,0,0,0,0,0,0,0,0,0,0,0,0,0,0,1,0,1,2,0,0,0,0
185609.0,Szczyglowska Aleksandra,OH,Poland,26.0,172,2023,Dominican Republic,2023-06-13,True,0,0,0,0,0,0,0,0,0,0,0,0,0,0,0,0,0,0,1,1,0,0,0,0
185609.0,Szczyglowska Aleksandra,OH,Poland,26.0,172,2023,Netherlands,2023-06-16,False,0,0,0,0,0,0,0,0,0,0,0,0,0,0,0,0,2,1,1,4,1,0,0,1
185609.0,Szczyglowska Aleksandra,OH,Poland,26.0,172,2023,China,2023-06-17,True,0,0,0,0,0,0,1,1,0,0,0,0,0,0,0,0,0,0,1,1,0,0,0,0
185609.0,Szczyglowska Aleksandra,OH,Poland,26.0,172,2023,USA,2023-06-28,False,0,0,0,0,0,0,0,0,0,0,0,0,0,0,0,0,0,0,0,0,0,0,0,0
185609.0,Szczyglowska Aleksandra,OH,Poland,26.0,172,2023,Germany,2023-06-29,True,0,0,0,0,0,0,0,0,0,0,0,0,0,0,0,0,2,0,1,3,2,0,0,2
185609.0,Szczyglowska Aleksandra,OH,Poland,26.0,172,2023,Bulgaria,2023-06-30,True,0,0,0,0,0,0,1,1,0,0,0,0,0,0,0,0,0,0,0,0,2,0,0,2
185609.0,Szczyglowska Aleksandra,OH,Poland,26.0,172,2023,Germany,2023-07-12,True,0,0,0,0,0,0,0,0,0,0,0,0,0,0,0,0,0,0,0,0,0,0,0,0
185609.0,Szczyglowska Aleksandra,OH,Poland,26.0,172,2023,China,2023-07-15,False,0,0,0,0,0,0,0,0,0,0,0,0,0,0,0,0,0,0,0,0,0,0,0,0
185609.0,Szczyglowska Aleksandra,OH,Poland,26.0,172,2023,USA,2023-07-16,True,0,0,0,0,0,0,1,1,0,0,0,0,0,0,0,0,1,0,2,3,0,0,0,0
181268.0,Czyrnianska Martyna,OH,Poland,20.0,191,2023,Canada,2023-05-30,True,1,0,2,3,0,0,0,0,4,1,5,10,0,0,0,0,1,0,2,3,2,1,0,3
181268.0,Czyrnianska Martyna,OH,Poland,20.0,191,2023,Italy,2023-06-01,True,1,3,12,16,0,0,2,2,6,4,7,17,1,3,1,5,0,0,8,8,5,1,0,6
181268.0,Czyrnianska Martyna,OH,Poland,20.0,191,2023,Thailand,2023-06-02,True,0,0,0,0,0,0,0,0,0,0,0,0,0,0,0,0,0,0,0,0,0,0,0,0
181268.0,Czyrnianska Martyna,OH,Poland,20.0,191,2023,Serbia,2023-06-03,True,0,2,4,6,0,0,0,0,0,0,4,4,1,1,0,2,4,0,5,9,3,1,1,5
181268.0,Czyrnianska Martyna,OH,Poland,20.0,191,2023,Dominican Republic,2023-06-13,True,0,1,0,1,0,0,0,0,0,0,0,0,0,0,0,0,0,0,0,0,0,0,0,0
181268.0,Czyrnianska Martyna,OH,Poland,20.0,191,2023,Netherlands,2023-06-16,False,0,1,2,3,0,0,1,1,4,0,5,9,1,0,1,2,0,0,3,3,3,1,0,4
181268.0,Czyrnianska Martyna,OH,Poland,20.0,191,2023,China,2023-06-17,True,0,0,1,1,0,0,0,0,0,0,0,0,0,0,0,0,1,0,1,2,0,0,0,0
181268.0,Czyrnianska Martyna,OH,Poland,20.0,191,2023,USA,2023-06-28,False,1,2,6,9,0,0,3,3,9,3,9,21,0,2,0,2,2,0,2,4,8,2,0,10
181268.0,Czyrnianska Martyna,OH,Poland,20.0,191,2023,Germany,2023-06-29,True,3,3,7,13,0,0,2,2,6,5,13,24,1,1,1,3,7,1,14,22,7,1,6,14
181268.0,Czyrnianska Martyna,OH,Poland,20.0,191,2023,Bulgaria,2023-06-30,True,1,1,5,7,0,0,1,1,11,1,6,18,2,1,0,3,1,0,8,9,8,1,1,10
181268.0,Czyrnianska Martyna,OH,Poland,20.0,191,2023,Germany,2023-07-12,True,0,0,1,1,0,0,2,2,2,2,2,6,1,0,0,1,0,0,1,1,0,1,1,2
181268.0,Czyrnianska Martyna,OH,Poland,20.0,191,2023,China,2023-07-15,False,0,3,7,10,0,0,0,0,5,1,7,13,0,1,3,4,3,0,11,14,3,0,0,3
181268.0,Czyrnianska Martyna,OH,Poland,20.0,191,2023,USA,2023-07-16,True,0,0,0,0,0,0,0,0,0,0,0,0,0,0,0,0,0,0,0,0,0,0,0,0
181963.0,Pierzchała Dominika,MB,Poland,21.0,190,2023,Dominican Republic,2023-06-13,True,0,0,0,0,0,0,0,0,0,0,0,0,0,0,0,0,0,0,0,0,0,0,0,0
181963.0,Pierzchała Dominika,MB,Poland,21.0,190,2023,Netherlands,2023-06-16,False,0,0,0,0,0,0,0,0,0,0,0,0,0,0,0,0,0,0,0,0,0,0,0,0
181963.0,Pierzchała Dominika,MB,Poland,21.0,190,2023,China,2023-06-17,True,0,0,0,0,0,0,0,0,0,0,0,0,0,0,0,0,0,0,0,0,0,0,0,0
181963.0,Pierzchała Dominika,MB,Poland,21.0,190,2023,USA,2023-06-28,False,0,0,0,0,0,0,0,0,0,0,0,0,0,0,0,0,0,0,0,0,0,0,0,0
181963.0,Pierzchała Dominika,MB,Poland,21.0,190,2023,Germany,2023-06-29,True,0,0,0,0,0,0,0,0,0,0,0,0,0,0,0,0,0,0,0,0,0,0,0,0
181963.0,Pierzchała Dominika,MB,Poland,21.0,190,2023,Bulgaria,2023-06-30,True,0,0,0,0,0,0,0,0,0,0,0,0,0,0,0,0,0,0,0,0,0,0,0,0
181963.0,Pierzchała Dominika,MB,Poland,21.0,190,2023,Germany,2023-07-12,True,0,0,0,0,0,0,0,0,0,0,0,0,0,0,0,0,0,0,0,0,0,0,0,0
181963.0,Pierzchała Dominika,MB,Poland,21.0,190,2023,China,2023-07-15,False,0,0,0,0,0,0,0,0,0,0,0,0,0,0,0,0,0,0,0,0,0,0,0,0
181963.0,Pierzchała Dominika,MB,Poland,21.0,190,2023,USA,2023-07-16,True,0,0,0,0,0,0,0,0,0,0,0,0,0,0,0,0,0,0,0,0,0,0,0,0
181263.0,Wenerska Katarzyna,S,Poland,31.0,180,2023,Canada,2023-05-30,True,0,2,15,17,27,1,103,131,1,0,3,4,1,5,5,11,0,0,0,0,13,3,0,16
181263.0,Wenerska Katarzyna,S,Poland,31.0,180,2023,Italy,2023-06-01,True,2,0,22,24,13,0,84,97,1,0,0,1,0,0,0,0,0,0,0,0,11,5,3,19
181263.0,Wenerska Katarzyna,S,Poland,31.0,180,2023,Thailand,2023-06-02,True,1,0,6,7,8,0,56,64,0,0,0,0,1,1,1,3,0,0,0,0,6,3,1,10
181263.0,Wenerska Katarzyna,S,Poland,31.0,180,2023,Serbia,2023-06-03,True,1,0,19,20,2,1,80,83,1,0,0,1,2,2,1,5,0,0,0,0,6,4,4,14
181263.0,Wenerska Katarzyna,S,Poland,31.0,180,2023,Dominican Republic,2023-06-13,True,0,1,11,12,27,2,73,102,1,0,0,1,0,1,4,5,0,0,1,1,7,5,1,13
181263.0,Wenerska Katarzyna,S,Poland,31.0,180,2023,Netherlands,2023-06-16,False,0,2,11,13,11,0,46,57,0,0,1,1,0,2,1,3,0,0,0,0,4,1,0,5
181263.0,Wenerska Katarzyna,S,Poland,31.0,180,2023,China,2023-06-17,True,0,1,12,13,12,0,59,71,0,0,1,1,0,2,1,3,0,0,0,0,9,6,1,16
181263.0,Wenerska Katarzyna,S,Poland,31.0,180,2023,USA,2023-06-28,False,0,0,22,22,22,1,101,124,0,0,2,2,2,8,4,14,0,0,0,0,12,4,2,18
181263.0,Wenerska Katarzyna,S,Poland,31.0,180,2023,Germany,2023-06-29,True,0,0,12,12,25,0,83,108,0,0,1,1,0,2,3,5,0,0,0,0,6,3,2,11
181263.0,Wenerska Katarzyna,S,Poland,31.0,180,2023,Bulgaria,2023-06-30,True,0,3,14,17,25,0,60,85,0,0,2,2,0,4,4,8,0,0,0,0,11,4,1,16
181263.0,Wenerska Katarzyna,S,Poland,31.0,180,2023,Germany,2023-07-12,True,0,1,11,12,18,1,87,106,1,0,2,3,2,4,3,9,0,0,0,0,10,2,0,12
181263.0,Wenerska Katarzyna,S,Poland,31.0,180,2023,China,2023-07-15,False,0,0,10,10,15,0,60,75,0,0,0,0,0,2,0,2,0,0,0,0,3,1,1,5
181263.0,Wenerska Katarzyna,S,Poland,31.0,180,2023,USA,2023-07-16,True,1,2,15,18,9,1,78,88,1,0,0,1,1,3,4,8,0,0,0,0,10,3,0,13
143460.0,Pacak Joanna,MB,Poland,27.0,186,2023,Canada,2023-05-30,True,0,0,0,0,0,0,0,0,0,0,0,0,0,0,0,0,0,0,0,0,0,0,0,0
143460.0,Pacak Joanna,MB,Poland,27.0,186,2023,Italy,2023-06-01,True,0,0,0,0,0,0,0,0,0,0,0,0,0,0,0,0,0,0,0,0,0,0,0,0
143460.0,Pacak Joanna,MB,Poland,27.0,186,2023,Thailand,2023-06-02,True,0,0,0,0,0,0,0,0,2,0,0,2,0,1,1,2,0,0,0,0,0,0,1,1
143460.0,Pacak Joanna,MB,Poland,27.0,186,2023,Serbia,2023-06-03,True,0,0,1,1,0,0,0,0,1,0,1,2,0,2,1,3,0,0,0,0,0,0,0,0
143460.0,Pacak Joanna,MB,Poland,27.0,186,2023,Dominican Republic,2023-06-13,True,0,0,0,0,0,0,0,0,0,0,0,0,0,0,0,0,0,0,0,0,0,0,0,0
143460.0,Pacak Joanna,MB,Poland,27.0,186,2023,Netherlands,2023-06-16,False,0,0,1,1,0,0,1,1,1,1,0,2,0,1,0,1,0,0,0,0,0,1,0,1
143460.0,Pacak Joanna,MB,Poland,27.0,186,2023,China,2023-06-17,True,0,0,0,0,0,0,0,0,0,0,0,0,0,0,0,0,0,0,0,0,0,0,0,0
143460.0,Pacak Joanna,MB,Poland,27.0,186,2023,USA,2023-06-28,False,0,0,0,0,0,0,0,0,0,0,0,0,0,0,0,0,0,0,0,0,0,0,0,0
143460.0,Pacak Joanna,MB,Poland,27.0,186,2023,Germany,2023-06-29,True,0,0,4,4,0,0,0,0,2,0,1,3,0,0,0,0,0,0,1,1,1,0,0,1
143460.0,Pacak Joanna,MB,Poland,27.0,186,2023,Bulgaria,2023-06-30,True,0,0,0,0,0,0,0,0,2,0,0,2,0,0,1,1,0,0,0,0,0,0,0,0
143460.0,Pacak Joanna,MB,Poland,27.0,186,2023,Germany,2023-07-12,True,0,0,9,9,0,1,0,1,3,0,4,7,6,2,5,13,0,0,1,1,1,2,0,3
143460.0,Pacak Joanna,MB,Poland,27.0,186,2023,China,2023-07-15,False,0,0,0,0,0,0,0,0,0,0,0,0,2,0,1,3,0,0,0,0,0,0,0,0
143460.0,Pacak Joanna,MB,Poland,27.0,186,2023,USA,2023-07-16,True,0,0,0,0,0,0,0,0,0,0,0,0,0,0,0,0,0,0,0,0,0,0,0,0
151231.0,Rozanski Olivia,OH,Poland,26.0,185,2023,Canada,2023-05-30,True,1,3,15,19,0,0,1,1,16,6,24,46,1,2,4,7,3,1,41,45,9,2,1,12
151231.0,Rozanski Olivia,OH,Poland,26.0,185,2023,Italy,2023-06-01,True,0,0,3,3,0,0,1,1,2,1,4,7,0,2,3,5,0,1,1,2,0,1,0,1
151231.0,Rozanski Olivia,OH,Poland,26.0,185,2023,Thailand,2023-06-02,True,1,2,8,11,0,0,0,0,6,3,7,16,0,1,1,2,1,0,20,21,11,2,1,14
151231.0,Rozanski Olivia,OH,Poland,26.0,185,2023,Serbia,2023-06-03,True,0,3,7,10,0,0,2,2,3,2,11,16,1,1,2,4,3,1,17,21,6,3,2,11
151231.0,Rozanski Olivia,OH,Poland,26.0,185,2023,Dominican Republic,2023-06-13,True,0,6,7,13,0,0,2,2,17,4,14,35,2,4,2,8,5,1,14,20,5,3,0,8
151231.0,Rozanski Olivia,OH,Poland,26.0,185,2023,Netherlands,2023-06-16,False,0,5,7,12,0,0,1,1,14,0,16,30,0,4,4,8,4,0,27,31,6,3,1,10
151231.0,Rozanski Olivia,OH,Poland,26.0,185,2023,China,2023-06-17,True,1,2,13,16,0,0,1,1,9,4,13,26,0,3,2,5,1,1,18,20,4,3,0,7
151231.0,Rozanski Olivia,OH,Poland,26.0,185,2023,USA,2023-06-28,False,0,5,5,10,0,0,3,3,8,3,14,25,0,3,5,8,2,2,14,18,3,1,1,5
151231.0,Rozanski Olivia,OH,Poland,26.0,185,2023,Germany,2023-06-29,True,0,4,18,22,0,0,3,3,11,1,18,30,1,6,3,10,5,1,23,29,8,5,0,13
151231.0,Rozanski Olivia,OH,Poland,26.0,185,2023,Bulgaria,2023-06-30,True,1,4,10,15,0,0,3,3,13,1,10,24,2,0,9,11,1,2,28,31,3,4,0,7
151231.0,Rozanski Olivia,OH,Poland,26.0,185,2023,Germany,2023-07-12,True,1,1,9,11,0,0,3,3,16,1,18,35,1,0,1,2,2,1,15,18,8,3,0,11
151231.0,Rozanski Olivia,OH,Poland,26.0,185,2023,China,2023-07-15,False,0,1,1,2,0,0,0,0,2,3,3,8,0,0,0,0,1,0,7,8,1,0,0,1
151231.0,Rozanski Olivia,OH,Poland,26.0,185,2023,USA,2023-07-16,True,1,2,12,15,0,0,3,3,10,3,15,28,3,4,5,12,3,3,30,36,10,3,0,13
152216.0,Nowicka Julia,S,Poland,25.0,174,2023,Canada,2023-05-30,True,0,0,0,0,0,0,3,3,0,0,0,0,0,0,0,0,0,0,0,0,0,0,0,0
152216.0,Nowicka Julia,S,Poland,25.0,174,2023,Italy,2023-06-01,True,0,0,1,1,0,0,1,1,0,0,0,0,0,0,0,0,0,0,0,0,0,0,0,0
152216.0,Nowicka Julia,S,Poland,25.0,174,2023,Thailand,2023-06-02,True,0,0,3,3,0,0,13,13,0,0,0,0,0,0,0,0,0,0,0,0,0,0,0,0
152216.0,Nowicka Julia,S,Poland,25.0,174,2023,Serbia,2023-06-03,True,0,0,1,1,0,1,2,3,0,0,0,0,0,0,0,0,0,0,0,0,0,1,0,1
152216.0,Nowicka Julia,S,Poland,25.0,174,2023,Dominican Republic,2023-06-13,True,0,0,2,2,5,0,5,10,0,0,0,0,0,0,0,0,0,0,0,0,0,1,1,2
152216.0,Nowicka Julia,S,Poland,25.0,174,2023,Netherlands,2023-06-16,False,0,0,7,7,5,0,29,34,0,1,0,1,0,0,1,1,0,0,0,0,2,2,2,6
152216.0,Nowicka Julia,S,Poland,25.0,174,2023,China,2023-06-17,True,0,0,3,3,1,0,7,8,0,0,0,0,0,0,0,0,0,0,0,0,1,1,0,2
152216.0,Nowicka Julia,S,Poland,25.0,174,2023,USA,2023-06-28,False,0,0,1,1,3,0,7,10,0,0,0,0,0,0,0,0,0,0,0,0,0,0,0,0
152216.0,Nowicka Julia,S,Poland,25.0,174,2023,Germany,2023-06-29,True,0,0,3,3,2,0,17,19,0,0,0,0,0,0,0,0,0,0,0,0,1,1,0,2
152216.0,Nowicka Julia,S,Poland,25.0,174,2023,Bulgaria,2023-06-30,True,0,0,4,4,3,1,7,11,1,0,0,1,0,1,1,2,0,0,0,0,2,0,0,2
152216.0,Nowicka Julia,S,Poland,25.0,174,2023,Germany,2023-07-12,True,0,0,1,1,0,0,1,1,0,0,0,0,0,0,0,0,0,0,0,0,0,0,0,0
152216.0,Nowicka Julia,S,Poland,25.0,174,2023,China,2023-07-15,False,0,0,1,1,4,0,6,10,0,0,0,0,0,1,0,1,0,0,0,0,0,0,0,0
152216.0,Nowicka Julia,S,Poland,25.0,174,2023,USA,2023-07-16,True,0,0,1,1,3,0,27,30,0,0,0,0,0,0,1,1,0,0,0,0,3,1,1,5
185611.0,Jurczyk Magdalena,MB,Poland,28.0,183,2023,Canada,2023-05-30,True,1,2,14,17,0,0,2,2,5,0,6,11,1,4,7,12,0,0,0,0,6,2,0,8
185611.0,Jurczyk Magdalena,MB,Poland,28.0,183,2023,Italy,2023-06-01,True,1,0,10,11,0,0,0,0,4,0,2,6,3,5,5,13,0,0,2,2,6,0,0,6
185611.0,Jurczyk Magdalena,MB,Poland,28.0,183,2023,Thailand,2023-06-02,True,0,1,7,8,0,0,0,0,7,1,4,12,2,3,4,9,0,0,0,0,2,0,2,4
185611.0,Jurczyk Magdalena,MB,Poland,28.0,183,2023,Serbia,2023-06-03,True,0,0,9,9,0,0,2,2,4,0,1,5,2,2,3,7,0,0,0,0,0,1,0,1
185611.0,Jurczyk Magdalena,MB,Poland,28.0,183,2023,Dominican Republic,2023-06-13,True,0,1,12,13,0,0,2,2,4,1,5,10,2,3,6,11,0,0,1,1,2,0,0,2
185611.0,Jurczyk Magdalena,MB,Poland,28.0,183,2023,Netherlands,2023-06-16,False,1,1,7,9,0,0,0,0,5,0,0,5,0,5,1,6,0,0,0,0,0,2,1,3
185611.0,Jurczyk Magdalena,MB,Poland,28.0,183,2023,China,2023-06-17,True,0,0,10,10,0,0,3,3,5,0,2,7,1,3,0,4,0,0,0,0,2,3,0,5
185611.0,Jurczyk Magdalena,MB,Poland,28.0,183,2023,USA,2023-06-28,False,1,0,14,15,0,0,2,2,6,1,2,9,1,6,9,16,0,0,0,0,3,1,0,4
185611.0,Jurczyk Magdalena,MB,Poland,28.0,183,2023,Germany,2023-06-29,True,0,0,14,14,0,0,5,5,10,2,4,16,1,5,2,8,0,0,0,0,4,2,0,6
185611.0,Jurczyk Magdalena,MB,Poland,28.0,183,2023,Bulgaria,2023-06-30,True,2,0,14,16,0,0,1,1,5,1,5,11,1,7,4,12,0,0,0,0,2,0,0,2
185611.0,Jurczyk Magdalena,MB,Poland,28.0,183,2023,Germany,2023-07-12,True,0,0,2,2,0,0,1,1,2,0,4,6,0,2,2,4,0,0,0,0,3,0,0,3
185611.0,Jurczyk Magdalena,MB,Poland,28.0,183,2023,China,2023-07-15,False,0,1,6,7,0,0,0,0,7,0,3,10,1,5,2,8,0,0,0,0,1,0,0,1
185611.0,Jurczyk Magdalena,MB,Poland,28.0,183,2023,USA,2023-07-16,True,0,1,12,13,0,0,8,8,8,3,3,14,2,2,3,7,0,0,0,0,3,0,0,3
136024.0,Busa Bianka,OH,Serbia,29.0,187,2023,USA,2023-05-31,False,1,1,15,17,0,0,2,2,14,4,10,28,0,3,0,3,10,2,26,38,10,5,2,17
136024.0,Busa Bianka,OH,Serbia,29.0,187,2023,Poland,2023-06-03,False,0,0,3,3,0,0,3,3,0,5,1,6,0,1,1,2,2,0,3,5,0,0,1,1
136024.0,Busa Bianka,OH,Serbia,29.0,187,2023,Canada,2023-06-04,False,0,2,11,13,0,0,1,1,3,5,9,17,0,1,0,1,10,2,18,30,6,1,3,10
136024.0,Busa Bianka,OH,Serbia,29.0,187,2023,China,2023-06-28,True,2,2,14,18,0,0,2,2,8,5,7,20,0,0,1,1,7,1,13,21,12,0,0,12
136024.0,Busa Bianka,OH,Serbia,29.0,187,2023,Germany,2023-06-30,True,0,4,13,17,0,0,4,4,7,3,6,16,0,1,0,1,7,3,17,27,10,2,2,14
136024.0,Busa Bianka,OH,Serbia,29.0,187,2023,Dominican Republic,2023-07-01,False,0,1,8,9,0,0,1,1,3,1,6,10,0,1,2,3,3,2,21,26,3,1,0,4
136024.0,Busa Bianka,OH,Serbia,29.0,187,2023,Bulgaria,2023-07-02,True,2,0,4,6,0,0,0,0,3,0,4,7,0,4,1,5,1,0,12,13,3,0,1,4
152168.0,Lazovic Katarina,OH,Serbia,24.0,182,2023,USA,2023-05-31,False,0,0,5,5,0,0,0,0,0,0,0,0,0,0,0,0,0,0,0,0,0,0,0,0
152168.0,Lazovic Katarina,OH,Serbia,24.0,182,2023,Poland,2023-06-03,False,0,1,3,4,0,0,0,0,8,0,3,11,0,0,0,0,0,0,9,9,5,0,0,5
152168.0,Lazovic Katarina,OH,Serbia,24.0,182,2023,Canada,2023-06-04,False,0,0,8,8,0,0,1,1,3,1,6,10,0,2,2,4,8,0,16,24,7,3,1,11
152168.0,Lazovic Katarina,OH,Serbia,24.0,182,2023,China,2023-06-28,True,0,0,0,0,0,0,0,0,0,0,0,0,0,0,0,0,0,0,0,0,0,0,0,0
152168.0,Lazovic Katarina,OH,Serbia,24.0,182,2023,Germany,2023-06-30,True,0,0,1,1,0,0,0,0,0,0,0,0,0,0,0,0,0,0,0,0,0,0,0,0
152168.0,Lazovic Katarina,OH,Serbia,24.0,182,2023,Dominican Republic,2023-07-01,False,0,0,4,4,0,0,0,0,2,1,5,8,0,1,0,1,1,0,5,6,1,1,0,2
152168.0,Lazovic Katarina,OH,Serbia,24.0,182,2023,Bulgaria,2023-07-02,True,0,1,6,7,0,0,2,2,2,4,6,12,2,1,1,4,4,1,8,13,12,2,1,15
120326.0,Drca Bojana,S,Serbia,35.0,186,2023,USA,2023-05-31,False,0,2,14,16,21,0,97,118,3,1,2,6,0,1,2,3,0,0,0,0,11,7,2,20
120326.0,Drca Bojana,S,Serbia,35.0,186,2023,Poland,2023-06-03,False,0,3,7,10,3,0,71,74,1,1,0,2,0,1,2,3,0,0,0,0,3,4,2,9
120326.0,Drca Bojana,S,Serbia,35.0,186,2023,Canada,2023-06-04,False,0,0,17,17,11,1,106,118,1,2,2,5,1,5,3,9,0,0,0,0,11,6,0,17
120326.0,Drca Bojana,S,Serbia,35.0,186,2023,China,2023-06-28,True,0,0,0,0,0,0,2,2,0,0,0,0,0,0,0,0,0,0,0,0,0,1,0,1
120326.0,Drca Bojana,S,Serbia,35.0,186,2023,Germany,2023-06-30,True,0,0,1,1,1,0,8,9,0,0,0,0,0,0,0,0,0,0,0,0,1,1,0,2
120326.0,Drca Bojana,S,Serbia,35.0,186,2023,Dominican Republic,2023-07-01,False,0,1,7,8,6,0,29,35,0,0,0,0,0,1,2,3,0,0,0,0,7,1,1,9
120326.0,Drca Bojana,S,Serbia,35.0,186,2023,Bulgaria,2023-07-02,True,2,2,12,16,22,1,73,96,2,0,1,3,0,3,2,5,0,0,0,0,7,2,2,11
136030.0,Popovic Mina,MB,Serbia,29.0,187,2023,USA,2023-05-31,False,0,2,14,16,0,0,2,2,5,1,5,11,3,5,3,11,1,0,1,2,0,0,1,1
136030.0,Popovic Mina,MB,Serbia,29.0,187,2023,Poland,2023-06-03,False,1,0,8,9,0,0,1,1,2,1,3,6,1,7,5,13,0,0,1,1,1,1,0,2
136030.0,Popovic Mina,MB,Serbia,29.0,187,2023,Canada,2023-06-04,False,1,1,16,18,0,1,1,2,6,0,4,10,3,10,8,21,0,1,0,1,2,3,0,5
136030.0,Popovic Mina,MB,Serbia,29.0,187,2023,China,2023-06-28,True,2,1,6,9,0,0,0,0,8,1,3,12,3,0,0,3,0,0,3,3,2,2,1,5
136030.0,Popovic Mina,MB,Serbia,29.0,187,2023,Germany,2023-06-30,True,2,1,15,18,0,0,0,0,7,1,5,13,0,6,9,15,0,0,1,1,1,0,1,2
136030.0,Popovic Mina,MB,Serbia,29.0,187,2023,Dominican Republic,2023-07-01,False,0,2,8,10,0,0,1,1,8,1,6,15,2,7,8,17,0,0,0,0,3,1,0,4
136030.0,Popovic Mina,MB,Serbia,29.0,187,2023,Bulgaria,2023-07-02,True,0,0,2,2,0,0,0,0,1,0,0,1,0,3,1,4,0,0,0,0,1,0,1,2
181204.0,Uzelac Aleksandra,OH,Serbia,19.0,188,2023,USA,2023-05-31,False,0,1,2,3,0,0,0,0,4,3,3,10,0,0,2,2,0,0,1,1,2,0,0,2
181204.0,Uzelac Aleksandra,OH,Serbia,19.0,188,2023,Poland,2023-06-03,False,1,3,7,11,0,0,1,1,9,8,13,30,1,1,0,2,3,0,10,13,5,2,1,8
181204.0,Uzelac Aleksandra,OH,Serbia,19.0,188,2023,Canada,2023-06-04,False,1,1,4,6,0,0,1,1,16,4,17,37,1,0,2,3,1,0,5,6,4,0,1,5
181204.0,Uzelac Aleksandra,OH,Serbia,19.0,188,2023,China,2023-06-28,True,0,0,0,0,0,0,1,1,1,0,2,3,0,0,0,0,0,0,0,0,0,0,0,0
181204.0,Uzelac Aleksandra,OH,Serbia,19.0,188,2023,Germany,2023-06-30,True,0,1,5,6,0,0,1,1,8,1,14,23,1,3,0,4,1,0,7,8,6,1,3,10
181204.0,Uzelac Aleksandra,OH,Serbia,19.0,188,2023,Dominican Republic,2023-07-01,False,0,1,10,11,0,1,2,3,8,3,18,29,2,3,2,7,3,1,8,12,5,3,1,9
181204.0,Uzelac Aleksandra,OH,Serbia,19.0,188,2023,Bulgaria,2023-07-02,True,0,0,0,0,0,0,0,0,0,3,3,6,1,2,0,3,0,0,1,1,0,1,0,1
116216.0,Ognjenovic Maja,S,Serbia,39.0,183,2023,China,2023-06-28,True,1,2,13,16,25,2,76,103,2,0,2,4,0,7,4,11,0,0,0,0,6,3,1,10
116216.0,Ognjenovic Maja,S,Serbia,39.0,183,2023,Germany,2023-06-30,True,0,1,23,24,20,1,82,103,2,0,1,3,0,3,0,3,0,0,0,0,5,2,1,8
116216.0,Ognjenovic Maja,S,Serbia,39.0,183,2023,Dominican Republic,2023-07-01,False,1,0,11,12,29,1,68,98,0,0,1,1,2,7,4,13,0,0,0,0,8,0,0,8
116216.0,Ognjenovic Maja,S,Serbia,39.0,183,2023,Bulgaria,2023-07-02,True,1,0,2,3,8,0,17,25,0,0,0,0,0,0,1,1,0,0,0,0,2,0,1,3
123709.0,Pusic Teodora,L,Serbia,31.0,170,2023,USA,2023-05-31,False,0,0,0,0,0,0,11,11,0,0,0,0,0,0,0,0,1,0,13,14,14,5,3,22
123709.0,Pusic Teodora,L,Serbia,31.0,170,2023,Poland,2023-06-03,False,0,0,0,0,0,0,9,9,0,0,0,0,0,0,0,0,5,0,15,20,11,2,3,16
123709.0,Pusic Teodora,L,Serbia,31.0,170,2023,Canada,2023-06-04,False,0,0,0,0,0,1,23,24,0,0,0,0,0,0,0,0,6,0,9,15,14,4,5,23
123709.0,Pusic Teodora,L,Serbia,31.0,170,2023,China,2023-06-28,True,0,0,0,0,0,0,7,7,0,0,0,0,0,0,0,0,8,0,12,20,10,6,3,19
123709.0,Pusic Teodora,L,Serbia,31.0,170,2023,Germany,2023-06-30,True,0,0,0,0,0,0,13,13,0,0,0,0,0,0,0,0,6,1,10,17,11,5,1,17
123709.0,Pusic Teodora,L,Serbia,31.0,170,2023,Dominican Republic,2023-07-01,False,0,0,0,0,0,0,15,15,0,0,0,0,0,0,0,0,8,2,15,25,11,3,4,18
123709.0,Pusic Teodora,L,Serbia,31.0,170,2023,Bulgaria,2023-07-02,True,0,0,0,0,0,0,3,3,0,0,0,0,0,0,0,0,1,1,4,6,4,0,0,4
123694.0,Bjelica Ana,O,Serbia,31.0,190,2023,USA,2023-05-31,False,2,2,11,15,0,0,1,1,17,5,21,43,0,5,1,6,0,0,0,0,5,2,1,8
123694.0,Bjelica Ana,O,Serbia,31.0,190,2023,Poland,2023-06-03,False,0,2,4,6,0,0,2,2,9,4,15,28,0,4,7,11,0,0,0,0,4,1,1,6
123694.0,Bjelica Ana,O,Serbia,31.0,190,2023,Canada,2023-06-04,False,3,2,15,20,0,0,4,4,13,5,14,32,2,3,9,14,0,0,0,0,10,8,1,19
123694.0,Bjelica Ana,O,Serbia,31.0,190,2023,China,2023-06-28,True,0,0,0,0,0,0,0,0,0,0,1,1,0,1,0,1,0,0,0,0,0,0,0,0
123694.0,Bjelica Ana,O,Serbia,31.0,190,2023,Germany,2023-06-30,True,0,1,0,1,0,0,0,0,3,0,1,4,0,0,1,1,0,0,0,0,1,0,0,1
123694.0,Bjelica Ana,O,Serbia,31.0,190,2023,Dominican Republic,2023-07-01,False,0,0,2,2,0,0,0,0,2,1,5,8,0,1,1,2,0,0,0,0,3,0,0,3
123694.0,Bjelica Ana,O,Serbia,31.0,190,2023,Bulgaria,2023-07-02,True,1,2,9,12,0,0,1,1,9,3,10,22,0,2,6,8,0,0,0,0,10,0,1,11
143548.0,Aleksic Maja,MB,Serbia,26.0,188,2023,USA,2023-05-31,False,2,2,11,15,0,0,4,4,9,4,4,17,2,10,9,21,0,0,0,0,5,2,2,9
143548.0,Aleksic Maja,MB,Serbia,26.0,188,2023,Poland,2023-06-03,False,0,1,12,13,0,0,2,2,3,0,6,9,0,5,5,10,0,0,0,0,2,0,2,4
143548.0,Aleksic Maja,MB,Serbia,26.0,188,2023,Canada,2023-06-04,False,0,0,18,18,0,0,2,2,10,4,3,17,2,3,18,23,0,0,0,0,2,2,0,4
143548.0,Aleksic Maja,MB,Serbia,26.0,188,2023,China,2023-06-28,True,0,0,3,3,0,0,0,0,0,0,0,0,0,2,0,2,1,0,1,2,0,0,1,1
143548.0,Aleksic Maja,MB,Serbia,26.0,188,2023,Germany,2023-06-30,True,0,0,0,0,0,0,0,0,0,0,0,0,0,0,0,0,0,0,0,0,0,0,0,0
143548.0,Aleksic Maja,MB,Serbia,26.0,188,2023,Dominican Republic,2023-07-01,False,0,0,1,1,0,0,0,0,0,0,1,1,0,1,0,1,0,0,0,0,0,0,0,0
143548.0,Aleksic Maja,MB,Serbia,26.0,188,2023,Bulgaria,2023-07-02,True,1,1,15,17,0,0,4,4,9,4,7,20,5,3,13,21,0,0,0,0,1,0,1,2
123700.0,Stevanovic Jovana,MB,Serbia,31.0,192,2023,China,2023-06-28,True,2,0,17,19,0,0,3,3,10,0,6,16,1,2,0,3,0,0,0,0,3,1,0,4
123700.0,Stevanovic Jovana,MB,Serbia,31.0,192,2023,Germany,2023-06-30,True,0,2,11,13,0,0,1,1,7,3,5,15,2,6,6,14,0,0,1,1,4,2,2,8
123700.0,Stevanovic Jovana,MB,Serbia,31.0,192,2023,Dominican Republic,2023-07-01,False,0,1,13,14,0,0,0,0,3,2,3,8,2,4,6,12,0,0,0,0,2,4,0,6
123700.0,Stevanovic Jovana,MB,Serbia,31.0,192,2023,Bulgaria,2023-07-02,True,1,1,9,11,0,0,0,0,6,5,3,14,1,3,5,9,0,0,0,0,2,1,1,4
170965.0,Jegdic Aleksandra,L,Serbia,29.0,167,2023,USA,2023-05-31,False,0,0,0,0,0,0,0,0,0,0,0,0,0,0,0,0,0,0,0,0,0,0,0,0
170965.0,Jegdic Aleksandra,L,Serbia,29.0,167,2023,Poland,2023-06-03,False,0,0,0,0,0,0,0,0,0,0,0,0,0,0,0,0,0,0,0,0,0,0,0,0
170965.0,Jegdic Aleksandra,L,Serbia,29.0,167,2023,Canada,2023-06-04,False,0,0,0,0,0,0,0,0,0,0,0,0,0,0,0,0,0,0,0,0,0,0,0,0
170965.0,Jegdic Aleksandra,L,Serbia,29.0,167,2023,China,2023-06-28,True,0,0,0,0,0,0,0,0,0,0,0,0,0,0,0,0,0,0,0,0,0,0,0,0
170965.0,Jegdic Aleksandra,L,Serbia,29.0,167,2023,Germany,2023-06-30,True,0,0,0,0,0,0,0,0,0,0,0,0,0,0,0,0,0,0,0,0,0,0,0,0
170965.0,Jegdic Aleksandra,L,Serbia,29.0,167,2023,Dominican Republic,2023-07-01,False,0,0,0,0,0,0,0,0,0,0,0,0,0,0,0,0,0,0,0,0,0,0,0,0
170965.0,Jegdic Aleksandra,L,Serbia,29.0,167,2023,Bulgaria,2023-07-02,True,0,0,0,0,0,0,5,5,0,0,0,0,0,0,0,0,4,3,16,23,10,1,2,13
137941.0,Boškovic Tijana,O,Serbia,27.0,193,2023,China,2023-06-28,True,1,1,7,9,0,0,3,3,24,5,15,44,0,2,2,4,0,0,0,0,10,5,2,17
137941.0,Boškovic Tijana,O,Serbia,27.0,193,2023,Germany,2023-06-30,True,1,1,14,16,0,0,3,3,34,4,12,50,4,2,3,9,0,0,0,0,14,1,1,16
137941.0,Boškovic Tijana,O,Serbia,27.0,193,2023,Dominican Republic,2023-07-01,False,1,1,12,14,0,0,2,2,27,10,12,49,3,5,4,12,0,0,0,0,12,5,2,19
137941.0,Boškovic Tijana,O,Serbia,27.0,193,2023,Bulgaria,2023-07-02,True,1,0,9,10,0,1,0,1,12,1,9,22,1,0,2,3,0,0,0,0,1,0,1,2
142478.0,Milenkovic Bojana,OH,Serbia,27.0,185,2023,USA,2023-05-31,False,0,0,1,1,0,0,0,0,0,0,0,0,0,0,0,0,0,0,4,4,1,0,0,1
142478.0,Milenkovic Bojana,OH,Serbia,27.0,185,2023,Poland,2023-06-03,False,0,0,1,1,0,0,0,0,0,0,1,1,0,0,0,0,0,1,3,4,0,1,1,2
142478.0,Milenkovic Bojana,OH,Serbia,27.0,185,2023,Canada,2023-06-04,False,0,0,2,2,0,0,0,0,0,0,0,0,0,0,0,0,0,0,0,0,0,0,0,0
142478.0,Milenkovic Bojana,OH,Serbia,27.0,185,2023,China,2023-06-28,True,0,0,0,0,0,0,0,0,0,0,0,0,0,0,0,0,1,1,4,6,0,0,0,0
142478.0,Milenkovic Bojana,OH,Serbia,27.0,185,2023,Germany,2023-06-30,True,0,0,0,0,0,0,1,1,0,0,0,0,0,0,0,0,0,0,9,9,3,0,0,3
142478.0,Milenkovic Bojana,OH,Serbia,27.0,185,2023,Dominican Republic,2023-07-01,False,0,0,3,3,0,1,0,1,2,1,4,7,1,0,1,2,3,0,11,14,5,2,1,8
142478.0,Milenkovic Bojana,OH,Serbia,27.0,185,2023,Bulgaria,2023-07-02,True,0,0,0,0,0,0,0,0,0,0,0,0,0,0,0,0,0,1,3,4,1,0,1,2
142479.0,Lozo Sara,O,Serbia,26.0,186,2023,USA,2023-05-31,False,1,0,14,15,0,0,2,2,9,5,17,31,2,2,4,8,5,3,24,32,4,2,1,7
142479.0,Lozo Sara,O,Serbia,26.0,186,2023,Poland,2023-06-03,False,0,1,6,7,0,0,0,0,5,4,5,14,1,3,1,5,0,1,17,18,0,0,0,0
142479.0,Lozo Sara,O,Serbia,26.0,186,2023,Canada,2023-06-04,False,0,0,10,10,0,0,2,2,16,5,11,32,0,1,3,4,0,1,13,14,12,2,0,14
142479.0,Lozo Sara,O,Serbia,26.0,186,2023,China,2023-06-28,True,1,1,15,17,0,0,2,2,8,2,8,18,2,3,4,9,9,1,14,24,4,3,0,7
142479.0,Lozo Sara,O,Serbia,26.0,186,2023,Germany,2023-06-30,True,0,2,3,5,0,0,0,0,4,3,4,11,0,0,2,2,1,1,12,14,3,0,0,3
142479.0,Lozo Sara,O,Serbia,26.0,186,2023,Dominican Republic,2023-07-01,False,0,0,6,6,0,0,2,2,6,4,6,16,1,1,1,3,3,0,11,14,5,2,1,8
142479.0,Lozo Sara,O,Serbia,26.0,186,2023,Bulgaria,2023-07-02,True,0,1,16,17,0,0,2,2,17,4,13,34,0,2,4,6,4,2,14,20,10,1,1,12
151120.0,Srithong Wipawee,OH,Thailand,25.0,174,2023,Italy,2023-05-30,False,0,0,4,4,0,0,0,0,0,0,1,1,0,0,0,0,0,0,1,1,0,0,0,0
151120.0,Srithong Wipawee,OH,Thailand,25.0,174,2023,Canada,2023-06-01,True,1,1,11,13,0,0,3,3,16,7,15,38,1,1,0,2,3,1,7,11,12,3,1,16
151120.0,Srithong Wipawee,OH,Thailand,25.0,174,2023,Poland,2023-06-02,False,0,1,3,4,0,0,2,2,6,3,10,19,1,0,0,1,4,1,5,10,2,4,1,7
151120.0,Srithong Wipawee,OH,Thailand,25.0,174,2023,Germany,2023-06-14,False,1,3,10,14,0,0,0,0,6,5,12,23,0,2,0,2,6,0,17,23,7,3,1,11
151120.0,Srithong Wipawee,OH,Thailand,25.0,174,2023,USA,2023-06-15,False,0,0,5,5,0,0,2,2,4,3,4,11,0,3,0,3,1,0,9,10,3,2,2,7
151120.0,Srithong Wipawee,OH,Thailand,25.0,174,2023,Croatia,2023-06-18,False,0,1,3,4,0,0,1,1,1,1,5,7,0,4,1,5,1,4,13,18,2,1,0,3
151120.0,Srithong Wipawee,OH,Thailand,25.0,174,2023,Netherlands,2023-06-27,False,0,0,4,4,0,1,2,3,7,5,7,19,0,1,2,3,1,2,8,11,3,2,2,7
151120.0,Srithong Wipawee,OH,Thailand,25.0,174,2023,Japan,2023-07-01,False,0,0,0,0,0,0,0,0,0,0,0,0,0,0,0,0,0,0,0,0,0,0,0,0
151120.0,Srithong Wipawee,OH,Thailand,25.0,174,2023,Brazil,2023-07-02,False,0,0,2,2,0,0,2,2,1,0,0,1,0,1,0,1,0,1,4,5,1,0,0,1
123019.0,Guedpard Pornpun,S,Thailand,30.0,170,2023,Italy,2023-05-30,False,0,0,14,14,34,0,111,145,2,1,1,4,0,2,2,4,0,0,0,0,7,4,2,13
123019.0,Guedpard Pornpun,S,Thailand,30.0,170,2023,Canada,2023-06-01,True,0,0,7,7,22,0,61,83,1,0,0,1,0,0,4,4,0,0,1,1,3,5,0,8
123019.0,Guedpard Pornpun,S,Thailand,30.0,170,2023,Poland,2023-06-02,False,0,1,7,8,6,2,57,65,0,0,0,0,0,1,1,2,0,0,1,1,4,1,2,7
123019.0,Guedpard Pornpun,S,Thailand,30.0,170,2023,Germany,2023-06-14,False,0,0,13,13,27,1,63,91,2,0,1,3,0,1,3,4,0,0,0,0,5,2,3,10
123019.0,Guedpard Pornpun,S,Thailand,30.0,170,2023,USA,2023-06-15,False,0,0,10,10,14,0,53,67,1,0,0,1,1,2,2,5,0,0,0,0,7,3,2,12
123019.0,Guedpard Pornpun,S,Thailand,30.0,170,2023,Croatia,2023-06-18,False,0,0,9,9,17,0,43,60,1,0,3,4,0,3,1,4,0,0,0,0,6,1,1,8
123019.0,Guedpard Pornpun,S,Thailand,30.0,170,2023,Netherlands,2023-06-27,False,0,0,10,10,22,2,62,86,1,0,0,1,0,1,1,2,0,0,0,0,9,5,3,17
123019.0,Guedpard Pornpun,S,Thailand,30.0,170,2023,Japan,2023-07-01,False,0,2,7,9,17,0,53,70,0,0,2,2,0,2,3,5,0,0,1,1,6,1,0,7
123019.0,Guedpard Pornpun,S,Thailand,30.0,170,2023,Brazil,2023-07-02,False,0,0,1,1,3,1,9,13,0,0,1,1,0,0,1,1,0,0,0,0,0,0,0,0
142172.0,Nuekjang Thatdao,MB,Thailand,30.0,185,2023,Italy,2023-05-30,False,1,0,24,25,0,0,4,4,7,2,6,15,2,5,9,16,0,0,1,1,6,2,0,8
142172.0,Nuekjang Thatdao,MB,Thailand,30.0,185,2023,Canada,2023-06-01,True,1,3,12,16,0,0,5,5,6,2,5,13,0,1,7,8,2,0,4,6,3,3,0,6
142172.0,Nuekjang Thatdao,MB,Thailand,30.0,185,2023,Poland,2023-06-02,False,0,1,7,8,0,0,2,2,4,2,1,7,1,4,2,7,0,1,0,1,1,0,1,2
142172.0,Nuekjang Thatdao,MB,Thailand,30.0,185,2023,Germany,2023-06-14,False,0,0,12,12,0,0,4,4,15,3,8,26,2,3,4,9,0,0,0,0,2,1,0,3
142172.0,Nuekjang Thatdao,MB,Thailand,30.0,185,2023,USA,2023-06-15,False,1,1,8,10,0,0,0,0,2,2,4,8,3,4,3,10,0,0,1,1,1,1,0,2
142172.0,Nuekjang Thatdao,MB,Thailand,30.0,185,2023,Croatia,2023-06-18,False,0,2,4,6,0,0,3,3,3,1,1,5,0,3,1,4,0,1,0,1,0,2,0,2
142172.0,Nuekjang Thatdao,MB,Thailand,30.0,185,2023,Netherlands,2023-06-27,False,0,3,12,15,0,0,1,1,7,1,3,11,0,1,5,6,0,0,0,0,2,0,2,4
142172.0,Nuekjang Thatdao,MB,Thailand,30.0,185,2023,Japan,2023-07-01,False,0,1,7,8,0,0,3,3,5,0,6,11,2,2,7,11,0,0,0,0,4,0,0,4
142172.0,Nuekjang Thatdao,MB,Thailand,30.0,185,2023,Brazil,2023-07-02,False,0,0,0,0,0,0,0,0,0,0,0,0,0,0,0,0,0,0,0,0,0,0,0,0
145244.0,Bamrungsuk Hattaya,MB,Thailand,30.0,180,2023,Italy,2023-05-30,False,0,2,10,12,0,0,2,2,5,3,5,13,3,6,8,17,0,0,0,0,0,0,3,3
145244.0,Bamrungsuk Hattaya,MB,Thailand,30.0,180,2023,Canada,2023-06-01,True,1,0,12,13,0,1,2,3,2,0,1,3,3,4,6,13,0,0,1,1,2,0,2,4
145244.0,Bamrungsuk Hattaya,MB,Thailand,30.0,180,2023,Poland,2023-06-02,False,0,0,5,5,0,0,1,1,0,0,0,0,0,0,0,0,0,0,0,0,0,0,1,1
145244.0,Bamrungsuk Hattaya,MB,Thailand,30.0,180,2023,Germany,2023-06-14,False,0,0,5,5,0,0,0,0,4,0,3,7,1,0,4,5,0,0,0,0,1,0,1,2
145244.0,Bamrungsuk Hattaya,MB,Thailand,30.0,180,2023,USA,2023-06-15,False,0,0,5,5,0,0,0,0,1,0,2,3,0,1,6,7,0,0,0,0,0,2,0,2
145244.0,Bamrungsuk Hattaya,MB,Thailand,30.0,180,2023,Croatia,2023-06-18,False,0,1,7,8,0,0,0,0,4,1,1,6,0,2,4,6,0,0,0,0,3,1,2,6
145244.0,Bamrungsuk Hattaya,MB,Thailand,30.0,180,2023,Netherlands,2023-06-27,False,0,2,3,5,0,0,1,1,3,2,2,7,0,3,0,3,0,0,0,0,0,0,0,0
145244.0,Bamrungsuk Hattaya,MB,Thailand,30.0,180,2023,Japan,2023-07-01,False,1,1,8,10,0,0,1,1,2,2,6,10,2,4,8,14,0,0,0,0,2,1,1,4
145244.0,Bamrungsuk Hattaya,MB,Thailand,30.0,180,2023,Brazil,2023-07-02,False,0,1,4,5,0,0,2,2,0,0,4,4,0,1,2,3,0,0,0,0,0,0,0,0
122866.0,Chuewulim Sutadta,OH,Thailand,31.0,173,2023,Netherlands,2023-06-27,False,0,0,1,1,0,0,1,1,0,0,0,0,0,0,0,0,0,0,0,0,0,0,0,0
122866.0,Chuewulim Sutadta,OH,Thailand,31.0,173,2023,Japan,2023-07-01,False,0,0,6,6,0,0,4,4,3,3,13,19,0,0,4,4,3,0,9,12,4,1,2,7
122866.0,Chuewulim Sutadta,OH,Thailand,31.0,173,2023,Brazil,2023-07-02,False,0,0,0,0,0,1,7,8,0,0,0,0,0,0,0,0,0,0,8,8,2,2,2,6
147188.0,Phomla Soraya,S,Thailand,31.0,169,2023,Netherlands,2023-06-27,False,0,0,0,0,2,0,5,7,0,0,1,1,0,0,0,0,0,0,0,0,1,0,0,1
147188.0,Phomla Soraya,S,Thailand,31.0,169,2023,Japan,2023-07-01,False,0,0,1,1,6,1,8,15,1,0,1,2,0,0,3,3,0,0,0,0,4,0,0,4
147188.0,Phomla Soraya,S,Thailand,31.0,169,2023,Brazil,2023-07-02,False,1,1,3,5,13,1,51,65,0,0,1,1,0,2,0,2,0,0,0,0,2,1,0,3
151121.0,Kokram Pimpichaya,O,Thailand,25.0,180,2023,Italy,2023-05-30,False,1,3,16,20,0,0,3,3,21,8,19,48,0,1,3,4,1,0,0,1,11,1,3,15
151121.0,Kokram Pimpichaya,O,Thailand,25.0,180,2023,Canada,2023-06-01,True,2,0,10,12,1,0,3,4,6,4,14,24,0,2,2,4,0,0,0,0,6,7,0,13
151121.0,Kokram Pimpichaya,O,Thailand,25.0,180,2023,Poland,2023-06-02,False,0,1,6,7,0,0,1,1,5,2,8,15,0,3,4,7,0,0,0,0,2,3,2,7
151121.0,Kokram Pimpichaya,O,Thailand,25.0,180,2023,Germany,2023-06-14,False,0,2,9,11,0,0,1,1,9,5,9,23,1,0,1,2,0,0,1,1,3,2,1,6
151121.0,Kokram Pimpichaya,O,Thailand,25.0,180,2023,USA,2023-06-15,False,0,0,2,2,0,0,2,2,3,3,9,15,1,0,1,2,0,0,2,2,2,0,0,2
151121.0,Kokram Pimpichaya,O,Thailand,25.0,180,2023,Croatia,2023-06-18,False,0,0,6,6,0,0,1,1,2,5,6,13,0,0,3,3,0,0,1,1,1,1,0,2
151121.0,Kokram Pimpichaya,O,Thailand,25.0,180,2023,Netherlands,2023-06-27,False,0,0,5,5,0,0,0,0,3,2,12,17,0,0,3,3,0,0,0,0,3,0,0,3
151121.0,Kokram Pimpichaya,O,Thailand,25.0,180,2023,Japan,2023-07-01,False,0,0,9,9,0,0,3,3,5,4,10,19,0,1,1,2,0,0,2,2,8,0,2,10
151121.0,Kokram Pimpichaya,O,Thailand,25.0,180,2023,Brazil,2023-07-02,False,0,1,8,9,0,0,3,3,7,3,7,17,0,2,0,2,0,0,0,0,11,1,2,14
133511.0,Kongyot Ajcharaporn,OH,Thailand,28.0,180,2023,Italy,2023-05-30,False,0,1,14,15,0,0,4,4,11,3,17,31,2,2,0,4,6,0,16,22,7,3,3,13
133511.0,Kongyot Ajcharaporn,OH,Thailand,28.0,180,2023,Canada,2023-06-01,True,0,0,0,0,0,0,0,0,0,0,0,0,0,0,0,0,0,0,0,0,0,0,0,0
133511.0,Kongyot Ajcharaporn,OH,Thailand,28.0,180,2023,Poland,2023-06-02,False,0,1,5,6,0,0,4,4,4,1,7,12,0,0,0,0,3,1,12,16,7,2,1,10
133511.0,Kongyot Ajcharaporn,OH,Thailand,28.0,180,2023,Germany,2023-06-14,False,0,0,3,3,0,0,2,2,2,1,4,7,1,0,1,2,0,1,9,10,6,0,0,6
133511.0,Kongyot Ajcharaporn,OH,Thailand,28.0,180,2023,USA,2023-06-15,False,0,0,9,9,0,0,3,3,8,4,13,25,2,3,1,6,0,0,3,3,6,3,1,10
133511.0,Kongyot Ajcharaporn,OH,Thailand,28.0,180,2023,Croatia,2023-06-18,False,1,2,7,10,0,0,1,1,13,1,17,31,0,3,2,5,6,1,14,21,11,1,2,14
133511.0,Kongyot Ajcharaporn,OH,Thailand,28.0,180,2023,Netherlands,2023-06-27,False,0,0,4,4,0,0,0,0,8,1,5,14,0,2,1,3,1,2,8,11,1,1,1,3
133511.0,Kongyot Ajcharaporn,OH,Thailand,28.0,180,2023,Japan,2023-07-01,False,0,0,5,5,0,0,0,0,6,1,7,14,0,2,0,2,3,4,7,14,4,2,3,9
133511.0,Kongyot Ajcharaporn,OH,Thailand,28.0,180,2023,Brazil,2023-07-02,False,1,0,8,9,0,0,3,3,4,4,6,14,0,0,2,2,10,0,18,28,4,6,1,11
147213.0,Moksri Chatchu-On,OH,Thailand,24.0,180,2023,Italy,2023-05-30,False,0,3,11,14,0,0,3,3,15,9,15,39,0,1,1,2,7,6,31,44,16,5,4,25
147213.0,Moksri Chatchu-On,OH,Thailand,24.0,180,2023,Canada,2023-06-01,True,1,1,12,14,0,0,6,6,14,6,20,40,2,1,3,6,11,0,18,29,16,3,0,19
147213.0,Moksri Chatchu-On,OH,Thailand,24.0,180,2023,Poland,2023-06-02,False,0,1,6,7,0,0,1,1,7,5,10,22,3,1,0,4,2,0,12,14,1,0,2,3
147213.0,Moksri Chatchu-On,OH,Thailand,24.0,180,2023,Germany,2023-06-14,False,0,1,12,13,0,1,2,3,8,4,14,26,2,4,5,11,12,2,19,33,9,2,4,15
147213.0,Moksri Chatchu-On,OH,Thailand,24.0,180,2023,USA,2023-06-15,False,1,1,8,10,0,0,3,3,10,3,12,25,2,3,3,8,8,2,29,39,6,3,1,10
147213.0,Moksri Chatchu-On,OH,Thailand,24.0,180,2023,Croatia,2023-06-18,False,0,0,9,9,0,0,0,0,16,4,11,31,3,3,6,12,4,0,13,17,5,3,3,11
147213.0,Moksri Chatchu-On,OH,Thailand,24.0,180,2023,Netherlands,2023-06-27,False,0,2,8,10,0,0,3,3,13,5,10,28,0,5,2,7,3,2,25,30,7,2,1,10
147213.0,Moksri Chatchu-On,OH,Thailand,24.0,180,2023,Japan,2023-07-01,False,0,1,8,9,0,0,2,2,8,5,20,33,0,3,1,4,5,1,17,23,5,0,0,5
147213.0,Moksri Chatchu-On,OH,Thailand,24.0,180,2023,Brazil,2023-07-02,False,1,2,8,11,0,0,0,0,18,6,18,42,1,0,2,3,6,1,18,25,6,1,2,9
162681.0,Pairoj Supattra,L,Thailand,33.0,160,2023,Italy,2023-05-30,False,0,0,0,0,0,0,1,1,0,0,0,0,0,0,0,0,0,0,1,1,14,1,2,17
162681.0,Pairoj Supattra,L,Thailand,33.0,160,2023,Canada,2023-06-01,True,0,0,0,0,0,0,2,2,0,0,0,0,0,0,0,0,0,0,1,1,13,4,2,19
162681.0,Pairoj Supattra,L,Thailand,33.0,160,2023,Poland,2023-06-02,False,0,0,0,0,0,0,2,2,0,0,0,0,0,0,0,0,1,0,3,4,4,4,2,10
162681.0,Pairoj Supattra,L,Thailand,33.0,160,2023,Germany,2023-06-14,False,0,0,0,0,0,0,6,6,0,0,0,0,0,0,0,0,0,0,0,0,1,2,1,4
162681.0,Pairoj Supattra,L,Thailand,33.0,160,2023,USA,2023-06-15,False,0,0,0,0,0,0,2,2,0,0,0,0,0,0,0,0,0,0,0,0,0,4,0,4
162681.0,Pairoj Supattra,L,Thailand,33.0,160,2023,Croatia,2023-06-18,False,0,0,0,0,0,0,2,2,0,0,0,0,0,0,0,0,0,0,0,0,4,3,2,9
162681.0,Pairoj Supattra,L,Thailand,33.0,160,2023,Netherlands,2023-06-27,False,0,0,0,0,0,0,2,2,0,0,0,0,0,0,0,0,0,0,0,0,8,2,0,10
162681.0,Pairoj Supattra,L,Thailand,33.0,160,2023,Japan,2023-07-01,False,0,0,0,0,0,0,4,4,0,0,0,0,0,0,0,0,0,0,0,0,4,1,0,5
162681.0,Pairoj Supattra,L,Thailand,33.0,160,2023,Brazil,2023-07-02,False,0,0,0,0,0,0,0,0,0,0,0,0,0,0,0,0,0,0,0,0,1,1,1,3
152205.0,Sooksod Thanacha,O,Thailand,23.0,180,2023,Italy,2023-05-30,False,0,0,2,2,0,0,0,0,5,1,4,10,0,2,1,3,0,0,0,0,0,1,0,1
152205.0,Sooksod Thanacha,O,Thailand,23.0,180,2023,Canada,2023-06-01,True,0,0,0,0,0,0,0,0,0,1,0,1,0,0,0,0,0,0,0,0,0,0,0,0
152205.0,Sooksod Thanacha,O,Thailand,23.0,180,2023,Poland,2023-06-02,False,0,0,3,3,0,0,2,2,4,2,4,10,0,2,0,2,0,0,0,0,0,0,0,0
152205.0,Sooksod Thanacha,O,Thailand,23.0,180,2023,Germany,2023-06-14,False,0,0,5,5,0,0,1,1,4,2,2,8,0,0,0,0,0,0,0,0,3,2,0,5
152205.0,Sooksod Thanacha,O,Thailand,23.0,180,2023,USA,2023-06-15,False,0,0,1,1,0,0,0,0,0,1,1,2,0,0,0,0,1,0,0,1,1,0,0,1
152205.0,Sooksod Thanacha,O,Thailand,23.0,180,2023,Croatia,2023-06-18,False,0,1,2,3,0,0,1,1,3,1,2,6,0,1,0,1,0,0,0,0,1,0,0,1
152205.0,Sooksod Thanacha,O,Thailand,23.0,180,2023,Netherlands,2023-06-27,False,0,0,8,8,0,0,0,0,5,1,9,15,0,2,2,4,0,0,0,0,5,0,1,6
152205.0,Sooksod Thanacha,O,Thailand,23.0,180,2023,Japan,2023-07-01,False,0,1,2,3,0,0,0,0,0,0,6,6,0,2,0,2,0,0,0,0,3,0,0,3
152205.0,Sooksod Thanacha,O,Thailand,23.0,180,2023,Brazil,2023-07-02,False,0,0,7,7,0,0,3,3,1,0,3,4,0,1,1,2,0,0,0,0,2,0,0,2
163495.0,Boonlert Tichakorn,MB,Thailand,23.0,181,2023,Netherlands,2023-06-27,False,0,2,1,3,0,0,1,1,0,0,3,3,0,3,1,4,0,0,0,0,1,0,1,2
163495.0,Boonlert Tichakorn,MB,Thailand,23.0,181,2023,Japan,2023-07-01,False,0,0,0,0,0,0,0,0,0,0,0,0,0,0,0,0,0,0,0,0,0,0,0,0
163495.0,Boonlert Tichakorn,MB,Thailand,23.0,181,2023,Brazil,2023-07-02,False,0,1,2,3,0,0,0,0,0,1,2,3,0,1,3,4,0,0,0,0,0,0,0,0
143002.0,Bundasak Jarasporn,MB,Thailand,31.0,182,2023,Italy,2023-05-30,False,0,1,0,1,0,0,0,0,0,0,0,0,0,0,0,0,0,0,1,1,0,0,0,0
143002.0,Bundasak Jarasporn,MB,Thailand,31.0,182,2023,Canada,2023-06-01,True,0,0,0,0,0,0,0,0,0,0,0,0,0,0,0,0,0,0,0,0,0,0,0,0
143002.0,Bundasak Jarasporn,MB,Thailand,31.0,182,2023,Poland,2023-06-02,False,0,0,3,3,0,1,1,2,1,1,0,2,0,2,1,3,0,0,0,0,1,0,0,1
143002.0,Bundasak Jarasporn,MB,Thailand,31.0,182,2023,Germany,2023-06-14,False,0,1,5,6,0,0,0,0,4,0,4,8,0,0,2,2,0,0,0,0,2,0,0,2
143002.0,Bundasak Jarasporn,MB,Thailand,31.0,182,2023,USA,2023-06-15,False,0,0,5,5,0,0,0,0,0,0,2,2,0,1,0,1,1,0,0,1,1,0,0,1
143002.0,Bundasak Jarasporn,MB,Thailand,31.0,182,2023,Croatia,2023-06-18,False,0,0,1,1,0,0,0,0,1,1,1,3,0,3,0,3,0,0,0,0,0,0,0,0
143002.0,Bundasak Jarasporn,MB,Thailand,31.0,182,2023,Netherlands,2023-06-27,False,0,0,0,0,0,0,0,0,0,0,0,0,0,0,0,0,0,0,0,0,0,0,0,0
143002.0,Bundasak Jarasporn,MB,Thailand,31.0,182,2023,Japan,2023-07-01,False,0,0,2,2,0,0,0,0,1,0,1,2,0,0,1,1,0,0,0,0,0,0,0,0
143002.0,Bundasak Jarasporn,MB,Thailand,31.0,182,2023,Brazil,2023-07-02,False,0,0,8,8,0,0,0,0,2,0,6,8,3,0,3,6,0,0,0,0,0,4,0,4
132835.0,Hancock Micha,S,USA,31.0,180,2023,Serbia,2023-05-31,False,0,0,13,13,12,0,110,122,3,2,1,6,0,3,9,12,0,0,0,0,6,4,2,12
132835.0,Hancock Micha,S,USA,31.0,180,2023,Italy,2023-06-02,False,0,2,10,12,15,0,99,114,1,0,3,4,1,1,6,8,0,0,0,0,10,6,3,19
132835.0,Hancock Micha,S,USA,31.0,180,2023,Croatia,2023-06-13,False,0,0,9,9,10,1,54,65,2,0,0,2,1,2,3,6,0,0,0,0,8,2,0,10
132835.0,Hancock Micha,S,USA,31.0,180,2023,Thailand,2023-06-15,False,3,2,15,20,20,0,63,83,2,0,2,4,0,1,3,4,0,0,1,1,12,4,2,18
132835.0,Hancock Micha,S,USA,31.0,180,2023,Japan,2023-06-17,False,0,0,6,6,1,1,15,17,0,0,0,0,0,0,0,0,0,1,1,2,1,0,0,1
132835.0,Hancock Micha,S,USA,31.0,180,2023,Brazil,2023-06-18,False,2,1,15,18,9,0,59,68,1,1,0,2,0,5,3,8,0,0,0,0,3,0,0,3
132835.0,Hancock Micha,S,USA,31.0,180,2023,Poland,2023-06-28,False,2,2,19,23,25,0,115,140,4,1,1,6,1,3,13,17,0,0,3,3,5,4,2,11
132835.0,Hancock Micha,S,USA,31.0,180,2023,Bulgaria,2023-06-29,False,0,0,0,0,0,0,0,0,0,0,0,0,0,0,0,0,0,0,0,0,0,0,0,0
132835.0,Hancock Micha,S,USA,31.0,180,2023,Germany,2023-07-01,False,1,0,13,14,10,0,43,53,0,0,0,0,1,1,2,4,0,0,0,0,6,1,1,8
132835.0,Hancock Micha,S,USA,31.0,180,2023,China,2023-07-02,False,0,2,3,5,0,0,1,1,0,0,0,0,0,0,0,0,0,0,0,0,0,1,0,1
132835.0,Hancock Micha,S,USA,31.0,180,2023,Poland,2023-07-16,False,2,0,3,5,3,0,17,20,0,0,1,1,0,1,2,3,0,0,0,0,0,2,1,3
135564.0,Wong-Orantes Justine,L,USA,28.0,168,2023,Serbia,2023-05-31,False,0,0,0,0,0,1,8,9,0,0,0,0,0,0,0,0,4,0,7,11,11,6,3,20
135564.0,Wong-Orantes Justine,L,USA,28.0,168,2023,Italy,2023-06-02,False,0,0,0,0,0,0,0,0,0,0,0,0,0,0,0,0,0,0,0,0,0,0,0,0
135564.0,Wong-Orantes Justine,L,USA,28.0,168,2023,Poland,2023-06-28,False,0,0,0,0,0,0,15,15,0,0,0,0,0,0,0,0,6,2,8,16,23,5,4,32
135564.0,Wong-Orantes Justine,L,USA,28.0,168,2023,Bulgaria,2023-06-29,False,0,0,0,0,0,0,0,0,0,0,0,0,0,0,0,0,0,0,0,0,0,0,0,0
135564.0,Wong-Orantes Justine,L,USA,28.0,168,2023,Germany,2023-07-01,False,0,0,0,0,0,0,19,19,0,0,0,0,0,0,0,0,3,1,5,9,17,7,1,25
135564.0,Wong-Orantes Justine,L,USA,28.0,168,2023,China,2023-07-02,False,0,0,0,0,0,0,8,8,0,0,0,0,0,0,0,0,3,0,11,14,17,4,0,21
135564.0,Wong-Orantes Justine,L,USA,28.0,168,2023,Poland,2023-07-16,False,0,0,0,0,0,0,13,13,0,0,0,0,0,0,0,0,2,2,10,14,12,8,2,22
139848.0,Frantti Alexandra,OH,USA,28.0,191,2023,Croatia,2023-06-13,False,1,1,16,18,0,0,3,3,15,2,14,31,1,4,2,7,3,1,26,30,8,2,1,11
139848.0,Frantti Alexandra,OH,USA,28.0,191,2023,Thailand,2023-06-15,False,0,0,0,0,0,0,0,0,0,0,0,0,0,0,0,0,0,0,0,0,0,0,0,0
139848.0,Frantti Alexandra,OH,USA,28.0,191,2023,Japan,2023-06-17,False,0,0,0,0,0,0,0,0,0,0,0,0,0,0,0,0,0,0,0,0,0,0,0,0
139848.0,Frantti Alexandra,OH,USA,28.0,191,2023,Brazil,2023-06-18,False,0,0,0,0,0,0,0,0,0,0,0,0,0,0,0,0,0,0,0,0,0,0,0,0
139848.0,Frantti Alexandra,OH,USA,28.0,191,2023,Poland,2023-06-28,False,0,1,18,19,0,0,2,2,12,2,11,25,0,5,3,8,8,1,24,33,10,2,2,14
139848.0,Frantti Alexandra,OH,USA,28.0,191,2023,Bulgaria,2023-06-29,False,0,0,0,0,0,0,0,0,0,0,0,0,0,0,0,0,0,0,0,0,0,0,0,0
139848.0,Frantti Alexandra,OH,USA,28.0,191,2023,Germany,2023-07-01,False,1,1,18,20,0,0,3,3,15,8,21,44,1,2,4,7,10,0,12,22,8,1,2,11
139848.0,Frantti Alexandra,OH,USA,28.0,191,2023,China,2023-07-02,False,0,0,0,0,0,0,0,0,0,0,0,0,0,0,0,0,1,0,6,7,0,1,0,1
139848.0,Frantti Alexandra,OH,USA,28.0,191,2023,Poland,2023-07-16,False,1,0,2,3,0,0,1,1,2,3,2,7,0,0,1,1,0,1,6,7,4,1,0,5
152187.0,Hentz Morgan,L,USA,25.0,175,2023,Serbia,2023-05-31,False,0,0,0,0,0,0,0,0,0,0,0,0,0,0,0,0,0,0,0,0,0,0,0,0
152187.0,Hentz Morgan,L,USA,25.0,175,2023,Italy,2023-06-02,False,0,0,0,0,0,0,8,8,0,0,0,0,0,0,0,0,3,1,8,12,16,3,0,19
152187.0,Hentz Morgan,L,USA,25.0,175,2023,Croatia,2023-06-13,False,0,0,0,0,0,0,0,0,0,0,0,0,0,0,0,0,0,0,0,0,0,0,0,0
152187.0,Hentz Morgan,L,USA,25.0,175,2023,Thailand,2023-06-15,False,0,0,0,0,0,0,17,17,0,0,0,0,0,0,0,0,2,0,10,12,7,2,0,9
152187.0,Hentz Morgan,L,USA,25.0,175,2023,Japan,2023-06-17,False,0,0,0,0,0,0,0,0,0,0,0,0,0,0,0,0,0,0,0,0,0,0,0,0
152187.0,Hentz Morgan,L,USA,25.0,175,2023,Brazil,2023-06-18,False,0,0,0,0,0,0,7,7,0,0,0,0,0,0,0,0,2,0,4,6,9,3,3,15
152187.0,Hentz Morgan,L,USA,25.0,175,2023,Poland,2023-06-28,False,0,0,0,0,0,0,0,0,0,0,0,0,0,0,0,0,0,0,0,0,0,0,0,0
152187.0,Hentz Morgan,L,USA,25.0,175,2023,Bulgaria,2023-06-29,False,0,0,0,0,0,0,10,10,0,0,0,0,0,0,0,0,1,0,3,4,3,4,2,9
152187.0,Hentz Morgan,L,USA,25.0,175,2023,Germany,2023-07-01,False,0,0,0,0,0,0,0,0,0,0,0,0,0,0,0,0,0,0,0,0,0,0,0,0
152187.0,Hentz Morgan,L,USA,25.0,175,2023,China,2023-07-02,False,0,0,0,0,0,0,0,0,0,0,0,0,0,0,0,0,0,0,0,0,0,0,0,0
152187.0,Hentz Morgan,L,USA,25.0,175,2023,Poland,2023-07-16,False,0,0,0,0,0,0,3,3,0,0,0,0,0,0,0,0,1,0,2,3,4,0,0,4
132500.0,Carlini Lauren,S,USA,29.0,185,2023,Poland,2023-06-28,False,0,0,0,0,0,0,0,0,0,0,0,0,0,0,0,0,0,0,0,0,0,0,0,0
132500.0,Carlini Lauren,S,USA,29.0,185,2023,Bulgaria,2023-06-29,False,0,2,2,4,12,2,37,51,1,1,1,3,2,3,2,7,0,0,1,1,10,2,0,12
132500.0,Carlini Lauren,S,USA,29.0,185,2023,Germany,2023-07-01,False,0,0,3,3,10,2,44,56,2,0,0,2,0,1,1,2,0,1,0,1,10,2,0,12
132500.0,Carlini Lauren,S,USA,29.0,185,2023,China,2023-07-02,False,0,0,15,15,37,1,90,128,4,0,3,7,0,4,5,9,0,0,0,0,4,6,2,12
132500.0,Carlini Lauren,S,USA,29.0,185,2023,Poland,2023-07-16,False,0,0,8,8,17,0,74,91,2,0,1,3,1,4,7,12,0,0,0,0,7,2,0,9
155307.0,Drews Andrea,O,USA,30.0,191,2023,Serbia,2023-05-31,False,2,4,12,18,0,0,2,2,22,6,15,43,1,3,2,6,0,0,0,0,14,7,3,24
155307.0,Drews Andrea,O,USA,30.0,191,2023,Italy,2023-06-02,False,0,3,15,18,0,0,0,0,12,5,18,35,0,3,3,6,0,0,0,0,10,7,1,18
155307.0,Drews Andrea,O,USA,30.0,191,2023,Poland,2023-06-28,False,1,1,12,14,0,0,1,1,18,9,21,48,1,3,4,8,0,0,0,0,7,1,1,9
155307.0,Drews Andrea,O,USA,30.0,191,2023,Bulgaria,2023-06-29,False,0,0,0,0,0,0,0,0,0,0,0,0,0,0,0,0,0,0,0,0,0,0,0,0
155307.0,Drews Andrea,O,USA,30.0,191,2023,Germany,2023-07-01,False,0,0,0,0,0,0,0,0,0,0,0,0,0,0,0,0,0,0,0,0,0,0,0,0
155307.0,Drews Andrea,O,USA,30.0,191,2023,China,2023-07-02,False,0,3,5,8,0,0,4,4,15,4,19,38,1,10,3,14,0,0,0,0,7,2,1,10
155307.0,Drews Andrea,O,USA,30.0,191,2023,Poland,2023-07-16,False,0,1,13,14,0,0,0,0,9,4,11,24,1,2,1,4,0,0,0,0,3,0,0,3
172978.0,Thompson Jordan,O,USA,26.0,193,2023,Croatia,2023-06-13,False,1,0,11,12,0,0,2,2,14,1,9,24,2,2,3,7,0,0,0,0,4,2,2,8
172978.0,Thompson Jordan,O,USA,26.0,193,2023,Thailand,2023-06-15,False,0,1,9,10,0,0,2,2,14,6,16,36,1,1,2,4,0,0,0,0,9,2,0,11
172978.0,Thompson Jordan,O,USA,26.0,193,2023,Japan,2023-06-17,False,0,0,1,1,0,0,0,0,3,2,5,10,2,1,1,4,0,0,0,0,0,0,0,0
172978.0,Thompson Jordan,O,USA,26.0,193,2023,Brazil,2023-06-18,False,2,1,11,14,0,0,2,2,13,4,8,25,0,1,0,1,0,0,0,0,6,2,0,8
172978.0,Thompson Jordan,O,USA,26.0,193,2023,Poland,2023-06-28,False,0,0,2,2,0,0,0,0,5,3,6,14,0,0,2,2,0,0,1,1,0,0,0,0
172978.0,Thompson Jordan,O,USA,26.0,193,2023,Bulgaria,2023-06-29,False,1,1,7,9,0,0,4,4,11,2,9,22,4,2,5,11,0,0,0,0,8,0,0,8
172978.0,Thompson Jordan,O,USA,26.0,193,2023,Germany,2023-07-01,False,2,0,15,17,0,0,6,6,14,6,24,44,1,1,7,9,0,0,0,0,10,2,0,12
172978.0,Thompson Jordan,O,USA,26.0,193,2023,China,2023-07-02,False,0,0,0,0,0,0,0,0,0,0,0,0,0,0,0,0,0,0,0,0,0,0,0,0
172978.0,Thompson Jordan,O,USA,26.0,193,2023,Poland,2023-07-16,False,0,2,4,6,0,0,2,2,5,3,12,20,0,2,3,5,0,0,0,0,6,5,3,14
140052.0,Washington Haleigh,MB,USA,28.0,190,2023,Croatia,2023-06-13,False,0,0,0,0,0,0,0,0,0,0,0,0,0,0,0,0,0,0,0,0,0,0,0,0
140052.0,Washington Haleigh,MB,USA,28.0,190,2023,Thailand,2023-06-15,False,0,0,10,10,0,0,0,0,7,3,2,12,3,4,3,10,0,0,0,0,0,0,0,0
140052.0,Washington Haleigh,MB,USA,28.0,190,2023,Japan,2023-06-17,False,0,0,0,0,0,0,0,0,0,0,0,0,0,0,0,0,0,0,0,0,0,0,0,0
140052.0,Washington Haleigh,MB,USA,28.0,190,2023,Brazil,2023-06-18,False,0,0,10,10,0,0,1,1,5,0,1,6,3,4,2,9,0,0,0,0,0,0,0,0
140052.0,Washington Haleigh,MB,USA,28.0,190,2023,Poland,2023-06-28,False,1,1,15,17,0,0,2,2,5,2,3,10,5,11,5,21,0,0,1,1,4,2,1,7
140052.0,Washington Haleigh,MB,USA,28.0,190,2023,Bulgaria,2023-06-29,False,0,0,0,0,0,0,0,0,0,0,0,0,0,0,0,0,0,0,0,0,0,0,0,0
140052.0,Washington Haleigh,MB,USA,28.0,190,2023,Germany,2023-07-01,False,0,0,0,0,0,0,0,0,0,0,0,0,0,0,0,0,0,0,0,0,0,0,0,0
140052.0,Washington Haleigh,MB,USA,28.0,190,2023,China,2023-07-02,False,0,3,13,16,0,0,1,1,7,0,7,14,0,1,4,5,0,0,0,0,3,0,2,5
140052.0,Washington Haleigh,MB,USA,28.0,190,2023,Poland,2023-07-16,False,0,0,3,3,0,0,0,0,0,0,2,2,1,1,0,2,0,0,0,0,1,0,0,1
172977.0,Rettke Dana,MB,USA,25.0,203,2023,Serbia,2023-05-31,False,0,1,4,5,0,0,2,2,3,2,3,8,1,1,3,5,0,1,0,1,1,0,0,1
172977.0,Rettke Dana,MB,USA,25.0,203,2023,Italy,2023-06-02,False,1,1,16,18,0,0,1,1,11,1,8,20,2,3,10,15,1,0,1,2,4,1,1,6
172977.0,Rettke Dana,MB,USA,25.0,203,2023,Poland,2023-06-28,False,0,1,16,17,0,0,3,3,10,0,7,17,3,3,9,15,1,0,4,5,5,2,1,8
172977.0,Rettke Dana,MB,USA,25.0,203,2023,Bulgaria,2023-06-29,False,0,0,0,0,0,0,0,0,0,0,0,0,0,0,0,0,0,0,0,0,0,0,0,0
172977.0,Rettke Dana,MB,USA,25.0,203,2023,Germany,2023-07-01,False,0,0,1,1,0,0,0,0,0,0,0,0,0,0,0,0,0,0,0,0,0,1,0,1
172977.0,Rettke Dana,MB,USA,25.0,203,2023,China,2023-07-02,False,1,3,9,13,0,0,3,3,7,1,4,12,2,3,7,12,0,0,3,3,1,1,1,3
172977.0,Rettke Dana,MB,USA,25.0,203,2023,Poland,2023-07-16,False,0,2,5,7,0,0,0,0,0,0,1,1,0,1,1,2,0,1,1,2,1,0,0,1
141933.0,Robinson Kelsey,OH,USA,31.0,188,2023,Poland,2023-06-28,False,0,0,16,16,0,0,8,8,17,8,21,46,3,6,6,15,8,0,19,27,10,2,0,12
141933.0,Robinson Kelsey,OH,USA,31.0,188,2023,Bulgaria,2023-06-29,False,0,0,0,0,0,0,0,0,0,0,0,0,0,0,0,0,0,0,0,0,0,0,0,0
141933.0,Robinson Kelsey,OH,USA,31.0,188,2023,Germany,2023-07-01,False,0,0,0,0,0,0,0,0,0,0,0,0,0,0,0,0,0,0,1,1,1,0,0,1
141933.0,Robinson Kelsey,OH,USA,31.0,188,2023,China,2023-07-02,False,0,2,17,19,0,0,5,5,17,6,24,47,0,7,3,10,5,1,19,25,10,1,1,12
141933.0,Robinson Kelsey,OH,USA,31.0,188,2023,Poland,2023-07-16,False,0,1,18,19,0,0,3,3,6,4,18,28,0,3,3,6,8,1,12,21,7,2,0,9
166638.0,Ogbogu Chiaka,MB,USA,28.0,188,2023,Poland,2023-07-16,False,1,1,7,9,0,0,2,2,4,0,2,6,4,6,8,18,0,0,0,0,0,1,0,1
200701.0,O'Neal Asjia,MB,USA,24.0,190,2023,Serbia,2023-05-31,False,0,1,10,11,0,0,1,1,4,0,4,8,1,1,7,9,0,0,0,0,1,1,0,2
200701.0,O'Neal Asjia,MB,USA,24.0,190,2023,Italy,2023-06-02,False,1,3,19,23,0,1,3,4,7,1,3,11,3,3,5,11,0,0,1,1,1,1,2,4
200701.0,O'Neal Asjia,MB,USA,24.0,190,2023,Croatia,2023-06-13,False,0,0,7,7,0,0,1,1,3,0,1,4,2,3,6,11,0,0,0,0,1,1,0,2
200701.0,O'Neal Asjia,MB,USA,24.0,190,2023,Thailand,2023-06-15,False,0,1,10,11,0,0,0,0,8,0,4,12,5,2,7,14,0,0,2,2,3,0,0,3
200701.0,O'Neal Asjia,MB,USA,24.0,190,2023,Japan,2023-06-17,False,0,0,0,0,0,0,0,0,0,0,0,0,0,0,0,0,0,0,0,0,0,0,0,0
200701.0,O'Neal Asjia,MB,USA,24.0,190,2023,Brazil,2023-06-18,False,0,1,9,10,0,0,0,0,3,2,2,7,1,5,3,9,0,0,1,1,2,1,0,3
200701.0,O'Neal Asjia,MB,USA,24.0,190,2023,Poland,2023-07-16,False,1,1,11,13,0,0,1,1,4,2,5,11,4,4,8,16,0,1,0,1,2,2,1,5
192906.0,Skinner Avery,OH,USA,24.0,186,2023,Serbia,2023-05-31,False,1,3,15,19,0,0,1,1,17,4,11,32,1,4,2,7,5,1,29,35,10,6,0,16
192906.0,Skinner Avery,OH,USA,24.0,186,2023,Italy,2023-06-02,False,0,0,2,2,0,0,0,0,0,1,3,4,0,0,0,0,0,0,3,3,1,0,0,1
192906.0,Skinner Avery,OH,USA,24.0,186,2023,Croatia,2023-06-13,False,0,0,0,0,0,0,0,0,0,0,0,0,0,0,0,0,0,0,0,0,0,0,0,0
192906.0,Skinner Avery,OH,USA,24.0,186,2023,Thailand,2023-06-15,False,0,0,8,8,0,1,1,2,13,3,10,26,2,1,3,6,3,0,12,15,8,0,1,9
192906.0,Skinner Avery,OH,USA,24.0,186,2023,Japan,2023-06-17,False,1,2,14,17,0,0,2,2,12,8,18,38,1,2,2,5,4,1,29,34,11,7,1,19
192906.0,Skinner Avery,OH,USA,24.0,186,2023,Brazil,2023-06-18,False,0,0,0,0,0,0,0,0,0,0,0,0,0,0,0,0,0,0,0,0,0,0,0,0
192906.0,Skinner Avery,OH,USA,24.0,186,2023,Poland,2023-07-16,False,0,2,9,11,0,0,2,2,15,2,12,29,3,1,3,7,1,0,26,27,5,1,0,6
147590.0,Lanier Khalia,OH,USA,25.0,190,2023,Serbia,2023-05-31,False,2,2,15,19,0,0,3,3,13,5,16,34,1,1,4,6,7,0,29,36,10,3,0,13
147590.0,Lanier Khalia,OH,USA,25.0,190,2023,Italy,2023-06-02,False,1,2,12,15,0,0,1,1,13,2,15,30,2,4,3,9,4,2,16,22,3,1,1,5
147590.0,Lanier Khalia,OH,USA,25.0,190,2023,Croatia,2023-06-13,False,0,4,12,16,0,0,5,5,12,4,16,32,1,2,4,7,2,2,18,22,9,1,0,10
147590.0,Lanier Khalia,OH,USA,25.0,190,2023,Thailand,2023-06-15,False,0,0,0,0,0,0,0,0,0,0,0,0,0,0,0,0,0,0,0,0,0,0,0,0
147590.0,Lanier Khalia,OH,USA,25.0,190,2023,Japan,2023-06-17,False,2,0,13,15,0,0,3,3,15,3,15,33,3,8,2,13,6,0,23,29,16,2,1,19
147590.0,Lanier Khalia,OH,USA,25.0,190,2023,Brazil,2023-06-18,False,0,0,8,8,0,0,3,3,12,1,9,22,0,4,2,6,2,0,5,7,3,3,1,7
147590.0,Lanier Khalia,OH,USA,25.0,190,2023,Poland,2023-07-16,False,0,1,1,2,0,0,1,1,3,1,6,10,0,2,0,2,1,1,9,11,1,0,0,1
